PID,Step,Dispatch,Followed,ResultingOptMakespan,Rank,phi.proc,phi.startTime,phi.endTime,phi.arrival,phi.wait,phi.macFree,phi.makespan,phi.reducedSlack,phi.macSlack,phi.allSlack,phi.jobOps,phi.macOps,phi.jobWrm,phi.macWrm,phi.jobTotProcTime,phi.macTotProcTime,xi.step,xi.totProcTime,xi.totWrm
1501,0,0.0.0,0,582,0,27,0,27,0,0,27,27,0,0,0,1,1,220,244,220,244,1,1619,1619
1501,0,1.0.0,0,611,2,29,0,29,0,0,29,29,0,0,0,1,1,246,244,246,244,1,1619,1619
1501,0,2.0.0,0,582,0,18,0,18,0,0,18,18,0,0,0,1,1,203,244,203,244,1,1619,1619
1501,0,3.0.0,1,615,3,55,0,55,0,0,55,55,0,0,0,1,1,378,244,378,244,1,1619,1619
1501,0,4.0.0,0,584,1,25,0,25,0,0,25,25,0,0,0,1,1,205,244,205,244,1,1619,1619
1501,0,5.0.0,0,634,4,90,0,90,0,0,90,90,0,0,0,1,1,367,244,367,244,1,1619,1619
1501,1,0.0.55,0,625,1,27,55,82,0,55,82,82,0,0,0,1,2,220,189,220,244,2,1619,1564
1501,1,1.0.55,1,644,2,29,55,84,0,55,84,84,0,0,0,1,2,246,189,246,244,2,1619,1564
1501,1,2.0.55,0,615,0,18,55,73,0,55,73,73,0,0,0,1,2,203,189,203,244,2,1619,1564
1501,1,3.1.55,0,651,3,97,55,152,55,0,152,152,-55,55,55,2,1,323,297,378,297,2,1619,1564
1501,1,4.0.55,0,625,1,25,55,80,0,55,80,80,0,0,0,1,2,205,189,205,244,2,1619,1564
1501,1,5.0.55,0,669,4,90,55,145,0,55,145,145,0,0,0,1,2,367,189,367,244,2,1619,1564
1501,2,0.0.84,0,654,2,27,84,111,0,84,111,111,0,0,0,1,3,220,160,220,244,3,1619,1535
1501,2,1.1.84,0,670,3,66,84,150,84,0,150,150,-84,84,84,2,1,217,297,246,297,3,1619,1535
1501,2,2.0.84,1,644,0,18,84,102,0,84,102,102,0,0,0,1,3,203,160,203,244,3,1619,1535
1501,2,3.1.55,0,652,1,97,55,152,55,0,152,152,-55,55,55,2,1,323,297,378,297,3,1619,1535
1501,2,4.0.84,0,652,1,25,84,109,0,84,109,109,0,0,0,1,3,205,160,205,244,3,1619,1535
1501,2,5.0.84,0,679,4,90,84,174,0,84,174,174,0,0,0,1,3,367,160,367,244,3,1619,1535
1501,3,0.0.102,1,648,1,27,102,129,0,102,129,129,0,0,0,1,4,220,142,220,244,4,1619,1517
1501,3,1.1.84,0,670,4,66,84,150,84,0,150,150,-84,84,84,2,1,217,297,246,297,4,1619,1517
1501,3,2.1.102,0,644,0,1,102,103,102,0,103,103,-102,102,102,2,1,185,297,203,297,4,1619,1517
1501,3,3.1.55,0,656,2,97,55,152,55,0,152,152,-55,55,55,2,1,323,297,378,297,4,1619,1517
1501,3,4.0.102,0,644,0,25,102,127,0,102,127,127,0,0,0,1,4,205,142,205,244,4,1619,1517
1501,3,5.0.102,0,667,3,90,102,192,0,102,192,192,0,0,0,1,4,367,142,367,244,4,1619,1517
1501,4,0.1.129,0,648,0,7,129,136,129,0,136,136,-129,129,129,2,1,193,297,220,297,5,1619,1490
1501,4,1.1.84,0,670,2,66,84,150,84,0,150,150,-84,84,84,2,1,217,297,246,297,5,1619,1490
1501,4,2.1.102,0,648,0,1,102,103,102,0,103,129,-102,102,102,2,1,185,297,203,297,5,1619,1490
1501,4,3.1.55,0,666,1,97,55,152,55,0,152,152,-55,55,55,2,1,323,297,378,297,5,1619,1490
1501,4,4.0.129,1,648,0,25,129,154,0,129,154,154,0,0,0,1,5,205,115,205,244,5,1619,1490
1501,4,5.0.129,0,676,3,90,129,219,0,129,219,219,0,0,0,1,5,367,115,367,244,5,1619,1490
1501,5,0.1.129,0,648,0,7,129,136,129,0,136,154,-129,129,129,2,1,193,297,220,297,6,1619,1465
1501,5,1.1.84,0,670,2,66,84,150,84,0,150,154,-84,84,84,2,1,217,297,246,297,6,1619,1465
1501,5,2.1.102,0,648,0,1,102,103,102,0,103,154,-102,102,102,2,1,185,297,203,297,6,1619,1465
1501,5,3.1.55,0,666,1,97,55,152,55,0,152,154,-55,55,55,2,1,323,297,378,297,6,1619,1465
1501,5,4.1.154,0,648,0,37,154,191,154,0,191,191,-154,154,154,2,1,180,297,205,297,6,1619,1465
1501,5,5.0.154,1,648,0,90,154,244,0,154,244,244,0,0,0,1,6,367,90,367,244,6,1619,1465
1501,6,0.1.129,0,648,0,7,129,136,129,0,136,244,-129,129,129,2,1,193,297,220,297,7,1619,1375
1501,6,1.1.84,0,670,3,66,84,150,84,0,150,244,-84,84,84,2,1,217,297,246,297,7,1619,1375
1501,6,2.1.102,0,648,0,1,102,103,102,0,103,244,-102,102,102,2,1,185,297,203,297,7,1619,1375
1501,6,3.1.55,1,666,2,97,55,152,55,0,152,244,-55,55,55,2,1,323,297,378,297,7,1619,1375
1501,6,4.1.154,0,648,0,37,154,191,154,0,191,244,-154,154,154,2,1,180,297,205,297,7,1619,1375
1501,6,5.1.244,0,650,1,89,244,333,244,0,333,333,-244,244,244,2,1,277,297,367,297,7,1619,1375
1501,7,0.1.152,0,666,0,7,152,159,129,23,159,244,0,55,55,2,2,193,200,220,297,8,1619,1278
1501,7,1.1.152,0,683,1,66,152,218,84,68,218,244,0,55,55,2,2,217,200,246,297,8,1619,1278
1501,7,2.1.152,1,666,0,1,152,153,102,50,153,244,0,55,55,2,2,185,200,203,297,8,1619,1278
1501,7,3.2.152,0,683,1,87,152,239,152,0,239,244,-152,152,207,3,1,226,298,378,298,8,1619,1278
1501,7,4.1.154,0,666,0,37,154,191,154,0,191,244,-2,57,57,2,2,180,200,205,297,8,1619,1278
1501,7,5.1.244,0,666,0,89,244,333,244,0,333,333,-92,147,147,2,2,277,200,367,297,8,1619,1278
1501,8,0.1.153,1,666,0,7,153,160,129,24,160,244,0,55,55,2,3,193,199,220,297,9,1619,1277
1501,8,1.1.153,0,683,1,66,153,219,84,69,219,244,0,55,55,2,3,217,199,246,297,9,1619,1277
1501,8,2.2.153,0,694,2,91,153,244,153,0,244,244,-153,153,208,3,1,184,298,203,298,9,1619,1277
1501,8,3.2.152,0,683,1,87,152,239,152,0,239,244,-152,152,207,3,1,226,298,378,298,9,1619,1277
1501,8,4.1.154,0,666,0,37,154,191,154,0,191,244,-1,56,56,2,3,180,199,205,297,9,1619,1277
1501,8,5.1.244,0,666,0,89,244,333,244,0,333,333,-91,146,146,2,3,277,199,367,297,9,1619,1277
1501,9,0.2.160,0,692,2,82,160,242,160,0,242,244,-160,160,215,3,1,186,298,220,298,10,1619,1270
1501,9,1.1.160,1,683,1,66,160,226,84,76,226,244,0,55,55,2,4,217,192,246,297,10,1619,1270
1501,9,2.2.153,0,694,3,91,153,244,153,0,244,244,-153,153,208,3,1,184,298,203,298,10,1619,1270
1501,9,3.2.152,0,683,1,87,152,239,152,0,239,244,-152,152,207,3,1,226,298,378,298,10,1619,1270
1501,9,4.1.160,0,666,0,37,160,197,154,6,197,244,0,55,55,2,4,180,192,205,297,10,1619,1270
1501,9,5.1.244,0,666,0,89,244,333,244,0,333,333,-84,139,139,2,4,277,192,367,297,10,1619,1270
1501,10,0.2.160,0,695,1,82,160,242,160,0,242,244,-160,160,215,3,1,186,298,220,298,11,1619,1204
1501,10,1.2.226,0,725,3,22,226,248,226,0,248,248,-226,226,281,3,1,151,298,246,298,11,1619,1204
1501,10,2.2.153,0,696,2,91,153,244,153,0,244,244,-153,153,208,3,1,184,298,203,298,11,1619,1204
1501,10,3.2.152,0,683,0,87,152,239,152,0,239,244,-152,152,207,3,1,226,298,378,298,11,1619,1204
1501,10,4.1.226,1,683,0,37,226,263,154,72,263,263,0,55,55,2,5,180,126,205,297,11,1619,1204
1501,10,5.1.244,0,696,2,89,244,333,244,0,333,333,-18,73,73,2,5,277,126,367,297,11,1619,1204
1501,11,0.2.160,0,695,1,82,160,242,160,0,242,263,-160,160,215,3,1,186,298,220,298,12,1619,1167
1501,11,1.2.226,0,725,3,22,226,248,226,0,248,263,-226,226,281,3,1,151,298,246,298,12,1619,1167
1501,11,2.2.153,0,696,2,91,153,244,153,0,244,263,-153,153,208,3,1,184,298,203,298,12,1619,1167
1501,11,3.2.152,0,683,0,87,152,239,152,0,239,263,-152,152,207,3,1,226,298,378,298,12,1619,1167
1501,11,4.2.263,0,683,0,3,263,266,263,0,266,266,-263,263,318,3,1,143,298,205,298,12,1619,1167
1501,11,5.1.263,1,683,0,89,263,352,244,19,352,352,0,55,55,2,6,277,89,367,297,12,1619,1167
1501,12,0.2.160,0,695,1,82,160,242,160,0,242,352,-160,160,215,3,1,186,298,220,298,13,1619,1078
1501,12,1.2.226,0,725,3,22,226,248,226,0,248,352,-226,226,281,3,1,151,298,246,298,13,1619,1078
1501,12,2.2.153,0,696,2,91,153,244,153,0,244,352,-153,153,208,3,1,184,298,203,298,13,1619,1078
1501,12,3.2.152,1,683,0,87,152,239,152,0,239,352,-152,152,207,3,1,226,298,378,298,13,1619,1078
1501,12,4.2.263,0,683,0,3,263,266,263,0,266,352,-263,263,318,3,1,143,298,205,298,13,1619,1078
1501,12,5.2.352,0,683,0,13,352,365,352,0,365,365,-352,352,407,3,1,188,298,367,298,13,1619,1078
1501,13,0.2.239,0,696,1,82,239,321,160,79,321,352,0,152,207,3,2,186,211,220,298,14,1619,991
1501,13,1.2.239,1,683,0,22,239,261,226,13,261,352,0,152,207,3,2,151,211,246,298,14,1619,991
1501,13,2.2.239,0,705,2,91,239,330,153,86,330,352,0,152,207,3,2,184,211,203,298,14,1619,991
1501,13,3.3.239,0,683,0,59,239,298,239,0,298,352,-239,239,446,4,1,139,395,378,395,14,1619,991
1501,13,4.2.263,0,683,0,3,263,266,263,0,266,352,-24,176,231,3,2,143,211,205,298,14,1619,991
1501,13,5.2.352,0,683,0,13,352,365,352,0,365,365,-113,265,320,3,2,188,211,367,298,14,1619,991
1501,14,0.2.261,0,718,1,82,261,343,160,101,343,352,0,152,207,3,3,186,189,220,298,15,1619,969
1501,14,1.3.261,0,756,2,90,261,351,261,0,351,352,-261,261,468,4,1,129,395,246,395,15,1619,969
1501,14,2.2.261,0,718,1,91,261,352,153,108,352,352,0,152,207,3,3,184,189,203,298,15,1619,969
1501,14,3.3.239,0,683,0,59,239,298,239,0,298,352,-239,239,446,4,1,139,395,378,395,15,1619,969
1501,14,4.2.263,1,683,0,3,263,266,263,0,266,352,-2,154,209,3,3,143,189,205,298,15,1619,969
1501,14,5.2.352,0,683,0,13,352,365,352,0,365,365,-91,243,298,3,3,188,189,367,298,15,1619,969
1501,15,0.2.266,1,683,0,82,266,348,160,106,348,352,0,154,209,3,4,186,186,220,298,16,1619,966
1501,15,1.3.261,0,756,2,90,261,351,261,0,351,352,-261,261,470,4,1,129,395,246,395,16,1619,966
1501,15,2.2.266,0,683,0,91,266,357,153,113,357,357,0,154,209,3,4,184,186,203,298,16,1619,966
1501,15,3.3.239,0,683,0,59,239,298,239,0,298,352,-239,239,448,4,1,139,395,378,395,16,1619,966
1501,15,4.3.266,0,713,1,62,266,328,266,0,328,352,-266,266,475,4,1,140,395,205,395,16,1619,966
1501,15,5.2.352,0,683,0,13,352,365,352,0,365,365,-86,240,295,3,4,188,186,367,298,16,1619,966
1501,16,0.3.348,0,720,3,55,348,403,348,0,403,403,-348,348,557,4,1,104,395,220,395,17,1619,884
1501,16,1.3.261,0,756,4,90,261,351,261,0,351,352,-261,261,470,4,1,129,395,246,395,17,1619,884
1501,16,2.2.348,0,702,1,91,348,439,153,195,439,439,0,154,209,3,5,184,104,203,298,17,1619,884
1501,16,3.3.239,0,683,0,59,239,298,239,0,298,352,-239,239,448,4,1,139,395,378,395,17,1619,884
1501,16,4.3.266,0,713,2,62,266,328,266,0,328,352,-266,266,475,4,1,140,395,205,395,17,1619,884
1501,16,5.2.352,1,683,0,13,352,365,352,0,365,365,-4,158,213,3,5,188,104,367,298,17,1619,884
1501,17,0.3.348,0,720,2,55,348,403,348,0,403,403,-348,348,561,4,1,104,395,220,395,18,1619,871
1501,17,1.3.261,0,756,3,90,261,351,261,0,351,365,-261,261,474,4,1,129,395,246,395,18,1619,871
1501,17,2.2.365,1,683,0,91,365,456,153,212,456,456,0,158,213,3,6,184,91,203,298,18,1619,871
1501,17,3.3.239,0,683,0,59,239,298,239,0,298,365,-239,239,452,4,1,139,395,378,395,18,1619,871
1501,17,4.3.266,0,713,1,62,266,328,266,0,328,365,-266,266,479,4,1,140,395,205,395,18,1619,871
1501,17,5.3.365,0,683,0,80,365,445,365,0,445,445,-365,365,578,4,1,175,395,367,395,18,1619,871
1501,18,0.3.348,0,720,3,55,348,403,348,0,403,456,-348,348,561,4,1,104,395,220,395,19,1619,780
1501,18,1.3.261,0,756,4,90,261,351,261,0,351,456,-261,261,474,4,1,129,395,246,395,19,1619,780
1501,18,2.3.456,0,689,1,49,456,505,456,0,505,505,-456,456,669,4,1,93,395,203,395,19,1619,780
1501,18,3.3.239,1,683,0,59,239,298,239,0,298,456,-239,239,452,4,1,139,395,378,395,19,1619,780
1501,18,4.3.266,0,713,2,62,266,328,266,0,328,456,-266,266,479,4,1,140,395,205,395,19,1619,780
1501,18,5.3.365,0,683,0,80,365,445,365,0,445,456,-365,365,578,4,1,175,395,367,395,19,1619,780
1501,19,0.3.348,0,723,3,55,348,403,348,0,403,456,-50,289,502,4,2,104,336,220,395,20,1619,721
1501,19,1.3.298,0,718,2,90,298,388,261,37,388,456,0,239,452,4,2,129,336,246,395,20,1619,721
1501,19,2.3.456,0,689,1,49,456,505,456,0,505,505,-158,397,610,4,2,93,336,203,395,20,1619,721
1501,19,3.4.298,1,683,0,80,298,378,298,0,378,456,-298,298,750,5,1,80,385,378,385,20,1619,721
1501,19,4.3.298,0,683,0,62,298,360,266,32,360,456,0,239,452,4,2,140,336,205,395,20,1619,721
1501,19,5.3.365,0,683,0,80,365,445,365,0,445,456,-67,306,519,4,2,175,336,367,395,20,1619,721
1501,20,0.3.348,0,723,3,55,348,403,348,0,403,456,-50,289,800,4,2,104,336,220,395,21,1619,641
1501,20,1.3.298,0,718,2,90,298,388,261,37,388,456,0,239,750,4,2,129,336,246,395,21,1619,641
1501,20,2.3.456,0,689,1,49,456,505,456,0,505,505,-158,397,908,4,2,93,336,203,395,21,1619,641
1501,20,4.3.298,1,683,0,62,298,360,266,32,360,456,0,239,750,4,2,140,336,205,395,21,1619,641
1501,20,5.3.365,0,683,0,80,365,445,365,0,445,456,-67,306,817,4,2,175,336,367,395,21,1619,641
1501,21,0.3.360,0,683,0,55,360,415,348,12,415,456,0,239,750,4,3,104,274,220,395,22,1619,579
1501,21,1.3.360,1,718,2,90,360,450,261,99,450,456,0,239,750,4,3,129,274,246,395,22,1619,579
1501,21,2.3.456,0,689,1,49,456,505,456,0,505,505,-96,335,846,4,3,93,274,203,395,22,1619,579
1501,21,4.4.378,0,683,0,78,378,456,360,18,456,456,0,298,750,5,2,78,305,205,385,22,1619,579
1501,21,5.3.365,0,683,0,80,365,445,365,0,445,456,-5,244,755,4,3,175,274,367,395,22,1619,579
1501,22,0.3.450,0,724,1,55,450,505,348,102,505,505,0,239,750,4,4,104,184,220,395,23,1619,489
1501,22,1.4.450,0,755,3,39,450,489,450,0,489,489,-72,370,822,5,2,39,305,246,385,23,1619,489
1501,22,2.3.456,0,729,2,49,456,505,456,0,505,505,-6,245,756,4,4,93,184,203,395,23,1619,489
1501,22,4.4.378,0,718,0,78,378,456,360,18,456,456,0,298,750,5,2,78,305,205,385,23,1619,489
1501,22,5.3.450,1,718,0,80,450,530,365,85,530,530,0,239,750,4,4,175,184,367,395,23,1619,489
1501,23,0.3.530,1,718,0,55,530,585,348,182,585,585,0,239,750,4,5,104,104,220,395,24,1619,409
1501,23,1.4.450,0,755,1,39,450,489,450,0,489,530,-72,370,822,5,2,39,305,246,385,24,1619,409
1501,23,2.3.530,0,718,0,49,530,579,456,74,579,579,0,239,750,4,5,93,104,203,395,24,1619,409
1501,23,4.4.378,0,718,0,78,378,456,360,18,456,530,0,298,750,5,2,78,305,205,385,24,1619,409
1501,23,5.4.530,0,718,0,95,530,625,530,0,625,625,-152,450,902,5,2,95,305,367,385,24,1619,409
1501,24,0.4.585,0,773,2,49,585,634,585,0,634,634,-207,505,957,5,2,49,305,220,385,25,1619,354
1501,24,1.4.450,0,755,1,39,450,489,450,0,489,585,-72,370,822,5,2,39,305,246,385,25,1619,354
1501,24,2.3.585,1,718,0,49,585,634,456,129,634,634,0,239,750,4,6,93,49,203,395,25,1619,354
1501,24,4.4.378,0,718,0,78,378,456,360,18,456,585,0,298,750,5,2,78,305,205,385,25,1619,354
1501,24,5.4.530,0,718,0,95,530,625,530,0,625,625,-152,450,902,5,2,95,305,367,385,25,1619,354
1501,25,0.4.585,0,773,3,49,585,634,585,0,634,634,-207,505,957,5,2,49,305,220,385,26,1619,305
1501,25,1.4.450,0,755,2,39,450,489,450,0,489,634,-72,370,822,5,2,39,305,246,385,26,1619,305
1501,25,2.4.634,0,727,1,44,634,678,634,0,678,678,-256,554,1006,5,2,44,305,203,385,26,1619,305
1501,25,4.4.378,1,718,0,78,378,456,360,18,456,634,0,298,750,5,2,78,305,205,385,26,1619,305
1501,25,5.4.530,0,718,0,95,530,625,530,0,625,634,-152,450,902,5,2,95,305,367,385,26,1619,305
1501,26,0.4.585,0,773,2,49,585,634,585,0,634,634,-129,427,879,5,3,49,227,220,385,27,1619,227
1501,26,1.4.456,1,718,0,39,456,495,450,6,495,634,0,298,750,5,3,39,227,246,385,27,1619,227
1501,26,2.4.634,0,727,1,44,634,678,634,0,678,678,-178,476,928,5,3,44,227,203,385,27,1619,227
1501,26,5.4.530,0,718,0,95,530,625,530,0,625,634,-74,372,824,5,3,95,227,367,385,27,1619,227
1501,27,0.4.585,0,773,2,49,585,634,585,0,634,634,-90,388,840,5,4,49,188,220,385,28,1619,188
1501,27,2.4.634,0,727,1,44,634,678,634,0,678,678,-139,437,889,5,4,44,188,203,385,28,1619,188
1501,27,5.4.530,1,718,0,95,530,625,530,0,625,634,-35,333,785,5,4,95,188,367,385,28,1619,188
1501,28,0.4.625,1,718,0,49,625,674,585,40,674,674,0,333,785,5,5,49,93,220,385,29,1619,93
1501,28,2.4.634,0,727,1,44,634,678,634,0,678,678,-9,342,794,5,5,44,93,203,385,29,1619,93
1501,29,2.4.674,1,718,0,44,674,718,634,40,718,718,0,333,785,5,6,44,44,203,385,30,1619,44
1502,0,0.0.0,1,511,2,40,0,40,0,0,40,40,0,0,0,1,1,264,257,264,257,1,1389,1389
1502,0,1.0.0,0,485,0,5,0,5,0,0,5,5,0,0,0,1,1,147,257,147,257,1,1389,1389
1502,0,2.0.0,0,548,4,63,0,63,0,0,63,63,0,0,0,1,1,229,257,229,257,1,1389,1389
1502,0,3.0.0,0,488,1,8,0,8,0,0,8,8,0,0,0,1,1,139,257,139,257,1,1389,1389
1502,0,4.0.0,0,526,3,46,0,46,0,0,46,46,0,0,0,1,1,241,257,241,257,1,1389,1389
1502,0,5.0.0,0,565,5,95,0,95,0,0,95,95,0,0,0,1,1,369,257,369,257,1,1389,1389
1502,1,0.1.40,0,511,0,74,40,114,40,0,114,114,-40,40,40,2,1,224,398,264,398,2,1389,1349
1502,1,1.0.40,1,511,0,5,40,45,0,40,45,45,0,0,0,1,2,147,217,147,257,2,1389,1349
1502,1,2.0.40,0,543,3,63,40,103,0,40,103,103,0,0,0,1,2,229,217,229,257,2,1389,1349
1502,1,3.0.40,0,511,0,8,40,48,0,40,48,48,0,0,0,1,2,139,217,139,257,2,1389,1349
1502,1,4.0.40,0,534,1,46,40,86,0,40,86,86,0,0,0,1,2,241,217,241,257,2,1389,1349
1502,1,5.0.40,0,536,2,95,40,135,0,40,135,135,0,0,0,1,2,369,217,369,257,2,1389,1349
1502,2,0.1.40,0,511,0,74,40,114,40,0,114,114,-40,40,40,2,1,224,398,264,398,3,1389,1344
1502,2,1.1.45,0,523,1,34,45,79,45,0,79,79,-45,45,45,2,1,142,398,147,398,3,1389,1344
1502,2,2.0.45,0,543,3,63,45,108,0,45,108,108,0,0,0,1,3,229,212,229,257,3,1389,1344
1502,2,3.0.45,1,511,0,8,45,53,0,45,53,53,0,0,0,1,3,139,212,139,257,3,1389,1344
1502,2,4.0.45,0,534,2,46,45,91,0,45,91,91,0,0,0,1,3,241,212,241,257,3,1389,1344
1502,2,5.0.45,0,511,0,95,45,140,0,45,140,140,0,0,0,1,3,369,212,369,257,3,1389,1344
1502,3,0.1.40,0,511,0,74,40,114,40,0,114,114,-40,40,40,2,1,224,398,264,398,4,1389,1336
1502,3,1.1.45,0,523,1,34,45,79,45,0,79,79,-45,45,45,2,1,142,398,147,398,4,1389,1336
1502,3,2.0.53,0,543,4,63,53,116,0,53,116,116,0,0,0,1,4,229,204,229,257,4,1389,1336
1502,3,3.1.53,0,533,3,36,53,89,53,0,89,89,-53,53,53,2,1,131,398,139,398,4,1389,1336
1502,3,4.0.53,1,525,2,46,53,99,0,53,99,99,0,0,0,1,4,241,204,241,257,4,1389,1336
1502,3,5.0.53,0,511,0,95,53,148,0,53,148,148,0,0,0,1,4,369,204,369,257,4,1389,1336
1502,4,0.1.40,0,534,2,74,40,114,40,0,114,114,-40,40,40,2,1,224,398,264,398,5,1389,1290
1502,4,1.1.45,0,525,0,34,45,79,45,0,79,99,-45,45,45,2,1,142,398,147,398,5,1389,1290
1502,4,2.0.99,0,556,4,63,99,162,0,99,162,162,0,0,0,1,5,229,158,229,257,5,1389,1290
1502,4,3.1.53,0,533,1,36,53,89,53,0,89,99,-53,53,53,2,1,131,398,139,398,5,1389,1290
1502,4,4.1.99,0,543,3,88,99,187,99,0,187,187,-99,99,99,2,1,195,398,241,398,5,1389,1290
1502,4,5.0.99,1,525,0,95,99,194,0,99,194,194,0,0,0,1,5,369,158,369,257,5,1389,1290
1502,5,0.1.40,0,534,2,74,40,114,40,0,114,194,-40,40,40,2,1,224,398,264,398,6,1389,1195
1502,5,1.1.45,0,525,0,34,45,79,45,0,79,194,-45,45,45,2,1,142,398,147,398,6,1389,1195
1502,5,2.0.194,1,525,0,63,194,257,0,194,257,257,0,0,0,1,6,229,63,229,257,6,1389,1195
1502,5,3.1.53,0,533,1,36,53,89,53,0,89,194,-53,53,53,2,1,131,398,139,398,6,1389,1195
1502,5,4.1.99,0,543,3,88,99,187,99,0,187,194,-99,99,99,2,1,195,398,241,398,6,1389,1195
1502,5,5.1.194,0,534,2,72,194,266,194,0,266,266,-194,194,194,2,1,274,398,369,398,6,1389,1195
1502,6,0.1.40,1,534,2,74,40,114,40,0,114,257,-40,40,40,2,1,224,398,264,398,7,1389,1132
1502,6,1.1.45,0,525,0,34,45,79,45,0,79,257,-45,45,45,2,1,142,398,147,398,7,1389,1132
1502,6,2.1.257,0,647,4,94,257,351,257,0,351,351,-257,257,257,2,1,166,398,229,398,7,1389,1132
1502,6,3.1.53,0,533,1,36,53,89,53,0,89,257,-53,53,53,2,1,131,398,139,398,7,1389,1132
1502,6,4.1.99,0,543,3,88,99,187,99,0,187,257,-99,99,99,2,1,195,398,241,398,7,1389,1132
1502,6,5.1.194,0,534,2,72,194,266,194,0,266,266,-194,194,194,2,1,274,398,369,398,7,1389,1132
1502,7,0.2.114,1,541,1,86,114,200,114,0,200,257,-114,114,154,3,1,150,266,264,266,8,1389,1058
1502,7,1.1.114,0,534,0,34,114,148,45,69,148,257,0,40,40,2,2,142,324,147,398,8,1389,1058
1502,7,2.1.257,0,647,3,94,257,351,257,0,351,351,-143,183,183,2,2,166,324,229,398,8,1389,1058
1502,7,3.1.114,0,534,0,36,114,150,53,61,150,257,0,40,40,2,2,131,324,139,398,8,1389,1058
1502,7,4.1.114,0,542,2,88,114,202,99,15,202,257,0,40,40,2,2,195,324,241,398,8,1389,1058
1502,7,5.1.194,0,534,0,72,194,266,194,0,266,266,-80,120,120,2,2,274,324,369,398,8,1389,1058
1502,8,0.3.200,1,541,0,62,200,262,200,0,262,262,-200,200,354,4,1,64,252,264,252,9,1389,972
1502,8,1.1.114,0,541,0,34,114,148,45,69,148,257,0,40,154,2,2,142,324,147,398,9,1389,972
1502,8,2.1.257,0,647,2,94,257,351,257,0,351,351,-143,183,297,2,2,166,324,229,398,9,1389,972
1502,8,3.1.114,0,541,0,36,114,150,53,61,150,257,0,40,154,2,2,131,324,139,398,9,1389,972
1502,8,4.1.114,0,542,1,88,114,202,99,15,202,257,0,40,154,2,2,195,324,241,398,9,1389,972
1502,8,5.1.194,0,541,0,72,194,266,194,0,266,266,-80,120,234,2,2,274,324,369,398,9,1389,972
1502,9,0.4.262,1,541,0,2,262,264,262,0,264,264,-262,262,616,5,1,2,216,264,216,10,1389,910
1502,9,1.1.114,0,541,0,34,114,148,45,69,148,262,0,40,354,2,2,142,324,147,398,10,1389,910
1502,9,2.1.257,0,647,2,94,257,351,257,0,351,351,-143,183,497,2,2,166,324,229,398,10,1389,910
1502,9,3.1.114,0,541,0,36,114,150,53,61,150,262,0,40,354,2,2,131,324,139,398,10,1389,910
1502,9,4.1.114,0,542,1,88,114,202,99,15,202,262,0,40,354,2,2,195,324,241,398,10,1389,910
1502,9,5.1.194,0,541,0,72,194,266,194,0,266,266,-80,120,434,2,2,274,324,369,398,10,1389,910
1502,10,1.1.114,1,541,0,34,114,148,45,69,148,264,0,40,616,2,2,142,324,147,398,11,1389,908
1502,10,2.1.257,0,647,2,94,257,351,257,0,351,351,-143,183,759,2,2,166,324,229,398,11,1389,908
1502,10,3.1.114,0,541,0,36,114,150,53,61,150,264,0,40,616,2,2,131,324,139,398,11,1389,908
1502,10,4.1.114,0,542,1,88,114,202,99,15,202,264,0,40,616,2,2,195,324,241,398,11,1389,908
1502,10,5.1.194,0,541,0,72,194,266,194,0,266,266,-80,120,696,2,2,274,324,369,398,11,1389,908
1502,11,1.2.200,1,541,0,27,200,227,148,52,227,264,0,114,616,3,2,108,180,147,266,12,1389,874
1502,11,2.1.257,0,647,2,94,257,351,257,0,351,351,-109,149,725,2,3,166,290,229,398,12,1389,874
1502,11,3.1.148,0,541,0,36,148,184,53,95,184,264,0,40,616,2,3,131,290,139,398,12,1389,874
1502,11,4.1.148,0,542,1,88,148,236,99,49,236,264,0,40,616,2,3,195,290,241,398,12,1389,874
1502,11,5.1.194,0,541,0,72,194,266,194,0,266,266,-46,86,662,2,3,274,290,369,398,12,1389,874
1502,12,1.3.262,1,541,0,33,262,295,227,35,295,295,0,200,616,4,2,81,190,147,252,13,1389,847
1502,12,2.1.257,0,647,2,94,257,351,257,0,351,351,-109,149,725,2,3,166,290,229,398,13,1389,847
1502,12,3.1.148,0,541,0,36,148,184,53,95,184,264,0,40,616,2,3,131,290,139,398,13,1389,847
1502,12,4.1.148,0,542,1,88,148,236,99,49,236,264,0,40,616,2,3,195,290,241,398,13,1389,847
1502,12,5.1.194,0,541,0,72,194,266,194,0,266,266,-46,86,662,2,3,274,290,369,398,13,1389,847
1502,13,1.4.295,1,541,0,48,295,343,295,0,343,343,-31,293,647,5,2,48,214,147,216,14,1389,814
1502,13,2.1.257,0,647,2,94,257,351,257,0,351,351,-109,149,725,2,3,166,290,229,398,14,1389,814
1502,13,3.1.148,0,541,0,36,148,184,53,95,184,295,0,40,616,2,3,131,290,139,398,14,1389,814
1502,13,4.1.148,0,542,1,88,148,236,99,49,236,295,0,40,616,2,3,195,290,241,398,14,1389,814
1502,13,5.1.194,0,541,0,72,194,266,194,0,266,295,-46,86,662,2,3,274,290,369,398,14,1389,814
1502,14,2.1.257,0,647,2,94,257,351,257,0,351,351,-109,149,756,2,3,166,290,229,398,15,1389,766
1502,14,3.1.148,1,541,0,36,148,184,53,95,184,343,0,40,647,2,3,131,290,139,398,15,1389,766
1502,14,4.1.148,0,542,1,88,148,236,99,49,236,343,0,40,647,2,3,195,290,241,398,15,1389,766
1502,14,5.1.194,0,541,0,72,194,266,194,0,266,343,-46,86,693,2,3,274,290,369,398,15,1389,766
1502,15,2.1.257,0,673,2,94,257,351,257,0,351,351,-73,113,720,2,4,166,254,229,398,16,1389,730
1502,15,3.2.227,1,541,0,54,227,281,184,43,281,343,0,114,647,3,3,95,153,139,266,16,1389,730
1502,15,4.1.184,0,556,1,88,184,272,99,85,272,343,0,40,647,2,4,195,254,241,398,16,1389,730
1502,15,5.1.194,0,541,0,72,194,266,194,0,266,343,-10,50,657,2,4,274,254,369,398,16,1389,730
1502,16,2.1.257,0,673,2,94,257,351,257,0,351,351,-73,113,720,2,4,166,254,229,398,17,1389,676
1502,16,3.3.295,1,541,0,19,295,314,281,14,314,343,0,200,647,4,3,41,157,139,252,17,1389,676
1502,16,4.1.184,0,556,1,88,184,272,99,85,272,343,0,40,647,2,4,195,254,241,398,17,1389,676
1502,16,5.1.194,0,541,0,72,194,266,194,0,266,343,-10,50,657,2,4,274,254,369,398,17,1389,676
1502,17,2.1.257,0,673,2,94,257,351,257,0,351,351,-73,113,720,2,4,166,254,229,398,18,1389,657
1502,17,3.4.343,1,541,0,22,343,365,314,29,365,365,0,293,647,5,3,22,166,139,216,18,1389,657
1502,17,4.1.184,0,556,1,88,184,272,99,85,272,343,0,40,647,2,4,195,254,241,398,18,1389,657
1502,17,5.1.194,0,541,0,72,194,266,194,0,266,343,-10,50,657,2,4,274,254,369,398,18,1389,657
1502,18,2.1.257,0,673,2,94,257,351,257,0,351,365,-73,113,720,2,4,166,254,229,398,19,1389,635
1502,18,4.1.184,0,556,1,88,184,272,99,85,272,365,0,40,647,2,4,195,254,241,398,19,1389,635
1502,18,5.1.194,1,541,0,72,194,266,194,0,266,365,-10,50,657,2,4,274,254,369,398,19,1389,635
1502,19,2.1.266,0,555,1,94,266,360,257,9,360,365,0,50,657,2,5,166,182,229,398,20,1389,563
1502,19,4.1.266,0,541,0,88,266,354,99,167,354,365,0,50,657,2,5,195,182,241,398,20,1389,563
1502,19,5.2.281,1,541,0,51,281,332,266,15,332,365,0,114,657,3,4,202,99,369,266,20,1389,563
1502,20,2.1.266,0,555,1,94,266,360,257,9,360,365,0,50,657,2,5,166,182,229,398,21,1389,512
1502,20,4.1.266,0,541,0,88,266,354,99,167,354,365,0,50,657,2,5,195,182,241,398,21,1389,512
1502,20,5.3.332,1,541,0,65,332,397,332,0,397,397,-18,218,675,4,4,151,138,369,252,21,1389,512
1502,21,2.1.266,0,555,1,94,266,360,257,9,360,397,0,50,675,2,5,166,182,229,398,22,1389,447
1502,21,4.1.266,0,541,0,88,266,354,99,167,354,397,0,50,675,2,5,195,182,241,398,22,1389,447
1502,21,5.4.397,1,541,0,86,397,483,397,0,483,483,-32,325,707,5,4,86,144,369,216,22,1389,447
1502,22,2.1.266,0,555,1,94,266,360,257,9,360,483,0,50,707,2,5,166,182,229,398,23,1389,361
1502,22,4.1.266,1,541,0,88,266,354,99,167,354,483,0,50,707,2,5,195,182,241,398,23,1389,361
1502,23,2.1.354,0,541,0,94,354,448,257,97,448,483,0,50,707,2,6,166,94,229,398,24,1389,273
1502,23,4.2.354,1,541,0,4,354,358,354,0,358,483,-22,136,729,3,5,107,48,241,266,24,1389,273
1502,24,2.1.354,0,541,0,94,354,448,257,97,448,483,0,50,729,2,6,166,94,229,398,25,1389,269
1502,24,4.3.397,1,541,0,55,397,452,358,39,452,483,0,218,729,4,5,103,73,241,252,25,1389,269
1502,25,2.1.354,0,541,0,94,354,448,257,97,448,483,0,50,729,2,6,166,94,229,398,26,1389,214
1502,25,4.4.483,1,541,0,48,483,531,452,31,531,531,0,325,729,5,5,48,58,241,216,26,1389,214
1502,26,2.1.354,1,541,0,94,354,448,257,97,448,531,0,50,729,2,6,166,94,229,398,27,1389,166
1502,27,2.2.448,1,541,0,44,448,492,448,0,492,531,-90,226,819,3,6,72,44,229,266,28,1389,72
1502,28,2.3.492,1,541,0,18,492,510,492,0,510,531,-40,258,859,4,6,28,18,229,252,29,1389,28
1502,29,2.4.531,1,541,0,10,531,541,510,21,541,541,0,325,859,5,6,10,10,229,216,30,1389,10
1503,0,0.0.0,0,646,2,53,0,53,0,0,53,53,0,0,0,1,1,306,370,306,370,1,1752,1752
1503,0,1.0.0,0,647,3,80,0,80,0,0,80,80,0,0,0,1,1,245,370,245,370,1,1752,1752
1503,0,2.0.0,1,601,0,9,0,9,0,0,9,9,0,0,0,1,1,353,370,353,370,1,1752,1752
1503,0,3.0.0,0,644,1,61,0,61,0,0,61,61,0,0,0,1,1,298,370,298,370,1,1752,1752
1503,0,4.0.0,0,669,4,68,0,68,0,0,68,68,0,0,0,1,1,180,370,180,370,1,1752,1752
1503,0,5.0.0,0,676,5,99,0,99,0,0,99,99,0,0,0,1,1,370,370,370,370,1,1752,1752
1503,1,0.0.9,0,631,3,53,9,62,0,9,62,62,0,0,0,1,2,306,361,306,370,2,1752,1743
1503,1,1.0.9,0,601,0,80,9,89,0,9,89,89,0,0,0,1,2,245,361,245,370,2,1752,1743
1503,1,2.1.9,1,601,0,87,9,96,9,0,96,96,-9,9,9,2,1,344,301,353,301,2,1752,1743
1503,1,3.0.9,0,627,2,61,9,70,0,9,70,70,0,0,0,1,2,298,361,298,370,2,1752,1743
1503,1,4.0.9,0,637,4,68,9,77,0,9,77,77,0,0,0,1,2,180,361,180,370,2,1752,1743
1503,1,5.0.9,0,624,1,99,9,108,0,9,108,108,0,0,0,1,2,370,361,370,370,2,1752,1743
1503,2,0.0.9,0,631,3,53,9,62,0,9,62,96,0,0,9,1,2,306,361,306,370,3,1752,1656
1503,2,1.0.9,0,601,0,80,9,89,0,9,89,96,0,0,9,1,2,245,361,245,370,3,1752,1656
1503,2,2.2.96,1,624,1,97,96,193,96,0,193,193,-96,96,105,3,1,257,333,353,333,3,1752,1656
1503,2,3.0.9,0,627,2,61,9,70,0,9,70,96,0,0,9,1,2,298,361,298,370,3,1752,1656
1503,2,4.0.9,0,637,4,68,9,77,0,9,77,96,0,0,9,1,2,180,361,180,370,3,1752,1656
1503,2,5.0.9,0,624,1,99,9,108,0,9,108,108,0,0,9,1,2,370,361,370,370,3,1752,1656
1503,3,0.0.9,0,631,2,53,9,62,0,9,62,193,0,0,105,1,2,306,361,306,370,4,1752,1559
1503,3,1.0.9,0,624,0,80,9,89,0,9,89,193,0,0,105,1,2,245,361,245,370,4,1752,1559
1503,3,2.3.193,1,624,0,86,193,279,193,0,279,279,-193,193,298,4,1,160,403,353,403,4,1752,1559
1503,3,3.0.9,0,627,1,61,9,70,0,9,70,193,0,0,105,1,2,298,361,298,370,4,1752,1559
1503,3,4.0.9,0,637,3,68,9,77,0,9,77,193,0,0,105,1,2,180,361,180,370,4,1752,1559
1503,3,5.0.9,0,624,0,99,9,108,0,9,108,193,0,0,105,1,2,370,361,370,370,4,1752,1559
1503,4,0.0.9,0,631,2,53,9,62,0,9,62,279,0,0,298,1,2,306,361,306,370,5,1752,1473
1503,4,1.0.9,0,624,0,80,9,89,0,9,89,279,0,0,298,1,2,245,361,245,370,5,1752,1473
1503,4,2.4.279,1,624,0,74,279,353,279,0,353,353,-279,279,577,5,1,74,345,353,345,5,1752,1473
1503,4,3.0.9,0,627,1,61,9,70,0,9,70,279,0,0,298,1,2,298,361,298,370,5,1752,1473
1503,4,4.0.9,0,637,3,68,9,77,0,9,77,279,0,0,298,1,2,180,361,180,370,5,1752,1473
1503,4,5.0.9,0,624,0,99,9,108,0,9,108,279,0,0,298,1,2,370,361,370,370,5,1752,1473
1503,5,0.0.9,1,631,2,53,9,62,0,9,62,353,0,0,577,1,2,306,361,306,370,6,1752,1399
1503,5,1.0.9,0,624,0,80,9,89,0,9,89,353,0,0,577,1,2,245,361,245,370,6,1752,1399
1503,5,3.0.9,0,627,1,61,9,70,0,9,70,353,0,0,577,1,2,298,361,298,370,6,1752,1399
1503,5,4.0.9,0,637,3,68,9,77,0,9,77,353,0,0,577,1,2,180,361,180,370,6,1752,1399
1503,5,5.0.9,0,624,0,99,9,108,0,9,108,353,0,0,577,1,2,370,361,370,370,6,1752,1399
1503,6,0.1.96,1,631,0,42,96,138,62,34,138,353,0,9,577,2,2,253,214,306,301,7,1752,1346
1503,6,1.0.62,0,635,2,80,62,142,0,62,142,353,0,0,577,1,3,245,308,245,370,7,1752,1346
1503,6,3.0.62,0,631,0,61,62,123,0,62,123,353,0,0,577,1,3,298,308,298,370,7,1752,1346
1503,6,4.0.62,0,642,3,68,62,130,0,62,130,353,0,0,577,1,3,180,308,180,370,7,1752,1346
1503,6,5.0.62,0,632,1,99,62,161,0,62,161,353,0,0,577,1,3,370,308,370,370,7,1752,1346
1503,7,0.2.193,1,641,3,89,193,282,138,55,282,353,0,96,577,3,2,211,236,306,333,8,1752,1304
1503,7,1.0.62,0,635,2,80,62,142,0,62,142,353,0,0,577,1,3,245,308,245,370,8,1752,1304
1503,7,3.0.62,0,631,0,61,62,123,0,62,123,353,0,0,577,1,3,298,308,298,370,8,1752,1304
1503,7,4.0.62,0,642,4,68,62,130,0,62,130,353,0,0,577,1,3,180,308,180,370,8,1752,1304
1503,7,5.0.62,0,632,1,99,62,161,0,62,161,353,0,0,577,1,3,370,308,370,370,8,1752,1304
1503,8,0.3.282,0,641,0,68,282,350,282,0,350,353,-3,196,580,4,2,122,317,306,403,9,1752,1215
1503,8,1.0.62,0,641,0,80,62,142,0,62,142,353,0,0,577,1,3,245,308,245,370,9,1752,1215
1503,8,3.0.62,1,641,0,61,62,123,0,62,123,353,0,0,577,1,3,298,308,298,370,9,1752,1215
1503,8,4.0.62,0,642,1,68,62,130,0,62,130,353,0,0,577,1,3,180,308,180,370,9,1752,1215
1503,8,5.0.62,0,641,0,99,62,161,0,62,161,353,0,0,577,1,3,370,308,370,370,9,1752,1215
1503,9,0.3.282,0,641,0,68,282,350,282,0,350,353,-3,196,580,4,2,122,317,306,403,10,1752,1154
1503,9,1.0.123,0,649,2,80,123,203,0,123,203,353,0,0,577,1,4,245,247,245,370,10,1752,1154
1503,9,3.1.138,1,641,0,74,138,212,123,15,212,353,0,9,577,2,3,237,172,298,301,10,1752,1154
1503,9,4.0.123,0,644,1,68,123,191,0,123,191,353,0,0,577,1,4,180,247,180,370,10,1752,1154
1503,9,5.0.123,0,641,0,99,123,222,0,123,222,353,0,0,577,1,4,370,247,370,370,10,1752,1154
1503,10,0.3.282,0,641,0,68,282,350,282,0,350,353,-3,196,580,4,2,122,317,306,403,11,1752,1080
1503,10,1.0.123,0,649,2,80,123,203,0,123,203,353,0,0,577,1,4,245,247,245,370,11,1752,1080
1503,10,3.2.282,1,641,0,22,282,304,212,70,304,353,0,96,577,3,3,163,147,298,333,11,1752,1080
1503,10,4.0.123,0,644,1,68,123,191,0,123,191,353,0,0,577,1,4,180,247,180,370,11,1752,1080
1503,10,5.0.123,0,641,0,99,123,222,0,123,222,353,0,0,577,1,4,370,247,370,370,11,1752,1080
1503,11,0.3.282,0,641,0,68,282,350,282,0,350,353,-3,196,580,4,2,122,317,306,403,12,1752,1058
1503,11,1.0.123,0,649,2,80,123,203,0,123,203,353,0,0,577,1,4,245,247,245,370,12,1752,1058
1503,11,3.3.304,0,656,3,77,304,381,304,0,381,381,-25,218,602,4,2,141,317,298,403,12,1752,1058
1503,11,4.0.123,0,644,1,68,123,191,0,123,191,353,0,0,577,1,4,180,247,180,370,12,1752,1058
1503,11,5.0.123,1,641,0,99,123,222,0,123,222,353,0,0,577,1,4,370,247,370,370,12,1752,1058
1503,12,0.3.282,0,641,0,68,282,350,282,0,350,353,-3,196,580,4,2,122,317,306,403,13,1752,959
1503,12,1.0.222,0,641,0,80,222,302,0,222,302,353,0,0,577,1,5,245,148,245,370,13,1752,959
1503,12,3.3.304,0,656,2,77,304,381,304,0,381,381,-25,218,602,4,2,141,317,298,403,13,1752,959
1503,12,4.0.222,0,644,1,68,222,290,0,222,290,353,0,0,577,1,5,180,148,180,370,13,1752,959
1503,12,5.1.222,1,641,0,55,222,277,222,0,277,353,-10,19,587,2,4,271,98,370,301,13,1752,959
1503,13,0.3.282,0,641,0,68,282,350,282,0,350,353,-3,196,590,4,2,122,317,306,403,14,1752,904
1503,13,1.0.222,0,641,0,80,222,302,0,222,302,353,0,0,587,1,5,245,148,245,370,14,1752,904
1503,13,3.3.304,0,656,2,77,304,381,304,0,381,381,-25,218,612,4,2,141,317,298,403,14,1752,904
1503,13,4.0.222,0,644,1,68,222,290,0,222,290,353,0,0,587,1,5,180,148,180,370,14,1752,904
1503,13,5.2.304,1,644,1,89,304,393,277,27,393,393,0,96,587,3,4,216,125,370,333,14,1752,904
1503,14,0.3.282,0,644,0,68,282,350,282,0,350,393,-3,196,590,4,2,122,317,306,403,15,1752,815
1503,14,1.0.222,1,644,0,80,222,302,0,222,302,393,0,0,587,1,5,245,148,245,370,15,1752,815
1503,14,3.3.304,0,656,1,77,304,381,304,0,381,393,-25,218,612,4,2,141,317,298,403,15,1752,815
1503,14,4.0.222,0,644,0,68,222,290,0,222,290,393,0,0,587,1,5,180,148,180,370,15,1752,815
1503,14,5.3.393,0,658,2,50,393,443,393,0,443,443,-114,307,701,4,2,127,317,370,403,15,1752,815
1503,15,0.3.282,0,644,0,68,282,350,282,0,350,393,-3,196,590,4,2,122,317,306,403,16,1752,735
1503,15,1.1.302,1,644,0,2,302,304,302,0,304,393,-25,44,612,2,5,165,43,245,301,16,1752,735
1503,15,3.3.304,0,656,1,77,304,381,304,0,381,393,-25,218,612,4,2,141,317,298,403,16,1752,735
1503,15,4.0.302,0,644,0,68,302,370,0,302,370,393,0,0,587,1,6,180,68,180,370,16,1752,735
1503,15,5.3.393,0,658,2,50,393,443,393,0,443,443,-114,307,701,4,2,127,317,370,403,16,1752,735
1503,16,0.3.282,0,644,0,68,282,350,282,0,350,393,-3,196,615,4,2,122,317,306,403,17,1752,733
1503,16,1.2.393,1,644,0,32,393,425,304,89,425,425,0,96,612,3,5,163,36,245,333,17,1752,733
1503,16,3.3.304,0,656,1,77,304,381,304,0,381,393,-25,218,637,4,2,141,317,298,403,17,1752,733
1503,16,4.0.302,0,644,0,68,302,370,0,302,370,393,0,0,612,1,6,180,68,180,370,17,1752,733
1503,16,5.3.393,0,658,2,50,393,443,393,0,443,443,-114,307,726,4,2,127,317,370,403,17,1752,733
1503,17,0.3.282,0,644,0,68,282,350,282,0,350,425,-3,196,615,4,2,122,317,306,403,18,1752,701
1503,17,1.3.425,0,706,3,74,425,499,425,0,499,499,-146,339,758,4,2,131,317,245,403,18,1752,701
1503,17,3.3.304,0,656,1,77,304,381,304,0,381,425,-25,218,637,4,2,141,317,298,403,18,1752,701
1503,17,4.0.302,1,644,0,68,302,370,0,302,370,425,0,0,612,1,6,180,68,180,370,18,1752,701
1503,17,5.3.393,0,658,2,50,393,443,393,0,443,443,-114,307,726,4,2,127,317,370,403,18,1752,701
1503,18,0.3.282,0,644,0,68,282,350,282,0,350,425,-3,196,615,4,2,122,317,306,403,19,1752,633
1503,18,1.3.425,0,706,3,74,425,499,425,0,499,499,-146,339,758,4,2,131,317,245,403,19,1752,633
1503,18,3.3.304,0,656,1,77,304,381,304,0,381,425,-25,218,637,4,2,141,317,298,403,19,1752,633
1503,18,4.1.370,1,644,0,41,370,411,370,0,411,425,-66,110,678,2,6,112,41,180,301,19,1752,633
1503,18,5.3.393,0,658,2,50,393,443,393,0,443,443,-114,307,726,4,2,127,317,370,403,19,1752,633
1503,19,0.3.282,0,644,0,68,282,350,282,0,350,425,-3,196,681,4,2,122,317,306,403,20,1752,592
1503,19,1.3.425,0,706,3,74,425,499,425,0,499,499,-146,339,824,4,2,131,317,245,403,20,1752,592
1503,19,3.3.304,0,656,1,77,304,381,304,0,381,425,-25,218,703,4,2,141,317,298,403,20,1752,592
1503,19,4.2.425,1,644,0,4,425,429,411,14,429,429,0,96,678,3,6,71,4,180,333,20,1752,592
1503,19,5.3.393,0,658,2,50,393,443,393,0,443,443,-114,307,792,4,2,127,317,370,403,20,1752,592
1503,20,0.3.282,1,644,0,68,282,350,282,0,350,429,-3,196,681,4,2,122,317,306,403,21,1752,588
1503,20,1.3.425,0,706,4,74,425,499,425,0,499,499,-146,339,824,4,2,131,317,245,403,21,1752,588
1503,20,3.3.304,0,656,1,77,304,381,304,0,381,429,-25,218,703,4,2,141,317,298,403,21,1752,588
1503,20,4.3.429,0,661,3,48,429,477,429,0,477,477,-150,343,828,4,2,67,317,180,403,21,1752,588
1503,20,5.3.393,0,658,2,50,393,443,393,0,443,443,-114,307,792,4,2,127,317,370,403,21,1752,588
1503,21,0.4.353,1,644,0,54,353,407,350,3,407,429,0,279,681,5,2,54,271,306,345,22,1752,520
1503,21,1.3.425,0,716,3,74,425,499,425,0,499,499,-75,271,756,4,3,131,249,245,403,22,1752,520
1503,21,3.3.350,0,644,0,77,350,427,304,46,427,429,0,196,681,4,3,141,249,298,403,22,1752,520
1503,21,4.3.429,0,661,1,48,429,477,429,0,477,477,-79,275,760,4,3,67,249,180,403,22,1752,520
1503,21,5.3.393,0,670,2,50,393,443,393,0,443,443,-43,239,724,4,3,127,249,370,403,22,1752,520
1503,22,1.3.425,0,716,3,74,425,499,425,0,499,499,-75,271,756,4,3,131,249,245,403,23,1752,466
1503,22,3.3.350,1,644,0,77,350,427,304,46,427,429,0,196,681,4,3,141,249,298,403,23,1752,466
1503,22,4.3.429,0,661,1,48,429,477,429,0,477,477,-79,275,760,4,3,67,249,180,403,23,1752,466
1503,22,5.3.393,0,670,2,50,393,443,393,0,443,443,-43,239,724,4,3,127,249,370,403,23,1752,466
1503,23,1.3.427,0,654,1,74,427,501,425,2,501,501,0,196,681,4,4,131,172,245,403,24,1752,389
1503,23,3.4.427,0,644,0,64,427,491,427,0,491,491,-20,299,701,5,3,64,217,298,345,24,1752,389
1503,23,4.3.429,0,661,2,48,429,477,429,0,477,477,-2,198,683,4,4,67,172,180,403,24,1752,389
1503,23,5.3.427,1,644,0,50,427,477,393,34,477,477,0,196,681,4,4,127,172,370,403,24,1752,389
1503,24,1.3.477,0,644,0,74,477,551,425,52,551,551,0,196,681,4,5,131,122,245,403,25,1752,339
1503,24,3.4.427,1,644,0,64,427,491,427,0,491,491,-20,299,701,5,3,64,217,298,345,25,1752,339
1503,24,4.3.477,0,656,1,48,477,525,429,48,525,525,0,196,681,4,5,67,122,180,403,25,1752,339
1503,24,5.4.477,0,694,2,77,477,554,477,0,554,554,-70,349,751,5,3,77,217,370,345,25,1752,339
1503,25,1.3.477,0,644,0,74,477,551,425,52,551,551,0,196,701,4,5,131,122,245,403,26,1752,275
1503,25,4.3.477,0,656,1,48,477,525,429,48,525,525,0,196,701,4,5,67,122,180,403,26,1752,275
1503,25,5.4.491,1,644,0,77,491,568,477,14,568,568,0,299,701,5,4,77,153,370,345,26,1752,275
1503,26,1.3.477,1,644,0,74,477,551,425,52,551,568,0,196,701,4,5,131,122,245,403,27,1752,198
1503,26,4.3.477,0,656,1,48,477,525,429,48,525,568,0,196,701,4,5,67,122,180,403,27,1752,198
1503,27,1.4.568,0,644,0,57,568,625,551,17,625,625,0,299,701,5,5,57,76,245,345,28,1752,124
1503,27,4.3.551,1,644,0,48,551,599,429,122,599,599,0,196,701,4,6,67,48,180,403,28,1752,124
1503,28,1.4.568,1,644,0,57,568,625,551,17,625,625,0,299,701,5,5,57,76,245,345,29,1752,76
1503,28,4.4.599,0,675,1,19,599,618,599,0,618,618,-31,330,732,5,5,19,76,180,345,29,1752,76
1503,29,4.4.625,1,644,0,19,625,644,599,26,644,644,0,299,701,5,6,19,19,180,345,30,1752,19
1504,0,0.0.0,0,518,1,66,0,66,0,0,66,66,0,0,0,1,1,251,287,251,287,1,1426,1426
1504,0,1.0.0,0,528,3,56,0,56,0,0,56,56,0,0,0,1,1,246,287,246,287,1,1426,1426
1504,0,2.0.0,0,523,2,55,0,55,0,0,55,55,0,0,0,1,1,281,287,281,287,1,1426,1426
1504,0,3.0.0,0,496,0,15,0,15,0,0,15,15,0,0,0,1,1,158,287,158,287,1,1426,1426
1504,0,4.0.0,0,544,4,90,0,90,0,0,90,90,0,0,0,1,1,316,287,316,287,1,1426,1426
1504,0,5.0.0,1,496,0,5,0,5,0,0,5,5,0,0,0,1,1,174,287,174,287,1,1426,1426
1504,1,0.0.5,0,512,3,66,5,71,0,5,71,71,0,0,0,1,2,251,282,251,287,2,1426,1421
1504,1,1.0.5,0,502,2,56,5,61,0,5,61,61,0,0,0,1,2,246,282,246,287,2,1426,1421
1504,1,2.0.5,0,500,1,55,5,60,0,5,60,60,0,0,0,1,2,281,282,281,287,2,1426,1421
1504,1,3.0.5,0,496,0,15,5,20,0,5,20,20,0,0,0,1,2,158,282,158,287,2,1426,1421
1504,1,4.0.5,0,528,4,90,5,95,0,5,95,95,0,0,0,1,2,316,282,316,287,2,1426,1421
1504,1,5.1.5,1,496,0,38,5,43,5,0,43,43,-5,5,5,2,1,169,304,174,304,2,1426,1421
1504,2,0.0.5,0,512,3,66,5,71,0,5,71,71,0,0,5,1,2,251,282,251,287,3,1426,1383
1504,2,1.0.5,0,502,2,56,5,61,0,5,61,61,0,0,5,1,2,246,282,246,287,3,1426,1383
1504,2,2.0.5,0,500,1,55,5,60,0,5,60,60,0,0,5,1,2,281,282,281,287,3,1426,1383
1504,2,3.0.5,0,496,0,15,5,20,0,5,20,43,0,0,5,1,2,158,282,158,287,3,1426,1383
1504,2,4.0.5,0,528,4,90,5,95,0,5,95,95,0,0,5,1,2,316,282,316,287,3,1426,1383
1504,2,5.2.43,1,496,0,28,43,71,43,0,71,71,-43,43,48,3,1,131,302,174,302,3,1426,1383
1504,3,0.0.5,0,512,3,66,5,71,0,5,71,71,0,0,48,1,2,251,282,251,287,4,1426,1355
1504,3,1.0.5,0,502,2,56,5,61,0,5,61,71,0,0,48,1,2,246,282,246,287,4,1426,1355
1504,3,2.0.5,0,500,1,55,5,60,0,5,60,71,0,0,48,1,2,281,282,281,287,4,1426,1355
1504,3,3.0.5,0,496,0,15,5,20,0,5,20,71,0,0,48,1,2,158,282,158,287,4,1426,1355
1504,3,4.0.5,0,528,4,90,5,95,0,5,95,95,0,0,48,1,2,316,282,316,287,4,1426,1355
1504,3,5.3.71,1,496,0,35,71,106,71,0,106,106,-71,71,119,4,1,103,258,174,258,4,1426,1355
1504,4,0.0.5,0,512,3,66,5,71,0,5,71,106,0,0,119,1,2,251,282,251,287,5,1426,1320
1504,4,1.0.5,0,502,2,56,5,61,0,5,61,106,0,0,119,1,2,246,282,246,287,5,1426,1320
1504,4,2.0.5,0,500,1,55,5,60,0,5,60,106,0,0,119,1,2,281,282,281,287,5,1426,1320
1504,4,3.0.5,0,496,0,15,5,20,0,5,20,106,0,0,119,1,2,158,282,158,287,5,1426,1320
1504,4,4.0.5,0,528,4,90,5,95,0,5,95,106,0,0,119,1,2,316,282,316,287,5,1426,1320
1504,4,5.4.106,1,496,0,68,106,174,106,0,174,174,-106,106,225,5,1,68,275,174,275,5,1426,1320
1504,5,0.0.5,0,512,3,66,5,71,0,5,71,174,0,0,225,1,2,251,282,251,287,6,1426,1252
1504,5,1.0.5,0,502,2,56,5,61,0,5,61,174,0,0,225,1,2,246,282,246,287,6,1426,1252
1504,5,2.0.5,1,500,1,55,5,60,0,5,60,174,0,0,225,1,2,281,282,281,287,6,1426,1252
1504,5,3.0.5,0,496,0,15,5,20,0,5,20,174,0,0,225,1,2,158,282,158,287,6,1426,1252
1504,5,4.0.5,0,528,4,90,5,95,0,5,95,174,0,0,225,1,2,316,282,316,287,6,1426,1252
1504,6,0.0.60,0,527,3,66,60,126,0,60,126,174,0,0,225,1,3,251,227,251,287,7,1426,1197
1504,6,1.0.60,0,501,1,56,60,116,0,60,116,174,0,0,225,1,3,246,227,246,287,7,1426,1197
1504,6,2.1.60,0,501,1,81,60,141,60,0,141,174,-17,22,242,2,2,226,266,281,304,7,1426,1197
1504,6,3.0.60,1,500,0,15,60,75,0,60,75,174,0,0,225,1,3,158,227,158,287,7,1426,1197
1504,6,4.0.60,0,513,2,90,60,150,0,60,150,174,0,0,225,1,3,316,227,316,287,7,1426,1197
1504,7,0.0.75,0,530,2,66,75,141,0,75,141,174,0,0,225,1,4,251,212,251,287,8,1426,1182
1504,7,1.0.75,1,501,1,56,75,131,0,75,131,174,0,0,225,1,4,246,212,246,287,8,1426,1182
1504,7,2.1.60,0,501,1,81,60,141,60,0,141,174,-17,22,242,2,2,226,266,281,304,8,1426,1182
1504,7,3.1.75,0,500,0,13,75,88,75,0,88,174,-32,37,257,2,2,143,266,158,304,8,1426,1182
1504,7,4.0.75,0,500,0,90,75,165,0,75,165,174,0,0,225,1,4,316,212,316,287,8,1426,1182
1504,8,0.0.131,1,520,2,66,131,197,0,131,197,197,0,0,225,1,5,251,156,251,287,9,1426,1126
1504,8,1.1.131,0,559,3,70,131,201,131,0,201,201,-88,93,313,2,2,190,266,246,304,9,1426,1126
1504,8,2.1.60,0,501,0,81,60,141,60,0,141,174,-17,22,242,2,2,226,266,281,304,9,1426,1126
1504,8,3.1.75,0,516,1,13,75,88,75,0,88,174,-32,37,257,2,2,143,266,158,304,9,1426,1126
1504,8,4.0.131,0,501,0,90,131,221,0,131,221,221,0,0,225,1,5,316,156,316,287,9,1426,1126
1504,9,0.1.197,0,534,1,10,197,207,197,0,207,207,-154,159,379,2,2,185,266,251,304,10,1426,1060
1504,9,1.1.131,0,564,3,70,131,201,131,0,201,201,-88,93,313,2,2,190,266,246,304,10,1426,1060
1504,9,2.1.60,0,542,2,81,60,141,60,0,141,197,-17,22,242,2,2,226,266,281,304,10,1426,1060
1504,9,3.1.75,0,520,0,13,75,88,75,0,88,197,-32,37,257,2,2,143,266,158,304,10,1426,1060
1504,9,4.0.197,1,520,0,90,197,287,0,197,287,287,0,0,225,1,6,316,90,316,287,10,1426,1060
1504,10,0.1.197,0,534,1,10,197,207,197,0,207,287,-154,159,379,2,2,185,266,251,304,11,1426,970
1504,10,1.1.131,0,564,3,70,131,201,131,0,201,287,-88,93,313,2,2,190,266,246,304,11,1426,970
1504,10,2.1.60,0,542,2,81,60,141,60,0,141,287,-17,22,242,2,2,226,266,281,304,11,1426,970
1504,10,3.1.75,1,520,0,13,75,88,75,0,88,287,-32,37,257,2,2,143,266,158,304,11,1426,970
1504,10,4.1.287,0,520,0,92,287,379,287,0,379,379,-244,249,469,2,2,226,266,316,304,11,1426,970
1504,11,0.1.197,0,534,1,10,197,207,197,0,207,287,-109,146,366,2,3,185,253,251,304,12,1426,957
1504,11,1.1.131,0,564,2,70,131,201,131,0,201,287,-43,80,300,2,3,190,253,246,304,12,1426,957
1504,11,2.1.88,1,520,0,81,88,169,60,28,169,287,0,37,257,2,3,226,253,281,304,12,1426,957
1504,11,3.2.88,0,520,0,88,88,176,88,0,176,287,-17,60,274,3,2,130,274,158,302,12,1426,957
1504,11,4.1.287,0,520,0,92,287,379,287,0,379,379,-199,236,456,2,3,226,253,316,304,12,1426,957
1504,12,0.1.197,1,534,1,10,197,207,197,0,207,287,-28,65,285,2,4,185,172,251,304,13,1426,876
1504,12,1.1.169,0,520,0,70,169,239,131,38,239,287,0,37,257,2,4,190,172,246,304,13,1426,876
1504,12,2.2.169,0,542,2,50,169,219,169,0,219,287,-98,141,355,3,2,145,274,281,302,13,1426,876
1504,12,3.2.88,0,520,0,88,88,176,88,0,176,287,-17,60,274,3,2,130,274,158,302,13,1426,876
1504,12,4.1.287,0,520,0,92,287,379,287,0,379,379,-118,155,375,2,4,226,172,316,304,13,1426,876
1504,13,0.2.207,0,571,2,93,207,300,207,0,300,300,-136,179,421,3,2,175,274,251,302,14,1426,866
1504,13,1.1.207,1,534,0,70,207,277,131,76,277,287,0,65,285,2,5,190,162,246,304,14,1426,866
1504,13,2.2.169,0,542,1,50,169,219,169,0,219,287,-98,141,383,3,2,145,274,281,302,14,1426,866
1504,13,3.2.88,0,534,0,88,88,176,88,0,176,287,-17,60,302,3,2,130,274,158,302,14,1426,866
1504,13,4.1.287,0,534,0,92,287,379,287,0,379,379,-80,145,365,2,5,226,162,316,304,14,1426,866
1504,14,0.2.207,0,571,3,93,207,300,207,0,300,300,-136,179,421,3,2,175,274,251,302,15,1426,796
1504,14,1.2.277,0,549,2,38,277,315,277,0,315,315,-206,249,491,3,2,120,274,246,302,15,1426,796
1504,14,2.2.169,1,542,1,50,169,219,169,0,219,287,-98,141,383,3,2,145,274,281,302,15,1426,796
1504,14,3.2.88,0,534,0,88,88,176,88,0,176,287,-17,60,302,3,2,130,274,158,302,15,1426,796
1504,14,4.1.287,0,534,0,92,287,379,287,0,379,379,-10,75,295,2,6,226,92,316,304,15,1426,796
1504,15,0.2.219,0,542,0,93,219,312,207,12,312,312,0,141,383,3,3,175,224,251,302,16,1426,746
1504,15,1.2.277,0,571,2,38,277,315,277,0,315,315,-58,199,441,3,3,120,224,246,302,16,1426,746
1504,15,2.3.219,1,542,0,55,219,274,219,0,274,287,-113,184,496,4,2,95,223,281,258,16,1426,746
1504,15,3.2.219,0,559,1,88,219,307,88,131,307,307,0,141,383,3,3,130,224,158,302,16,1426,746
1504,15,4.1.287,0,542,0,92,287,379,287,0,379,379,-10,75,393,2,6,226,92,316,304,16,1426,746
1504,16,0.2.219,0,542,0,93,219,312,207,12,312,312,0,141,496,3,3,175,224,251,302,17,1426,691
1504,16,1.2.277,0,571,2,38,277,315,277,0,315,315,-58,199,554,3,3,120,224,246,302,17,1426,691
1504,16,2.4.274,1,542,0,40,274,314,274,0,314,314,-100,206,596,5,2,40,207,281,275,17,1426,691
1504,16,3.2.219,0,559,1,88,219,307,88,131,307,307,0,141,496,3,3,130,224,158,302,17,1426,691
1504,16,4.1.287,0,542,0,92,287,379,287,0,379,379,-10,75,506,2,6,226,92,316,304,17,1426,691
1504,17,0.2.219,0,542,0,93,219,312,207,12,312,314,0,141,596,3,3,175,224,251,302,18,1426,651
1504,17,1.2.277,0,571,2,38,277,315,277,0,315,315,-58,199,654,3,3,120,224,246,302,18,1426,651
1504,17,3.2.219,0,559,1,88,219,307,88,131,307,314,0,141,596,3,3,130,224,158,302,18,1426,651
1504,17,4.1.287,1,542,0,92,287,379,287,0,379,379,-10,75,606,2,6,226,92,316,304,18,1426,651
1504,18,0.2.219,0,542,0,93,219,312,207,12,312,379,0,141,606,3,3,175,224,251,302,19,1426,559
1504,18,1.2.277,0,571,2,38,277,315,277,0,315,379,-58,199,664,3,3,120,224,246,302,19,1426,559
1504,18,3.2.219,1,559,1,88,219,307,88,131,307,379,0,141,606,3,3,130,224,158,302,19,1426,559
1504,18,4.2.379,0,542,0,5,379,384,379,0,384,384,-160,301,766,3,3,134,224,316,302,19,1426,559
1504,19,0.2.307,0,607,1,93,307,400,207,100,400,400,0,141,606,3,4,175,136,251,302,20,1426,471
1504,19,1.2.307,0,559,0,38,307,345,277,30,345,379,0,141,606,3,4,120,136,246,302,20,1426,471
1504,19,3.3.307,1,559,0,36,307,343,307,0,343,379,-33,217,639,4,3,42,168,158,258,20,1426,471
1504,19,4.2.379,0,559,0,5,379,384,379,0,384,384,-72,213,678,3,4,134,136,316,302,20,1426,471
1504,20,0.2.307,0,607,1,93,307,400,207,100,400,400,0,141,639,3,4,175,136,251,302,21,1426,435
1504,20,1.2.307,0,559,0,38,307,345,277,30,345,379,0,141,639,3,4,120,136,246,302,21,1426,435
1504,20,3.4.343,1,559,0,6,343,349,343,0,349,379,-29,235,668,5,3,6,167,158,275,21,1426,435
1504,20,4.2.379,0,559,0,5,379,384,379,0,384,384,-72,213,711,3,4,134,136,316,302,21,1426,435
1504,21,0.2.307,0,607,1,93,307,400,207,100,400,400,0,141,668,3,4,175,136,251,302,22,1426,429
1504,21,1.2.307,1,559,0,38,307,345,277,30,345,379,0,141,668,3,4,120,136,246,302,22,1426,429
1504,21,4.2.379,0,559,0,5,379,384,379,0,384,384,-72,213,740,3,4,134,136,316,302,22,1426,429
1504,22,0.2.345,0,579,1,93,345,438,207,138,438,438,0,141,668,3,5,175,98,251,302,23,1426,391
1504,22,1.3.345,1,559,0,16,345,361,345,0,361,379,-2,219,670,4,4,82,132,246,258,23,1426,391
1504,22,4.2.379,0,559,0,5,379,384,379,0,384,384,-34,175,702,3,5,134,98,316,302,23,1426,391
1504,23,0.2.345,0,579,1,93,345,438,207,138,438,438,0,141,670,3,5,175,98,251,302,24,1426,375
1504,23,1.4.361,1,559,0,66,361,427,361,0,427,427,-12,247,682,5,4,66,161,246,275,24,1426,375
1504,23,4.2.379,0,559,0,5,379,384,379,0,384,384,-34,175,704,3,5,134,98,316,302,24,1426,375
1504,24,0.2.345,0,579,1,93,345,438,207,138,438,438,0,141,682,3,5,175,98,251,302,25,1426,309
1504,24,4.2.379,1,559,0,5,379,384,379,0,384,427,-34,175,716,3,5,134,98,316,302,25,1426,309
1504,25,0.2.384,0,559,0,93,384,477,207,177,477,477,0,175,716,3,6,175,93,251,302,26,1426,304
1504,25,4.3.384,1,559,0,41,384,425,384,0,425,427,-23,242,739,4,5,129,116,316,258,26,1426,304
1504,26,0.2.384,0,559,0,93,384,477,207,177,477,477,0,175,739,3,6,175,93,251,302,27,1426,263
1504,26,4.4.427,1,559,0,88,427,515,425,2,515,515,0,247,739,5,5,88,95,316,275,27,1426,263
1504,27,0.2.384,1,559,0,93,384,477,207,177,477,515,0,175,739,3,6,175,93,251,302,28,1426,175
1504,28,0.3.477,1,559,0,75,477,552,477,0,552,552,-52,294,791,4,6,82,75,251,258,29,1426,82
1504,29,0.4.552,1,559,0,7,552,559,552,0,559,559,-37,284,828,5,6,7,7,251,275,30,1426,7
1505,0,0.0.0,1,571,3,79,0,79,0,0,79,79,0,0,0,1,1,392,202,392,202,1,1397,1397
1505,0,1.0.0,0,520,0,32,0,32,0,0,32,32,0,0,0,1,1,246,202,246,202,1,1397,1397
1505,0,2.0.0,0,521,1,1,0,1,0,0,1,1,0,0,0,1,1,110,202,110,202,1,1397,1397
1505,0,3.0.0,0,552,2,68,0,68,0,0,68,68,0,0,0,1,1,317,202,317,202,1,1397,1397
1505,0,4.0.0,0,520,0,12,0,12,0,0,12,12,0,0,0,1,1,155,202,155,202,1,1397,1397
1505,0,5.0.0,0,520,0,10,0,10,0,0,10,10,0,0,0,1,1,177,202,177,202,1,1397,1397
1505,1,0.1.79,0,608,3,77,79,156,79,0,156,156,-79,79,79,2,1,313,307,392,307,2,1397,1318
1505,1,1.0.79,1,585,2,32,79,111,0,79,111,111,0,0,0,1,2,246,123,246,202,2,1397,1318
1505,1,2.0.79,0,572,1,1,79,80,0,79,80,80,0,0,0,1,2,110,123,110,202,2,1397,1318
1505,1,3.0.79,0,610,4,68,79,147,0,79,147,147,0,0,0,1,2,317,123,317,202,2,1397,1318
1505,1,4.0.79,0,571,0,12,79,91,0,79,91,91,0,0,0,1,2,155,123,155,202,2,1397,1318
1505,1,5.0.79,0,571,0,10,79,89,0,79,89,89,0,0,0,1,2,177,123,177,202,2,1397,1318
1505,2,0.1.79,0,608,1,77,79,156,79,0,156,156,-79,79,79,2,1,313,307,392,307,3,1397,1286
1505,2,1.1.111,0,585,0,38,111,149,111,0,149,149,-111,111,111,2,1,214,307,246,307,3,1397,1286
1505,2,2.0.111,0,585,0,1,111,112,0,111,112,112,0,0,0,1,3,110,91,110,202,3,1397,1286
1505,2,3.0.111,0,608,1,68,111,179,0,111,179,179,0,0,0,1,3,317,91,317,202,3,1397,1286
1505,2,4.0.111,0,585,0,12,111,123,0,111,123,123,0,0,0,1,3,155,91,155,202,3,1397,1286
1505,2,5.0.111,1,585,0,10,111,121,0,111,121,121,0,0,0,1,3,177,91,177,202,3,1397,1286
1505,3,0.1.79,0,608,3,77,79,156,79,0,156,156,-79,79,79,2,1,313,307,392,307,4,1397,1276
1505,3,1.1.111,0,585,0,38,111,149,111,0,149,149,-111,111,111,2,1,214,307,246,307,4,1397,1276
1505,3,2.0.121,0,585,0,1,121,122,0,121,122,122,0,0,0,1,4,110,81,110,202,4,1397,1276
1505,3,3.0.121,0,599,2,68,121,189,0,121,189,189,0,0,0,1,4,317,81,317,202,4,1397,1276
1505,3,4.0.121,1,585,0,12,121,133,0,121,133,133,0,0,0,1,4,155,81,155,202,4,1397,1276
1505,3,5.1.121,0,595,1,22,121,143,121,0,143,143,-121,121,121,2,1,167,307,177,307,4,1397,1276
1505,4,0.1.79,0,608,3,77,79,156,79,0,156,156,-79,79,79,2,1,313,307,392,307,5,1397,1264
1505,4,1.1.111,0,585,0,38,111,149,111,0,149,149,-111,111,111,2,1,214,307,246,307,5,1397,1264
1505,4,2.0.133,1,585,0,1,133,134,0,133,134,134,0,0,0,1,5,110,69,110,202,5,1397,1264
1505,4,3.0.133,0,585,0,68,133,201,0,133,201,201,0,0,0,1,5,317,69,317,202,5,1397,1264
1505,4,4.1.133,0,607,2,44,133,177,133,0,177,177,-133,133,133,2,1,143,307,155,307,5,1397,1264
1505,4,5.1.121,0,595,1,22,121,143,121,0,143,143,-121,121,121,2,1,167,307,177,307,5,1397,1264
1505,5,0.1.79,0,608,3,77,79,156,79,0,156,156,-79,79,79,2,1,313,307,392,307,6,1397,1263
1505,5,1.1.111,0,585,0,38,111,149,111,0,149,149,-111,111,111,2,1,214,307,246,307,6,1397,1263
1505,5,2.1.134,0,673,4,75,134,209,134,0,209,209,-134,134,134,2,1,109,307,110,307,6,1397,1263
1505,5,3.0.134,1,585,0,68,134,202,0,134,202,202,0,0,0,1,6,317,68,317,202,6,1397,1263
1505,5,4.1.133,0,607,2,44,133,177,133,0,177,177,-133,133,133,2,1,143,307,155,307,6,1397,1263
1505,5,5.1.121,0,595,1,22,121,143,121,0,143,143,-121,121,121,2,1,167,307,177,307,6,1397,1263
1505,6,0.1.79,1,608,3,77,79,156,79,0,156,202,-79,79,79,2,1,313,307,392,307,7,1397,1195
1505,6,1.1.111,0,585,0,38,111,149,111,0,149,202,-111,111,111,2,1,214,307,246,307,7,1397,1195
1505,6,2.1.134,0,673,5,75,134,209,134,0,209,209,-134,134,134,2,1,109,307,110,307,7,1397,1195
1505,6,3.1.202,0,610,4,51,202,253,202,0,253,253,-202,202,202,2,1,249,307,317,307,7,1397,1195
1505,6,4.1.133,0,607,2,44,133,177,133,0,177,202,-133,133,133,2,1,143,307,155,307,7,1397,1195
1505,6,5.1.121,0,595,1,22,121,143,121,0,143,202,-121,121,121,2,1,167,307,177,307,7,1397,1195
1505,7,0.2.156,1,611,2,96,156,252,156,0,252,252,-156,156,235,3,1,236,271,392,271,8,1397,1118
1505,7,1.1.156,0,608,0,38,156,194,111,45,194,202,0,79,79,2,2,214,230,246,307,8,1397,1118
1505,7,2.1.156,0,636,4,75,156,231,134,22,231,231,0,79,79,2,2,109,230,110,307,8,1397,1118
1505,7,3.1.202,0,619,3,51,202,253,202,0,253,253,-46,125,125,2,2,249,230,317,307,8,1397,1118
1505,7,4.1.156,0,611,2,44,156,200,133,23,200,202,0,79,79,2,2,143,230,155,307,8,1397,1118
1505,7,5.1.156,0,609,1,22,156,178,121,35,178,202,0,79,79,2,2,167,230,177,307,8,1397,1118
1505,8,0.3.252,0,638,4,81,252,333,252,0,333,333,-252,252,487,4,1,140,312,392,312,9,1397,1022
1505,8,1.1.156,1,611,0,38,156,194,111,45,194,252,0,79,235,2,2,214,230,246,307,9,1397,1022
1505,8,2.1.156,0,636,3,75,156,231,134,22,231,252,0,79,235,2,2,109,230,110,307,9,1397,1022
1505,8,3.1.202,0,619,2,51,202,253,202,0,253,253,-46,125,281,2,2,249,230,317,307,9,1397,1022
1505,8,4.1.156,0,611,0,44,156,200,133,23,200,252,0,79,235,2,2,143,230,155,307,9,1397,1022
1505,8,5.1.156,0,613,1,22,156,178,121,35,178,252,0,79,235,2,2,167,230,177,307,9,1397,1022
1505,9,0.3.252,0,638,2,81,252,333,252,0,333,333,-252,252,487,4,1,140,312,392,312,10,1397,984
1505,9,1.2.252,1,638,2,43,252,295,194,58,295,295,0,156,235,3,2,176,175,246,271,10,1397,984
1505,9,2.1.194,0,638,2,75,194,269,134,60,269,269,0,79,235,2,3,109,192,110,307,10,1397,984
1505,9,3.1.202,0,638,2,51,202,253,202,0,253,253,-8,87,243,2,3,249,192,317,307,10,1397,984
1505,9,4.1.194,0,611,0,44,194,238,133,61,238,252,0,79,235,2,3,143,192,155,307,10,1397,984
1505,9,5.1.194,0,619,1,22,194,216,121,73,216,252,0,79,235,2,3,167,192,177,307,10,1397,984
1505,10,0.3.252,0,638,0,81,252,333,252,0,333,333,-252,252,487,4,1,140,312,392,312,11,1397,941
1505,10,1.3.295,0,658,1,58,295,353,295,0,353,353,-295,295,530,4,1,133,312,246,312,11,1397,941
1505,10,2.1.194,0,638,0,75,194,269,134,60,269,295,0,79,235,2,3,109,192,110,307,11,1397,941
1505,10,3.1.202,0,638,0,51,202,253,202,0,253,295,-8,87,243,2,3,249,192,317,307,11,1397,941
1505,10,4.1.194,0,638,0,44,194,238,133,61,238,295,0,79,235,2,3,143,192,155,307,11,1397,941
1505,10,5.1.194,1,638,0,22,194,216,121,73,216,295,0,79,235,2,3,167,192,177,307,11,1397,941
1505,11,0.3.252,0,638,0,81,252,333,252,0,333,333,-252,252,487,4,1,140,312,392,312,12,1397,919
1505,11,1.3.295,0,658,1,58,295,353,295,0,353,353,-295,295,530,4,1,133,312,246,312,12,1397,919
1505,11,2.1.216,0,638,0,75,216,291,134,82,291,295,0,79,235,2,4,109,170,110,307,12,1397,919
1505,11,3.1.216,1,638,0,51,216,267,202,14,267,295,0,79,235,2,4,249,170,317,307,12,1397,919
1505,11,4.1.216,0,638,0,44,216,260,133,83,260,295,0,79,235,2,4,143,170,155,307,12,1397,919
1505,11,5.2.295,0,638,0,66,295,361,216,79,361,361,0,156,235,3,3,145,132,177,271,12,1397,919
1505,12,0.3.252,0,638,0,81,252,333,252,0,333,333,-252,252,487,4,1,140,312,392,312,13,1397,868
1505,12,1.3.295,0,658,1,58,295,353,295,0,353,353,-295,295,530,4,1,133,312,246,312,13,1397,868
1505,12,2.1.267,0,638,0,75,267,342,134,133,342,342,0,79,235,2,5,109,119,110,307,13,1397,868
1505,12,3.2.295,0,638,0,56,295,351,267,28,351,351,0,156,235,3,3,198,132,317,271,13,1397,868
1505,12,4.1.267,1,638,0,44,267,311,133,134,311,311,0,79,235,2,5,143,119,155,307,13,1397,868
1505,12,5.2.295,0,638,0,66,295,361,216,79,361,361,0,156,235,3,3,145,132,177,271,13,1397,868
1505,13,0.3.252,0,638,0,81,252,333,252,0,333,333,-252,252,487,4,1,140,312,392,312,14,1397,824
1505,13,1.3.295,0,658,1,58,295,353,295,0,353,353,-295,295,530,4,1,133,312,246,312,14,1397,824
1505,13,2.1.311,0,638,0,75,311,386,134,177,386,386,0,79,235,2,6,109,75,110,307,14,1397,824
1505,13,3.2.295,1,638,0,56,295,351,267,28,351,351,0,156,235,3,3,198,132,317,271,14,1397,824
1505,13,4.2.311,0,638,0,6,311,317,311,0,317,317,-16,172,251,3,3,99,132,155,271,14,1397,824
1505,13,5.2.295,0,638,0,66,295,361,216,79,361,361,0,156,235,3,3,145,132,177,271,14,1397,824
1505,14,0.3.252,0,638,0,81,252,333,252,0,333,351,-252,252,487,4,1,140,312,392,312,15,1397,768
1505,14,1.3.295,0,658,1,58,295,353,295,0,353,353,-295,295,530,4,1,133,312,246,312,15,1397,768
1505,14,2.1.311,0,638,0,75,311,386,134,177,386,386,0,79,235,2,6,109,75,110,307,15,1397,768
1505,14,3.3.351,0,692,2,95,351,446,351,0,446,446,-351,351,586,4,1,142,312,317,312,15,1397,768
1505,14,4.2.351,1,638,0,6,351,357,311,40,357,357,0,156,235,3,4,99,76,155,271,15,1397,768
1505,14,5.2.351,0,638,0,66,351,417,216,135,417,417,0,156,235,3,4,145,76,177,271,15,1397,768
1505,15,0.3.252,0,638,0,81,252,333,252,0,333,357,-252,252,487,4,1,140,312,392,312,16,1397,762
1505,15,1.3.295,0,658,1,58,295,353,295,0,353,357,-295,295,530,4,1,133,312,246,312,16,1397,762
1505,15,2.1.311,0,638,0,75,311,386,134,177,386,386,0,79,235,2,6,109,75,110,307,16,1397,762
1505,15,3.3.351,0,692,2,95,351,446,351,0,446,446,-351,351,586,4,1,142,312,317,312,16,1397,762
1505,15,4.3.357,0,638,0,34,357,391,357,0,391,391,-357,357,592,4,1,93,312,155,312,16,1397,762
1505,15,5.2.357,1,638,0,66,357,423,216,141,423,423,0,156,235,3,5,145,70,177,271,16,1397,762
1505,16,0.3.252,0,638,0,81,252,333,252,0,333,423,-252,252,487,4,1,140,312,392,312,17,1397,696
1505,16,1.3.295,0,658,1,58,295,353,295,0,353,423,-295,295,530,4,1,133,312,246,312,17,1397,696
1505,16,2.1.311,1,638,0,75,311,386,134,177,386,423,0,79,235,2,6,109,75,110,307,17,1397,696
1505,16,3.3.351,0,692,2,95,351,446,351,0,446,446,-351,351,586,4,1,142,312,317,312,17,1397,696
1505,16,4.3.357,0,638,0,34,357,391,357,0,391,423,-357,357,592,4,1,93,312,155,312,17,1397,696
1505,16,5.3.423,0,638,0,20,423,443,423,0,443,443,-423,423,658,4,1,79,312,177,312,17,1397,696
1505,17,0.3.252,0,638,0,81,252,333,252,0,333,423,-252,252,487,4,1,140,312,392,312,18,1397,621
1505,17,1.3.295,0,658,1,58,295,353,295,0,353,423,-295,295,530,4,1,133,312,246,312,18,1397,621
1505,17,2.2.423,1,638,0,4,423,427,386,37,427,427,0,156,235,3,6,34,4,110,271,18,1397,621
1505,17,3.3.351,0,692,2,95,351,446,351,0,446,446,-351,351,586,4,1,142,312,317,312,18,1397,621
1505,17,4.3.357,0,638,0,34,357,391,357,0,391,423,-357,357,592,4,1,93,312,155,312,18,1397,621
1505,17,5.3.423,0,638,0,20,423,443,423,0,443,443,-423,423,658,4,1,79,312,177,312,18,1397,621
1505,18,0.3.252,1,638,0,81,252,333,252,0,333,427,-252,252,487,4,1,140,312,392,312,19,1397,617
1505,18,1.3.295,0,658,1,58,295,353,295,0,353,427,-295,295,530,4,1,133,312,246,312,19,1397,617
1505,18,2.3.427,0,638,0,24,427,451,427,0,451,451,-427,427,662,4,1,30,312,110,312,19,1397,617
1505,18,3.3.351,0,692,2,95,351,446,351,0,446,446,-351,351,586,4,1,142,312,317,312,19,1397,617
1505,18,4.3.357,0,638,0,34,357,391,357,0,391,427,-357,357,592,4,1,93,312,155,312,19,1397,617
1505,18,5.3.423,0,638,0,20,423,443,423,0,443,443,-423,423,658,4,1,79,312,177,312,19,1397,617
1505,19,0.4.333,1,638,0,59,333,392,333,0,392,427,-333,333,820,5,1,59,305,392,305,20,1397,536
1505,19,1.3.333,0,638,0,58,333,391,295,38,391,427,0,252,487,4,2,133,231,246,312,20,1397,536
1505,19,2.3.427,0,638,0,24,427,451,427,0,451,451,-94,346,581,4,2,30,231,110,312,20,1397,536
1505,19,3.3.351,0,692,1,95,351,446,351,0,446,446,-18,270,505,4,2,142,231,317,312,20,1397,536
1505,19,4.3.357,0,638,0,34,357,391,357,0,391,427,-24,276,511,4,2,93,231,155,312,20,1397,536
1505,19,5.3.423,0,638,0,20,423,443,423,0,443,443,-90,342,577,4,2,79,231,177,312,20,1397,536
1505,20,1.3.333,1,638,0,58,333,391,295,38,391,427,0,252,820,4,2,133,231,246,312,21,1397,477
1505,20,2.3.427,0,638,0,24,427,451,427,0,451,451,-94,346,914,4,2,30,231,110,312,21,1397,477
1505,20,3.3.351,0,692,1,95,351,446,351,0,446,446,-18,270,838,4,2,142,231,317,312,21,1397,477
1505,20,4.3.357,0,638,0,34,357,391,357,0,391,427,-24,276,844,4,2,93,231,155,312,21,1397,477
1505,20,5.3.423,0,638,0,20,423,443,423,0,443,443,-90,342,910,4,2,79,231,177,312,21,1397,477
1505,21,1.4.392,0,638,0,75,392,467,391,1,467,467,0,333,820,5,2,75,246,246,305,22,1397,419
1505,21,2.3.427,0,638,0,24,427,451,427,0,451,451,-36,288,856,4,3,30,173,110,312,22,1397,419
1505,21,3.3.391,0,657,1,95,391,486,351,40,486,486,0,252,820,4,3,142,173,317,312,22,1397,419
1505,21,4.3.391,1,638,0,34,391,425,357,34,425,427,0,252,820,4,3,93,173,155,312,22,1397,419
1505,21,5.3.423,0,638,0,20,423,443,423,0,443,443,-32,284,852,4,3,79,173,177,312,22,1397,419
1505,22,1.4.392,0,638,0,75,392,467,391,1,467,467,0,333,820,5,2,75,246,246,305,23,1397,385
1505,22,2.3.427,0,638,0,24,427,451,427,0,451,451,-2,254,822,4,4,30,139,110,312,23,1397,385
1505,22,3.3.425,0,638,0,95,425,520,351,74,520,520,0,252,820,4,4,142,139,317,312,23,1397,385
1505,22,4.4.425,0,671,1,59,425,484,425,0,484,484,-33,366,853,5,2,59,246,155,305,23,1397,385
1505,22,5.3.425,1,638,0,20,425,445,423,2,445,445,0,252,820,4,4,79,139,177,312,23,1397,385
1505,23,1.4.392,0,638,0,75,392,467,391,1,467,467,0,333,820,5,2,75,246,246,305,24,1397,365
1505,23,2.3.445,0,638,0,24,445,469,427,18,469,469,0,252,820,4,5,30,119,110,312,24,1397,365
1505,23,3.3.445,1,638,0,95,445,540,351,94,540,540,0,252,820,4,5,142,119,317,312,24,1397,365
1505,23,4.4.425,0,671,1,59,425,484,425,0,484,484,-33,366,853,5,2,59,246,155,305,24,1397,365
1505,23,5.4.445,0,691,2,59,445,504,445,0,504,504,-53,386,873,5,2,59,246,177,305,24,1397,365
1505,24,1.4.392,0,638,0,75,392,467,391,1,467,540,0,333,820,5,2,75,246,246,305,25,1397,270
1505,24,2.3.540,1,638,0,24,540,564,427,113,564,564,0,252,820,4,6,30,24,110,312,25,1397,270
1505,24,3.4.540,0,652,1,47,540,587,540,0,587,587,-148,481,968,5,2,47,246,317,305,25,1397,270
1505,24,4.4.425,0,671,2,59,425,484,425,0,484,540,-33,366,853,5,2,59,246,155,305,25,1397,270
1505,24,5.4.445,0,691,3,59,445,504,445,0,504,540,-53,386,873,5,2,59,246,177,305,25,1397,270
1505,25,1.4.392,1,638,0,75,392,467,391,1,467,564,0,333,820,5,2,75,246,246,305,26,1397,246
1505,25,2.4.564,0,676,3,6,564,570,564,0,570,570,-172,505,992,5,2,6,246,110,305,26,1397,246
1505,25,3.4.540,0,652,1,47,540,587,540,0,587,587,-148,481,968,5,2,47,246,317,305,26,1397,246
1505,25,4.4.425,0,671,2,59,425,484,425,0,484,564,-33,366,853,5,2,59,246,155,305,26,1397,246
1505,25,5.4.445,0,691,4,59,445,504,445,0,504,564,-53,386,873,5,2,59,246,177,305,26,1397,246
1505,26,2.4.564,0,676,2,6,564,570,564,0,570,570,-97,430,917,5,3,6,171,110,305,27,1397,171
1505,26,3.4.540,0,652,1,47,540,587,540,0,587,587,-73,406,893,5,3,47,171,317,305,27,1397,171
1505,26,4.4.467,1,638,0,59,467,526,425,42,526,564,0,333,820,5,3,59,171,155,305,27,1397,171
1505,26,5.4.467,0,638,0,59,467,526,445,22,526,564,0,333,820,5,3,59,171,177,305,27,1397,171
1505,27,2.4.564,0,676,2,6,564,570,564,0,570,570,-38,371,858,5,4,6,112,110,305,28,1397,112
1505,27,3.4.540,1,652,1,47,540,587,540,0,587,587,-14,347,834,5,4,47,112,317,305,28,1397,112
1505,27,5.4.526,0,638,0,59,526,585,445,81,585,585,0,333,820,5,4,59,112,177,305,28,1397,112
1505,28,2.4.587,0,652,0,6,587,593,564,23,593,593,0,347,834,5,5,6,65,110,305,29,1397,65
1505,28,5.4.587,1,652,0,59,587,646,445,142,646,646,0,347,834,5,5,59,65,177,305,29,1397,65
1505,29,2.4.646,1,652,0,6,646,652,564,82,652,652,0,347,834,5,6,6,6,110,305,30,1397,6
1506,0,0.0.0,0,566,3,92,0,92,0,0,92,92,0,0,0,1,1,239,215,239,215,1,1364,1364
1506,0,1.0.0,1,474,0,7,0,7,0,0,7,7,0,0,0,1,1,244,215,244,215,1,1364,1364
1506,0,2.0.0,0,508,2,47,0,47,0,0,47,47,0,0,0,1,1,334,215,334,215,1,1364,1364
1506,0,3.0.0,0,479,1,21,0,21,0,0,21,21,0,0,0,1,1,275,215,275,215,1,1364,1364
1506,0,4.0.0,0,508,2,34,0,34,0,0,34,34,0,0,0,1,1,193,215,193,215,1,1364,1364
1506,0,5.0.0,0,474,0,14,0,14,0,0,14,14,0,0,0,1,1,79,215,79,215,1,1364,1364
1506,1,0.0.7,0,555,4,92,7,99,0,7,99,99,0,0,0,1,2,239,208,239,215,2,1364,1357
1506,1,1.1.7,0,474,0,6,7,13,7,0,13,13,-7,7,7,2,1,237,310,244,310,2,1364,1357
1506,1,2.0.7,0,489,2,47,7,54,0,7,54,54,0,0,0,1,2,334,208,334,215,2,1364,1357
1506,1,3.0.7,1,479,1,21,7,28,0,7,28,28,0,0,0,1,2,275,208,275,215,2,1364,1357
1506,1,4.0.7,0,499,3,34,7,41,0,7,41,41,0,0,0,1,2,193,208,193,215,2,1364,1357
1506,1,5.0.7,0,474,0,14,7,21,0,7,21,21,0,0,0,1,2,79,208,79,215,2,1364,1357
1506,2,0.0.28,0,498,2,92,28,120,0,28,120,120,0,0,0,1,3,239,187,239,215,3,1364,1336
1506,2,1.1.7,0,479,0,6,7,13,7,0,13,28,-7,7,7,2,1,237,310,244,310,3,1364,1336
1506,2,2.0.28,1,495,1,47,28,75,0,28,75,75,0,0,0,1,3,334,187,334,215,3,1364,1336
1506,2,3.1.28,0,495,1,89,28,117,28,0,117,117,-28,28,28,2,1,254,310,275,310,3,1364,1336
1506,2,4.0.28,0,495,1,34,28,62,0,28,62,62,0,0,0,1,3,193,187,193,215,3,1364,1336
1506,2,5.0.28,0,479,0,14,28,42,0,28,42,42,0,0,0,1,3,79,187,79,215,3,1364,1336
1506,3,0.0.75,0,495,0,92,75,167,0,75,167,167,0,0,0,1,4,239,140,239,215,4,1364,1289
1506,3,1.1.7,0,495,0,6,7,13,7,0,13,75,-7,7,7,2,1,237,310,244,310,4,1364,1289
1506,3,2.1.75,0,500,1,68,75,143,75,0,143,143,-75,75,75,2,1,287,310,334,310,4,1364,1289
1506,3,3.1.28,0,495,0,89,28,117,28,0,117,117,-28,28,28,2,1,254,310,275,310,4,1364,1289
1506,3,4.0.75,1,495,0,34,75,109,0,75,109,109,0,0,0,1,4,193,140,193,215,4,1364,1289
1506,3,5.0.75,0,495,0,14,75,89,0,75,89,89,0,0,0,1,4,79,140,79,215,4,1364,1289
1506,4,0.0.109,0,495,0,92,109,201,0,109,201,201,0,0,0,1,5,239,106,239,215,5,1364,1255
1506,4,1.1.7,0,495,0,6,7,13,7,0,13,109,-7,7,7,2,1,237,310,244,310,5,1364,1255
1506,4,2.1.75,0,500,1,68,75,143,75,0,143,143,-75,75,75,2,1,287,310,334,310,5,1364,1255
1506,4,3.1.28,0,495,0,89,28,117,28,0,117,117,-28,28,28,2,1,254,310,275,310,5,1364,1255
1506,4,4.1.109,0,597,2,96,109,205,109,0,205,205,-109,109,109,2,1,159,310,193,310,5,1364,1255
1506,4,5.0.109,1,495,0,14,109,123,0,109,123,123,0,0,0,1,5,79,106,79,215,5,1364,1255
1506,5,0.0.123,1,495,0,92,123,215,0,123,215,215,0,0,0,1,6,239,92,239,215,6,1364,1241
1506,5,1.1.7,0,495,0,6,7,13,7,0,13,123,-7,7,7,2,1,237,310,244,310,6,1364,1241
1506,5,2.1.75,0,500,1,68,75,143,75,0,143,143,-75,75,75,2,1,287,310,334,310,6,1364,1241
1506,5,3.1.28,0,495,0,89,28,117,28,0,117,123,-28,28,28,2,1,254,310,275,310,6,1364,1241
1506,5,4.1.109,0,597,2,96,109,205,109,0,205,205,-109,109,109,2,1,159,310,193,310,6,1364,1241
1506,5,5.1.123,0,495,0,5,123,128,123,0,128,128,-123,123,123,2,1,65,310,79,310,6,1364,1241
1506,6,0.1.215,0,495,0,46,215,261,215,0,261,261,-215,215,215,2,1,147,310,239,310,7,1364,1149
1506,6,1.1.7,1,495,0,6,7,13,7,0,13,215,-7,7,7,2,1,237,310,244,310,7,1364,1149
1506,6,2.1.75,0,500,1,68,75,143,75,0,143,215,-75,75,75,2,1,287,310,334,310,7,1364,1149
1506,6,3.1.28,0,495,0,89,28,117,28,0,117,215,-28,28,28,2,1,254,310,275,310,7,1364,1149
1506,6,4.1.109,0,597,2,96,109,205,109,0,205,215,-109,109,109,2,1,159,310,193,310,7,1364,1149
1506,6,5.1.123,0,495,0,5,123,128,123,0,128,215,-123,123,123,2,1,65,310,79,310,7,1364,1149
1506,7,0.1.215,0,495,0,46,215,261,215,0,261,261,-202,209,209,2,2,147,304,239,310,8,1364,1143
1506,7,1.2.13,1,495,0,48,13,61,13,0,61,215,-13,13,20,3,1,231,140,244,140,8,1364,1143
1506,7,2.1.75,0,500,1,68,75,143,75,0,143,215,-62,69,69,2,2,287,304,334,310,8,1364,1143
1506,7,3.1.28,0,495,0,89,28,117,28,0,117,215,-15,22,22,2,2,254,304,275,310,8,1364,1143
1506,7,4.1.109,0,597,2,96,109,205,109,0,205,215,-96,103,103,2,2,159,304,193,310,8,1364,1143
1506,7,5.1.123,0,495,0,5,123,128,123,0,128,215,-110,117,117,2,2,65,304,79,310,8,1364,1143
1506,8,0.1.215,0,495,0,46,215,261,215,0,261,261,-202,209,222,2,2,147,304,239,310,9,1364,1095
1506,8,1.3.61,1,495,0,99,61,160,61,0,160,215,-61,61,81,4,1,183,364,244,364,9,1364,1095
1506,8,2.1.75,0,500,1,68,75,143,75,0,143,215,-62,69,82,2,2,287,304,334,310,9,1364,1095
1506,8,3.1.28,0,495,0,89,28,117,28,0,117,215,-15,22,35,2,2,254,304,275,310,9,1364,1095
1506,8,4.1.109,0,597,2,96,109,205,109,0,205,215,-96,103,116,2,2,159,304,193,310,9,1364,1095
1506,8,5.1.123,0,495,0,5,123,128,123,0,128,215,-110,117,130,2,2,65,304,79,310,9,1364,1095
1506,9,0.1.215,0,495,0,46,215,261,215,0,261,261,-202,209,283,2,2,147,304,239,310,10,1364,996
1506,9,1.4.160,1,495,0,84,160,244,160,0,244,244,-160,160,241,5,1,84,335,244,335,10,1364,996
1506,9,2.1.75,0,500,1,68,75,143,75,0,143,215,-62,69,143,2,2,287,304,334,310,10,1364,996
1506,9,3.1.28,0,495,0,89,28,117,28,0,117,215,-15,22,96,2,2,254,304,275,310,10,1364,996
1506,9,4.1.109,0,597,2,96,109,205,109,0,205,215,-96,103,177,2,2,159,304,193,310,10,1364,996
1506,9,5.1.123,0,495,0,5,123,128,123,0,128,215,-110,117,191,2,2,65,304,79,310,10,1364,996
1506,10,0.1.215,0,495,0,46,215,261,215,0,261,261,-202,209,443,2,2,147,304,239,310,11,1364,912
1506,10,2.1.75,1,500,1,68,75,143,75,0,143,244,-62,69,303,2,2,287,304,334,310,11,1364,912
1506,10,3.1.28,0,495,0,89,28,117,28,0,117,244,-15,22,256,2,2,254,304,275,310,11,1364,912
1506,10,4.1.109,0,597,2,96,109,205,109,0,205,244,-96,103,337,2,2,159,304,193,310,11,1364,912
1506,10,5.1.123,0,495,0,5,123,128,123,0,128,244,-110,117,351,2,2,65,304,79,310,11,1364,912
1506,11,0.1.215,0,554,3,46,215,261,215,0,261,261,-72,141,375,2,3,147,236,239,310,12,1364,844
1506,11,2.2.143,1,500,0,56,143,199,143,0,199,244,-82,95,385,3,2,219,92,334,140,12,1364,844
1506,11,3.1.143,0,537,1,89,143,232,28,115,232,244,0,69,303,2,3,254,236,275,310,12,1364,844
1506,11,4.1.143,0,540,2,96,143,239,109,34,239,244,0,69,303,2,3,159,236,193,310,12,1364,844
1506,11,5.1.143,0,500,0,5,143,148,123,20,148,244,0,69,303,2,3,65,236,79,310,12,1364,844
1506,12,0.1.215,0,554,4,46,215,261,215,0,261,261,-72,141,457,2,3,147,236,239,310,13,1364,788
1506,12,2.3.199,1,542,3,92,199,291,199,0,291,291,-39,100,424,4,2,163,265,334,364,13,1364,788
1506,12,3.1.143,0,537,1,89,143,232,28,115,232,244,0,69,385,2,3,254,236,275,310,13,1364,788
1506,12,4.1.143,0,540,2,96,143,239,109,34,239,244,0,69,385,2,3,159,236,193,310,13,1364,788
1506,12,5.1.143,0,500,0,5,143,148,123,20,148,244,0,69,385,2,3,65,236,79,310,13,1364,788
1506,13,0.1.215,0,554,1,46,215,261,215,0,261,291,-72,141,496,2,3,147,236,239,310,14,1364,696
1506,13,2.4.291,1,542,0,71,291,362,291,0,362,362,-47,207,471,5,2,71,251,334,335,14,1364,696
1506,13,3.1.143,0,542,0,89,143,232,28,115,232,291,0,69,424,2,3,254,236,275,310,14,1364,696
1506,13,4.1.143,0,542,0,96,143,239,109,34,239,291,0,69,424,2,3,159,236,193,310,14,1364,696
1506,13,5.1.143,0,542,0,5,143,148,123,20,148,291,0,69,424,2,3,65,236,79,310,14,1364,696
1506,14,0.1.215,0,554,1,46,215,261,215,0,261,362,-72,141,543,2,3,147,236,239,310,15,1364,625
1506,14,3.1.143,1,542,0,89,143,232,28,115,232,362,0,69,471,2,3,254,236,275,310,15,1364,625
1506,14,4.1.143,0,542,0,96,143,239,109,34,239,362,0,69,471,2,3,159,236,193,310,15,1364,625
1506,14,5.1.143,0,542,0,5,143,148,123,20,148,362,0,69,471,2,3,65,236,79,310,15,1364,625
1506,15,0.1.232,0,542,0,46,232,278,215,17,278,362,0,69,471,2,4,147,147,239,310,16,1364,536
1506,15,3.2.232,1,542,0,23,232,255,232,0,255,362,-33,128,504,3,3,165,36,275,140,16,1364,536
1506,15,4.1.232,0,542,0,96,232,328,109,123,328,362,0,69,471,2,4,159,147,193,310,16,1364,536
1506,15,5.1.232,0,542,0,5,232,237,123,109,237,362,0,69,471,2,4,65,147,79,310,16,1364,536
1506,16,0.1.232,0,542,0,46,232,278,215,17,278,362,0,69,504,2,4,147,147,239,310,17,1364,513
1506,16,3.3.291,1,542,0,54,291,345,255,36,345,362,0,100,504,4,3,142,173,275,364,17,1364,513
1506,16,4.1.232,0,542,0,96,232,328,109,123,328,362,0,69,504,2,4,159,147,193,310,17,1364,513
1506,16,5.1.232,0,542,0,5,232,237,123,109,237,362,0,69,504,2,4,65,147,79,310,17,1364,513
1506,17,0.1.232,0,542,0,46,232,278,215,17,278,362,0,69,504,2,4,147,147,239,310,18,1364,459
1506,17,3.4.362,1,542,0,88,362,450,345,17,450,450,0,207,504,5,3,88,180,275,335,18,1364,459
1506,17,4.1.232,0,542,0,96,232,328,109,123,328,362,0,69,504,2,4,159,147,193,310,18,1364,459
1506,17,5.1.232,0,542,0,5,232,237,123,109,237,362,0,69,504,2,4,65,147,79,310,18,1364,459
1506,18,0.1.232,0,542,0,46,232,278,215,17,278,450,0,69,504,2,4,147,147,239,310,19,1364,371
1506,18,4.1.232,0,542,0,96,232,328,109,123,328,450,0,69,504,2,4,159,147,193,310,19,1364,371
1506,18,5.1.232,1,542,0,5,232,237,123,109,237,450,0,69,504,2,4,65,147,79,310,19,1364,371
1506,19,0.1.237,0,542,0,46,237,283,215,22,283,450,0,69,504,2,5,147,142,239,310,20,1364,366
1506,19,4.1.237,0,542,0,96,237,333,109,128,333,450,0,69,504,2,5,159,142,193,310,20,1364,366
1506,19,5.2.255,1,542,0,5,255,260,237,18,260,450,0,128,504,3,4,60,13,79,140,20,1364,366
1506,20,0.1.237,0,542,0,46,237,283,215,22,283,450,0,69,504,2,5,147,142,239,310,21,1364,361
1506,20,4.1.237,0,542,0,96,237,333,109,128,333,450,0,69,504,2,5,159,142,193,310,21,1364,361
1506,20,5.3.345,1,542,0,4,345,349,260,85,349,450,0,100,504,4,4,55,119,79,364,21,1364,361
1506,21,0.1.237,0,542,0,46,237,283,215,22,283,450,0,69,504,2,5,147,142,239,310,22,1364,357
1506,21,4.1.237,0,542,0,96,237,333,109,128,333,450,0,69,504,2,5,159,142,193,310,22,1364,357
1506,21,5.4.450,1,542,0,51,450,501,349,101,501,501,0,207,504,5,4,51,92,79,335,22,1364,357
1506,22,0.1.237,1,542,0,46,237,283,215,22,283,501,0,69,504,2,5,147,142,239,310,23,1364,306
1506,22,4.1.237,0,542,0,96,237,333,109,128,333,501,0,69,504,2,5,159,142,193,310,23,1364,306
1506,23,0.2.283,1,542,0,1,283,284,283,0,284,501,-23,151,527,3,5,101,8,239,140,24,1364,260
1506,23,4.1.283,0,542,0,96,283,379,109,174,379,501,0,69,504,2,6,159,96,193,310,24,1364,260
1506,24,0.3.349,1,542,0,88,349,437,284,65,437,501,0,100,527,4,5,100,115,239,364,25,1364,259
1506,24,4.1.283,0,542,0,96,283,379,109,174,379,501,0,69,527,2,6,159,96,193,310,25,1364,259
1506,25,0.4.501,1,542,0,12,501,513,437,64,513,513,0,207,527,5,5,12,41,239,335,26,1364,171
1506,25,4.1.283,0,542,0,96,283,379,109,174,379,501,0,69,527,2,6,159,96,193,310,26,1364,171
1506,26,4.1.283,1,542,0,96,283,379,109,174,379,513,0,69,527,2,6,159,96,193,310,27,1364,159
1506,27,4.2.379,1,542,0,7,379,386,379,0,386,513,-95,246,622,3,6,63,7,193,140,28,1364,63
1506,28,4.3.437,1,542,0,27,437,464,386,51,464,513,0,100,622,4,6,56,27,193,364,29,1364,56
1506,29,4.4.513,1,542,0,29,513,542,464,49,542,542,0,207,622,5,6,29,29,193,335,30,1364,29
1507,0,0.0.0,0,491,0,6,0,6,0,0,6,6,0,0,0,1,1,184,329,184,329,1,1531,1531
1507,0,1.0.0,0,566,4,82,0,82,0,0,82,82,0,0,0,1,1,344,329,344,329,1,1531,1531
1507,0,2.0.0,0,583,5,92,0,92,0,0,92,92,0,0,0,1,1,261,329,261,329,1,1531,1531
1507,0,3.0.0,0,558,3,74,0,74,0,0,74,74,0,0,0,1,1,234,329,234,329,1,1531,1531
1507,0,4.0.0,0,538,2,56,0,56,0,0,56,56,0,0,0,1,1,229,329,229,329,1,1531,1531
1507,0,5.0.0,1,503,1,19,0,19,0,0,19,19,0,0,0,1,1,279,329,279,329,1,1531,1531
1507,1,0.0.19,1,503,0,6,19,25,0,19,25,25,0,0,0,1,2,184,310,184,329,2,1531,1512
1507,1,1.0.19,0,585,3,82,19,101,0,19,101,101,0,0,0,1,2,344,310,344,329,2,1531,1512
1507,1,2.0.19,0,595,4,92,19,111,0,19,111,111,0,0,0,1,2,261,310,261,329,2,1531,1512
1507,1,3.0.19,0,577,2,74,19,93,0,19,93,93,0,0,0,1,2,234,310,234,329,2,1531,1512
1507,1,4.0.19,0,546,1,56,19,75,0,19,75,75,0,0,0,1,2,229,310,229,329,2,1531,1512
1507,1,5.1.19,0,546,1,87,19,106,19,0,106,106,-19,19,19,2,1,260,312,279,312,2,1531,1512
1507,2,0.1.25,1,503,0,14,25,39,25,0,39,39,-25,25,25,2,1,178,312,184,312,3,1531,1506
1507,2,1.0.25,0,539,2,82,25,107,0,25,107,107,0,0,0,1,3,344,304,344,329,3,1531,1506
1507,2,2.0.25,0,557,4,92,25,117,0,25,117,117,0,0,0,1,3,261,304,261,329,3,1531,1506
1507,2,3.0.25,0,535,1,74,25,99,0,25,99,99,0,0,0,1,3,234,304,234,329,3,1531,1506
1507,2,4.0.25,0,503,0,56,25,81,0,25,81,81,0,0,0,1,3,229,304,229,329,3,1531,1506
1507,2,5.1.19,0,546,3,87,19,106,19,0,106,106,-19,19,19,2,1,260,312,279,312,3,1531,1506
1507,3,0.2.39,1,503,0,4,39,43,39,0,43,43,-39,39,64,3,1,164,207,184,207,4,1531,1492
1507,3,1.0.25,0,539,2,82,25,107,0,25,107,107,0,0,25,1,3,344,304,344,329,4,1531,1492
1507,3,2.0.25,0,557,3,92,25,117,0,25,117,117,0,0,25,1,3,261,304,261,329,4,1531,1492
1507,3,3.0.25,0,535,1,74,25,99,0,25,99,99,0,0,25,1,3,234,304,234,329,4,1531,1492
1507,3,4.0.25,0,503,0,56,25,81,0,25,81,81,0,0,25,1,3,229,304,229,329,4,1531,1492
1507,3,5.1.39,0,503,0,87,39,126,19,20,126,126,0,25,25,2,2,260,298,279,312,4,1531,1492
1507,4,0.3.43,1,503,0,95,43,138,43,0,138,138,-43,43,107,4,1,160,318,184,318,5,1531,1488
1507,4,1.0.25,0,539,2,82,25,107,0,25,107,107,0,0,64,1,3,344,304,344,329,5,1531,1488
1507,4,2.0.25,0,557,3,92,25,117,0,25,117,117,0,0,64,1,3,261,304,261,329,5,1531,1488
1507,4,3.0.25,0,535,1,74,25,99,0,25,99,99,0,0,64,1,3,234,304,234,329,5,1531,1488
1507,4,4.0.25,0,503,0,56,25,81,0,25,81,81,0,0,64,1,3,229,304,229,329,5,1531,1488
1507,4,5.1.39,0,503,0,87,39,126,19,20,126,126,0,25,64,2,2,260,298,279,312,5,1531,1488
1507,5,0.4.138,1,503,0,65,138,203,138,0,203,203,-138,138,245,5,1,65,365,184,365,6,1531,1393
1507,5,1.0.25,0,539,2,82,25,107,0,25,107,138,0,0,107,1,3,344,304,344,329,6,1531,1393
1507,5,2.0.25,0,557,3,92,25,117,0,25,117,138,0,0,107,1,3,261,304,261,329,6,1531,1393
1507,5,3.0.25,0,535,1,74,25,99,0,25,99,138,0,0,107,1,3,234,304,234,329,6,1531,1393
1507,5,4.0.25,0,503,0,56,25,81,0,25,81,138,0,0,107,1,3,229,304,229,329,6,1531,1393
1507,5,5.1.39,0,503,0,87,39,126,19,20,126,138,0,25,107,2,2,260,298,279,312,6,1531,1393
1507,6,1.0.25,0,539,2,82,25,107,0,25,107,203,0,0,245,1,3,344,304,344,329,7,1531,1328
1507,6,2.0.25,0,557,3,92,25,117,0,25,117,203,0,0,245,1,3,261,304,261,329,7,1531,1328
1507,6,3.0.25,0,535,1,74,25,99,0,25,99,203,0,0,245,1,3,234,304,234,329,7,1531,1328
1507,6,4.0.25,0,503,0,56,25,81,0,25,81,203,0,0,245,1,3,229,304,229,329,7,1531,1328
1507,6,5.1.39,1,503,0,87,39,126,19,20,126,203,0,25,245,2,2,260,298,279,312,7,1531,1328
1507,7,1.0.25,0,539,2,82,25,107,0,25,107,203,0,0,245,1,3,344,304,344,329,8,1531,1241
1507,7,2.0.25,0,557,3,92,25,117,0,25,117,203,0,0,245,1,3,261,304,261,329,8,1531,1241
1507,7,3.0.25,0,535,1,74,25,99,0,25,99,203,0,0,245,1,3,234,304,234,329,8,1531,1241
1507,7,4.0.25,0,503,0,56,25,81,0,25,81,203,0,0,245,1,3,229,304,229,329,8,1531,1241
1507,7,5.2.126,1,503,0,43,126,169,126,0,169,203,-83,122,328,3,2,173,203,279,207,8,1531,1241
1507,8,1.0.25,0,539,2,82,25,107,0,25,107,203,0,0,328,1,3,344,304,344,329,9,1531,1198
1507,8,2.0.25,0,557,3,92,25,117,0,25,117,203,0,0,328,1,3,261,304,261,329,9,1531,1198
1507,8,3.0.25,0,535,1,74,25,99,0,25,99,203,0,0,328,1,3,234,304,234,329,9,1531,1198
1507,8,4.0.25,0,503,0,56,25,81,0,25,81,203,0,0,328,1,3,229,304,229,329,9,1531,1198
1507,8,5.3.169,1,557,3,88,169,257,169,0,257,257,-31,74,359,4,2,130,223,279,318,9,1531,1198
1507,9,1.0.25,0,557,0,82,25,107,0,25,107,257,0,0,359,1,3,344,304,344,329,10,1531,1110
1507,9,2.0.25,0,557,0,92,25,117,0,25,117,257,0,0,359,1,3,261,304,261,329,10,1531,1110
1507,9,3.0.25,0,557,0,74,25,99,0,25,99,257,0,0,359,1,3,234,304,234,329,10,1531,1110
1507,9,4.0.25,0,557,0,56,25,81,0,25,81,257,0,0,359,1,3,229,304,229,329,10,1531,1110
1507,9,5.4.257,1,557,0,42,257,299,257,0,299,299,-54,192,413,5,2,42,300,279,365,10,1531,1110
1507,10,1.0.25,1,557,0,82,25,107,0,25,107,299,0,0,413,1,3,344,304,344,329,11,1531,1068
1507,10,2.0.25,0,557,0,92,25,117,0,25,117,299,0,0,413,1,3,261,304,261,329,11,1531,1068
1507,10,3.0.25,0,557,0,74,25,99,0,25,99,299,0,0,413,1,3,234,304,234,329,11,1531,1068
1507,10,4.0.25,0,557,0,56,25,81,0,25,81,299,0,0,413,1,3,229,304,229,329,11,1531,1068
1507,11,1.1.126,1,557,0,73,126,199,107,19,199,299,0,25,413,2,3,262,211,344,312,12,1531,986
1507,11,2.0.107,0,557,0,92,107,199,0,107,199,299,0,0,413,1,4,261,222,261,329,12,1531,986
1507,11,3.0.107,0,557,0,74,107,181,0,107,181,299,0,0,413,1,4,234,222,234,329,12,1531,986
1507,11,4.0.107,0,557,0,56,107,163,0,107,163,299,0,0,413,1,4,229,222,229,329,12,1531,986
1507,12,1.2.199,1,557,0,54,199,253,199,0,253,299,-30,152,443,3,3,189,160,344,207,13,1531,913
1507,12,2.0.107,0,557,0,92,107,199,0,107,199,299,0,0,413,1,4,261,222,261,329,13,1531,913
1507,12,3.0.107,0,557,0,74,107,181,0,107,181,299,0,0,413,1,4,234,222,234,329,13,1531,913
1507,12,4.0.107,0,557,0,56,107,163,0,107,163,299,0,0,413,1,4,229,222,229,329,13,1531,913
1507,13,1.3.257,1,557,0,41,257,298,253,4,298,299,0,74,443,4,3,135,135,344,318,14,1531,859
1507,13,2.0.107,0,557,0,92,107,199,0,107,199,299,0,0,443,1,4,261,222,261,329,14,1531,859
1507,13,3.0.107,0,557,0,74,107,181,0,107,181,299,0,0,443,1,4,234,222,234,329,14,1531,859
1507,13,4.0.107,0,557,0,56,107,163,0,107,163,299,0,0,443,1,4,229,222,229,329,14,1531,859
1507,14,1.4.299,1,557,0,94,299,393,298,1,393,393,0,192,443,5,3,94,258,344,365,15,1531,818
1507,14,2.0.107,0,557,0,92,107,199,0,107,199,299,0,0,443,1,4,261,222,261,329,15,1531,818
1507,14,3.0.107,0,557,0,74,107,181,0,107,181,299,0,0,443,1,4,234,222,234,329,15,1531,818
1507,14,4.0.107,0,557,0,56,107,163,0,107,163,299,0,0,443,1,4,229,222,229,329,15,1531,818
1507,15,2.0.107,0,557,0,92,107,199,0,107,199,393,0,0,443,1,4,261,222,261,329,16,1531,724
1507,15,3.0.107,0,557,0,74,107,181,0,107,181,393,0,0,443,1,4,234,222,234,329,16,1531,724
1507,15,4.0.107,1,557,0,56,107,163,0,107,163,393,0,0,443,1,4,229,222,229,329,16,1531,724
1507,16,2.0.163,0,557,0,92,163,255,0,163,255,393,0,0,443,1,5,261,166,261,329,17,1531,668
1507,16,3.0.163,0,557,0,74,163,237,0,163,237,393,0,0,443,1,5,234,166,234,329,17,1531,668
1507,16,4.1.199,1,557,0,48,199,247,163,36,247,393,0,25,443,2,4,173,138,229,312,17,1531,668
1507,17,2.0.163,0,557,0,92,163,255,0,163,255,393,0,0,443,1,5,261,166,261,329,18,1531,620
1507,17,3.0.163,0,557,0,74,163,237,0,163,237,393,0,0,443,1,5,234,166,234,329,18,1531,620
1507,17,4.2.253,1,557,0,7,253,260,247,6,260,393,0,152,443,3,4,125,106,229,207,18,1531,620
1507,18,2.0.163,0,557,0,92,163,255,0,163,255,393,0,0,443,1,5,261,166,261,329,19,1531,613
1507,18,3.0.163,0,557,0,74,163,237,0,163,237,393,0,0,443,1,5,234,166,234,329,19,1531,613
1507,18,4.3.298,1,557,0,20,298,318,260,38,318,393,0,74,443,4,4,118,94,229,318,19,1531,613
1507,19,2.0.163,0,557,0,92,163,255,0,163,255,393,0,0,443,1,5,261,166,261,329,20,1531,593
1507,19,3.0.163,0,557,0,74,163,237,0,163,237,393,0,0,443,1,5,234,166,234,329,20,1531,593
1507,19,4.4.393,1,557,0,98,393,491,318,75,491,491,0,192,443,5,4,98,164,229,365,20,1531,593
1507,20,2.0.163,0,557,0,92,163,255,0,163,255,491,0,0,443,1,5,261,166,261,329,21,1531,495
1507,20,3.0.163,1,557,0,74,163,237,0,163,237,491,0,0,443,1,5,234,166,234,329,21,1531,495
1507,21,2.0.237,0,557,0,92,237,329,0,237,329,491,0,0,443,1,6,261,92,261,329,22,1531,421
1507,21,3.1.247,1,557,0,28,247,275,237,10,275,491,0,25,443,2,5,160,90,234,312,22,1531,421
1507,22,2.0.237,1,557,0,92,237,329,0,237,329,491,0,0,443,1,6,261,92,261,329,23,1531,393
1507,22,3.2.275,0,557,0,89,275,364,275,0,364,491,-15,167,458,3,5,132,99,234,207,23,1531,393
1507,23,2.1.329,0,557,0,62,329,391,329,0,391,491,-54,79,497,2,6,169,62,261,312,24,1531,301
1507,23,3.2.275,1,557,0,89,275,364,275,0,364,491,-15,167,458,3,5,132,99,234,207,24,1531,301
1507,24,2.1.329,0,557,0,62,329,391,329,0,391,491,-54,79,512,2,6,169,62,261,312,25,1531,212
1507,24,3.3.364,1,557,0,13,364,377,364,0,377,491,-46,120,504,4,5,43,74,234,318,25,1531,212
1507,25,2.1.329,0,557,0,62,329,391,329,0,391,491,-54,79,558,2,6,169,62,261,312,26,1531,199
1507,25,3.4.491,1,557,0,30,491,521,377,114,521,521,0,192,504,5,5,30,66,234,365,26,1531,199
1507,26,2.1.329,1,557,0,62,329,391,329,0,391,521,-54,79,558,2,6,169,62,261,312,27,1531,169
1507,27,2.2.391,1,557,0,10,391,401,391,0,401,521,-27,194,585,3,6,107,10,261,207,28,1531,107
1507,28,2.3.401,1,557,0,61,401,462,401,0,462,521,-24,144,609,4,6,97,61,261,318,29,1531,97
1507,29,2.4.521,1,557,0,36,521,557,462,59,557,557,0,192,609,5,6,36,36,261,365,30,1531,36
1508,0,0.0.0,0,456,3,19,0,19,0,0,19,19,0,0,0,1,1,127,244,127,244,1,1303,1303
1508,0,1.0.0,0,455,2,58,0,58,0,0,58,58,0,0,0,1,1,246,244,246,244,1,1303,1303
1508,0,2.0.0,0,475,4,38,0,38,0,0,38,38,0,0,0,1,1,187,244,187,244,1,1303,1303
1508,0,3.0.0,1,437,0,28,0,28,0,0,28,28,0,0,0,1,1,294,244,294,244,1,1303,1303
1508,0,4.0.0,0,508,5,77,0,77,0,0,77,77,0,0,0,1,1,168,244,168,244,1,1303,1303
1508,0,5.0.0,0,449,1,24,0,24,0,0,24,24,0,0,0,1,1,281,244,281,244,1,1303,1303
1508,1,0.0.28,0,444,1,19,28,47,0,28,47,47,0,0,0,1,2,127,216,127,244,2,1303,1275
1508,1,1.0.28,0,437,0,58,28,86,0,28,86,86,0,0,0,1,2,246,216,246,244,2,1303,1275
1508,1,2.0.28,0,447,2,38,28,66,0,28,66,66,0,0,0,1,2,187,216,187,244,2,1303,1275
1508,1,3.1.28,0,437,0,66,28,94,28,0,94,94,-28,28,28,2,1,266,315,294,315,2,1303,1275
1508,1,4.0.28,0,470,3,77,28,105,0,28,105,105,0,0,0,1,2,168,216,168,244,2,1303,1275
1508,1,5.0.28,1,444,1,24,28,52,0,28,52,52,0,0,0,1,2,281,216,281,244,2,1303,1275
1508,2,0.0.52,0,444,0,19,52,71,0,52,71,71,0,0,0,1,3,127,192,127,244,3,1303,1251
1508,2,1.0.52,0,444,0,58,52,110,0,52,110,110,0,0,0,1,3,246,192,246,244,3,1303,1251
1508,2,2.0.52,1,447,1,38,52,90,0,52,90,90,0,0,0,1,3,187,192,187,244,3,1303,1251
1508,2,3.1.28,0,444,0,66,28,94,28,0,94,94,-28,28,28,2,1,266,315,294,315,3,1303,1251
1508,2,4.0.52,0,444,0,77,52,129,0,52,129,129,0,0,0,1,3,168,192,168,244,3,1303,1251
1508,2,5.1.52,0,477,2,70,52,122,52,0,122,122,-52,52,52,2,1,257,315,281,315,3,1303,1251
1508,3,0.0.90,1,448,1,19,90,109,0,90,109,109,0,0,0,1,4,127,154,127,244,4,1303,1213
1508,3,1.0.90,0,448,1,58,90,148,0,90,148,148,0,0,0,1,4,246,154,246,244,4,1303,1213
1508,3,2.1.90,0,525,3,55,90,145,90,0,145,145,-90,90,90,2,1,149,315,187,315,4,1303,1213
1508,3,3.1.28,0,447,0,66,28,94,28,0,94,94,-28,28,28,2,1,266,315,294,315,4,1303,1213
1508,3,4.0.90,0,447,0,77,90,167,0,90,167,167,0,0,0,1,4,168,154,168,244,4,1303,1213
1508,3,5.1.52,0,477,2,70,52,122,52,0,122,122,-52,52,52,2,1,257,315,281,315,4,1303,1213
1508,4,0.1.109,0,500,3,81,109,190,109,0,190,190,-109,109,109,2,1,108,315,127,315,5,1303,1194
1508,4,1.0.109,1,448,0,58,109,167,0,109,167,167,0,0,0,1,5,246,135,246,244,5,1303,1194
1508,4,2.1.90,0,525,4,55,90,145,90,0,145,145,-90,90,90,2,1,149,315,187,315,5,1303,1194
1508,4,3.1.28,0,448,0,66,28,94,28,0,94,109,-28,28,28,2,1,266,315,294,315,5,1303,1194
1508,4,4.0.109,0,462,1,77,109,186,0,109,186,186,0,0,0,1,5,168,135,168,244,5,1303,1194
1508,4,5.1.52,0,477,2,70,52,122,52,0,122,122,-52,52,52,2,1,257,315,281,315,5,1303,1194
1508,5,0.1.109,0,500,2,81,109,190,109,0,190,190,-109,109,109,2,1,108,315,127,315,6,1303,1136
1508,5,1.1.167,0,448,0,42,167,209,167,0,209,209,-167,167,167,2,1,188,315,246,315,6,1303,1136
1508,5,2.1.90,0,535,3,55,90,145,90,0,145,167,-90,90,90,2,1,149,315,187,315,6,1303,1136
1508,5,3.1.28,0,448,0,66,28,94,28,0,94,167,-28,28,28,2,1,266,315,294,315,6,1303,1136
1508,5,4.0.167,1,448,0,77,167,244,0,167,244,244,0,0,0,1,6,168,77,168,244,6,1303,1136
1508,5,5.1.52,0,477,1,70,52,122,52,0,122,167,-52,52,52,2,1,257,315,281,315,6,1303,1136
1508,6,0.1.109,0,500,2,81,109,190,109,0,190,244,-109,109,109,2,1,108,315,127,315,7,1303,1059
1508,6,1.1.167,0,448,0,42,167,209,167,0,209,244,-167,167,167,2,1,188,315,246,315,7,1303,1059
1508,6,2.1.90,0,535,3,55,90,145,90,0,145,244,-90,90,90,2,1,149,315,187,315,7,1303,1059
1508,6,3.1.28,1,448,0,66,28,94,28,0,94,244,-28,28,28,2,1,266,315,294,315,7,1303,1059
1508,6,4.1.244,0,448,0,1,244,245,244,0,245,245,-244,244,244,2,1,91,315,168,315,7,1303,1059
1508,6,5.1.52,0,477,1,70,52,122,52,0,122,244,-52,52,52,2,1,257,315,281,315,7,1303,1059
1508,7,0.1.109,0,500,2,81,109,190,109,0,190,244,-15,43,43,2,2,108,249,127,315,8,1303,993
1508,7,1.1.167,0,448,0,42,167,209,167,0,209,244,-73,101,101,2,2,188,249,246,315,8,1303,993
1508,7,2.1.94,0,483,1,55,94,149,90,4,149,244,0,28,28,2,2,149,249,187,315,8,1303,993
1508,7,3.2.94,1,448,0,57,94,151,94,0,151,244,-94,94,122,3,1,200,274,294,274,8,1303,993
1508,7,4.1.244,0,448,0,1,244,245,244,0,245,245,-150,178,178,2,2,91,249,168,315,8,1303,993
1508,7,5.1.94,0,448,0,70,94,164,52,42,164,244,0,28,28,2,2,257,249,281,315,8,1303,993
1508,8,0.1.109,0,500,2,81,109,190,109,0,190,244,-15,43,137,2,2,108,249,127,315,9,1303,936
1508,8,1.1.167,0,448,0,42,167,209,167,0,209,244,-73,101,195,2,2,188,249,246,315,9,1303,936
1508,8,2.1.94,0,483,1,55,94,149,90,4,149,244,0,28,122,2,2,149,249,187,315,9,1303,936
1508,8,3.3.151,1,448,0,71,151,222,151,0,222,244,-151,151,273,4,1,143,272,294,272,9,1303,936
1508,8,4.1.244,0,448,0,1,244,245,244,0,245,245,-150,178,272,2,2,91,249,168,315,9,1303,936
1508,8,5.1.94,0,448,0,70,94,164,52,42,164,244,0,28,122,2,2,257,249,281,315,9,1303,936
1508,9,0.1.109,0,500,2,81,109,190,109,0,190,244,-15,43,288,2,2,108,249,127,315,10,1303,865
1508,9,1.1.167,0,448,0,42,167,209,167,0,209,244,-73,101,346,2,2,188,249,246,315,10,1303,865
1508,9,2.1.94,0,483,1,55,94,149,90,4,149,244,0,28,273,2,2,149,249,187,315,10,1303,865
1508,9,3.4.222,1,448,0,72,222,294,222,0,294,294,-222,222,495,5,1,72,198,294,198,10,1303,865
1508,9,4.1.244,0,448,0,1,244,245,244,0,245,245,-150,178,423,2,2,91,249,168,315,10,1303,865
1508,9,5.1.94,0,448,0,70,94,164,52,42,164,244,0,28,273,2,2,257,249,281,315,10,1303,865
1508,10,0.1.109,0,500,2,81,109,190,109,0,190,294,-15,43,510,2,2,108,249,127,315,11,1303,793
1508,10,1.1.167,0,448,0,42,167,209,167,0,209,294,-73,101,568,2,2,188,249,246,315,11,1303,793
1508,10,2.1.94,0,483,1,55,94,149,90,4,149,294,0,28,495,2,2,149,249,187,315,11,1303,793
1508,10,4.1.244,0,448,0,1,244,245,244,0,245,294,-150,178,645,2,2,91,249,168,315,11,1303,793
1508,10,5.1.94,1,448,0,70,94,164,52,42,164,294,0,28,495,2,2,257,249,281,315,11,1303,793
1508,11,0.1.164,0,462,1,81,164,245,109,55,245,294,0,28,495,2,3,108,179,127,315,12,1303,723
1508,11,1.1.167,0,448,0,42,167,209,167,0,209,294,-3,31,498,2,3,188,179,246,315,12,1303,723
1508,11,2.1.164,0,448,0,55,164,219,90,74,219,294,0,28,495,2,3,149,179,187,315,12,1303,723
1508,11,4.1.244,0,448,0,1,244,245,244,0,245,294,-80,108,575,2,3,91,179,168,315,12,1303,723
1508,11,5.2.164,1,448,0,81,164,245,164,0,245,294,-13,107,508,3,2,187,217,281,274,12,1303,723
1508,12,0.1.164,0,462,1,81,164,245,109,55,245,294,0,28,508,2,3,108,179,127,315,13,1303,642
1508,12,1.1.167,0,448,0,42,167,209,167,0,209,294,-3,31,511,2,3,188,179,246,315,13,1303,642
1508,12,2.1.164,0,448,0,55,164,219,90,74,219,294,0,28,508,2,3,149,179,187,315,13,1303,642
1508,12,4.1.244,0,448,0,1,244,245,244,0,245,294,-80,108,588,2,3,91,179,168,315,13,1303,642
1508,12,5.3.245,1,448,0,73,245,318,245,0,318,318,-23,174,531,4,2,106,201,281,272,13,1303,642
1508,13,0.1.164,0,462,1,81,164,245,109,55,245,318,0,28,531,2,3,108,179,127,315,14,1303,569
1508,13,1.1.167,0,448,0,42,167,209,167,0,209,318,-3,31,534,2,3,188,179,246,315,14,1303,569
1508,13,2.1.164,0,448,0,55,164,219,90,74,219,318,0,28,531,2,3,149,179,187,315,14,1303,569
1508,13,4.1.244,0,448,0,1,244,245,244,0,245,318,-80,108,611,2,3,91,179,168,315,14,1303,569
1508,13,5.4.318,1,448,0,33,318,351,318,0,351,351,-24,246,555,5,2,33,126,281,198,14,1303,569
1508,14,0.1.164,0,462,1,81,164,245,109,55,245,351,0,28,555,2,3,108,179,127,315,15,1303,536
1508,14,1.1.167,0,448,0,42,167,209,167,0,209,351,-3,31,558,2,3,188,179,246,315,15,1303,536
1508,14,2.1.164,1,448,0,55,164,219,90,74,219,351,0,28,555,2,3,149,179,187,315,15,1303,536
1508,14,4.1.244,0,448,0,1,244,245,244,0,245,351,-80,108,635,2,3,91,179,168,315,15,1303,536
1508,15,0.1.219,0,489,3,81,219,300,109,110,300,351,0,28,555,2,4,108,124,127,315,16,1303,481
1508,15,1.1.219,1,448,0,42,219,261,167,52,261,351,0,28,555,2,4,188,124,246,315,16,1303,481
1508,15,2.2.245,0,470,2,62,245,307,219,26,307,351,0,107,555,3,3,94,136,187,274,16,1303,481
1508,15,4.1.244,0,463,1,1,244,245,244,0,245,351,-25,53,580,2,4,91,124,168,315,16,1303,481
1508,16,0.1.261,0,478,3,81,261,342,109,152,342,351,0,28,555,2,5,108,82,127,315,17,1303,439
1508,16,1.2.261,0,458,1,59,261,320,261,0,320,351,-16,123,571,3,3,146,136,246,274,17,1303,439
1508,16,2.2.245,0,470,2,62,245,307,219,26,307,351,0,107,555,3,3,94,136,187,274,17,1303,439
1508,16,4.1.261,1,448,0,1,261,262,244,17,262,351,0,28,555,2,5,91,82,168,315,17,1303,439
1508,17,0.1.262,1,448,0,81,262,343,109,153,343,351,0,28,555,2,6,108,81,127,315,18,1303,438
1508,17,1.2.261,0,458,1,59,261,320,261,0,320,351,-16,123,571,3,3,146,136,246,274,18,1303,438
1508,17,2.2.245,0,470,2,62,245,307,219,26,307,351,0,107,555,3,3,94,136,187,274,18,1303,438
1508,17,4.2.262,0,448,0,8,262,270,262,0,270,351,-17,124,572,3,3,90,136,168,274,18,1303,438
1508,18,0.2.343,0,448,0,7,343,350,343,0,350,351,-98,205,653,3,3,27,136,127,274,19,1303,357
1508,18,1.2.261,0,458,1,59,261,320,261,0,320,351,-16,123,571,3,3,146,136,246,274,19,1303,357
1508,18,2.2.245,0,470,2,62,245,307,219,26,307,351,0,107,555,3,3,94,136,187,274,19,1303,357
1508,18,4.2.262,1,448,0,8,262,270,262,0,270,351,-17,124,572,3,3,90,136,168,274,19,1303,357
1508,19,0.2.343,0,448,0,7,343,350,343,0,350,351,-73,197,645,3,4,27,128,127,274,20,1303,349
1508,19,1.2.270,0,448,0,59,270,329,261,9,329,351,0,124,572,3,4,146,128,246,274,20,1303,349
1508,19,2.2.270,0,487,1,62,270,332,219,51,332,351,0,124,572,3,4,94,128,187,274,20,1303,349
1508,19,4.3.318,1,448,0,13,318,331,270,48,331,351,0,174,572,4,3,82,128,168,272,20,1303,349
1508,20,0.2.343,0,448,0,7,343,350,343,0,350,351,-73,197,645,3,4,27,128,127,274,21,1303,336
1508,20,1.2.270,0,448,0,59,270,329,261,9,329,351,0,124,572,3,4,146,128,246,274,21,1303,336
1508,20,2.2.270,0,487,1,62,270,332,219,51,332,351,0,124,572,3,4,94,128,187,274,21,1303,336
1508,20,4.4.351,1,448,0,69,351,420,331,20,420,420,0,246,572,5,3,69,93,168,198,21,1303,336
1508,21,0.2.343,0,448,0,7,343,350,343,0,350,420,-73,197,645,3,4,27,128,127,274,22,1303,267
1508,21,1.2.270,1,448,0,59,270,329,261,9,329,420,0,124,572,3,4,146,128,246,274,22,1303,267
1508,21,2.2.270,0,487,1,62,270,332,219,51,332,420,0,124,572,3,4,94,128,187,274,22,1303,267
1508,22,0.2.343,0,448,0,7,343,350,343,0,350,420,-14,138,586,3,5,27,69,127,274,23,1303,208
1508,22,1.3.331,0,448,0,83,331,414,329,2,414,420,0,174,572,4,4,87,115,246,272,23,1303,208
1508,22,2.2.329,1,448,0,62,329,391,219,110,391,420,0,124,572,3,5,94,69,187,274,23,1303,208
1508,23,0.2.391,1,448,0,7,391,398,343,48,398,420,0,124,572,3,6,27,7,127,274,24,1303,146
1508,23,1.3.331,0,448,0,83,331,414,329,2,414,420,0,174,572,4,4,87,115,246,272,24,1303,146
1508,23,2.3.391,0,510,1,30,391,421,391,0,421,421,-60,234,632,4,4,32,115,187,272,24,1303,146
1508,24,0.3.398,0,515,2,2,398,400,398,0,400,420,-67,241,639,4,4,20,115,127,272,25,1303,139
1508,24,1.3.331,1,448,0,83,331,414,329,2,414,420,0,174,572,4,4,87,115,246,272,25,1303,139
1508,24,2.3.391,0,510,1,30,391,421,391,0,421,421,-60,234,632,4,4,32,115,187,272,25,1303,139
1508,25,0.3.414,0,448,0,2,414,416,398,16,416,420,0,174,572,4,5,20,32,127,272,26,1303,56
1508,25,1.4.420,1,448,0,4,420,424,414,6,424,424,0,246,572,5,4,4,24,246,198,26,1303,56
1508,25,2.3.414,0,464,1,30,414,444,391,23,444,444,0,174,572,4,5,32,32,187,272,26,1303,56
1508,26,0.3.414,1,448,0,2,414,416,398,16,416,424,0,174,572,4,5,20,32,127,272,27,1303,52
1508,26,2.3.414,0,464,1,30,414,444,391,23,444,444,0,174,572,4,5,32,32,187,272,27,1303,52
1508,27,0.4.424,1,448,0,18,424,442,416,8,442,442,0,246,572,5,5,18,20,127,198,28,1303,50
1508,27,2.3.416,0,448,0,30,416,446,391,25,446,446,0,174,572,4,6,32,30,187,272,28,1303,50
1508,28,2.3.416,1,448,0,30,416,446,391,25,446,446,0,174,572,4,6,32,30,187,272,29,1303,32
1508,29,2.4.446,1,448,0,2,446,448,446,0,448,448,-4,250,576,5,6,2,2,187,198,30,1303,2
1509,0,0.0.0,0,435,0,32,0,32,0,0,32,32,0,0,0,1,1,171,358,171,358,1,1174,1174
1509,0,1.0.0,0,456,2,34,0,34,0,0,34,34,0,0,0,1,1,146,358,146,358,1,1174,1174
1509,0,2.0.0,0,457,3,84,0,84,0,0,84,84,0,0,0,1,1,313,358,313,358,1,1174,1174
1509,0,3.0.0,0,502,4,81,0,81,0,0,81,81,0,0,0,1,1,155,358,155,358,1,1174,1174
1509,0,4.0.0,0,504,5,99,0,99,0,0,99,99,0,0,0,1,1,205,358,205,358,1,1174,1174
1509,0,5.0.0,1,439,1,28,0,28,0,0,28,28,0,0,0,1,1,184,358,184,358,1,1174,1174
1509,1,0.0.28,0,439,0,32,28,60,0,28,60,60,0,0,0,1,2,171,330,171,358,2,1174,1146
1509,1,1.0.28,0,460,1,34,28,62,0,28,62,62,0,0,0,1,2,146,330,146,358,2,1174,1146
1509,1,2.0.28,0,461,2,84,28,112,0,28,112,112,0,0,0,1,2,313,330,313,358,2,1174,1146
1509,1,3.0.28,0,506,4,81,28,109,0,28,109,109,0,0,0,1,2,155,330,155,358,2,1174,1146
1509,1,4.0.28,0,499,3,99,28,127,0,28,127,127,0,0,0,1,2,205,330,205,358,2,1174,1146
1509,1,5.1.28,1,439,0,54,28,82,28,0,82,82,-28,28,28,2,1,156,219,184,219,2,1174,1146
1509,2,0.0.28,0,439,0,32,28,60,0,28,60,82,0,0,28,1,2,171,330,171,358,3,1174,1092
1509,2,1.0.28,0,460,1,34,28,62,0,28,62,82,0,0,28,1,2,146,330,146,358,3,1174,1092
1509,2,2.0.28,0,461,2,84,28,112,0,28,112,112,0,0,28,1,2,313,330,313,358,3,1174,1092
1509,2,3.0.28,0,506,4,81,28,109,0,28,109,109,0,0,28,1,2,155,330,155,358,3,1174,1092
1509,2,4.0.28,0,499,3,99,28,127,0,28,127,127,0,0,28,1,2,205,330,205,358,3,1174,1092
1509,2,5.2.82,1,439,0,20,82,102,82,0,102,102,-82,82,110,3,1,102,143,184,143,3,1174,1092
1509,3,0.0.28,0,439,0,32,28,60,0,28,60,102,0,0,110,1,2,171,330,171,358,4,1174,1072
1509,3,1.0.28,0,460,1,34,28,62,0,28,62,102,0,0,110,1,2,146,330,146,358,4,1174,1072
1509,3,2.0.28,0,461,2,84,28,112,0,28,112,112,0,0,110,1,2,313,330,313,358,4,1174,1072
1509,3,3.0.28,0,506,4,81,28,109,0,28,109,109,0,0,110,1,2,155,330,155,358,4,1174,1072
1509,3,4.0.28,0,499,3,99,28,127,0,28,127,127,0,0,110,1,2,205,330,205,358,4,1174,1072
1509,3,5.3.102,1,439,0,58,102,160,102,0,160,160,-102,102,212,4,1,82,227,184,227,4,1174,1072
1509,4,0.0.28,0,439,0,32,28,60,0,28,60,160,0,0,212,1,2,171,330,171,358,5,1174,1014
1509,4,1.0.28,0,460,1,34,28,62,0,28,62,160,0,0,212,1,2,146,330,146,358,5,1174,1014
1509,4,2.0.28,0,461,2,84,28,112,0,28,112,160,0,0,212,1,2,313,330,313,358,5,1174,1014
1509,4,3.0.28,0,506,4,81,28,109,0,28,109,160,0,0,212,1,2,155,330,155,358,5,1174,1014
1509,4,4.0.28,0,499,3,99,28,127,0,28,127,160,0,0,212,1,2,205,330,205,358,5,1174,1014
1509,4,5.4.160,1,439,0,24,160,184,160,0,184,184,-160,160,372,5,1,24,227,184,227,5,1174,1014
1509,5,0.0.28,0,439,0,32,28,60,0,28,60,184,0,0,372,1,2,171,330,171,358,6,1174,990
1509,5,1.0.28,0,460,1,34,28,62,0,28,62,184,0,0,372,1,2,146,330,146,358,6,1174,990
1509,5,2.0.28,1,461,2,84,28,112,0,28,112,184,0,0,372,1,2,313,330,313,358,6,1174,990
1509,5,3.0.28,0,506,4,81,28,109,0,28,109,184,0,0,372,1,2,155,330,155,358,6,1174,990
1509,5,4.0.28,0,499,3,99,28,127,0,28,127,184,0,0,372,1,2,205,330,205,358,6,1174,990
1509,6,0.0.112,0,461,0,32,112,144,0,112,144,184,0,0,372,1,3,171,246,171,358,7,1174,906
1509,6,1.0.112,0,477,1,34,112,146,0,112,146,184,0,0,372,1,3,146,246,146,358,7,1174,906
1509,6,2.1.112,1,461,0,49,112,161,112,0,161,184,-30,58,402,2,2,229,165,313,219,7,1174,906
1509,6,3.0.112,0,477,1,81,112,193,0,112,193,193,0,0,372,1,3,155,246,155,358,7,1174,906
1509,6,4.0.112,0,477,1,99,112,211,0,112,211,211,0,0,372,1,3,205,246,205,358,7,1174,906
1509,7,0.0.112,0,461,0,32,112,144,0,112,144,184,0,0,402,1,3,171,246,171,358,8,1174,857
1509,7,1.0.112,0,477,1,34,112,146,0,112,146,184,0,0,402,1,3,146,246,146,358,8,1174,857
1509,7,2.2.161,1,461,0,15,161,176,161,0,176,184,-59,141,461,3,2,180,123,313,143,8,1174,857
1509,7,3.0.112,0,477,1,81,112,193,0,112,193,193,0,0,402,1,3,155,246,155,358,8,1174,857
1509,7,4.0.112,0,477,1,99,112,211,0,112,211,211,0,0,402,1,3,205,246,205,358,8,1174,857
1509,8,0.0.112,0,461,0,32,112,144,0,112,144,184,0,0,461,1,3,171,246,171,358,9,1174,842
1509,8,1.0.112,0,477,1,34,112,146,0,112,146,184,0,0,461,1,3,146,246,146,358,9,1174,842
1509,8,2.3.176,1,477,1,98,176,274,176,0,274,274,-16,118,477,4,2,165,169,313,227,9,1174,842
1509,8,3.0.112,0,477,1,81,112,193,0,112,193,193,0,0,461,1,3,155,246,155,358,9,1174,842
1509,8,4.0.112,0,477,1,99,112,211,0,112,211,211,0,0,461,1,3,205,246,205,358,9,1174,842
1509,9,0.0.112,0,477,0,32,112,144,0,112,144,274,0,0,477,1,3,171,246,171,358,10,1174,744
1509,9,1.0.112,0,477,0,34,112,146,0,112,146,274,0,0,477,1,3,146,246,146,358,10,1174,744
1509,9,2.4.274,1,477,0,67,274,341,274,0,341,341,-90,250,567,5,2,67,203,313,227,10,1174,744
1509,9,3.0.112,0,477,0,81,112,193,0,112,193,274,0,0,477,1,3,155,246,155,358,10,1174,744
1509,9,4.0.112,0,477,0,99,112,211,0,112,211,274,0,0,477,1,3,205,246,205,358,10,1174,744
1509,10,0.0.112,1,477,0,32,112,144,0,112,144,341,0,0,567,1,3,171,246,171,358,11,1174,677
1509,10,1.0.112,0,477,0,34,112,146,0,112,146,341,0,0,567,1,3,146,246,146,358,11,1174,677
1509,10,3.0.112,0,477,0,81,112,193,0,112,193,341,0,0,567,1,3,155,246,155,358,11,1174,677
1509,10,4.0.112,0,477,0,99,112,211,0,112,211,341,0,0,567,1,3,205,246,205,358,11,1174,677
1509,11,0.1.161,1,477,0,49,161,210,144,17,210,341,0,58,567,2,3,139,116,171,219,12,1174,645
1509,11,1.0.144,0,477,0,34,144,178,0,144,178,341,0,0,567,1,4,146,214,146,358,12,1174,645
1509,11,3.0.144,0,477,0,81,144,225,0,144,225,341,0,0,567,1,4,155,214,155,358,12,1174,645
1509,11,4.0.144,0,477,0,99,144,243,0,144,243,341,0,0,567,1,4,205,214,205,358,12,1174,645
1509,12,0.2.210,1,477,0,11,210,221,210,0,221,341,-34,175,601,3,3,90,108,171,143,13,1174,596
1509,12,1.0.144,0,477,0,34,144,178,0,144,178,341,0,0,567,1,4,146,214,146,358,13,1174,596
1509,12,3.0.144,0,477,0,81,144,225,0,144,225,341,0,0,567,1,4,155,214,155,358,13,1174,596
1509,12,4.0.144,0,477,0,99,144,243,0,144,243,341,0,0,567,1,4,205,214,205,358,13,1174,596
1509,13,0.3.274,1,477,0,9,274,283,221,53,283,341,0,118,601,4,3,79,71,171,227,14,1174,585
1509,13,1.0.144,0,477,0,34,144,178,0,144,178,341,0,0,601,1,4,146,214,146,358,14,1174,585
1509,13,3.0.144,0,477,0,81,144,225,0,144,225,341,0,0,601,1,4,155,214,155,358,14,1174,585
1509,13,4.0.144,0,477,0,99,144,243,0,144,243,341,0,0,601,1,4,205,214,205,358,14,1174,585
1509,14,0.4.341,1,477,0,70,341,411,283,58,411,411,0,250,601,5,3,70,136,171,227,15,1174,576
1509,14,1.0.144,0,477,0,34,144,178,0,144,178,341,0,0,601,1,4,146,214,146,358,15,1174,576
1509,14,3.0.144,0,477,0,81,144,225,0,144,225,341,0,0,601,1,4,155,214,155,358,15,1174,576
1509,14,4.0.144,0,477,0,99,144,243,0,144,243,341,0,0,601,1,4,205,214,205,358,15,1174,576
1509,15,1.0.144,1,477,0,34,144,178,0,144,178,411,0,0,601,1,4,146,214,146,358,16,1174,506
1509,15,3.0.144,0,477,0,81,144,225,0,144,225,411,0,0,601,1,4,155,214,155,358,16,1174,506
1509,15,4.0.144,0,477,0,99,144,243,0,144,243,411,0,0,601,1,4,205,214,205,358,16,1174,506
1509,16,1.1.210,1,477,0,10,210,220,178,32,220,411,0,58,601,2,4,112,67,146,219,17,1174,472
1509,16,3.0.178,0,477,0,81,178,259,0,178,259,411,0,0,601,1,5,155,180,155,358,17,1174,472
1509,16,4.0.178,0,477,0,99,178,277,0,178,277,411,0,0,601,1,5,205,180,205,358,17,1174,472
1509,17,1.2.221,1,477,0,64,221,285,220,1,285,411,0,175,601,3,4,102,97,146,143,18,1174,462
1509,17,3.0.178,0,477,0,81,178,259,0,178,259,411,0,0,601,1,5,155,180,155,358,18,1174,462
1509,17,4.0.178,0,477,0,99,178,277,0,178,277,411,0,0,601,1,5,205,180,205,358,18,1174,462
1509,18,1.3.285,1,477,0,25,285,310,285,0,310,411,-2,120,603,4,4,38,62,146,227,19,1174,398
1509,18,3.0.178,0,477,0,81,178,259,0,178,259,411,0,0,601,1,5,155,180,155,358,19,1174,398
1509,18,4.0.178,0,477,0,99,178,277,0,178,277,411,0,0,601,1,5,205,180,205,358,19,1174,398
1509,19,1.4.411,1,477,0,13,411,424,310,101,424,424,0,250,603,5,4,13,66,146,227,20,1174,373
1509,19,3.0.178,0,477,0,81,178,259,0,178,259,411,0,0,603,1,5,155,180,155,358,20,1174,373
1509,19,4.0.178,0,477,0,99,178,277,0,178,277,411,0,0,603,1,5,205,180,205,358,20,1174,373
1509,20,3.0.178,0,477,0,81,178,259,0,178,259,424,0,0,603,1,5,155,180,155,358,21,1174,360
1509,20,4.0.178,1,477,0,99,178,277,0,178,277,424,0,0,603,1,5,205,180,205,358,21,1174,360
1509,21,3.0.277,0,477,0,81,277,358,0,277,358,424,0,0,603,1,6,155,81,155,358,22,1174,261
1509,21,4.1.277,1,477,0,52,277,329,277,0,329,424,-57,115,660,2,5,106,57,205,219,22,1174,261
1509,22,3.0.277,0,477,0,81,277,358,0,277,358,424,0,0,660,1,6,155,81,155,358,23,1174,209
1509,22,4.2.329,1,477,0,9,329,338,329,0,338,424,-44,219,704,3,5,54,33,205,143,23,1174,209
1509,23,3.0.277,0,477,0,81,277,358,0,277,358,424,0,0,704,1,6,155,81,155,358,24,1174,200
1509,23,4.3.338,1,477,0,6,338,344,338,0,344,424,-28,148,732,4,5,45,37,205,227,24,1174,200
1509,24,3.0.277,0,477,0,81,277,358,0,277,358,424,0,0,732,1,6,155,81,155,358,25,1174,194
1509,24,4.4.424,1,477,0,39,424,463,344,80,463,463,0,250,732,5,5,39,53,205,227,25,1174,194
1509,25,3.0.277,1,477,0,81,277,358,0,277,358,463,0,0,732,1,6,155,81,155,358,26,1174,155
1509,26,3.1.358,1,477,0,5,358,363,358,0,363,463,-29,144,761,2,6,74,5,155,219,27,1174,74
1509,27,3.2.363,1,477,0,24,363,387,363,0,387,463,-25,244,786,3,6,69,24,155,143,28,1174,69
1509,28,3.3.387,1,477,0,31,387,418,387,0,418,463,-43,191,829,4,6,45,31,155,227,29,1174,45
1509,29,3.4.463,1,477,0,14,463,477,418,45,477,477,0,250,829,5,6,14,14,155,227,30,1174,14
1510,0,0.0.0,0,510,5,45,0,45,0,0,45,45,0,0,0,1,1,115,174,115,174,1,1243,1243
1510,0,1.0.0,1,489,3,10,0,10,0,0,10,10,0,0,0,1,1,245,174,245,174,1,1243,1243
1510,0,2.0.0,0,481,1,30,0,30,0,0,30,30,0,0,0,1,1,240,174,240,174,1,1243,1243
1510,0,3.0.0,0,486,2,34,0,34,0,0,34,34,0,0,0,1,1,312,174,312,174,1,1243,1243
1510,0,4.0.0,0,479,0,22,0,22,0,0,22,22,0,0,0,1,1,146,174,146,174,1,1243,1243
1510,0,5.0.0,0,493,4,33,0,33,0,0,33,33,0,0,0,1,1,185,174,185,174,1,1243,1243
1510,1,0.0.10,0,496,2,45,10,55,0,10,55,55,0,0,0,1,2,115,164,115,174,2,1243,1233
1510,1,1.1.10,0,496,2,77,10,87,10,0,87,87,-10,10,10,2,1,235,221,245,221,2,1243,1233
1510,1,2.0.10,0,491,1,30,10,40,0,10,40,40,0,0,0,1,2,240,164,240,174,2,1243,1233
1510,1,3.0.10,1,496,2,34,10,44,0,10,44,44,0,0,0,1,2,312,164,312,174,2,1243,1233
1510,1,4.0.10,0,489,0,22,10,32,0,10,32,32,0,0,0,1,2,146,164,146,174,2,1243,1233
1510,1,5.0.10,0,496,2,33,10,43,0,10,43,43,0,0,0,1,2,185,164,185,174,2,1243,1233
1510,2,0.0.44,0,514,3,45,44,89,0,44,89,89,0,0,0,1,3,115,130,115,174,3,1243,1199
1510,2,1.1.10,0,496,0,77,10,87,10,0,87,87,-10,10,10,2,1,235,221,245,221,3,1243,1199
1510,2,2.0.44,1,505,1,30,44,74,0,44,74,74,0,0,0,1,3,240,130,240,174,3,1243,1199
1510,2,3.1.44,0,496,0,43,44,87,44,0,87,87,-44,44,44,2,1,278,221,312,221,3,1243,1199
1510,2,4.0.44,0,496,0,22,44,66,0,44,66,66,0,0,0,1,3,146,130,146,174,3,1243,1199
1510,2,5.0.44,0,508,2,33,44,77,0,44,77,77,0,0,0,1,3,185,130,185,174,3,1243,1199
1510,3,0.0.74,0,544,3,45,74,119,0,74,119,119,0,0,0,1,4,115,100,115,174,4,1243,1169
1510,3,1.1.10,0,505,0,77,10,87,10,0,87,87,-10,10,10,2,1,235,221,245,221,4,1243,1169
1510,3,2.1.74,0,525,1,42,74,116,74,0,116,116,-74,74,74,2,1,210,221,240,221,4,1243,1169
1510,3,3.1.44,0,505,0,43,44,87,44,0,87,87,-44,44,44,2,1,278,221,312,221,4,1243,1169
1510,3,4.0.74,0,505,0,22,74,96,0,74,96,96,0,0,0,1,4,146,100,146,174,4,1243,1169
1510,3,5.0.74,1,538,2,33,74,107,0,74,107,107,0,0,0,1,4,185,100,185,174,4,1243,1169
1510,4,0.0.107,0,551,1,45,107,152,0,107,152,152,0,0,0,1,5,115,67,115,174,5,1243,1136
1510,4,1.1.10,0,538,0,77,10,87,10,0,87,107,-10,10,10,2,1,235,221,245,221,5,1243,1136
1510,4,2.1.74,0,538,0,42,74,116,74,0,116,116,-74,74,74,2,1,210,221,240,221,5,1243,1136
1510,4,3.1.44,0,538,0,43,44,87,44,0,87,107,-44,44,44,2,1,278,221,312,221,5,1243,1136
1510,4,4.0.107,1,538,0,22,107,129,0,107,129,129,0,0,0,1,5,146,67,146,174,5,1243,1136
1510,4,5.1.107,0,551,1,37,107,144,107,0,144,144,-107,107,107,2,1,152,221,185,221,5,1243,1136
1510,5,0.0.129,1,538,0,45,129,174,0,129,174,174,0,0,0,1,6,115,45,115,174,6,1243,1114
1510,5,1.1.10,0,538,0,77,10,87,10,0,87,129,-10,10,10,2,1,235,221,245,221,6,1243,1114
1510,5,2.1.74,0,538,0,42,74,116,74,0,116,129,-74,74,74,2,1,210,221,240,221,6,1243,1114
1510,5,3.1.44,0,538,0,43,44,87,44,0,87,129,-44,44,44,2,1,278,221,312,221,6,1243,1114
1510,5,4.1.129,0,538,0,5,129,134,129,0,134,134,-129,129,129,2,1,124,221,146,221,6,1243,1114
1510,5,5.1.107,0,551,1,37,107,144,107,0,144,144,-107,107,107,2,1,152,221,185,221,6,1243,1114
1510,6,0.1.174,0,538,0,17,174,191,174,0,191,191,-174,174,174,2,1,70,221,115,221,7,1243,1069
1510,6,1.1.10,0,538,0,77,10,87,10,0,87,174,-10,10,10,2,1,235,221,245,221,7,1243,1069
1510,6,2.1.74,0,538,0,42,74,116,74,0,116,174,-74,74,74,2,1,210,221,240,221,7,1243,1069
1510,6,3.1.44,1,538,0,43,44,87,44,0,87,174,-44,44,44,2,1,278,221,312,221,7,1243,1069
1510,6,4.1.129,0,538,0,5,129,134,129,0,134,174,-129,129,129,2,1,124,221,146,221,7,1243,1069
1510,6,5.1.107,0,551,1,37,107,144,107,0,144,174,-107,107,107,2,1,152,221,185,221,7,1243,1069
1510,7,0.1.174,0,538,0,17,174,191,174,0,191,191,-87,131,131,2,2,70,178,115,221,8,1243,1026
1510,7,1.1.87,0,567,2,77,87,164,10,77,164,174,0,44,44,2,2,235,178,245,221,8,1243,1026
1510,7,2.1.87,1,538,0,42,87,129,74,13,129,174,0,44,44,2,2,210,178,240,221,8,1243,1026
1510,7,3.2.87,0,567,2,91,87,178,87,0,178,178,-87,87,131,3,1,235,311,312,311,8,1243,1026
1510,7,4.1.129,0,538,0,5,129,134,129,0,134,174,-42,86,86,2,2,124,178,146,221,8,1243,1026
1510,7,5.1.107,0,553,1,37,107,144,107,0,144,174,-20,64,64,2,2,152,178,185,221,8,1243,1026
1510,8,0.1.174,0,538,0,17,174,191,174,0,191,191,-45,89,89,2,3,70,136,115,221,9,1243,984
1510,8,1.1.129,1,567,1,77,129,206,10,119,206,206,0,44,44,2,3,235,136,245,221,9,1243,984
1510,8,2.2.129,0,591,2,68,129,197,129,0,197,197,-129,129,173,3,1,168,311,240,311,9,1243,984
1510,8,3.2.87,0,567,1,91,87,178,87,0,178,178,-87,87,131,3,1,235,311,312,311,9,1243,984
1510,8,4.1.129,0,538,0,5,129,134,129,0,134,174,0,44,44,2,3,124,136,146,221,9,1243,984
1510,8,5.1.129,0,567,1,37,129,166,107,22,166,174,0,44,44,2,3,152,136,185,221,9,1243,984
1510,9,0.1.206,0,567,0,17,206,223,174,32,223,223,0,44,44,2,4,70,59,115,221,10,1243,907
1510,9,1.2.206,0,576,1,70,206,276,206,0,276,276,-206,206,250,3,1,158,311,245,311,10,1243,907
1510,9,2.2.129,0,591,2,68,129,197,129,0,197,206,-129,129,173,3,1,168,311,240,311,10,1243,907
1510,9,3.2.87,0,567,0,91,87,178,87,0,178,206,-87,87,131,3,1,235,311,312,311,10,1243,907
1510,9,4.1.206,1,567,0,5,206,211,129,77,211,211,0,44,44,2,4,124,59,146,221,10,1243,907
1510,9,5.1.206,0,567,0,37,206,243,107,99,243,243,0,44,44,2,4,152,59,185,221,10,1243,907
1510,10,0.1.211,0,567,0,17,211,228,174,37,228,228,0,44,44,2,5,70,54,115,221,11,1243,902
1510,10,1.2.206,0,576,2,70,206,276,206,0,276,276,-206,206,250,3,1,158,311,245,311,11,1243,902
1510,10,2.2.129,0,591,3,68,129,197,129,0,197,211,-129,129,173,3,1,168,311,240,311,11,1243,902
1510,10,3.2.87,0,567,0,91,87,178,87,0,178,211,-87,87,131,3,1,235,311,312,311,11,1243,902
1510,10,4.2.211,0,572,1,10,211,221,211,0,221,221,-211,211,255,3,1,119,311,146,311,11,1243,902
1510,10,5.1.211,1,567,0,37,211,248,107,104,248,248,0,44,44,2,5,152,54,185,221,11,1243,902
1510,11,0.1.248,1,567,0,17,248,265,174,74,265,265,0,44,44,2,6,70,17,115,221,12,1243,865
1510,11,1.2.206,0,576,2,70,206,276,206,0,276,276,-206,206,250,3,1,158,311,245,311,12,1243,865
1510,11,2.2.129,0,591,3,68,129,197,129,0,197,248,-129,129,173,3,1,168,311,240,311,12,1243,865
1510,11,3.2.87,0,567,0,91,87,178,87,0,178,248,-87,87,131,3,1,235,311,312,311,12,1243,865
1510,11,4.2.211,0,572,1,10,211,221,211,0,221,248,-211,211,255,3,1,119,311,146,311,12,1243,865
1510,11,5.2.248,0,567,0,58,248,306,248,0,306,306,-248,248,292,3,1,115,311,185,311,12,1243,865
1510,12,0.2.265,0,567,0,14,265,279,265,0,279,279,-265,265,309,3,1,53,311,115,311,13,1243,848
1510,12,1.2.206,0,576,2,70,206,276,206,0,276,276,-206,206,250,3,1,158,311,245,311,13,1243,848
1510,12,2.2.129,0,591,3,68,129,197,129,0,197,265,-129,129,173,3,1,168,311,240,311,13,1243,848
1510,12,3.2.87,1,567,0,91,87,178,87,0,178,265,-87,87,131,3,1,235,311,312,311,13,1243,848
1510,12,4.2.211,0,572,1,10,211,221,211,0,221,265,-211,211,255,3,1,119,311,146,311,13,1243,848
1510,12,5.2.248,0,567,0,58,248,306,248,0,306,306,-248,248,292,3,1,115,311,185,311,13,1243,848
1510,13,0.2.265,0,567,0,14,265,279,265,0,279,279,-87,174,218,3,2,53,220,115,311,14,1243,757
1510,13,1.2.206,0,576,2,70,206,276,206,0,276,276,-28,115,159,3,2,158,220,245,311,14,1243,757
1510,13,2.2.178,1,567,0,68,178,246,129,49,246,265,0,87,131,3,2,168,220,240,311,14,1243,757
1510,13,3.3.178,0,567,0,89,178,267,178,0,267,267,-178,178,309,4,1,144,379,312,379,14,1243,757
1510,13,4.2.211,0,572,1,10,211,221,211,0,221,265,-33,120,164,3,2,119,220,146,311,14,1243,757
1510,13,5.2.248,0,567,0,58,248,306,248,0,306,306,-70,157,201,3,2,115,220,185,311,14,1243,757
1510,14,0.2.265,0,567,0,14,265,279,265,0,279,279,-19,106,150,3,3,53,152,115,311,15,1243,689
1510,14,1.2.246,0,567,0,70,246,316,206,40,316,316,0,87,131,3,3,158,152,245,311,15,1243,689
1510,14,2.3.246,0,635,1,67,246,313,246,0,313,313,-246,246,377,4,1,100,379,240,379,15,1243,689
1510,14,3.3.178,0,567,0,89,178,267,178,0,267,267,-178,178,309,4,1,144,379,312,379,15,1243,689
1510,14,4.2.246,1,567,0,10,246,256,211,35,256,265,0,87,131,3,3,119,152,146,311,15,1243,689
1510,14,5.2.248,0,567,0,58,248,306,248,0,306,306,-2,89,133,3,3,115,152,185,311,15,1243,689
1510,15,0.2.265,0,567,0,14,265,279,265,0,279,279,-9,96,140,3,4,53,142,115,311,16,1243,679
1510,15,1.2.256,1,567,0,70,256,326,206,50,326,326,0,87,131,3,4,158,142,245,311,16,1243,679
1510,15,2.3.246,0,635,2,67,246,313,246,0,313,313,-246,246,377,4,1,100,379,240,379,16,1243,679
1510,15,3.3.178,0,567,0,89,178,267,178,0,267,267,-178,178,309,4,1,144,379,312,379,16,1243,679
1510,15,4.3.256,0,650,3,99,256,355,256,0,355,355,-256,256,387,4,1,109,379,146,379,16,1243,679
1510,15,5.2.256,0,572,1,58,256,314,248,8,314,314,0,87,131,3,4,115,142,185,311,16,1243,679
1510,16,0.2.326,1,567,0,14,326,340,265,61,340,340,0,87,131,3,5,53,72,115,311,17,1243,609
1510,16,1.3.326,0,626,1,66,326,392,326,0,392,392,-326,326,457,4,1,88,379,245,379,17,1243,609
1510,16,2.3.246,0,635,2,67,246,313,246,0,313,326,-246,246,377,4,1,100,379,240,379,17,1243,609
1510,16,3.3.178,0,567,0,89,178,267,178,0,267,326,-178,178,309,4,1,144,379,312,379,17,1243,609
1510,16,4.3.256,0,650,3,99,256,355,256,0,355,355,-256,256,387,4,1,109,379,146,379,17,1243,609
1510,16,5.2.326,0,567,0,58,326,384,248,78,384,384,0,87,131,3,5,115,72,185,311,17,1243,609
1510,17,0.3.340,0,573,1,16,340,356,340,0,356,356,-340,340,471,4,1,39,379,115,379,18,1243,595
1510,17,1.3.326,0,626,2,66,326,392,326,0,392,392,-326,326,457,4,1,88,379,245,379,18,1243,595
1510,17,2.3.246,0,635,3,67,246,313,246,0,313,340,-246,246,377,4,1,100,379,240,379,18,1243,595
1510,17,3.3.178,0,567,0,89,178,267,178,0,267,340,-178,178,309,4,1,144,379,312,379,18,1243,595
1510,17,4.3.256,0,650,4,99,256,355,256,0,355,355,-256,256,387,4,1,109,379,146,379,18,1243,595
1510,17,5.2.340,1,567,0,58,340,398,248,92,398,398,0,87,131,3,6,115,58,185,311,18,1243,595
1510,18,0.3.340,0,573,1,16,340,356,340,0,356,398,-340,340,471,4,1,39,379,115,379,19,1243,537
1510,18,1.3.326,0,626,3,66,326,392,326,0,392,398,-326,326,457,4,1,88,379,245,379,19,1243,537
1510,18,2.3.246,0,635,4,67,246,313,246,0,313,398,-246,246,377,4,1,100,379,240,379,19,1243,537
1510,18,3.3.178,1,567,0,89,178,267,178,0,267,398,-178,178,309,4,1,144,379,312,379,19,1243,537
1510,18,4.3.256,0,650,5,99,256,355,256,0,355,398,-256,256,387,4,1,109,379,146,379,19,1243,537
1510,18,5.3.398,0,595,2,42,398,440,398,0,440,440,-398,398,529,4,1,57,379,185,379,19,1243,537
1510,19,0.3.340,0,573,2,16,340,356,340,0,356,398,-73,251,382,4,2,39,290,115,379,20,1243,448
1510,19,1.3.326,0,626,4,66,326,392,326,0,392,398,-59,237,368,4,2,88,290,245,379,20,1243,448
1510,19,2.3.267,0,567,0,67,267,334,246,21,334,398,0,178,309,4,2,100,290,240,379,20,1243,448
1510,19,3.4.267,1,567,0,55,267,322,267,0,322,398,-267,267,576,5,1,55,158,312,158,20,1243,448
1510,19,4.3.267,0,572,1,99,267,366,256,11,366,398,0,178,309,4,2,109,290,146,379,20,1243,448
1510,19,5.3.398,0,595,3,42,398,440,398,0,440,440,-131,309,440,4,2,57,290,185,379,20,1243,448
1510,20,0.3.340,0,573,2,16,340,356,340,0,356,398,-73,251,649,4,2,39,290,115,379,21,1243,393
1510,20,1.3.326,0,626,4,66,326,392,326,0,392,398,-59,237,635,4,2,88,290,245,379,21,1243,393
1510,20,2.3.267,1,567,0,67,267,334,246,21,334,398,0,178,576,4,2,100,290,240,379,21,1243,393
1510,20,4.3.267,0,572,1,99,267,366,256,11,366,398,0,178,576,4,2,109,290,146,379,21,1243,393
1510,20,5.3.398,0,595,3,42,398,440,398,0,440,440,-131,309,707,4,2,57,290,185,379,21,1243,393
1510,21,0.3.340,0,573,2,16,340,356,340,0,356,398,-6,184,582,4,3,39,223,115,379,22,1243,326
1510,21,1.3.334,0,567,0,66,334,400,326,8,400,400,0,178,576,4,3,88,223,245,379,22,1243,326
1510,21,2.4.334,1,567,0,33,334,367,334,0,367,398,-12,279,588,5,2,33,103,240,158,22,1243,326
1510,21,4.3.334,0,572,1,99,334,433,256,78,433,433,0,178,576,4,3,109,223,146,379,22,1243,326
1510,21,5.3.398,0,615,3,42,398,440,398,0,440,440,-64,242,640,4,3,57,223,185,379,22,1243,326
1510,22,0.3.340,1,573,2,16,340,356,340,0,356,398,-6,184,594,4,3,39,223,115,379,23,1243,293
1510,22,1.3.334,0,567,0,66,334,400,326,8,400,400,0,178,588,4,3,88,223,245,379,23,1243,293
1510,22,4.3.334,0,572,1,99,334,433,256,78,433,433,0,178,588,4,3,109,223,146,379,23,1243,293
1510,22,5.3.398,0,615,3,42,398,440,398,0,440,440,-64,242,652,4,3,57,223,185,379,23,1243,293
1510,23,0.4.367,1,573,0,23,367,390,356,11,390,398,0,279,594,5,3,23,70,115,158,24,1243,277
1510,23,1.3.356,0,573,0,66,356,422,326,30,422,422,0,184,594,4,4,88,207,245,379,24,1243,277
1510,23,4.3.356,0,578,1,99,356,455,256,100,455,455,0,184,594,4,4,109,207,146,379,24,1243,277
1510,23,5.3.398,0,615,2,42,398,440,398,0,440,440,-42,226,636,4,4,57,207,185,379,24,1243,277
1510,24,1.3.356,1,573,0,66,356,422,326,30,422,422,0,184,594,4,4,88,207,245,379,25,1243,254
1510,24,4.3.356,0,578,1,99,356,455,256,100,455,455,0,184,594,4,4,109,207,146,379,25,1243,254
1510,24,5.3.398,0,615,2,42,398,440,398,0,440,440,-42,226,636,4,4,57,207,185,379,25,1243,254
1510,25,1.4.422,1,573,0,22,422,444,422,0,444,444,-32,311,626,5,4,22,47,245,158,26,1243,188
1510,25,4.3.422,0,578,1,99,422,521,256,166,521,521,0,184,594,4,5,109,141,146,379,26,1243,188
1510,25,5.3.422,0,573,0,42,422,464,398,24,464,464,0,184,594,4,5,57,141,185,379,26,1243,188
1510,26,4.3.422,0,578,1,99,422,521,256,166,521,521,0,184,626,4,5,109,141,146,379,27,1243,166
1510,26,5.3.422,1,573,0,42,422,464,398,24,464,464,0,184,626,4,5,57,141,185,379,27,1243,166
1510,27,4.3.464,0,573,0,99,464,563,256,208,563,563,0,184,626,4,6,109,99,146,379,28,1243,124
1510,27,5.4.464,1,573,0,15,464,479,464,0,479,479,-20,331,646,5,5,15,25,185,158,28,1243,124
1510,28,4.3.464,1,573,0,99,464,563,256,208,563,563,0,184,646,4,6,109,99,146,379,29,1243,109
1510,29,4.4.563,1,573,0,10,563,573,563,0,573,573,-84,415,730,5,6,10,10,146,158,30,1243,10
1511,0,0.0.0,0,608,2,58,0,58,0,0,58,58,0,0,0,1,1,258,388,258,388,1,1608,1608
1511,0,1.0.0,0,639,4,85,0,85,0,0,85,85,0,0,0,1,1,245,388,245,388,1,1608,1608
1511,0,2.0.0,0,602,1,76,0,76,0,0,76,76,0,0,0,1,1,266,388,266,388,1,1608,1608
1511,0,3.0.0,0,645,5,87,0,87,0,0,87,87,0,0,0,1,1,370,388,370,388,1,1608,1608
1511,0,4.0.0,1,596,0,44,0,44,0,0,44,44,0,0,0,1,1,282,388,282,388,1,1608,1608
1511,0,5.0.0,0,617,3,38,0,38,0,0,38,38,0,0,0,1,1,187,388,187,388,1,1608,1608
1511,1,0.0.44,0,596,0,58,44,102,0,44,102,102,0,0,0,1,2,258,344,258,388,2,1608,1564
1511,1,1.0.44,0,639,4,85,44,129,0,44,129,129,0,0,0,1,2,245,344,245,388,2,1608,1564
1511,1,2.0.44,0,602,1,76,44,120,0,44,120,120,0,0,0,1,2,266,344,266,388,2,1608,1564
1511,1,3.0.44,0,610,2,87,44,131,0,44,131,131,0,0,0,1,2,370,344,370,388,2,1608,1564
1511,1,4.1.44,1,596,0,56,44,100,44,0,100,100,-44,44,44,2,1,238,323,282,323,2,1608,1564
1511,1,5.0.44,0,617,3,38,44,82,0,44,82,82,0,0,0,1,2,187,344,187,388,2,1608,1564
1511,2,0.0.44,0,596,0,58,44,102,0,44,102,102,0,0,44,1,2,258,344,258,388,3,1608,1508
1511,2,1.0.44,0,639,4,85,44,129,0,44,129,129,0,0,44,1,2,245,344,245,388,3,1608,1508
1511,2,2.0.44,0,602,1,76,44,120,0,44,120,120,0,0,44,1,2,266,344,266,388,3,1608,1508
1511,2,3.0.44,0,610,2,87,44,131,0,44,131,131,0,0,44,1,2,370,344,370,388,3,1608,1508
1511,2,4.2.100,1,596,0,11,100,111,100,0,111,111,-100,100,144,3,1,182,279,282,279,3,1608,1508
1511,2,5.0.44,0,617,3,38,44,82,0,44,82,100,0,0,44,1,2,187,344,187,388,3,1608,1508
1511,3,0.0.44,0,596,0,58,44,102,0,44,102,111,0,0,144,1,2,258,344,258,388,4,1608,1497
1511,3,1.0.44,0,639,4,85,44,129,0,44,129,129,0,0,144,1,2,245,344,245,388,4,1608,1497
1511,3,2.0.44,0,602,1,76,44,120,0,44,120,120,0,0,144,1,2,266,344,266,388,4,1608,1497
1511,3,3.0.44,0,610,2,87,44,131,0,44,131,131,0,0,144,1,2,370,344,370,388,4,1608,1497
1511,3,4.3.111,1,596,0,92,111,203,111,0,203,203,-111,111,255,4,1,171,234,282,234,4,1608,1497
1511,3,5.0.44,0,617,3,38,44,82,0,44,82,111,0,0,144,1,2,187,344,187,388,4,1608,1497
1511,4,0.0.44,0,596,0,58,44,102,0,44,102,203,0,0,255,1,2,258,344,258,388,5,1608,1405
1511,4,1.0.44,0,639,4,85,44,129,0,44,129,203,0,0,255,1,2,245,344,245,388,5,1608,1405
1511,4,2.0.44,0,602,1,76,44,120,0,44,120,203,0,0,255,1,2,266,344,266,388,5,1608,1405
1511,4,3.0.44,0,610,2,87,44,131,0,44,131,203,0,0,255,1,2,370,344,370,388,5,1608,1405
1511,4,4.4.203,1,596,0,79,203,282,203,0,282,282,-203,203,458,5,1,79,384,282,384,5,1608,1405
1511,4,5.0.44,0,617,3,38,44,82,0,44,82,203,0,0,255,1,2,187,344,187,388,5,1608,1405
1511,5,0.0.44,0,596,0,58,44,102,0,44,102,282,0,0,458,1,2,258,344,258,388,6,1608,1326
1511,5,1.0.44,0,639,4,85,44,129,0,44,129,282,0,0,458,1,2,245,344,245,388,6,1608,1326
1511,5,2.0.44,0,602,1,76,44,120,0,44,120,282,0,0,458,1,2,266,344,266,388,6,1608,1326
1511,5,3.0.44,1,610,2,87,44,131,0,44,131,282,0,0,458,1,2,370,344,370,388,6,1608,1326
1511,5,5.0.44,0,617,3,38,44,82,0,44,82,282,0,0,458,1,2,187,344,187,388,6,1608,1326
1511,6,0.0.131,0,623,1,58,131,189,0,131,189,282,0,0,458,1,3,258,257,258,388,7,1608,1239
1511,6,1.0.131,0,623,1,85,131,216,0,131,216,282,0,0,458,1,3,245,257,245,388,7,1608,1239
1511,6,2.0.131,0,610,0,76,131,207,0,131,207,282,0,0,458,1,3,266,257,266,388,7,1608,1239
1511,6,3.1.131,1,610,0,81,131,212,131,0,212,282,-31,75,489,2,2,283,267,370,323,7,1608,1239
1511,6,5.0.131,0,623,1,38,131,169,0,131,169,282,0,0,458,1,3,187,257,187,388,7,1608,1239
1511,7,0.0.131,0,623,1,58,131,189,0,131,189,282,0,0,489,1,3,258,257,258,388,8,1608,1158
1511,7,1.0.131,0,623,1,85,131,216,0,131,216,282,0,0,489,1,3,245,257,245,388,8,1608,1158
1511,7,2.0.131,0,610,0,76,131,207,0,131,207,282,0,0,489,1,3,266,257,266,388,8,1608,1158
1511,7,3.2.212,1,623,1,58,212,270,212,0,270,282,-101,201,590,3,2,202,268,370,279,8,1608,1158
1511,7,5.0.131,0,623,1,38,131,169,0,131,169,282,0,0,489,1,3,187,257,187,388,8,1608,1158
1511,8,0.0.131,0,623,0,58,131,189,0,131,189,282,0,0,590,1,3,258,257,258,388,9,1608,1100
1511,8,1.0.131,0,623,0,85,131,216,0,131,216,282,0,0,590,1,3,245,257,245,388,9,1608,1100
1511,8,2.0.131,0,623,0,76,131,207,0,131,207,282,0,0,590,1,3,266,257,266,388,9,1608,1100
1511,8,3.3.270,1,623,0,48,270,318,270,0,318,318,-67,178,657,4,2,144,142,370,234,9,1608,1100
1511,8,5.0.131,0,623,0,38,131,169,0,131,169,282,0,0,590,1,3,187,257,187,388,9,1608,1100
1511,9,0.0.131,0,623,0,58,131,189,0,131,189,318,0,0,657,1,3,258,257,258,388,10,1608,1052
1511,9,1.0.131,0,623,0,85,131,216,0,131,216,318,0,0,657,1,3,245,257,245,388,10,1608,1052
1511,9,2.0.131,0,623,0,76,131,207,0,131,207,318,0,0,657,1,3,266,257,266,388,10,1608,1052
1511,9,3.4.318,1,623,0,96,318,414,318,0,414,414,-36,239,693,5,2,96,305,370,384,10,1608,1052
1511,9,5.0.131,0,623,0,38,131,169,0,131,169,318,0,0,657,1,3,187,257,187,388,10,1608,1052
1511,10,0.0.131,1,623,0,58,131,189,0,131,189,414,0,0,693,1,3,258,257,258,388,11,1608,956
1511,10,1.0.131,0,623,0,85,131,216,0,131,216,414,0,0,693,1,3,245,257,245,388,11,1608,956
1511,10,2.0.131,0,623,0,76,131,207,0,131,207,414,0,0,693,1,3,266,257,266,388,11,1608,956
1511,10,5.0.131,0,623,0,38,131,169,0,131,169,414,0,0,693,1,3,187,257,187,388,11,1608,956
1511,11,0.1.212,0,623,0,85,212,297,189,23,297,414,0,75,693,2,3,200,186,258,323,12,1608,898
1511,11,1.0.189,0,623,0,85,189,274,0,189,274,414,0,0,693,1,4,245,199,245,388,12,1608,898
1511,11,2.0.189,0,623,0,76,189,265,0,189,265,414,0,0,693,1,4,266,199,266,388,12,1608,898
1511,11,5.0.189,1,623,0,38,189,227,0,189,227,414,0,0,693,1,4,187,199,187,388,12,1608,898
1511,12,0.1.212,0,623,0,85,212,297,189,23,297,414,0,75,693,2,3,200,186,258,323,13,1608,860
1511,12,1.0.227,0,623,0,85,227,312,0,227,312,414,0,0,693,1,5,245,161,245,388,13,1608,860
1511,12,2.0.227,1,623,0,76,227,303,0,227,303,414,0,0,693,1,5,266,161,266,388,13,1608,860
1511,12,5.1.227,0,623,0,20,227,247,227,0,247,414,-15,90,708,2,3,149,186,187,323,13,1608,860
1511,13,0.1.212,0,623,0,85,212,297,189,23,297,414,0,75,693,2,3,200,186,258,323,14,1608,784
1511,13,1.0.303,1,623,0,85,303,388,0,303,388,414,0,0,693,1,6,245,85,245,388,14,1608,784
1511,13,2.1.303,0,623,0,36,303,339,303,0,339,414,-91,166,784,2,3,190,186,266,323,14,1608,784
1511,13,5.1.227,0,623,0,20,227,247,227,0,247,414,-15,90,708,2,3,149,186,187,323,14,1608,784
1511,14,0.1.212,0,623,0,85,212,297,189,23,297,414,0,75,693,2,3,200,186,258,323,15,1608,699
1511,14,1.1.388,0,623,0,45,388,433,388,0,433,433,-176,251,869,2,3,160,186,245,323,15,1608,699
1511,14,2.1.303,0,623,0,36,303,339,303,0,339,414,-91,166,784,2,3,190,186,266,323,15,1608,699
1511,14,5.1.227,1,623,0,20,227,247,227,0,247,414,-15,90,708,2,3,149,186,187,323,15,1608,699
1511,15,0.1.247,1,623,0,85,247,332,189,58,332,414,0,90,708,2,4,200,166,258,323,16,1608,679
1511,15,1.1.388,0,623,0,45,388,433,388,0,433,433,-141,231,849,2,4,160,166,245,323,16,1608,679
1511,15,2.1.303,0,623,0,36,303,339,303,0,339,414,-56,146,764,2,4,190,166,266,323,16,1608,679
1511,15,5.2.270,0,623,0,96,270,366,247,23,366,414,0,201,708,3,3,129,210,187,279,16,1608,679
1511,16,0.2.332,0,623,0,18,332,350,332,0,350,414,-62,263,770,3,3,115,210,258,279,17,1608,594
1511,16,1.1.388,0,623,0,45,388,433,388,0,433,433,-56,146,764,2,5,160,81,245,323,17,1608,594
1511,16,2.1.332,1,623,0,36,332,368,303,29,368,414,0,90,708,2,5,190,81,266,323,17,1608,594
1511,16,5.2.270,0,623,0,96,270,366,247,23,366,414,0,201,708,3,3,129,210,187,279,17,1608,594
1511,17,0.2.332,0,623,0,18,332,350,332,0,350,414,-62,263,770,3,3,115,210,258,279,18,1608,558
1511,17,1.1.388,1,623,0,45,388,433,388,0,433,433,-20,110,728,2,6,160,45,245,323,18,1608,558
1511,17,2.2.368,0,623,0,21,368,389,368,0,389,414,-98,299,806,3,3,154,210,266,279,18,1608,558
1511,17,5.2.270,0,623,0,96,270,366,247,23,366,414,0,201,708,3,3,129,210,187,279,18,1608,558
1511,18,0.2.332,1,623,0,18,332,350,332,0,350,433,-62,263,790,3,3,115,210,258,279,19,1608,513
1511,18,1.2.433,0,623,0,75,433,508,433,0,508,508,-163,364,891,3,3,115,210,245,279,19,1608,513
1511,18,2.2.368,0,623,0,21,368,389,368,0,389,433,-98,299,826,3,3,154,210,266,279,19,1608,513
1511,18,5.2.270,0,623,0,96,270,366,247,23,366,433,0,201,728,3,3,129,210,187,279,19,1608,513
1511,19,0.3.350,1,623,0,22,350,372,350,0,372,433,-32,210,822,4,3,97,94,258,234,20,1608,495
1511,19,1.2.433,0,637,1,75,433,508,433,0,508,508,-83,346,873,3,4,115,192,245,279,20,1608,495
1511,19,2.2.368,0,623,0,21,368,389,368,0,389,433,-18,281,808,3,4,154,192,266,279,20,1608,495
1511,19,5.2.350,0,637,1,96,350,446,247,103,446,446,0,263,790,3,4,129,192,187,279,20,1608,495
1511,20,0.4.414,1,623,0,75,414,489,372,42,489,489,0,239,822,5,3,75,209,258,384,21,1608,473
1511,20,1.2.433,0,637,1,75,433,508,433,0,508,508,-83,346,905,3,4,115,192,245,279,21,1608,473
1511,20,2.2.368,0,623,0,21,368,389,368,0,389,433,-18,281,840,3,4,154,192,266,279,21,1608,473
1511,20,5.2.350,0,637,1,96,350,446,247,103,446,446,0,263,822,3,4,129,192,187,279,21,1608,473
1511,21,1.2.433,0,637,1,75,433,508,433,0,508,508,-83,346,905,3,4,115,192,245,279,22,1608,398
1511,21,2.2.368,1,623,0,21,368,389,368,0,389,489,-18,281,840,3,4,154,192,266,279,22,1608,398
1511,21,5.2.350,0,637,1,96,350,446,247,103,446,489,0,263,822,3,4,129,192,187,279,22,1608,398
1511,22,1.2.433,0,637,1,75,433,508,433,0,508,508,-44,325,884,3,5,115,171,245,279,23,1608,377
1511,22,2.3.389,1,623,0,36,389,425,389,0,425,489,-17,227,857,4,4,133,72,266,234,23,1608,377
1511,22,5.2.389,0,623,0,96,389,485,247,142,485,489,0,281,840,3,5,129,171,187,279,23,1608,377
1511,23,1.2.433,0,637,1,75,433,508,433,0,508,508,-44,325,901,3,5,115,171,245,279,24,1608,341
1511,23,2.4.489,1,623,0,97,489,586,425,64,586,586,0,239,857,5,4,97,134,266,384,24,1608,341
1511,23,5.2.389,0,623,0,96,389,485,247,142,485,489,0,281,857,3,5,129,171,187,279,24,1608,341
1511,24,1.2.433,0,637,1,75,433,508,433,0,508,586,-44,325,901,3,5,115,171,245,279,25,1608,244
1511,24,5.2.389,1,623,0,96,389,485,247,142,485,586,0,281,857,3,5,129,171,187,279,25,1608,244
1511,25,1.2.485,0,623,0,75,485,560,433,52,560,586,0,281,857,3,6,115,75,245,279,26,1608,148
1511,25,5.3.485,1,623,0,27,485,512,485,0,512,586,-60,287,917,4,5,33,36,187,234,26,1608,148
1511,26,1.2.485,0,623,0,75,485,560,433,52,560,586,0,281,917,3,6,115,75,245,279,27,1608,121
1511,26,5.4.586,1,623,0,6,586,592,512,74,592,592,0,239,917,5,5,6,37,187,384,27,1608,121
1511,27,1.2.485,1,623,0,75,485,560,433,52,560,592,0,281,917,3,6,115,75,245,279,28,1608,115
1511,28,1.3.560,1,623,0,9,560,569,560,0,569,592,-48,335,965,4,6,40,9,245,234,29,1608,40
1511,29,1.4.592,1,623,0,31,592,623,569,23,623,623,0,239,965,5,6,31,31,245,384,30,1608,31
1512,0,0.0.0,0,485,4,71,0,71,0,0,71,71,0,0,0,1,1,202,301,202,301,1,1179,1179
1512,0,1.0.0,0,467,2,60,0,60,0,0,60,60,0,0,0,1,1,244,301,244,301,1,1179,1179
1512,0,2.0.0,1,435,0,22,0,22,0,0,22,22,0,0,0,1,1,193,301,193,301,1,1179,1179
1512,0,3.0.0,0,442,1,41,0,41,0,0,41,41,0,0,0,1,1,133,301,133,301,1,1179,1179
1512,0,4.0.0,0,472,3,65,0,65,0,0,65,65,0,0,0,1,1,219,301,219,301,1,1179,1179
1512,0,5.0.0,0,435,0,42,0,42,0,0,42,42,0,0,0,1,1,188,301,188,301,1,1179,1179
1512,1,0.0.22,0,478,4,71,22,93,0,22,93,93,0,0,0,1,2,202,279,202,301,2,1179,1157
1512,1,1.0.22,0,449,3,60,22,82,0,22,82,82,0,0,0,1,2,244,279,244,301,2,1179,1157
1512,1,2.1.22,1,435,0,29,22,51,22,0,51,51,-22,22,22,2,1,171,127,193,127,2,1179,1157
1512,1,3.0.22,0,442,1,41,22,63,0,22,63,63,0,0,0,1,2,133,279,133,301,2,1179,1157
1512,1,4.0.22,0,445,2,65,22,87,0,22,87,87,0,0,0,1,2,219,279,219,301,2,1179,1157
1512,1,5.0.22,0,435,0,42,22,64,0,22,64,64,0,0,0,1,2,188,279,188,301,2,1179,1157
1512,2,0.0.22,0,478,4,71,22,93,0,22,93,93,0,0,22,1,2,202,279,202,301,3,1179,1128
1512,2,1.0.22,0,449,3,60,22,82,0,22,82,82,0,0,22,1,2,244,279,244,301,3,1179,1128
1512,2,2.2.51,1,445,2,74,51,125,51,0,125,125,-51,51,73,3,1,142,247,193,247,3,1179,1128
1512,2,3.0.22,0,442,1,41,22,63,0,22,63,63,0,0,22,1,2,133,279,133,301,3,1179,1128
1512,2,4.0.22,0,445,2,65,22,87,0,22,87,87,0,0,22,1,2,219,279,219,301,3,1179,1128
1512,2,5.0.22,0,435,0,42,22,64,0,22,64,64,0,0,22,1,2,188,279,188,301,3,1179,1128
1512,3,0.0.22,0,478,2,71,22,93,0,22,93,125,0,0,73,1,2,202,279,202,301,4,1179,1054
1512,3,1.0.22,0,449,1,60,22,82,0,22,82,125,0,0,73,1,2,244,279,244,301,4,1179,1054
1512,3,2.3.125,1,445,0,5,125,130,125,0,130,130,-125,125,198,4,1,68,189,193,189,4,1179,1054
1512,3,3.0.22,0,445,0,41,22,63,0,22,63,125,0,0,73,1,2,133,279,133,301,4,1179,1054
1512,3,4.0.22,0,445,0,65,22,87,0,22,87,125,0,0,73,1,2,219,279,219,301,4,1179,1054
1512,3,5.0.22,0,445,0,42,22,64,0,22,64,125,0,0,73,1,2,188,279,188,301,4,1179,1054
1512,4,0.0.22,0,478,2,71,22,93,0,22,93,130,0,0,198,1,2,202,279,202,301,5,1179,1049
1512,4,1.0.22,0,449,1,60,22,82,0,22,82,130,0,0,198,1,2,244,279,244,301,5,1179,1049
1512,4,2.4.130,1,445,0,63,130,193,130,0,193,193,-130,130,328,5,1,63,315,193,315,5,1179,1049
1512,4,3.0.22,0,445,0,41,22,63,0,22,63,130,0,0,198,1,2,133,279,133,301,5,1179,1049
1512,4,4.0.22,0,445,0,65,22,87,0,22,87,130,0,0,198,1,2,219,279,219,301,5,1179,1049
1512,4,5.0.22,0,445,0,42,22,64,0,22,64,130,0,0,198,1,2,188,279,188,301,5,1179,1049
1512,5,0.0.22,0,478,2,71,22,93,0,22,93,193,0,0,328,1,2,202,279,202,301,6,1179,986
1512,5,1.0.22,1,449,1,60,22,82,0,22,82,193,0,0,328,1,2,244,279,244,301,6,1179,986
1512,5,3.0.22,0,445,0,41,22,63,0,22,63,193,0,0,328,1,2,133,279,133,301,6,1179,986
1512,5,4.0.22,0,445,0,65,22,87,0,22,87,193,0,0,328,1,2,219,279,219,301,6,1179,986
1512,5,5.0.22,0,445,0,42,22,64,0,22,64,193,0,0,328,1,2,188,279,188,301,6,1179,986
1512,6,0.0.82,0,497,3,71,82,153,0,82,153,193,0,0,328,1,3,202,219,202,301,7,1179,926
1512,6,1.1.82,1,449,0,14,82,96,82,0,96,193,-31,53,359,2,2,184,98,244,127,7,1179,926
1512,6,3.0.82,0,452,1,41,82,123,0,82,123,193,0,0,328,1,3,133,219,133,301,7,1179,926
1512,6,4.0.82,0,491,2,65,82,147,0,82,147,193,0,0,328,1,3,219,219,219,301,7,1179,926
1512,6,5.0.82,0,449,0,42,82,124,0,82,124,193,0,0,328,1,3,188,219,188,301,7,1179,926
1512,7,0.0.82,0,497,4,71,82,153,0,82,153,193,0,0,359,1,3,202,219,202,301,8,1179,912
1512,7,1.2.125,1,492,3,80,125,205,96,29,205,205,0,51,359,3,2,170,173,244,247,8,1179,912
1512,7,3.0.82,0,452,1,41,82,123,0,82,123,193,0,0,359,1,3,133,219,133,301,8,1179,912
1512,7,4.0.82,0,491,2,65,82,147,0,82,147,193,0,0,359,1,3,219,219,219,301,8,1179,912
1512,7,5.0.82,0,449,0,42,82,124,0,82,124,193,0,0,359,1,3,188,219,188,301,8,1179,912
1512,8,0.0.82,0,501,2,71,82,153,0,82,153,205,0,0,359,1,3,202,219,202,301,9,1179,832
1512,8,1.3.205,1,507,3,50,205,255,205,0,255,255,-75,200,434,4,2,90,184,244,189,9,1179,832
1512,8,3.0.82,0,492,0,41,82,123,0,82,123,205,0,0,359,1,3,133,219,133,301,9,1179,832
1512,8,4.0.82,0,495,1,65,82,147,0,82,147,205,0,0,359,1,3,219,219,219,301,9,1179,832
1512,8,5.0.82,0,492,0,42,82,124,0,82,124,205,0,0,359,1,3,188,219,188,301,9,1179,832
1512,9,0.0.82,0,507,0,71,82,153,0,82,153,255,0,0,434,1,3,202,219,202,301,10,1179,782
1512,9,1.4.255,1,507,0,40,255,295,255,0,295,295,-62,192,496,5,2,40,252,244,315,10,1179,782
1512,9,3.0.82,0,507,0,41,82,123,0,82,123,255,0,0,434,1,3,133,219,133,301,10,1179,782
1512,9,4.0.82,0,507,0,65,82,147,0,82,147,255,0,0,434,1,3,219,219,219,301,10,1179,782
1512,9,5.0.82,0,507,0,42,82,124,0,82,124,255,0,0,434,1,3,188,219,188,301,10,1179,782
1512,10,0.0.82,0,507,0,71,82,153,0,82,153,295,0,0,496,1,3,202,219,202,301,11,1179,742
1512,10,3.0.82,0,507,0,41,82,123,0,82,123,295,0,0,496,1,3,133,219,133,301,11,1179,742
1512,10,4.0.82,0,507,0,65,82,147,0,82,147,295,0,0,496,1,3,219,219,219,301,11,1179,742
1512,10,5.0.82,1,507,0,42,82,124,0,82,124,295,0,0,496,1,3,188,219,188,301,11,1179,742
1512,11,0.0.124,0,507,0,71,124,195,0,124,195,295,0,0,496,1,4,202,177,202,301,12,1179,700
1512,11,3.0.124,0,507,0,41,124,165,0,124,165,295,0,0,496,1,4,133,177,133,301,12,1179,700
1512,11,4.0.124,0,507,0,65,124,189,0,124,189,295,0,0,496,1,4,219,177,219,301,12,1179,700
1512,11,5.1.124,1,507,0,3,124,127,124,0,127,295,-28,81,524,2,3,146,84,188,127,12,1179,700
1512,12,0.0.124,0,507,0,71,124,195,0,124,195,295,0,0,524,1,4,202,177,202,301,13,1179,697
1512,12,3.0.124,0,507,0,41,124,165,0,124,165,295,0,0,524,1,4,133,177,133,301,13,1179,697
1512,12,4.0.124,0,507,0,65,124,189,0,124,189,295,0,0,524,1,4,219,177,219,301,13,1179,697
1512,12,5.2.205,1,507,0,35,205,240,127,78,240,295,0,51,524,3,3,143,93,188,247,13,1179,697
1512,13,0.0.124,0,507,0,71,124,195,0,124,195,295,0,0,524,1,4,202,177,202,301,14,1179,662
1512,13,3.0.124,0,507,0,41,124,165,0,124,165,295,0,0,524,1,4,133,177,133,301,14,1179,662
1512,13,4.0.124,0,507,0,65,124,189,0,124,189,295,0,0,524,1,4,219,177,219,301,14,1179,662
1512,13,5.3.255,1,507,0,12,255,267,240,15,267,295,0,200,524,4,3,108,134,188,189,14,1179,662
1512,14,0.0.124,0,507,0,71,124,195,0,124,195,295,0,0,524,1,4,202,177,202,301,15,1179,650
1512,14,3.0.124,0,507,0,41,124,165,0,124,165,295,0,0,524,1,4,133,177,133,301,15,1179,650
1512,14,4.0.124,0,507,0,65,124,189,0,124,189,295,0,0,524,1,4,219,177,219,301,15,1179,650
1512,14,5.4.295,1,507,0,96,295,391,267,28,391,391,0,192,524,5,3,96,212,188,315,15,1179,650
1512,15,0.0.124,0,507,0,71,124,195,0,124,195,391,0,0,524,1,4,202,177,202,301,16,1179,554
1512,15,3.0.124,0,507,0,41,124,165,0,124,165,391,0,0,524,1,4,133,177,133,301,16,1179,554
1512,15,4.0.124,1,507,0,65,124,189,0,124,189,391,0,0,524,1,4,219,177,219,301,16,1179,554
1512,16,0.0.189,0,507,0,71,189,260,0,189,260,391,0,0,524,1,5,202,112,202,301,17,1179,489
1512,16,3.0.189,0,507,0,41,189,230,0,189,230,391,0,0,524,1,5,133,112,133,301,17,1179,489
1512,16,4.1.189,1,507,0,8,189,197,189,0,197,391,-62,143,586,2,4,154,81,219,127,17,1179,489
1512,17,0.0.189,0,507,0,71,189,260,0,189,260,391,0,0,586,1,5,202,112,202,301,18,1179,481
1512,17,3.0.189,0,507,0,41,189,230,0,189,230,391,0,0,586,1,5,133,112,133,301,18,1179,481
1512,17,4.2.240,1,507,0,11,240,251,197,43,251,391,0,51,586,3,4,146,58,219,247,18,1179,481
1512,18,0.0.189,0,507,0,71,189,260,0,189,260,391,0,0,586,1,5,202,112,202,301,19,1179,470
1512,18,3.0.189,0,507,0,41,189,230,0,189,230,391,0,0,586,1,5,133,112,133,301,19,1179,470
1512,18,4.3.267,1,507,0,85,267,352,251,16,352,391,0,200,586,4,4,135,122,219,189,19,1179,470
1512,19,0.0.189,0,507,0,71,189,260,0,189,260,391,0,0,586,1,5,202,112,202,301,20,1179,385
1512,19,3.0.189,0,507,0,41,189,230,0,189,230,391,0,0,586,1,5,133,112,133,301,20,1179,385
1512,19,4.4.391,1,507,0,50,391,441,352,39,441,441,0,192,586,5,4,50,116,219,315,20,1179,385
1512,20,0.0.189,0,507,0,71,189,260,0,189,260,441,0,0,586,1,5,202,112,202,301,21,1179,335
1512,20,3.0.189,1,507,0,41,189,230,0,189,230,441,0,0,586,1,5,133,112,133,301,21,1179,335
1512,21,0.0.230,1,507,0,71,230,301,0,230,301,441,0,0,586,1,6,202,71,202,301,22,1179,294
1512,21,3.1.230,0,507,0,20,230,250,230,0,250,441,-33,176,619,2,5,92,73,133,127,22,1179,294
1512,22,0.1.301,0,507,0,53,301,354,301,0,354,441,-104,247,690,2,5,131,73,202,127,23,1179,223
1512,22,3.1.230,1,507,0,20,230,250,230,0,250,441,-33,176,619,2,5,92,73,133,127,23,1179,223
1512,23,0.1.301,0,507,0,53,301,354,301,0,354,441,-51,227,670,2,6,131,53,202,127,24,1179,203
1512,23,3.2.251,1,507,0,26,251,277,250,1,277,441,0,51,619,3,5,72,47,133,247,24,1179,203
1512,24,0.1.301,0,507,0,53,301,354,301,0,354,441,-51,227,670,2,6,131,53,202,127,25,1179,177
1512,24,3.3.352,1,507,0,8,352,360,277,75,360,441,0,200,619,4,5,46,37,133,189,25,1179,177
1512,25,0.1.301,0,507,0,53,301,354,301,0,354,441,-51,227,670,2,6,131,53,202,127,26,1179,169
1512,25,3.4.441,1,507,0,38,441,479,360,81,479,479,0,192,619,5,5,38,66,133,315,26,1179,169
1512,26,0.1.301,1,507,0,53,301,354,301,0,354,479,-51,227,670,2,6,131,53,202,127,27,1179,131
1512,27,0.2.354,1,507,0,21,354,375,354,0,375,479,-77,128,747,3,6,78,21,202,247,28,1179,78
1512,28,0.3.375,1,507,0,29,375,404,375,0,404,479,-15,215,762,4,6,57,29,202,189,29,1179,57
1512,29,0.4.479,1,507,0,28,479,507,404,75,507,507,0,192,762,5,6,28,28,202,315,30,1179,28
1513,0,0.0.0,0,692,3,84,0,84,0,0,84,84,0,0,0,1,1,245,415,245,415,1,1840,1840
1513,0,1.0.0,0,660,0,36,0,36,0,0,36,36,0,0,0,1,1,342,415,342,415,1,1840,1840
1513,0,2.0.0,0,669,2,67,0,67,0,0,67,67,0,0,0,1,1,219,415,219,415,1,1840,1840
1513,0,3.0.0,0,696,4,94,0,94,0,0,94,94,0,0,0,1,1,389,415,389,415,1,1840,1840
1513,0,4.0.0,0,711,5,87,0,87,0,0,87,87,0,0,0,1,1,257,415,257,415,1,1840,1840
1513,0,5.0.0,1,664,1,47,0,47,0,0,47,47,0,0,0,1,1,388,415,388,415,1,1840,1840
1513,1,0.0.47,0,664,0,84,47,131,0,47,131,131,0,0,0,1,2,245,368,245,415,2,1840,1793
1513,1,1.0.47,0,664,0,36,47,83,0,47,83,83,0,0,0,1,2,342,368,342,415,2,1840,1793
1513,1,2.0.47,0,665,1,67,47,114,0,47,114,114,0,0,0,1,2,219,368,219,415,2,1840,1793
1513,1,3.0.47,0,664,0,94,47,141,0,47,141,141,0,0,0,1,2,389,368,389,415,2,1840,1793
1513,1,4.0.47,0,679,2,87,47,134,0,47,134,134,0,0,0,1,2,257,368,257,415,2,1840,1793
1513,1,5.1.47,1,664,0,86,47,133,47,0,133,133,-47,47,47,2,1,341,329,388,329,2,1840,1793
1513,2,0.0.47,0,664,0,84,47,131,0,47,131,133,0,0,47,1,2,245,368,245,415,3,1840,1707
1513,2,1.0.47,0,664,0,36,47,83,0,47,83,133,0,0,47,1,2,342,368,342,415,3,1840,1707
1513,2,2.0.47,0,665,1,67,47,114,0,47,114,133,0,0,47,1,2,219,368,219,415,3,1840,1707
1513,2,3.0.47,0,664,0,94,47,141,0,47,141,141,0,0,47,1,2,389,368,389,415,3,1840,1707
1513,2,4.0.47,0,679,2,87,47,134,0,47,134,134,0,0,47,1,2,257,368,257,415,3,1840,1707
1513,2,5.2.133,1,664,0,72,133,205,133,0,205,205,-133,133,180,3,1,255,312,388,312,3,1840,1707
1513,3,0.0.47,0,664,0,84,47,131,0,47,131,205,0,0,180,1,2,245,368,245,415,4,1840,1635
1513,3,1.0.47,1,664,0,36,47,83,0,47,83,205,0,0,180,1,2,342,368,342,415,4,1840,1635
1513,3,2.0.47,0,665,1,67,47,114,0,47,114,205,0,0,180,1,2,219,368,219,415,4,1840,1635
1513,3,3.0.47,0,664,0,94,47,141,0,47,141,205,0,0,180,1,2,389,368,389,415,4,1840,1635
1513,3,4.0.47,0,679,2,87,47,134,0,47,134,205,0,0,180,1,2,257,368,257,415,4,1840,1635
1513,3,5.3.205,0,664,0,96,205,301,205,0,301,301,-205,205,385,4,1,183,439,388,439,4,1840,1635
1513,4,0.0.83,0,664,0,84,83,167,0,83,167,205,0,0,180,1,3,245,332,245,415,5,1840,1599
1513,4,1.1.133,1,664,0,81,133,214,83,50,214,214,0,47,180,2,2,306,243,342,329,5,1840,1599
1513,4,2.0.83,0,665,1,67,83,150,0,83,150,205,0,0,180,1,3,219,332,219,415,5,1840,1599
1513,4,3.0.83,0,664,0,94,83,177,0,83,177,205,0,0,180,1,3,389,332,389,415,5,1840,1599
1513,4,4.0.83,0,679,2,87,83,170,0,83,170,205,0,0,180,1,3,257,332,257,415,5,1840,1599
1513,4,5.3.205,0,664,0,96,205,301,205,0,301,301,-205,205,385,4,1,183,439,388,439,5,1840,1599
1513,5,0.0.83,0,664,0,84,83,167,0,83,167,214,0,0,180,1,3,245,332,245,415,6,1840,1518
1513,5,1.2.214,1,664,0,85,214,299,214,0,299,299,-9,142,189,3,2,225,240,342,312,6,1840,1518
1513,5,2.0.83,0,665,1,67,83,150,0,83,150,214,0,0,180,1,3,219,332,219,415,6,1840,1518
1513,5,3.0.83,0,664,0,94,83,177,0,83,177,214,0,0,180,1,3,389,332,389,415,6,1840,1518
1513,5,4.0.83,0,679,2,87,83,170,0,83,170,214,0,0,180,1,3,257,332,257,415,6,1840,1518
1513,5,5.3.205,0,664,0,96,205,301,205,0,301,301,-205,205,385,4,1,183,439,388,439,6,1840,1518
1513,6,0.0.83,0,664,0,84,83,167,0,83,167,299,0,0,189,1,3,245,332,245,415,7,1840,1433
1513,6,1.3.299,0,758,3,91,299,390,299,0,390,390,-299,299,488,4,1,140,439,342,439,7,1840,1433
1513,6,2.0.83,0,665,1,67,83,150,0,83,150,299,0,0,189,1,3,219,332,219,415,7,1840,1433
1513,6,3.0.83,1,664,0,94,83,177,0,83,177,299,0,0,189,1,3,389,332,389,415,7,1840,1433
1513,6,4.0.83,0,679,2,87,83,170,0,83,170,299,0,0,189,1,3,257,332,257,415,7,1840,1433
1513,6,5.3.205,0,664,0,96,205,301,205,0,301,301,-205,205,394,4,1,183,439,388,439,7,1840,1433
1513,7,0.0.177,0,664,0,84,177,261,0,177,261,299,0,0,189,1,4,245,238,245,415,8,1840,1339
1513,7,1.3.299,0,758,3,91,299,390,299,0,390,390,-299,299,488,4,1,140,439,342,439,8,1840,1339
1513,7,2.0.177,0,665,1,67,177,244,0,177,244,299,0,0,189,1,4,219,238,219,415,8,1840,1339
1513,7,3.1.214,1,664,0,58,214,272,177,37,272,299,0,47,189,2,3,295,162,389,329,8,1840,1339
1513,7,4.0.177,0,667,2,87,177,264,0,177,264,299,0,0,189,1,4,257,238,257,415,8,1840,1339
1513,7,5.3.205,0,664,0,96,205,301,205,0,301,301,-205,205,394,4,1,183,439,388,439,8,1840,1339
1513,8,0.0.177,0,664,0,84,177,261,0,177,261,299,0,0,189,1,4,245,238,245,415,9,1840,1281
1513,8,1.3.299,0,758,3,91,299,390,299,0,390,390,-299,299,488,4,1,140,439,342,439,9,1840,1281
1513,8,2.0.177,0,665,1,67,177,244,0,177,244,299,0,0,189,1,4,219,238,219,415,9,1840,1281
1513,8,3.2.299,1,667,2,92,299,391,272,27,391,391,0,142,189,3,3,237,155,389,312,9,1840,1281
1513,8,4.0.177,0,667,2,87,177,264,0,177,264,299,0,0,189,1,4,257,238,257,415,9,1840,1281
1513,8,5.3.205,0,664,0,96,205,301,205,0,301,301,-205,205,394,4,1,183,439,388,439,9,1840,1281
1513,9,0.0.177,0,667,0,84,177,261,0,177,261,391,0,0,189,1,4,245,238,245,415,10,1840,1189
1513,9,1.3.299,0,759,2,91,299,390,299,0,390,391,-299,299,488,4,1,140,439,342,439,10,1840,1189
1513,9,2.0.177,1,667,0,67,177,244,0,177,244,391,0,0,189,1,4,219,238,219,415,10,1840,1189
1513,9,3.3.391,0,754,1,66,391,457,391,0,457,457,-391,391,580,4,1,145,439,389,439,10,1840,1189
1513,9,4.0.177,0,667,0,87,177,264,0,177,264,391,0,0,189,1,4,257,238,257,415,10,1840,1189
1513,9,5.3.205,0,667,0,96,205,301,205,0,301,391,-205,205,394,4,1,183,439,388,439,10,1840,1189
1513,10,0.0.244,0,667,0,84,244,328,0,244,328,391,0,0,189,1,5,245,171,245,415,11,1840,1122
1513,10,1.3.299,0,759,2,91,299,390,299,0,390,391,-299,299,488,4,1,140,439,342,439,11,1840,1122
1513,10,2.1.272,1,667,0,23,272,295,244,28,295,391,0,47,189,2,4,152,104,219,329,11,1840,1122
1513,10,3.3.391,0,754,1,66,391,457,391,0,457,457,-391,391,580,4,1,145,439,389,439,11,1840,1122
1513,10,4.0.244,0,667,0,87,244,331,0,244,331,391,0,0,189,1,5,257,171,257,415,11,1840,1122
1513,10,5.3.205,0,667,0,96,205,301,205,0,301,391,-205,205,394,4,1,183,439,388,439,11,1840,1122
1513,11,0.0.244,0,667,0,84,244,328,0,244,328,391,0,0,189,1,5,245,171,245,415,12,1840,1099
1513,11,1.3.299,0,759,2,91,299,390,299,0,390,391,-299,299,488,4,1,140,439,342,439,12,1840,1099
1513,11,2.2.391,1,667,0,27,391,418,295,96,418,418,0,142,189,3,4,129,63,219,312,12,1840,1099
1513,11,3.3.391,0,754,1,66,391,457,391,0,457,457,-391,391,580,4,1,145,439,389,439,12,1840,1099
1513,11,4.0.244,0,667,0,87,244,331,0,244,331,391,0,0,189,1,5,257,171,257,415,12,1840,1099
1513,11,5.3.205,0,667,0,96,205,301,205,0,301,391,-205,205,394,4,1,183,439,388,439,12,1840,1099
1513,12,0.0.244,0,667,0,84,244,328,0,244,328,418,0,0,189,1,5,245,171,245,415,13,1840,1072
1513,12,1.3.299,0,759,3,91,299,390,299,0,390,418,-299,299,488,4,1,140,439,342,439,13,1840,1072
1513,12,2.3.418,0,706,1,73,418,491,418,0,491,491,-418,418,607,4,1,102,439,219,439,13,1840,1072
1513,12,3.3.391,0,754,2,66,391,457,391,0,457,457,-391,391,580,4,1,145,439,389,439,13,1840,1072
1513,12,4.0.244,1,667,0,87,244,331,0,244,331,418,0,0,189,1,5,257,171,257,415,13,1840,1072
1513,12,5.3.205,0,667,0,96,205,301,205,0,301,418,-205,205,394,4,1,183,439,388,439,13,1840,1072
1513,13,0.0.331,1,667,0,84,331,415,0,331,415,418,0,0,189,1,6,245,84,245,415,14,1840,985
1513,13,1.3.299,0,762,3,91,299,390,299,0,390,418,-299,299,488,4,1,140,439,342,439,14,1840,985
1513,13,2.3.418,0,706,1,73,418,491,418,0,491,491,-418,418,607,4,1,102,439,219,439,14,1840,985
1513,13,3.3.391,0,754,2,66,391,457,391,0,457,457,-391,391,580,4,1,145,439,389,439,14,1840,985
1513,13,4.1.331,0,667,0,60,331,391,331,0,391,418,-36,83,225,2,5,170,81,257,329,14,1840,985
1513,13,5.3.205,0,667,0,96,205,301,205,0,301,418,-205,205,394,4,1,183,439,388,439,14,1840,985
1513,14,0.1.415,0,667,0,21,415,436,415,0,436,436,-120,167,309,2,5,161,81,245,329,15,1840,901
1513,14,1.3.299,0,762,3,91,299,390,299,0,390,418,-299,299,488,4,1,140,439,342,439,15,1840,901
1513,14,2.3.418,0,706,1,73,418,491,418,0,491,491,-418,418,607,4,1,102,439,219,439,15,1840,901
1513,14,3.3.391,0,754,2,66,391,457,391,0,457,457,-391,391,580,4,1,145,439,389,439,15,1840,901
1513,14,4.1.331,1,667,0,60,331,391,331,0,391,418,-36,83,225,2,5,170,81,257,329,15,1840,901
1513,14,5.3.205,0,667,0,96,205,301,205,0,301,418,-205,205,394,4,1,183,439,388,439,15,1840,901
1513,15,0.1.415,0,667,0,21,415,436,415,0,436,436,-24,107,249,2,6,161,21,245,329,16,1840,841
1513,15,1.3.299,0,762,3,91,299,390,299,0,390,418,-299,299,524,4,1,140,439,342,439,16,1840,841
1513,15,2.3.418,0,706,1,73,418,491,418,0,491,491,-418,418,643,4,1,102,439,219,439,16,1840,841
1513,15,3.3.391,0,754,2,66,391,457,391,0,457,457,-391,391,616,4,1,145,439,389,439,16,1840,841
1513,15,4.2.418,1,667,0,12,418,430,391,27,430,430,0,142,225,3,5,110,36,257,312,16,1840,841
1513,15,5.3.205,0,667,0,96,205,301,205,0,301,418,-205,205,430,4,1,183,439,388,439,16,1840,841
1513,16,0.1.415,1,667,0,21,415,436,415,0,436,436,-24,107,249,2,6,161,21,245,329,17,1840,829
1513,16,1.3.299,0,762,4,91,299,390,299,0,390,430,-299,299,524,4,1,140,439,342,439,17,1840,829
1513,16,2.3.418,0,706,1,73,418,491,418,0,491,491,-418,418,643,4,1,102,439,219,439,17,1840,829
1513,16,3.3.391,0,754,3,66,391,457,391,0,457,457,-391,391,616,4,1,145,439,389,439,17,1840,829
1513,16,4.3.430,0,732,2,78,430,508,430,0,508,508,-430,430,655,4,1,98,439,257,439,17,1840,829
1513,16,5.3.205,0,667,0,96,205,301,205,0,301,430,-205,205,430,4,1,183,439,388,439,17,1840,829
1513,17,0.2.436,1,667,0,24,436,460,436,0,460,460,-6,148,255,3,6,140,24,245,312,18,1840,808
1513,17,1.3.299,0,762,4,91,299,390,299,0,390,436,-299,299,548,4,1,140,439,342,439,18,1840,808
1513,17,2.3.418,0,706,1,73,418,491,418,0,491,491,-418,418,667,4,1,102,439,219,439,18,1840,808
1513,17,3.3.391,0,754,3,66,391,457,391,0,457,457,-391,391,640,4,1,145,439,389,439,18,1840,808
1513,17,4.3.430,0,732,2,78,430,508,430,0,508,508,-430,430,679,4,1,98,439,257,439,18,1840,808
1513,17,5.3.205,0,667,0,96,205,301,205,0,301,436,-205,205,454,4,1,183,439,388,439,18,1840,808
1513,18,0.3.460,0,667,0,35,460,495,460,0,495,495,-460,460,715,4,1,116,439,245,439,19,1840,784
1513,18,1.3.299,0,762,4,91,299,390,299,0,390,460,-299,299,554,4,1,140,439,342,439,19,1840,784
1513,18,2.3.418,0,706,1,73,418,491,418,0,491,491,-418,418,673,4,1,102,439,219,439,19,1840,784
1513,18,3.3.391,0,754,3,66,391,457,391,0,457,460,-391,391,646,4,1,145,439,389,439,19,1840,784
1513,18,4.3.430,0,732,2,78,430,508,430,0,508,508,-430,430,685,4,1,98,439,257,439,19,1840,784
1513,18,5.3.205,1,667,0,96,205,301,205,0,301,460,-205,205,460,4,1,183,439,388,439,19,1840,784
1513,19,0.3.460,0,667,0,35,460,495,460,0,495,495,-159,364,619,4,2,116,343,245,439,20,1840,688
1513,19,1.3.301,0,667,0,91,301,392,299,2,392,460,0,205,460,4,2,140,343,342,439,20,1840,688
1513,19,2.3.418,0,706,1,73,418,491,418,0,491,491,-117,322,577,4,2,102,343,219,439,20,1840,688
1513,19,3.3.391,0,754,3,66,391,457,391,0,457,460,-90,295,550,4,2,145,343,389,439,20,1840,688
1513,19,4.3.430,0,732,2,78,430,508,430,0,508,508,-129,334,589,4,2,98,343,257,439,20,1840,688
1513,19,5.4.301,1,667,0,87,301,388,301,0,388,460,-301,301,761,5,1,87,345,388,345,20,1840,688
1513,20,0.3.460,0,667,0,35,460,495,460,0,495,495,-159,364,920,4,2,116,343,245,439,21,1840,601
1513,20,1.3.301,1,667,0,91,301,392,299,2,392,460,0,205,761,4,2,140,343,342,439,21,1840,601
1513,20,2.3.418,0,706,1,73,418,491,418,0,491,491,-117,322,878,4,2,102,343,219,439,21,1840,601
1513,20,3.3.391,0,754,3,66,391,457,391,0,457,460,-90,295,851,4,2,145,343,389,439,21,1840,601
1513,20,4.3.430,0,732,2,78,430,508,430,0,508,508,-129,334,890,4,2,98,343,257,439,21,1840,601
1513,21,0.3.460,0,667,0,35,460,495,460,0,495,495,-68,273,829,4,3,116,252,245,439,22,1840,510
1513,21,1.4.392,1,667,0,49,392,441,392,0,441,460,-4,305,765,5,2,49,258,342,345,22,1840,510
1513,21,2.3.418,0,706,1,73,418,491,418,0,491,491,-26,231,787,4,3,102,252,219,439,22,1840,510
1513,21,3.3.392,0,667,0,66,392,458,391,1,458,460,0,205,761,4,3,145,252,389,439,22,1840,510
1513,21,4.3.430,0,732,2,78,430,508,430,0,508,508,-38,243,799,4,3,98,252,257,439,22,1840,510
1513,22,0.3.460,0,667,0,35,460,495,460,0,495,495,-68,273,833,4,3,116,252,245,439,23,1840,461
1513,22,2.3.418,0,706,1,73,418,491,418,0,491,491,-26,231,791,4,3,102,252,219,439,23,1840,461
1513,22,3.3.392,1,667,0,66,392,458,391,1,458,460,0,205,765,4,3,145,252,389,439,23,1840,461
1513,22,4.3.430,0,732,2,78,430,508,430,0,508,508,-38,243,803,4,3,98,252,257,439,23,1840,461
1513,23,0.3.460,0,667,0,35,460,495,460,0,495,495,-2,207,767,4,4,116,186,245,439,24,1840,395
1513,23,2.3.458,0,667,0,73,458,531,418,40,531,531,0,205,765,4,4,102,186,219,439,24,1840,395
1513,23,3.4.458,1,667,0,79,458,537,458,0,537,537,-17,322,782,5,3,79,209,389,345,24,1840,395
1513,23,4.3.458,0,681,1,78,458,536,430,28,536,536,0,205,765,4,4,98,186,257,439,24,1840,395
1513,24,0.3.460,1,667,0,35,460,495,460,0,495,537,-2,207,784,4,4,116,186,245,439,25,1840,316
1513,24,2.3.458,0,667,0,73,458,531,418,40,531,537,0,205,782,4,4,102,186,219,439,25,1840,316
1513,24,4.3.458,0,681,1,78,458,536,430,28,536,537,0,205,782,4,4,98,186,257,439,25,1840,316
1513,25,0.4.537,1,667,0,81,537,618,495,42,618,618,0,322,784,5,4,81,130,245,345,26,1840,281
1513,25,2.3.495,0,667,0,73,495,568,418,77,568,568,0,207,784,4,5,102,151,219,439,26,1840,281
1513,25,4.3.495,0,675,1,78,495,573,430,65,573,573,0,207,784,4,5,98,151,257,439,26,1840,281
1513,26,2.3.495,1,667,0,73,495,568,418,77,568,618,0,207,784,4,5,102,151,219,439,27,1840,200
1513,26,4.3.495,0,675,1,78,495,573,430,65,573,618,0,207,784,4,5,98,151,257,439,27,1840,200
1513,27,2.4.618,1,667,0,29,618,647,568,50,647,647,0,322,784,5,5,29,49,219,345,28,1840,127
1513,27,4.3.568,0,667,0,78,568,646,430,138,646,646,0,207,784,4,6,98,78,257,439,28,1840,127
1513,28,4.3.568,1,667,0,78,568,646,430,138,646,647,0,207,784,4,6,98,78,257,439,29,1840,98
1513,29,4.4.647,1,667,0,20,647,667,646,1,667,667,0,322,784,5,6,20,20,257,345,30,1840,20
1514,0,0.0.0,0,579,5,97,0,97,0,0,97,97,0,0,0,1,1,289,232,289,232,1,1515,1515
1514,0,1.0.0,1,494,1,12,0,12,0,0,12,12,0,0,0,1,1,244,232,244,232,1,1515,1515
1514,0,2.0.0,0,496,2,14,0,14,0,0,14,14,0,0,0,1,1,246,232,246,232,1,1515,1515
1514,0,3.0.0,0,529,3,47,0,47,0,0,47,47,0,0,0,1,1,250,232,250,232,1,1515,1515
1514,0,4.0.0,0,482,0,10,0,10,0,0,10,10,0,0,0,1,1,195,232,195,232,1,1515,1515
1514,0,5.0.0,0,534,4,52,0,52,0,0,52,52,0,0,0,1,1,291,232,291,232,1,1515,1515
1514,1,0.0.12,0,575,5,97,12,109,0,12,109,109,0,0,0,1,2,289,220,289,232,2,1515,1503
1514,1,1.1.12,0,533,2,49,12,61,12,0,61,61,-12,12,12,2,1,232,330,244,330,2,1515,1503
1514,1,2.0.12,1,508,1,14,12,26,0,12,26,26,0,0,0,1,2,246,220,246,232,2,1515,1503
1514,1,3.0.12,0,541,3,47,12,59,0,12,59,59,0,0,0,1,2,250,220,250,232,2,1515,1503
1514,1,4.0.12,0,494,0,10,12,22,0,12,22,22,0,0,0,1,2,195,220,195,232,2,1515,1503
1514,1,5.0.12,0,546,4,52,12,64,0,12,64,64,0,0,0,1,2,291,220,291,232,2,1515,1503
1514,2,0.0.26,0,540,3,97,26,123,0,26,123,123,0,0,0,1,3,289,206,289,232,3,1515,1489
1514,2,1.1.12,0,533,2,49,12,61,12,0,61,61,-12,12,12,2,1,232,330,244,330,3,1515,1489
1514,2,2.1.26,0,514,1,16,26,42,26,0,42,42,-26,26,26,2,1,232,330,246,330,3,1515,1489
1514,2,3.0.26,0,540,3,47,26,73,0,26,73,73,0,0,0,1,3,250,206,250,232,3,1515,1489
1514,2,4.0.26,1,508,0,10,26,36,0,26,36,36,0,0,0,1,3,195,206,195,232,3,1515,1489
1514,2,5.0.26,0,540,3,52,26,78,0,26,78,78,0,0,0,1,3,291,206,291,232,3,1515,1489
1514,3,0.0.36,0,508,0,97,36,133,0,36,133,133,0,0,0,1,4,289,196,289,232,4,1515,1479
1514,3,1.1.12,0,533,2,49,12,61,12,0,61,61,-12,12,12,2,1,232,330,244,330,4,1515,1479
1514,3,2.1.26,0,514,1,16,26,42,26,0,42,42,-26,26,26,2,1,232,330,246,330,4,1515,1479
1514,3,3.0.36,0,508,0,47,36,83,0,36,83,83,0,0,0,1,4,250,196,250,232,4,1515,1479
1514,3,4.1.36,0,508,0,12,36,48,36,0,48,48,-36,36,36,2,1,185,330,195,330,4,1515,1479
1514,3,5.0.36,1,508,0,52,36,88,0,36,88,88,0,0,0,1,4,291,196,291,232,4,1515,1479
1514,4,0.0.88,0,508,0,97,88,185,0,88,185,185,0,0,0,1,5,289,144,289,232,5,1515,1427
1514,4,1.1.12,0,533,2,49,12,61,12,0,61,88,-12,12,12,2,1,232,330,244,330,5,1515,1427
1514,4,2.1.26,0,514,1,16,26,42,26,0,42,88,-26,26,26,2,1,232,330,246,330,5,1515,1427
1514,4,3.0.88,1,508,0,47,88,135,0,88,135,135,0,0,0,1,5,250,144,250,232,5,1515,1427
1514,4,4.1.36,0,508,0,12,36,48,36,0,48,88,-36,36,36,2,1,185,330,195,330,5,1515,1427
1514,4,5.1.88,0,508,0,69,88,157,88,0,157,157,-88,88,88,2,1,239,330,291,330,5,1515,1427
1514,5,0.0.135,1,508,0,97,135,232,0,135,232,232,0,0,0,1,6,289,97,289,232,6,1515,1380
1514,5,1.1.12,0,533,3,49,12,61,12,0,61,135,-12,12,12,2,1,232,330,244,330,6,1515,1380
1514,5,2.1.26,0,514,2,16,26,42,26,0,42,135,-26,26,26,2,1,232,330,246,330,6,1515,1380
1514,5,3.1.135,0,513,1,96,135,231,135,0,231,231,-135,135,135,2,1,203,330,250,330,6,1515,1380
1514,5,4.1.36,0,508,0,12,36,48,36,0,48,135,-36,36,36,2,1,185,330,195,330,6,1515,1380
1514,5,5.1.88,0,508,0,69,88,157,88,0,157,157,-88,88,88,2,1,239,330,291,330,6,1515,1380
1514,6,0.1.232,0,523,3,88,232,320,232,0,320,320,-232,232,232,2,1,192,330,289,330,7,1515,1283
1514,6,1.1.12,0,533,4,49,12,61,12,0,61,232,-12,12,12,2,1,232,330,244,330,7,1515,1283
1514,6,2.1.26,1,514,2,16,26,42,26,0,42,232,-26,26,26,2,1,232,330,246,330,7,1515,1283
1514,6,3.1.135,0,513,1,96,135,231,135,0,231,232,-135,135,135,2,1,203,330,250,330,7,1515,1283
1514,6,4.1.36,0,508,0,12,36,48,36,0,48,232,-36,36,36,2,1,185,330,195,330,7,1515,1283
1514,6,5.1.88,0,508,0,69,88,157,88,0,157,232,-88,88,88,2,1,239,330,291,330,7,1515,1283
1514,7,0.1.232,0,523,2,88,232,320,232,0,320,320,-190,216,216,2,2,192,314,289,330,8,1515,1267
1514,7,1.1.42,0,540,3,49,42,91,12,30,91,232,0,26,26,2,2,232,314,244,330,8,1515,1267
1514,7,2.2.42,1,540,3,80,42,122,42,0,122,232,-42,42,68,3,1,216,283,246,283,8,1515,1267
1514,7,3.1.135,0,516,1,96,135,231,135,0,231,232,-93,119,119,2,2,203,314,250,330,8,1515,1267
1514,7,4.1.42,0,514,0,12,42,54,36,6,54,232,0,26,26,2,2,185,314,195,330,8,1515,1267
1514,7,5.1.88,0,514,0,69,88,157,88,0,157,232,-46,72,72,2,2,239,314,291,330,8,1515,1267
1514,8,0.1.232,0,540,0,88,232,320,232,0,320,320,-190,216,258,2,2,192,314,289,330,9,1515,1187
1514,8,1.1.42,0,540,0,49,42,91,12,30,91,232,0,26,68,2,2,232,314,244,330,9,1515,1187
1514,8,2.3.122,1,540,0,42,122,164,122,0,164,232,-122,122,190,4,1,136,294,246,294,9,1515,1187
1514,8,3.1.135,0,540,0,96,135,231,135,0,231,232,-93,119,161,2,2,203,314,250,330,9,1515,1187
1514,8,4.1.42,0,540,0,12,42,54,36,6,54,232,0,26,68,2,2,185,314,195,330,9,1515,1187
1514,8,5.1.88,0,540,0,69,88,157,88,0,157,232,-46,72,114,2,2,239,314,291,330,9,1515,1187
1514,9,0.1.232,0,540,0,88,232,320,232,0,320,320,-190,216,380,2,2,192,314,289,330,10,1515,1145
1514,9,1.1.42,0,540,0,49,42,91,12,30,91,232,0,26,190,2,2,232,314,244,330,10,1515,1145
1514,9,2.4.164,1,540,0,94,164,258,164,0,258,258,-164,164,354,5,1,94,376,246,376,10,1515,1145
1514,9,3.1.135,0,540,0,96,135,231,135,0,231,232,-93,119,283,2,2,203,314,250,330,10,1515,1145
1514,9,4.1.42,0,540,0,12,42,54,36,6,54,232,0,26,190,2,2,185,314,195,330,10,1515,1145
1514,9,5.1.88,0,540,0,69,88,157,88,0,157,232,-46,72,236,2,2,239,314,291,330,10,1515,1145
1514,10,0.1.232,0,540,0,88,232,320,232,0,320,320,-190,216,544,2,2,192,314,289,330,11,1515,1051
1514,10,1.1.42,0,540,0,49,42,91,12,30,91,258,0,26,354,2,2,232,314,244,330,11,1515,1051
1514,10,3.1.135,0,540,0,96,135,231,135,0,231,258,-93,119,447,2,2,203,314,250,330,11,1515,1051
1514,10,4.1.42,1,540,0,12,42,54,36,6,54,258,0,26,354,2,2,185,314,195,330,11,1515,1051
1514,10,5.1.88,0,540,0,69,88,157,88,0,157,258,-46,72,400,2,2,239,314,291,330,11,1515,1051
1514,11,0.1.232,0,540,0,88,232,320,232,0,320,320,-178,204,532,2,3,192,302,289,330,12,1515,1039
1514,11,1.1.54,0,540,0,49,54,103,12,42,103,258,0,26,354,2,3,232,302,244,330,12,1515,1039
1514,11,3.1.135,0,540,0,96,135,231,135,0,231,258,-81,107,435,2,3,203,302,250,330,12,1515,1039
1514,11,4.2.122,1,540,0,13,122,135,54,68,135,258,0,42,354,3,2,173,203,195,283,12,1515,1039
1514,11,5.1.88,0,540,0,69,88,157,88,0,157,258,-34,60,388,2,3,239,302,291,330,12,1515,1039
1514,12,0.1.232,0,540,0,88,232,320,232,0,320,320,-178,204,532,2,3,192,302,289,330,13,1515,1026
1514,12,1.1.54,0,540,0,49,54,103,12,42,103,258,0,26,354,2,3,232,302,244,330,13,1515,1026
1514,12,3.1.135,0,540,0,96,135,231,135,0,231,258,-81,107,435,2,3,203,302,250,330,13,1515,1026
1514,12,4.3.164,1,540,0,71,164,235,135,29,235,258,0,122,354,4,2,160,252,195,294,13,1515,1026
1514,12,5.1.88,0,540,0,69,88,157,88,0,157,258,-34,60,388,2,3,239,302,291,330,13,1515,1026
1514,13,0.1.232,0,540,0,88,232,320,232,0,320,320,-178,204,532,2,3,192,302,289,330,14,1515,955
1514,13,1.1.54,1,540,0,49,54,103,12,42,103,258,0,26,354,2,3,232,302,244,330,14,1515,955
1514,13,3.1.135,0,540,0,96,135,231,135,0,231,258,-81,107,435,2,3,203,302,250,330,14,1515,955
1514,13,4.4.258,0,540,0,89,258,347,235,23,347,347,0,164,354,5,2,89,282,195,376,14,1515,955
1514,13,5.1.88,0,540,0,69,88,157,88,0,157,258,-34,60,388,2,3,239,302,291,330,14,1515,955
1514,14,0.1.232,0,540,0,88,232,320,232,0,320,320,-129,155,483,2,4,192,253,289,330,15,1515,906
1514,14,1.2.135,1,540,0,91,135,226,103,32,226,258,0,42,354,3,3,183,190,244,283,15,1515,906
1514,14,3.1.135,0,540,0,96,135,231,135,0,231,258,-32,58,386,2,4,203,253,250,330,15,1515,906
1514,14,4.4.258,0,540,0,89,258,347,235,23,347,347,0,164,354,5,2,89,282,195,376,15,1515,906
1514,14,5.1.103,0,540,0,69,103,172,88,15,172,258,0,26,354,2,4,239,253,291,330,15,1515,906
1514,15,0.1.232,0,540,0,88,232,320,232,0,320,320,-129,155,483,2,4,192,253,289,330,16,1515,815
1514,15,1.3.235,1,540,0,34,235,269,226,9,269,269,0,122,354,4,3,92,181,244,294,16,1515,815
1514,15,3.1.135,0,540,0,96,135,231,135,0,231,258,-32,58,386,2,4,203,253,250,330,16,1515,815
1514,15,4.4.258,0,540,0,89,258,347,235,23,347,347,0,164,354,5,2,89,282,195,376,16,1515,815
1514,15,5.1.103,0,540,0,69,103,172,88,15,172,258,0,26,354,2,4,239,253,291,330,16,1515,815
1514,16,0.1.232,0,540,0,88,232,320,232,0,320,320,-129,155,483,2,4,192,253,289,330,17,1515,781
1514,16,1.4.269,1,551,1,58,269,327,269,0,327,327,-11,175,365,5,2,58,282,244,376,17,1515,781
1514,16,3.1.135,0,540,0,96,135,231,135,0,231,269,-32,58,386,2,4,203,253,250,330,17,1515,781
1514,16,4.4.258,0,540,0,89,258,347,235,23,347,347,0,164,354,5,2,89,282,195,376,17,1515,781
1514,16,5.1.103,0,540,0,69,103,172,88,15,172,269,0,26,354,2,4,239,253,291,330,17,1515,781
1514,17,0.1.232,0,551,0,88,232,320,232,0,320,327,-129,155,494,2,4,192,253,289,330,18,1515,723
1514,17,3.1.135,0,551,0,96,135,231,135,0,231,327,-32,58,397,2,4,203,253,250,330,18,1515,723
1514,17,4.4.327,1,551,0,89,327,416,235,92,416,416,0,175,365,5,3,89,224,195,376,18,1515,723
1514,17,5.1.103,0,551,0,69,103,172,88,15,172,327,0,26,365,2,4,239,253,291,330,18,1515,723
1514,18,0.1.232,0,551,0,88,232,320,232,0,320,416,-129,155,494,2,4,192,253,289,330,19,1515,634
1514,18,3.1.135,0,551,0,96,135,231,135,0,231,416,-32,58,397,2,4,203,253,250,330,19,1515,634
1514,18,5.1.103,1,551,0,69,103,172,88,15,172,416,0,26,365,2,4,239,253,291,330,19,1515,634
1514,19,0.1.232,0,551,0,88,232,320,232,0,320,416,-60,86,425,2,5,192,184,289,330,20,1515,565
1514,19,3.1.172,0,551,0,96,172,268,135,37,268,416,0,26,365,2,5,203,184,250,330,20,1515,565
1514,19,5.2.226,1,551,0,11,226,237,172,54,237,416,0,42,365,3,4,170,99,291,283,20,1515,565
1514,20,0.1.232,0,551,0,88,232,320,232,0,320,416,-60,86,425,2,5,192,184,289,330,21,1515,554
1514,20,3.1.172,0,551,0,96,172,268,135,37,268,416,0,26,365,2,5,203,184,250,330,21,1515,554
1514,20,5.3.269,1,551,0,80,269,349,237,32,349,416,0,122,365,4,4,159,147,291,294,21,1515,554
1514,21,0.1.232,0,551,0,88,232,320,232,0,320,416,-60,86,425,2,5,192,184,289,330,22,1515,474
1514,21,3.1.172,0,551,0,96,172,268,135,37,268,416,0,26,365,2,5,203,184,250,330,22,1515,474
1514,21,5.4.416,1,551,0,79,416,495,349,67,495,495,0,175,365,5,4,79,135,291,376,22,1515,474
1514,22,0.1.232,0,551,0,88,232,320,232,0,320,495,-60,86,425,2,5,192,184,289,330,23,1515,395
1514,22,3.1.172,1,551,0,96,172,268,135,37,268,495,0,26,365,2,5,203,184,250,330,23,1515,395
1514,23,0.1.268,0,551,0,88,268,356,232,36,356,495,0,26,365,2,6,192,88,289,330,24,1515,299
1514,23,3.2.268,1,551,0,60,268,328,268,0,328,495,-31,73,396,3,5,107,88,250,283,24,1515,299
1514,24,0.1.268,0,551,0,88,268,356,232,36,356,495,0,26,396,2,6,192,88,289,330,25,1515,239
1514,24,3.3.349,1,551,0,25,349,374,328,21,374,495,0,122,396,4,5,47,67,250,294,25,1515,239
1514,25,0.1.268,0,551,0,88,268,356,232,36,356,495,0,26,396,2,6,192,88,289,330,26,1515,214
1514,25,3.4.495,1,551,0,22,495,517,374,121,517,517,0,175,396,5,5,22,56,250,376,26,1515,214
1514,26,0.1.268,1,551,0,88,268,356,232,36,356,517,0,26,396,2,6,192,88,289,330,27,1515,192
1514,27,0.2.356,1,551,0,28,356,384,356,0,384,517,-28,101,424,3,6,104,28,289,283,28,1515,104
1514,28,0.3.384,1,551,0,42,384,426,384,0,426,517,-10,132,434,4,6,76,42,289,294,29,1515,76
1514,29,0.4.517,1,551,0,34,517,551,426,91,551,551,0,175,434,5,6,34,34,289,376,30,1515,34
1515,0,0.0.0,0,544,0,11,0,11,0,0,11,11,0,0,0,1,1,233,245,233,245,1,1482,1482
1515,0,1.0.0,0,631,4,87,0,87,0,0,87,87,0,0,0,1,1,342,245,342,245,1,1482,1482
1515,0,2.0.0,0,560,1,59,0,59,0,0,59,59,0,0,0,1,1,172,245,172,245,1,1482,1482
1515,0,3.0.0,1,544,0,1,0,1,0,0,1,1,0,0,0,1,1,210,245,210,245,1,1482,1482
1515,0,4.0.0,0,562,2,31,0,31,0,0,31,31,0,0,0,1,1,233,245,233,245,1,1482,1482
1515,0,5.0.0,0,600,3,56,0,56,0,0,56,56,0,0,0,1,1,292,245,292,245,1,1482,1482
1515,1,0.0.1,0,545,1,11,1,12,0,1,12,12,0,0,0,1,2,233,244,233,245,2,1482,1481
1515,1,1.0.1,0,575,3,87,1,88,0,1,88,88,0,0,0,1,2,342,244,342,245,2,1482,1481
1515,1,2.0.1,0,544,0,59,1,60,0,1,60,60,0,0,0,1,2,172,244,172,245,2,1482,1481
1515,1,3.1.1,1,544,0,35,1,36,1,0,36,36,-1,1,1,2,1,209,234,210,234,2,1482,1481
1515,1,4.0.1,0,552,2,31,1,32,0,1,32,32,0,0,0,1,2,233,244,233,245,2,1482,1481
1515,1,5.0.1,0,552,2,56,1,57,0,1,57,57,0,0,0,1,2,292,244,292,245,2,1482,1481
1515,2,0.0.1,0,552,1,11,1,12,0,1,12,36,0,0,1,1,2,233,244,233,245,3,1482,1446
1515,2,1.0.1,0,575,2,87,1,88,0,1,88,88,0,0,1,1,2,342,244,342,245,3,1482,1446
1515,2,2.0.1,0,544,0,59,1,60,0,1,60,60,0,0,1,1,2,172,244,172,245,3,1482,1446
1515,2,3.2.36,1,544,0,27,36,63,36,0,63,63,-36,36,37,3,1,174,250,210,250,3,1482,1446
1515,2,4.0.1,0,552,1,31,1,32,0,1,32,36,0,0,1,1,2,233,244,233,245,3,1482,1446
1515,2,5.0.1,0,552,1,56,1,57,0,1,57,57,0,0,1,1,2,292,244,292,245,3,1482,1446
1515,3,0.0.1,0,552,1,11,1,12,0,1,12,63,0,0,37,1,2,233,244,233,245,4,1482,1419
1515,3,1.0.1,0,575,2,87,1,88,0,1,88,88,0,0,37,1,2,342,244,342,245,4,1482,1419
1515,3,2.0.1,0,544,0,59,1,60,0,1,60,63,0,0,37,1,2,172,244,172,245,4,1482,1419
1515,3,3.3.63,1,552,1,84,63,147,63,0,147,147,-63,63,100,4,1,147,348,210,348,4,1482,1419
1515,3,4.0.1,0,552,1,31,1,32,0,1,32,63,0,0,37,1,2,233,244,233,245,4,1482,1419
1515,3,5.0.1,0,552,1,56,1,57,0,1,57,63,0,0,37,1,2,292,244,292,245,4,1482,1419
1515,4,0.0.1,1,552,0,11,1,12,0,1,12,147,0,0,100,1,2,233,244,233,245,5,1482,1335
1515,4,1.0.1,0,575,1,87,1,88,0,1,88,147,0,0,100,1,2,342,244,342,245,5,1482,1335
1515,4,2.0.1,0,552,0,59,1,60,0,1,60,147,0,0,100,1,2,172,244,172,245,5,1482,1335
1515,4,3.4.147,0,552,0,63,147,210,147,0,210,210,-147,147,247,5,1,63,405,210,405,5,1482,1335
1515,4,4.0.1,0,552,0,31,1,32,0,1,32,147,0,0,100,1,2,233,244,233,245,5,1482,1335
1515,4,5.0.1,0,552,0,56,1,57,0,1,57,147,0,0,100,1,2,292,244,292,245,5,1482,1335
1515,5,0.1.36,1,552,0,56,36,92,12,24,92,147,0,1,100,2,2,222,199,233,234,6,1482,1324
1515,5,1.0.12,0,552,0,87,12,99,0,12,99,147,0,0,100,1,3,342,233,342,245,6,1482,1324
1515,5,2.0.12,0,552,0,59,12,71,0,12,71,147,0,0,100,1,3,172,233,172,245,6,1482,1324
1515,5,3.4.147,0,552,0,63,147,210,147,0,210,210,-147,147,247,5,1,63,405,210,405,6,1482,1324
1515,5,4.0.12,0,552,0,31,12,43,0,12,43,147,0,0,100,1,3,233,233,233,245,6,1482,1324
1515,5,5.0.12,0,552,0,56,12,68,0,12,68,147,0,0,100,1,3,292,233,292,245,6,1482,1324
1515,6,0.2.92,1,552,0,31,92,123,92,0,123,147,-29,65,129,3,2,166,223,233,250,7,1482,1268
1515,6,1.0.12,0,552,0,87,12,99,0,12,99,147,0,0,100,1,3,342,233,342,245,7,1482,1268
1515,6,2.0.12,0,552,0,59,12,71,0,12,71,147,0,0,100,1,3,172,233,172,245,7,1482,1268
1515,6,3.4.147,0,552,0,63,147,210,147,0,210,210,-147,147,247,5,1,63,405,210,405,7,1482,1268
1515,6,4.0.12,0,552,0,31,12,43,0,12,43,147,0,0,100,1,3,233,233,233,245,7,1482,1268
1515,6,5.0.12,0,552,0,56,12,68,0,12,68,147,0,0,100,1,3,292,233,292,245,7,1482,1268
1515,7,0.3.147,1,552,0,49,147,196,123,24,196,196,0,63,129,4,2,135,264,233,348,8,1482,1237
1515,7,1.0.12,0,552,0,87,12,99,0,12,99,147,0,0,129,1,3,342,233,342,245,8,1482,1237
1515,7,2.0.12,0,552,0,59,12,71,0,12,71,147,0,0,129,1,3,172,233,172,245,8,1482,1237
1515,7,3.4.147,0,552,0,63,147,210,147,0,210,210,-147,147,276,5,1,63,405,210,405,8,1482,1237
1515,7,4.0.12,0,552,0,31,12,43,0,12,43,147,0,0,129,1,3,233,233,233,245,8,1482,1237
1515,7,5.0.12,0,552,0,56,12,68,0,12,68,147,0,0,129,1,3,292,233,292,245,8,1482,1237
1515,8,0.4.196,0,601,1,86,196,282,196,0,282,282,-196,196,325,5,1,86,405,233,405,9,1482,1188
1515,8,1.0.12,0,552,0,87,12,99,0,12,99,196,0,0,129,1,3,342,233,342,245,9,1482,1188
1515,8,2.0.12,0,552,0,59,12,71,0,12,71,196,0,0,129,1,3,172,233,172,245,9,1482,1188
1515,8,3.4.147,0,552,0,63,147,210,147,0,210,210,-147,147,276,5,1,63,405,210,405,9,1482,1188
1515,8,4.0.12,1,552,0,31,12,43,0,12,43,196,0,0,129,1,3,233,233,233,245,9,1482,1188
1515,8,5.0.12,0,552,0,56,12,68,0,12,68,196,0,0,129,1,3,292,233,292,245,9,1482,1188
1515,9,0.4.196,0,601,1,86,196,282,196,0,282,282,-196,196,325,5,1,86,405,233,405,10,1482,1157
1515,9,1.0.43,0,552,0,87,43,130,0,43,130,196,0,0,129,1,4,342,202,342,245,10,1482,1157
1515,9,2.0.43,0,552,0,59,43,102,0,43,102,196,0,0,129,1,4,172,202,172,245,10,1482,1157
1515,9,3.4.147,0,552,0,63,147,210,147,0,210,210,-147,147,276,5,1,63,405,210,405,10,1482,1157
1515,9,4.1.92,1,552,0,64,92,156,43,49,156,196,0,1,129,2,3,202,143,233,234,10,1482,1157
1515,9,5.0.43,0,552,0,56,43,99,0,43,99,196,0,0,129,1,4,292,202,292,245,10,1482,1157
1515,10,0.4.196,0,601,1,86,196,282,196,0,282,282,-196,196,325,5,1,86,405,233,405,11,1482,1093
1515,10,1.0.43,0,552,0,87,43,130,0,43,130,196,0,0,129,1,4,342,202,342,245,11,1482,1093
1515,10,2.0.43,0,552,0,59,43,102,0,43,102,196,0,0,129,1,4,172,202,172,245,11,1482,1093
1515,10,3.4.147,0,552,0,63,147,210,147,0,210,210,-147,147,276,5,1,63,405,210,405,11,1482,1093
1515,10,4.2.156,1,552,0,14,156,170,156,0,170,196,-33,98,162,3,3,138,192,233,250,11,1482,1093
1515,10,5.0.43,0,552,0,56,43,99,0,43,99,196,0,0,129,1,4,292,202,292,245,11,1482,1093
1515,11,0.4.196,0,601,1,86,196,282,196,0,282,282,-196,196,358,5,1,86,405,233,405,12,1482,1079
1515,11,1.0.43,0,552,0,87,43,130,0,43,130,196,0,0,162,1,4,342,202,342,245,12,1482,1079
1515,11,2.0.43,0,552,0,59,43,102,0,43,102,196,0,0,162,1,4,172,202,172,245,12,1482,1079
1515,11,3.4.147,0,552,0,63,147,210,147,0,210,210,-147,147,309,5,1,63,405,210,405,12,1482,1079
1515,11,4.3.196,1,552,0,64,196,260,170,26,260,260,0,63,162,4,3,124,215,233,348,12,1482,1079
1515,11,5.0.43,0,552,0,56,43,99,0,43,99,196,0,0,162,1,4,292,202,292,245,12,1482,1079
1515,12,0.4.196,0,601,1,86,196,282,196,0,282,282,-196,196,358,5,1,86,405,233,405,13,1482,1015
1515,12,1.0.43,0,552,0,87,43,130,0,43,130,260,0,0,162,1,4,342,202,342,245,13,1482,1015
1515,12,2.0.43,0,552,0,59,43,102,0,43,102,260,0,0,162,1,4,172,202,172,245,13,1482,1015
1515,12,3.4.147,0,552,0,63,147,210,147,0,210,260,-147,147,309,5,1,63,405,210,405,13,1482,1015
1515,12,4.4.260,0,602,2,60,260,320,260,0,320,320,-260,260,422,5,1,60,405,233,405,13,1482,1015
1515,12,5.0.43,1,552,0,56,43,99,0,43,99,260,0,0,162,1,4,292,202,292,245,13,1482,1015
1515,13,0.4.196,0,601,1,86,196,282,196,0,282,282,-196,196,358,5,1,86,405,233,405,14,1482,959
1515,13,1.0.99,0,552,0,87,99,186,0,99,186,260,0,0,162,1,5,342,146,342,245,14,1482,959
1515,13,2.0.99,0,552,0,59,99,158,0,99,158,260,0,0,162,1,5,172,146,172,245,14,1482,959
1515,13,3.4.147,0,552,0,63,147,210,147,0,210,260,-147,147,309,5,1,63,405,210,405,14,1482,959
1515,13,4.4.260,0,602,2,60,260,320,260,0,320,320,-260,260,422,5,1,60,405,233,405,14,1482,959
1515,13,5.1.156,1,552,0,52,156,208,99,57,208,260,0,1,162,2,4,236,79,292,234,14,1482,959
1515,14,0.4.196,0,601,1,86,196,282,196,0,282,282,-196,196,358,5,1,86,405,233,405,15,1482,907
1515,14,1.0.99,0,552,0,87,99,186,0,99,186,260,0,0,162,1,5,342,146,342,245,15,1482,907
1515,14,2.0.99,0,552,0,59,99,158,0,99,158,260,0,0,162,1,5,172,146,172,245,15,1482,907
1515,14,3.4.147,0,552,0,63,147,210,147,0,210,260,-147,147,309,5,1,63,405,210,405,15,1482,907
1515,14,4.4.260,0,602,2,60,260,320,260,0,320,320,-260,260,422,5,1,60,405,233,405,15,1482,907
1515,14,5.2.208,1,552,0,49,208,257,208,0,257,260,-38,136,200,3,4,184,178,292,250,15,1482,907
1515,15,0.4.196,0,601,1,86,196,282,196,0,282,282,-196,196,396,5,1,86,405,233,405,16,1482,858
1515,15,1.0.99,0,552,0,87,99,186,0,99,186,260,0,0,200,1,5,342,146,342,245,16,1482,858
1515,15,2.0.99,0,552,0,59,99,158,0,99,158,260,0,0,200,1,5,172,146,172,245,16,1482,858
1515,15,3.4.147,0,552,0,63,147,210,147,0,210,260,-147,147,347,5,1,63,405,210,405,16,1482,858
1515,15,4.4.260,0,602,2,60,260,320,260,0,320,320,-260,260,460,5,1,60,405,233,405,16,1482,858
1515,15,5.3.260,1,552,0,65,260,325,257,3,325,325,0,63,200,4,4,135,151,292,348,16,1482,858
1515,16,0.4.196,0,601,2,86,196,282,196,0,282,325,-196,196,396,5,1,86,405,233,405,17,1482,793
1515,16,1.0.99,1,552,0,87,99,186,0,99,186,325,0,0,200,1,5,342,146,342,245,17,1482,793
1515,16,2.0.99,0,552,0,59,99,158,0,99,158,325,0,0,200,1,5,172,146,172,245,17,1482,793
1515,16,3.4.147,0,552,0,63,147,210,147,0,210,325,-147,147,347,5,1,63,405,210,405,17,1482,793
1515,16,4.4.260,0,602,3,60,260,320,260,0,320,325,-260,260,460,5,1,60,405,233,405,17,1482,793
1515,16,5.4.325,0,581,1,70,325,395,325,0,395,395,-325,325,525,5,1,70,405,292,405,17,1482,793
1515,17,0.4.196,0,601,2,86,196,282,196,0,282,325,-196,196,396,5,1,86,405,233,405,18,1482,706
1515,17,1.1.208,1,552,0,17,208,225,186,22,225,325,0,1,200,2,5,255,27,342,234,18,1482,706
1515,17,2.0.186,0,552,0,59,186,245,0,186,245,325,0,0,200,1,6,172,59,172,245,18,1482,706
1515,17,3.4.147,0,552,0,63,147,210,147,0,210,325,-147,147,347,5,1,63,405,210,405,18,1482,706
1515,17,4.4.260,0,602,3,60,260,320,260,0,320,325,-260,260,460,5,1,60,405,233,405,18,1482,706
1515,17,5.4.325,0,581,1,70,325,395,325,0,395,395,-325,325,525,5,1,70,405,292,405,18,1482,706
1515,18,0.4.196,0,601,2,86,196,282,196,0,282,325,-196,196,396,5,1,86,405,233,405,19,1482,689
1515,18,1.2.257,0,552,0,96,257,353,225,32,353,353,0,136,200,3,5,238,129,342,250,19,1482,689
1515,18,2.0.186,1,552,0,59,186,245,0,186,245,325,0,0,200,1,6,172,59,172,245,19,1482,689
1515,18,3.4.147,0,552,0,63,147,210,147,0,210,325,-147,147,347,5,1,63,405,210,405,19,1482,689
1515,18,4.4.260,0,602,3,60,260,320,260,0,320,325,-260,260,460,5,1,60,405,233,405,19,1482,689
1515,18,5.4.325,0,581,1,70,325,395,325,0,395,395,-325,325,525,5,1,70,405,292,405,19,1482,689
1515,19,0.4.196,0,601,2,86,196,282,196,0,282,325,-196,196,396,5,1,86,405,233,405,20,1482,630
1515,19,1.2.257,0,552,0,96,257,353,225,32,353,353,0,136,200,3,5,238,129,342,250,20,1482,630
1515,19,2.1.245,1,552,0,10,245,255,245,0,255,325,-20,21,220,2,6,113,10,172,234,20,1482,630
1515,19,3.4.147,0,552,0,63,147,210,147,0,210,325,-147,147,347,5,1,63,405,210,405,20,1482,630
1515,19,4.4.260,0,602,3,60,260,320,260,0,320,325,-260,260,460,5,1,60,405,233,405,20,1482,630
1515,19,5.4.325,0,581,1,70,325,395,325,0,395,395,-325,325,525,5,1,70,405,292,405,20,1482,630
1515,20,0.4.196,0,601,2,86,196,282,196,0,282,325,-196,196,416,5,1,86,405,233,405,21,1482,620
1515,20,1.2.257,1,552,0,96,257,353,225,32,353,353,0,136,220,3,5,238,129,342,250,21,1482,620
1515,20,2.2.257,0,552,0,33,257,290,255,2,290,325,0,136,220,3,5,103,129,172,250,21,1482,620
1515,20,3.4.147,0,552,0,63,147,210,147,0,210,325,-147,147,367,5,1,63,405,210,405,21,1482,620
1515,20,4.4.260,0,602,3,60,260,320,260,0,320,325,-260,260,480,5,1,60,405,233,405,21,1482,620
1515,20,5.4.325,0,581,1,70,325,395,325,0,395,395,-325,325,545,5,1,70,405,292,405,21,1482,620
1515,21,0.4.196,0,601,3,86,196,282,196,0,282,353,-196,196,416,5,1,86,405,233,405,22,1482,524
1515,21,1.3.353,0,554,1,75,353,428,353,0,428,428,-28,91,248,4,5,142,86,342,348,22,1482,524
1515,21,2.2.353,1,552,0,33,353,386,255,98,386,386,0,136,220,3,6,103,33,172,250,22,1482,524
1515,21,3.4.147,0,552,0,63,147,210,147,0,210,353,-147,147,367,5,1,63,405,210,405,22,1482,524
1515,21,4.4.260,0,602,4,60,260,320,260,0,320,353,-260,260,480,5,1,60,405,233,405,22,1482,524
1515,21,5.4.325,0,581,2,70,325,395,325,0,395,395,-325,325,545,5,1,70,405,292,405,22,1482,524
1515,22,0.4.196,0,601,3,86,196,282,196,0,282,386,-196,196,416,5,1,86,405,233,405,23,1482,491
1515,22,1.3.353,1,554,1,75,353,428,353,0,428,428,-28,91,248,4,5,142,86,342,348,23,1482,491
1515,22,2.3.386,0,552,0,11,386,397,386,0,397,397,-61,124,281,4,5,70,86,172,348,23,1482,491
1515,22,3.4.147,0,552,0,63,147,210,147,0,210,386,-147,147,367,5,1,63,405,210,405,23,1482,491
1515,22,4.4.260,0,602,4,60,260,320,260,0,320,386,-260,260,480,5,1,60,405,233,405,23,1482,491
1515,22,5.4.325,0,581,2,70,325,395,325,0,395,395,-325,325,545,5,1,70,405,292,405,23,1482,491
1515,23,0.4.196,0,601,2,86,196,282,196,0,282,428,-196,196,444,5,1,86,405,233,405,24,1482,416
1515,23,1.4.428,0,554,0,67,428,495,428,0,495,495,-428,428,676,5,1,67,405,342,405,24,1482,416
1515,23,2.3.428,1,554,0,11,428,439,386,42,439,439,0,91,248,4,6,70,11,172,348,24,1482,416
1515,23,3.4.147,0,554,0,63,147,210,147,0,210,428,-147,147,395,5,1,63,405,210,405,24,1482,416
1515,23,4.4.260,0,602,3,60,260,320,260,0,320,428,-260,260,508,5,1,60,405,233,405,24,1482,416
1515,23,5.4.325,0,581,1,70,325,395,325,0,395,428,-325,325,573,5,1,70,405,292,405,24,1482,416
1515,24,0.4.196,0,601,3,86,196,282,196,0,282,439,-196,196,444,5,1,86,405,233,405,25,1482,405
1515,24,1.4.428,0,554,0,67,428,495,428,0,495,495,-428,428,676,5,1,67,405,342,405,25,1482,405
1515,24,2.4.439,0,565,1,59,439,498,439,0,498,498,-439,439,687,5,1,59,405,172,405,25,1482,405
1515,24,3.4.147,1,554,0,63,147,210,147,0,210,439,-147,147,395,5,1,63,405,210,405,25,1482,405
1515,24,4.4.260,0,602,4,60,260,320,260,0,320,439,-260,260,508,5,1,60,405,233,405,25,1482,405
1515,24,5.4.325,0,581,2,70,325,395,325,0,395,439,-325,325,573,5,1,70,405,292,405,25,1482,405
1515,25,0.4.210,1,554,0,86,210,296,196,14,296,439,0,147,395,5,2,86,342,233,405,26,1482,342
1515,25,1.4.428,0,554,0,67,428,495,428,0,495,495,-218,365,613,5,2,67,342,342,405,26,1482,342
1515,25,2.4.439,0,565,1,59,439,498,439,0,498,498,-229,376,624,5,2,59,342,172,405,26,1482,342
1515,25,4.4.260,0,602,3,60,260,320,260,0,320,439,-50,197,445,5,2,60,342,233,405,26,1482,342
1515,25,5.4.325,0,581,2,70,325,395,325,0,395,439,-115,262,510,5,2,70,342,292,405,26,1482,342
1515,26,1.4.428,0,554,0,67,428,495,428,0,495,495,-132,279,527,5,3,67,256,342,405,27,1482,256
1515,26,2.4.439,0,565,1,59,439,498,439,0,498,498,-143,290,538,5,3,59,256,172,405,27,1482,256
1515,26,4.4.296,1,554,0,60,296,356,260,36,356,439,0,147,395,5,3,60,256,233,405,27,1482,256
1515,26,5.4.325,0,581,2,70,325,395,325,0,395,439,-29,176,424,5,3,70,256,292,405,27,1482,256
1515,27,1.4.428,0,554,0,67,428,495,428,0,495,495,-72,219,467,5,4,67,196,342,405,28,1482,196
1515,27,2.4.439,0,565,1,59,439,498,439,0,498,498,-83,230,478,5,4,59,196,172,405,28,1482,196
1515,27,5.4.356,1,554,0,70,356,426,325,31,426,439,0,147,395,5,4,70,196,292,405,28,1482,196
1515,28,1.4.428,1,554,0,67,428,495,428,0,495,495,-2,149,397,5,5,67,126,342,405,29,1482,126
1515,28,2.4.439,0,565,1,59,439,498,439,0,498,498,-13,160,408,5,5,59,126,172,405,29,1482,126
1515,29,2.4.495,1,554,0,59,495,554,439,56,554,554,0,149,397,5,6,59,59,172,405,30,1482,59
1516,0,0.0.0,0,458,1,24,0,24,0,0,24,24,0,0,0,1,1,178,261,178,261,1,1352,1352
1516,0,1.0.0,0,465,2,63,0,63,0,0,63,63,0,0,0,1,1,243,261,243,261,1,1352,1352
1516,0,2.0.0,1,450,0,6,0,6,0,0,6,6,0,0,0,1,1,198,261,198,261,1,1352,1352
1516,0,3.0.0,0,493,5,54,0,54,0,0,54,54,0,0,0,1,1,268,261,268,261,1,1352,1352
1516,0,4.0.0,0,486,4,53,0,53,0,0,53,53,0,0,0,1,1,170,261,170,261,1,1352,1352
1516,0,5.0.0,0,475,3,61,0,61,0,0,61,61,0,0,0,1,1,295,261,295,261,1,1352,1352
1516,1,0.0.6,0,450,0,24,6,30,0,6,30,30,0,0,0,1,2,178,255,178,261,2,1352,1346
1516,1,1.0.6,0,459,2,63,6,69,0,6,69,69,0,0,0,1,2,243,255,243,261,2,1352,1346
1516,1,2.1.6,1,450,0,3,6,9,6,0,9,9,-6,6,6,2,1,192,238,198,238,2,1352,1346
1516,1,3.0.6,0,484,4,54,6,60,0,6,60,60,0,0,0,1,2,268,255,268,261,2,1352,1346
1516,1,4.0.6,0,474,3,53,6,59,0,6,59,59,0,0,0,1,2,170,255,170,261,2,1352,1346
1516,1,5.0.6,0,451,1,61,6,67,0,6,67,67,0,0,0,1,2,295,255,295,261,2,1352,1346
1516,2,0.0.6,0,450,0,24,6,30,0,6,30,30,0,0,6,1,2,178,255,178,261,3,1352,1343
1516,2,1.0.6,0,459,2,63,6,69,0,6,69,69,0,0,6,1,2,243,255,243,261,3,1352,1343
1516,2,2.2.9,1,450,0,85,9,94,9,0,94,94,-9,9,15,3,1,189,316,198,316,3,1352,1343
1516,2,3.0.6,0,484,4,54,6,60,0,6,60,60,0,0,6,1,2,268,255,268,261,3,1352,1343
1516,2,4.0.6,0,474,3,53,6,59,0,6,59,59,0,0,6,1,2,170,255,170,261,3,1352,1343
1516,2,5.0.6,0,451,1,61,6,67,0,6,67,67,0,0,6,1,2,295,255,295,261,3,1352,1343
1516,3,0.0.6,0,450,0,24,6,30,0,6,30,94,0,0,15,1,2,178,255,178,261,4,1352,1258
1516,3,1.0.6,0,459,2,63,6,69,0,6,69,94,0,0,15,1,2,243,255,243,261,4,1352,1258
1516,3,2.3.94,1,450,0,79,94,173,94,0,173,173,-94,94,109,4,1,104,301,198,301,4,1352,1258
1516,3,3.0.6,0,484,4,54,6,60,0,6,60,94,0,0,15,1,2,268,255,268,261,4,1352,1258
1516,3,4.0.6,0,474,3,53,6,59,0,6,59,94,0,0,15,1,2,170,255,170,261,4,1352,1258
1516,3,5.0.6,0,451,1,61,6,67,0,6,67,94,0,0,15,1,2,295,255,295,261,4,1352,1258
1516,4,0.0.6,0,450,0,24,6,30,0,6,30,173,0,0,109,1,2,178,255,178,261,5,1352,1179
1516,4,1.0.6,0,459,2,63,6,69,0,6,69,173,0,0,109,1,2,243,255,243,261,5,1352,1179
1516,4,2.4.173,1,450,0,25,173,198,173,0,198,198,-173,173,282,5,1,25,236,198,236,5,1352,1179
1516,4,3.0.6,0,484,4,54,6,60,0,6,60,173,0,0,109,1,2,268,255,268,261,5,1352,1179
1516,4,4.0.6,0,474,3,53,6,59,0,6,59,173,0,0,109,1,2,170,255,170,261,5,1352,1179
1516,4,5.0.6,0,451,1,61,6,67,0,6,67,173,0,0,109,1,2,295,255,295,261,5,1352,1179
1516,5,0.0.6,0,450,0,24,6,30,0,6,30,198,0,0,282,1,2,178,255,178,261,6,1352,1154
1516,5,1.0.6,0,459,2,63,6,69,0,6,69,198,0,0,282,1,2,243,255,243,261,6,1352,1154
1516,5,3.0.6,0,484,4,54,6,60,0,6,60,198,0,0,282,1,2,268,255,268,261,6,1352,1154
1516,5,4.0.6,0,474,3,53,6,59,0,6,59,198,0,0,282,1,2,170,255,170,261,6,1352,1154
1516,5,5.0.6,1,451,1,61,6,67,0,6,67,198,0,0,282,1,2,295,255,295,261,6,1352,1154
1516,6,0.0.67,0,451,0,24,67,91,0,67,91,198,0,0,282,1,3,178,194,178,261,7,1352,1093
1516,6,1.0.67,0,475,3,63,67,130,0,67,130,198,0,0,282,1,3,243,194,243,261,7,1352,1093
1516,6,3.0.67,0,466,2,54,67,121,0,67,121,198,0,0,282,1,3,268,194,268,261,7,1352,1093
1516,6,4.0.67,0,464,1,53,67,120,0,67,120,198,0,0,282,1,3,170,194,170,261,7,1352,1093
1516,6,5.1.67,1,451,0,36,67,103,67,0,103,198,-58,64,340,2,2,234,235,295,238,7,1352,1093
1516,7,0.0.67,0,451,0,24,67,91,0,67,91,198,0,0,340,1,3,178,194,178,261,8,1352,1057
1516,7,1.0.67,0,475,3,63,67,130,0,67,130,198,0,0,340,1,3,243,194,243,261,8,1352,1057
1516,7,3.0.67,0,466,2,54,67,121,0,67,121,198,0,0,340,1,3,268,194,268,261,8,1352,1057
1516,7,4.0.67,0,464,1,53,67,120,0,67,120,198,0,0,340,1,3,170,194,170,261,8,1352,1057
1516,7,5.2.103,1,451,0,87,103,190,103,0,190,198,-9,18,349,3,2,198,231,295,316,8,1352,1057
1516,8,0.0.67,0,451,0,24,67,91,0,67,91,198,0,0,349,1,3,178,194,178,261,9,1352,970
1516,8,1.0.67,0,475,3,63,67,130,0,67,130,198,0,0,349,1,3,243,194,243,261,9,1352,970
1516,8,3.0.67,0,466,2,54,67,121,0,67,121,198,0,0,349,1,3,268,194,268,261,9,1352,970
1516,8,4.0.67,0,464,1,53,67,120,0,67,120,198,0,0,349,1,3,170,194,170,261,9,1352,970
1516,8,5.3.190,1,451,0,50,190,240,190,0,240,240,-17,111,366,4,2,111,222,295,301,9,1352,970
1516,9,0.0.67,0,451,0,24,67,91,0,67,91,240,0,0,366,1,3,178,194,178,261,10,1352,920
1516,9,1.0.67,0,475,3,63,67,130,0,67,130,240,0,0,366,1,3,243,194,243,261,10,1352,920
1516,9,3.0.67,0,466,2,54,67,121,0,67,121,240,0,0,366,1,3,268,194,268,261,10,1352,920
1516,9,4.0.67,0,464,1,53,67,120,0,67,120,240,0,0,366,1,3,170,194,170,261,10,1352,920
1516,9,5.4.240,1,451,0,61,240,301,240,0,301,301,-42,215,408,5,2,61,211,295,236,10,1352,920
1516,10,0.0.67,0,451,0,24,67,91,0,67,91,301,0,0,408,1,3,178,194,178,261,11,1352,859
1516,10,1.0.67,0,475,3,63,67,130,0,67,130,301,0,0,408,1,3,243,194,243,261,11,1352,859
1516,10,3.0.67,1,466,2,54,67,121,0,67,121,301,0,0,408,1,3,268,194,268,261,11,1352,859
1516,10,4.0.67,0,464,1,53,67,120,0,67,120,301,0,0,408,1,3,170,194,170,261,11,1352,859
1516,11,0.0.121,1,466,0,24,121,145,0,121,145,301,0,0,408,1,4,178,140,178,261,12,1352,805
1516,11,1.0.121,0,469,1,63,121,184,0,121,184,301,0,0,408,1,4,243,140,243,261,12,1352,805
1516,11,3.1.121,0,469,1,73,121,194,121,0,194,301,-18,82,426,2,3,214,199,268,238,12,1352,805
1516,11,4.0.121,0,472,2,53,121,174,0,121,174,301,0,0,408,1,4,170,140,170,261,12,1352,805
1516,12,0.1.145,0,466,0,25,145,170,145,0,170,301,-42,106,450,2,3,154,199,178,238,13,1352,781
1516,12,1.0.145,1,466,0,63,145,208,0,145,208,301,0,0,408,1,5,243,116,243,261,13,1352,781
1516,12,3.1.121,0,472,1,73,121,194,121,0,194,301,-18,82,426,2,3,214,199,268,238,13,1352,781
1516,12,4.0.145,0,466,0,53,145,198,0,145,198,301,0,0,408,1,5,170,116,170,261,13,1352,781
1516,13,0.1.145,0,466,0,25,145,170,145,0,170,301,-42,106,450,2,3,154,199,178,238,14,1352,718
1516,13,1.1.208,0,483,2,85,208,293,208,0,293,301,-105,169,513,2,3,180,199,243,238,14,1352,718
1516,13,3.1.121,0,475,1,73,121,194,121,0,194,301,-18,82,426,2,3,214,199,268,238,14,1352,718
1516,13,4.0.208,1,466,0,53,208,261,0,208,261,301,0,0,408,1,6,170,53,170,261,14,1352,718
1516,14,0.1.145,0,466,0,25,145,170,145,0,170,301,-42,106,450,2,3,154,199,178,238,15,1352,665
1516,14,1.1.208,0,483,2,85,208,293,208,0,293,301,-105,169,513,2,3,180,199,243,238,15,1352,665
1516,14,3.1.121,1,475,1,73,121,194,121,0,194,301,-18,82,426,2,3,214,199,268,238,15,1352,665
1516,14,4.1.261,0,484,3,16,261,277,261,0,277,301,-158,222,566,2,3,117,199,170,238,15,1352,665
1516,15,0.1.194,1,475,0,25,194,219,145,49,219,301,0,82,426,2,4,154,126,178,238,16,1352,592
1516,15,1.1.208,0,483,1,85,208,293,208,0,293,301,-14,96,440,2,4,180,126,243,238,16,1352,592
1516,15,3.2.194,0,483,1,93,194,287,194,0,287,301,-4,22,430,3,3,141,144,268,316,16,1352,592
1516,15,4.1.261,0,484,2,16,261,277,261,0,277,301,-67,149,493,2,4,117,126,170,238,16,1352,592
1516,16,0.2.219,1,475,0,35,219,254,219,0,254,301,-29,47,455,3,3,129,144,178,316,17,1352,567
1516,16,1.1.219,0,475,0,85,219,304,208,11,304,304,0,82,426,2,5,180,101,243,238,17,1352,567
1516,16,3.2.194,0,492,2,93,194,287,194,0,287,301,-4,22,430,3,3,141,144,268,316,17,1352,567
1516,16,4.1.261,0,484,1,16,261,277,261,0,277,301,-42,124,468,2,5,117,101,170,238,17,1352,567
1516,17,0.3.254,1,475,0,55,254,309,254,0,309,309,-14,125,469,4,3,94,172,178,301,18,1352,532
1516,17,1.1.219,0,475,0,85,219,304,208,11,304,304,0,82,455,2,5,180,101,243,238,18,1352,532
1516,17,3.2.254,0,477,1,93,254,347,194,60,347,347,0,47,455,3,4,141,109,268,316,18,1352,532
1516,17,4.1.261,0,484,2,16,261,277,261,0,277,301,-42,124,497,2,5,117,101,170,238,18,1352,532
1516,18,0.4.309,1,475,0,39,309,348,309,0,348,348,-8,223,477,5,3,39,150,178,236,19,1352,477
1516,18,1.1.219,0,475,0,85,219,304,208,11,304,309,0,82,469,2,5,180,101,243,238,19,1352,477
1516,18,3.2.254,0,477,1,93,254,347,194,60,347,347,0,47,469,3,4,141,109,268,316,19,1352,477
1516,18,4.1.261,0,484,2,16,261,277,261,0,277,309,-42,124,511,2,5,117,101,170,238,19,1352,477
1516,19,1.1.219,0,475,0,85,219,304,208,11,304,348,0,82,477,2,5,180,101,243,238,20,1352,438
1516,19,3.2.254,1,477,1,93,254,347,194,60,347,348,0,47,477,3,4,141,109,268,316,20,1352,438
1516,19,4.1.261,0,484,2,16,261,277,261,0,277,348,-42,124,519,2,5,117,101,170,238,20,1352,438
1516,20,1.1.219,0,477,0,85,219,304,208,11,304,348,0,82,477,2,5,180,101,243,238,21,1352,345
1516,20,3.3.347,1,513,2,43,347,390,347,0,390,390,-38,163,515,4,4,48,117,268,301,21,1352,345
1516,20,4.1.261,0,492,1,16,261,277,261,0,277,348,-42,124,519,2,5,117,101,170,238,21,1352,345
1516,21,1.1.219,0,513,0,85,219,304,208,11,304,390,0,82,515,2,5,180,101,243,238,22,1352,302
1516,21,3.4.390,1,513,0,5,390,395,390,0,395,395,-42,265,557,5,4,5,111,268,236,22,1352,302
1516,21,4.1.261,0,513,0,16,261,277,261,0,277,390,-42,124,557,2,5,117,101,170,238,22,1352,302
1516,22,1.1.219,0,513,0,85,219,304,208,11,304,395,0,82,557,2,5,180,101,243,238,23,1352,297
1516,22,4.1.261,1,513,0,16,261,277,261,0,277,395,-42,124,599,2,5,117,101,170,238,23,1352,297
1516,23,1.1.277,0,513,0,85,277,362,208,69,362,395,0,124,599,2,6,180,85,243,238,24,1352,281
1516,23,4.2.347,1,513,0,14,347,361,277,70,361,395,0,47,599,3,5,101,16,170,316,24,1352,281
1516,24,1.1.277,0,513,0,85,277,362,208,69,362,395,0,124,599,2,6,180,85,243,238,25,1352,267
1516,24,4.3.390,1,553,1,57,390,447,361,29,447,447,0,163,599,4,5,87,74,170,301,25,1352,267
1516,25,1.1.277,0,553,0,85,277,362,208,69,362,447,0,124,599,2,6,180,85,243,238,26,1352,210
1516,25,4.4.447,1,553,0,30,447,477,447,0,477,477,-52,317,651,5,5,30,106,170,236,26,1352,210
1516,26,1.1.277,1,553,0,85,277,362,208,69,362,477,0,124,651,2,6,180,85,243,238,27,1352,180
1516,27,1.2.362,1,553,0,2,362,364,362,0,364,477,-1,48,652,3,6,95,2,243,316,28,1352,95
1516,28,1.3.447,1,553,0,17,447,464,364,83,464,477,0,163,652,4,6,93,17,243,301,29,1352,93
1516,29,1.4.477,1,553,0,76,477,553,464,13,553,553,0,317,652,5,6,76,76,243,236,30,1352,76
1517,0,0.0.0,1,542,3,37,0,37,0,0,37,37,0,0,0,1,1,320,275,320,275,1,1424,1424
1517,0,1.0.0,0,521,1,38,0,38,0,0,38,38,0,0,0,1,1,244,275,244,275,1,1424,1424
1517,0,2.0.0,0,560,4,51,0,51,0,0,51,51,0,0,0,1,1,324,275,324,275,1,1424,1424
1517,0,3.0.0,0,509,0,8,0,8,0,0,8,8,0,0,0,1,1,129,275,129,275,1,1424,1424
1517,0,4.0.0,0,584,5,75,0,75,0,0,75,75,0,0,0,1,1,209,275,209,275,1,1424,1424
1517,0,5.0.0,0,539,2,66,0,66,0,0,66,66,0,0,0,1,1,198,275,198,275,1,1424,1424
1517,1,0.1.37,0,575,2,92,37,129,37,0,129,129,-37,37,37,2,1,283,340,320,340,2,1424,1387
1517,1,1.0.37,0,543,1,38,37,75,0,37,75,75,0,0,0,1,2,244,238,244,275,2,1424,1387
1517,1,2.0.37,1,589,3,51,37,88,0,37,88,88,0,0,0,1,2,324,238,324,275,2,1424,1387
1517,1,3.0.37,0,542,0,8,37,45,0,37,45,45,0,0,0,1,2,129,238,129,275,2,1424,1387
1517,1,4.0.37,0,595,4,75,37,112,0,37,112,112,0,0,0,1,2,209,238,209,275,2,1424,1387
1517,1,5.0.37,0,575,2,66,37,103,0,37,103,103,0,0,0,1,2,198,238,198,275,2,1424,1387
1517,2,0.1.37,0,589,0,92,37,129,37,0,129,129,-37,37,37,2,1,283,340,320,340,3,1424,1336
1517,2,1.0.88,1,594,1,38,88,126,0,88,126,126,0,0,0,1,3,244,187,244,275,3,1424,1336
1517,2,2.1.88,0,630,3,96,88,184,88,0,184,184,-88,88,88,2,1,273,340,324,340,3,1424,1336
1517,2,3.0.88,0,589,0,8,88,96,0,88,96,96,0,0,0,1,3,129,187,129,275,3,1424,1336
1517,2,4.0.88,0,595,2,75,88,163,0,88,163,163,0,0,0,1,3,209,187,209,275,3,1424,1336
1517,2,5.0.88,0,595,2,66,88,154,0,88,154,154,0,0,0,1,3,198,187,198,275,3,1424,1336
1517,3,0.1.37,0,594,0,92,37,129,37,0,129,129,-37,37,37,2,1,283,340,320,340,4,1424,1298
1517,3,1.1.126,0,612,2,53,126,179,126,0,179,179,-126,126,126,2,1,206,340,244,340,4,1424,1298
1517,3,2.1.88,0,637,3,96,88,184,88,0,184,184,-88,88,88,2,1,273,340,324,340,4,1424,1298
1517,3,3.0.126,1,594,0,8,126,134,0,126,134,134,0,0,0,1,4,129,149,129,275,4,1424,1298
1517,3,4.0.126,0,595,1,75,126,201,0,126,201,201,0,0,0,1,4,209,149,209,275,4,1424,1298
1517,3,5.0.126,0,595,1,66,126,192,0,126,192,192,0,0,0,1,4,198,149,198,275,4,1424,1298
1517,4,0.1.37,0,594,0,92,37,129,37,0,129,134,-37,37,37,2,1,283,340,320,340,5,1424,1290
1517,4,1.1.126,0,612,1,53,126,179,126,0,179,179,-126,126,126,2,1,206,340,244,340,5,1424,1290
1517,4,2.1.88,0,637,2,96,88,184,88,0,184,184,-88,88,88,2,1,273,340,324,340,5,1424,1290
1517,4,3.1.134,0,594,0,12,134,146,134,0,146,146,-134,134,134,2,1,121,340,129,340,5,1424,1290
1517,4,4.0.134,0,594,0,75,134,209,0,134,209,209,0,0,0,1,5,209,141,209,275,5,1424,1290
1517,4,5.0.134,1,594,0,66,134,200,0,134,200,200,0,0,0,1,5,198,141,198,275,5,1424,1290
1517,5,0.1.37,0,594,0,92,37,129,37,0,129,200,-37,37,37,2,1,283,340,320,340,6,1424,1224
1517,5,1.1.126,0,612,1,53,126,179,126,0,179,200,-126,126,126,2,1,206,340,244,340,6,1424,1224
1517,5,2.1.88,0,637,2,96,88,184,88,0,184,200,-88,88,88,2,1,273,340,324,340,6,1424,1224
1517,5,3.1.134,0,594,0,12,134,146,134,0,146,200,-134,134,134,2,1,121,340,129,340,6,1424,1224
1517,5,4.0.200,1,594,0,75,200,275,0,200,275,275,0,0,0,1,6,209,75,209,275,6,1424,1224
1517,5,5.1.200,0,594,0,19,200,219,200,0,219,219,-200,200,200,2,1,132,340,198,340,6,1424,1224
1517,6,0.1.37,1,594,0,92,37,129,37,0,129,275,-37,37,37,2,1,283,340,320,340,7,1424,1149
1517,6,1.1.126,0,612,2,53,126,179,126,0,179,275,-126,126,126,2,1,206,340,244,340,7,1424,1149
1517,6,2.1.88,0,637,3,96,88,184,88,0,184,275,-88,88,88,2,1,273,340,324,340,7,1424,1149
1517,6,3.1.134,0,594,0,12,134,146,134,0,146,275,-134,134,134,2,1,121,340,129,340,7,1424,1149
1517,6,4.1.275,0,595,1,68,275,343,275,0,343,343,-275,275,275,2,1,134,340,209,340,7,1424,1149
1517,6,5.1.200,0,594,0,19,200,219,200,0,219,275,-200,200,200,2,1,132,340,198,340,7,1424,1149
1517,7,0.2.129,1,595,1,38,129,167,129,0,167,275,-129,129,166,3,1,191,187,320,187,8,1424,1057
1517,7,1.1.129,0,595,1,53,129,182,126,3,182,275,0,37,37,2,2,206,248,244,340,8,1424,1057
1517,7,2.1.129,0,595,1,96,129,225,88,41,225,275,0,37,37,2,2,273,248,324,340,8,1424,1057
1517,7,3.1.134,0,594,0,12,134,146,134,0,146,275,-5,42,42,2,2,121,248,129,340,8,1424,1057
1517,7,4.1.275,0,595,1,68,275,343,275,0,343,343,-146,183,183,2,2,134,248,209,340,8,1424,1057
1517,7,5.1.200,0,594,0,19,200,219,200,0,219,275,-71,108,108,2,2,132,248,198,340,8,1424,1057
1517,8,0.3.167,1,595,0,62,167,229,167,0,229,275,-167,167,333,4,1,153,256,320,256,9,1424,1019
1517,8,1.1.129,0,595,0,53,129,182,126,3,182,275,0,37,166,2,2,206,248,244,340,9,1424,1019
1517,8,2.1.129,0,595,0,96,129,225,88,41,225,275,0,37,166,2,2,273,248,324,340,9,1424,1019
1517,8,3.1.134,0,595,0,12,134,146,134,0,146,275,-5,42,171,2,2,121,248,129,340,9,1424,1019
1517,8,4.1.275,0,595,0,68,275,343,275,0,343,343,-146,183,312,2,2,134,248,209,340,9,1424,1019
1517,8,5.1.200,0,595,0,19,200,219,200,0,219,275,-71,108,237,2,2,132,248,198,340,9,1424,1019
1517,9,0.4.229,1,595,0,91,229,320,229,0,320,320,-229,229,562,5,1,91,366,320,366,10,1424,957
1517,9,1.1.129,0,595,0,53,129,182,126,3,182,275,0,37,333,2,2,206,248,244,340,10,1424,957
1517,9,2.1.129,0,595,0,96,129,225,88,41,225,275,0,37,333,2,2,273,248,324,340,10,1424,957
1517,9,3.1.134,0,595,0,12,134,146,134,0,146,275,-5,42,338,2,2,121,248,129,340,10,1424,957
1517,9,4.1.275,0,595,0,68,275,343,275,0,343,343,-146,183,479,2,2,134,248,209,340,10,1424,957
1517,9,5.1.200,0,595,0,19,200,219,200,0,219,275,-71,108,404,2,2,132,248,198,340,10,1424,957
1517,10,1.1.129,0,595,0,53,129,182,126,3,182,320,0,37,562,2,2,206,248,244,340,11,1424,866
1517,10,2.1.129,1,595,0,96,129,225,88,41,225,320,0,37,562,2,2,273,248,324,340,11,1424,866
1517,10,3.1.134,0,595,0,12,134,146,134,0,146,320,-5,42,567,2,2,121,248,129,340,11,1424,866
1517,10,4.1.275,0,595,0,68,275,343,275,0,343,343,-146,183,708,2,2,134,248,209,340,11,1424,866
1517,10,5.1.200,0,595,0,19,200,219,200,0,219,320,-71,108,633,2,2,132,248,198,340,11,1424,866
1517,11,1.1.225,0,595,0,53,225,278,126,99,278,320,0,37,562,2,3,206,152,244,340,12,1424,770
1517,11,2.2.225,1,595,0,39,225,264,225,0,264,320,-58,187,620,3,2,177,149,324,187,12,1424,770
1517,11,3.1.225,0,595,0,12,225,237,134,91,237,320,0,37,562,2,3,121,152,129,340,12,1424,770
1517,11,4.1.275,0,595,0,68,275,343,275,0,343,343,-50,87,612,2,3,134,152,209,340,12,1424,770
1517,11,5.1.225,0,595,0,19,225,244,200,25,244,320,0,37,562,2,3,132,152,198,340,12,1424,770
1517,12,1.1.225,0,595,0,53,225,278,126,99,278,320,0,37,620,2,3,206,152,244,340,13,1424,731
1517,12,2.3.264,1,595,0,48,264,312,264,0,312,320,-35,202,655,4,2,138,194,324,256,13,1424,731
1517,12,3.1.225,0,595,0,12,225,237,134,91,237,320,0,37,620,2,3,121,152,129,340,13,1424,731
1517,12,4.1.275,0,595,0,68,275,343,275,0,343,343,-50,87,670,2,3,134,152,209,340,13,1424,731
1517,12,5.1.225,0,595,0,19,225,244,200,25,244,320,0,37,620,2,3,132,152,198,340,13,1424,731
1517,13,1.1.225,1,595,0,53,225,278,126,99,278,320,0,37,655,2,3,206,152,244,340,14,1424,683
1517,13,2.4.320,0,595,0,90,320,410,312,8,410,410,0,229,655,5,2,90,275,324,366,14,1424,683
1517,13,3.1.225,0,595,0,12,225,237,134,91,237,320,0,37,655,2,3,121,152,129,340,14,1424,683
1517,13,4.1.275,0,595,0,68,275,343,275,0,343,343,-50,87,705,2,3,134,152,209,340,14,1424,683
1517,13,5.1.225,0,595,0,19,225,244,200,25,244,320,0,37,655,2,3,132,152,198,340,14,1424,683
1517,14,1.2.278,1,595,0,8,278,286,278,0,286,320,-14,201,669,3,3,153,110,244,187,15,1424,630
1517,14,2.4.320,0,595,0,90,320,410,312,8,410,410,0,229,655,5,2,90,275,324,366,15,1424,630
1517,14,3.1.278,0,595,0,12,278,290,134,144,290,320,0,37,655,2,4,121,99,129,340,15,1424,630
1517,14,4.1.278,0,595,0,68,278,346,275,3,346,346,0,37,655,2,4,134,99,209,340,15,1424,630
1517,14,5.1.278,0,595,0,19,278,297,200,78,297,320,0,37,655,2,4,132,99,198,340,15,1424,630
1517,15,1.3.312,1,595,0,59,312,371,286,26,371,371,0,202,669,4,3,145,146,244,256,16,1424,622
1517,15,2.4.320,0,595,0,90,320,410,312,8,410,410,0,229,669,5,2,90,275,324,366,16,1424,622
1517,15,3.1.278,0,595,0,12,278,290,134,144,290,320,0,37,669,2,4,121,99,129,340,16,1424,622
1517,15,4.1.278,0,595,0,68,278,346,275,3,346,346,0,37,669,2,4,134,99,209,340,16,1424,622
1517,15,5.1.278,0,595,0,19,278,297,200,78,297,320,0,37,669,2,4,132,99,198,340,16,1424,622
1517,16,1.4.371,0,646,1,86,371,457,371,0,457,457,-51,280,720,5,2,86,275,244,366,17,1424,563
1517,16,2.4.320,0,595,0,90,320,410,312,8,410,410,0,229,669,5,2,90,275,324,366,17,1424,563
1517,16,3.1.278,1,595,0,12,278,290,134,144,290,371,0,37,669,2,4,121,99,129,340,17,1424,563
1517,16,4.1.278,0,595,0,68,278,346,275,3,346,371,0,37,669,2,4,134,99,209,340,17,1424,563
1517,16,5.1.278,0,595,0,19,278,297,200,78,297,371,0,37,669,2,4,132,99,198,340,17,1424,563
1517,17,1.4.371,0,646,1,86,371,457,371,0,457,457,-51,280,720,5,2,86,275,244,366,18,1424,551
1517,17,2.4.320,0,595,0,90,320,410,312,8,410,410,0,229,669,5,2,90,275,324,366,18,1424,551
1517,17,3.2.290,0,595,0,61,290,351,290,0,351,371,-4,205,673,3,4,109,102,129,187,18,1424,551
1517,17,4.1.290,0,595,0,68,290,358,275,15,358,371,0,37,669,2,5,134,87,209,340,18,1424,551
1517,17,5.1.290,1,595,0,19,290,309,200,90,309,371,0,37,669,2,5,132,87,198,340,18,1424,551
1517,18,1.4.371,0,646,1,86,371,457,371,0,457,457,-51,280,720,5,2,86,275,244,366,19,1424,532
1517,18,2.4.320,0,595,0,90,320,410,312,8,410,410,0,229,669,5,2,90,275,324,366,19,1424,532
1517,18,3.2.290,0,595,0,61,290,351,290,0,351,371,-4,205,673,3,4,109,102,129,187,19,1424,532
1517,18,4.1.309,0,595,0,68,309,377,275,34,377,377,0,37,669,2,6,134,68,209,340,19,1424,532
1517,18,5.2.309,1,595,0,26,309,335,309,0,335,371,-23,224,692,3,4,113,102,198,187,19,1424,532
1517,19,1.4.371,0,646,1,86,371,457,371,0,457,457,-51,280,743,5,2,86,275,244,366,20,1424,506
1517,19,2.4.320,0,595,0,90,320,410,312,8,410,410,0,229,692,5,2,90,275,324,366,20,1424,506
1517,19,3.2.335,0,595,0,61,335,396,290,45,396,396,0,224,692,3,5,109,76,129,187,20,1424,506
1517,19,4.1.309,0,595,0,68,309,377,275,34,377,377,0,37,692,2,6,134,68,209,340,20,1424,506
1517,19,5.3.371,1,595,0,35,371,406,335,36,406,406,0,202,692,4,4,87,87,198,256,20,1424,506
1517,20,1.4.371,0,646,1,86,371,457,371,0,457,457,-51,280,743,5,2,86,275,244,366,21,1424,471
1517,20,2.4.320,0,595,0,90,320,410,312,8,410,410,0,229,692,5,2,90,275,324,366,21,1424,471
1517,20,3.2.335,1,595,0,61,335,396,290,45,396,406,0,224,692,3,5,109,76,129,187,21,1424,471
1517,20,4.1.309,0,595,0,68,309,377,275,34,377,406,0,37,692,2,6,134,68,209,340,21,1424,471
1517,20,5.4.406,0,681,2,52,406,458,406,0,458,458,-86,315,778,5,2,52,275,198,366,21,1424,471
1517,21,1.4.371,0,646,1,86,371,457,371,0,457,457,-51,280,743,5,2,86,275,244,366,22,1424,410
1517,21,2.4.320,0,595,0,90,320,410,312,8,410,410,0,229,692,5,2,90,275,324,366,22,1424,410
1517,21,3.3.406,1,595,0,2,406,408,396,10,408,408,0,202,692,4,5,48,52,129,256,22,1424,410
1517,21,4.1.309,0,595,0,68,309,377,275,34,377,406,0,37,692,2,6,134,68,209,340,22,1424,410
1517,21,5.4.406,0,681,2,52,406,458,406,0,458,458,-86,315,778,5,2,52,275,198,366,22,1424,410
1517,22,1.4.371,0,646,1,86,371,457,371,0,457,457,-51,280,743,5,2,86,275,244,366,23,1424,408
1517,22,2.4.320,0,595,0,90,320,410,312,8,410,410,0,229,692,5,2,90,275,324,366,23,1424,408
1517,22,3.4.408,0,683,3,46,408,454,408,0,454,454,-88,317,780,5,2,46,275,129,366,23,1424,408
1517,22,4.1.309,1,595,0,68,309,377,275,34,377,408,0,37,692,2,6,134,68,209,340,23,1424,408
1517,22,5.4.406,0,681,2,52,406,458,406,0,458,458,-86,315,778,5,2,52,275,198,366,23,1424,408
1517,23,1.4.371,0,646,1,86,371,457,371,0,457,457,-51,280,743,5,2,86,275,244,366,24,1424,340
1517,23,2.4.320,0,595,0,90,320,410,312,8,410,410,0,229,692,5,2,90,275,324,366,24,1424,340
1517,23,3.4.408,0,683,3,46,408,454,408,0,454,454,-88,317,780,5,2,46,275,129,366,24,1424,340
1517,23,4.2.396,1,595,0,15,396,411,377,19,411,411,0,224,692,3,6,66,15,209,187,24,1424,340
1517,23,5.4.406,0,681,2,52,406,458,406,0,458,458,-86,315,778,5,2,52,275,198,366,24,1424,340
1517,24,1.4.371,0,646,1,86,371,457,371,0,457,457,-51,280,743,5,2,86,275,244,366,25,1424,325
1517,24,2.4.320,0,595,0,90,320,410,312,8,410,411,0,229,692,5,2,90,275,324,366,25,1424,325
1517,24,3.4.408,0,683,3,46,408,454,408,0,454,454,-88,317,780,5,2,46,275,129,366,25,1424,325
1517,24,4.3.411,1,595,0,50,411,461,411,0,461,461,-3,205,695,4,6,51,50,209,256,25,1424,325
1517,24,5.4.406,0,681,2,52,406,458,406,0,458,458,-86,315,778,5,2,52,275,198,366,25,1424,325
1517,25,1.4.371,0,646,2,86,371,457,371,0,457,461,-51,280,746,5,2,86,275,244,366,26,1424,275
1517,25,2.4.320,1,595,0,90,320,410,312,8,410,461,0,229,695,5,2,90,275,324,366,26,1424,275
1517,25,3.4.408,0,683,4,46,408,454,408,0,454,461,-88,317,783,5,2,46,275,129,366,26,1424,275
1517,25,4.4.461,0,600,1,1,461,462,461,0,462,462,-141,370,836,5,2,1,275,209,366,26,1424,275
1517,25,5.4.406,0,681,3,52,406,458,406,0,458,461,-86,315,781,5,2,52,275,198,366,26,1424,275
1517,26,1.4.410,0,595,0,86,410,496,371,39,496,496,0,229,695,5,3,86,185,244,366,27,1424,185
1517,26,3.4.410,0,595,0,46,410,456,408,2,456,461,0,229,695,5,3,46,185,129,366,27,1424,185
1517,26,4.4.461,1,600,1,1,461,462,461,0,462,462,-51,280,746,5,3,1,185,209,366,27,1424,185
1517,26,5.4.410,0,595,0,52,410,462,406,4,462,462,0,229,695,5,3,52,185,198,366,27,1424,185
1517,27,1.4.462,0,600,0,86,462,548,371,91,548,548,0,280,746,5,4,86,184,244,366,28,1424,184
1517,27,3.4.410,1,600,0,46,410,456,408,2,462,462,46,234,700,5,4,46,184,129,366,28,1424,184
1517,27,5.4.462,0,600,0,52,462,514,406,56,514,514,0,280,746,5,4,52,184,198,366,28,1424,184
1517,28,1.4.462,0,600,0,86,462,548,371,91,548,548,0,234,700,5,5,86,138,244,366,29,1424,138
1517,28,5.4.462,1,600,0,52,462,514,406,56,514,514,0,234,700,5,5,52,138,198,366,29,1424,138
1517,29,1.4.514,1,600,0,86,514,600,371,143,600,600,0,234,700,5,6,86,86,244,366,30,1424,86
1518,0,0.0.0,1,570,0,50,0,50,0,0,50,50,0,0,0,1,1,264,386,264,386,1,1487,1487
1518,0,1.0.0,0,570,0,14,0,14,0,0,14,14,0,0,0,1,1,144,386,144,386,1,1487,1487
1518,0,2.0.0,0,609,2,96,0,96,0,0,96,96,0,0,0,1,1,349,386,349,386,1,1487,1487
1518,0,3.0.0,0,570,0,60,0,60,0,0,60,60,0,0,0,1,1,286,386,286,386,1,1487,1487
1518,0,4.0.0,0,623,3,96,0,96,0,0,96,96,0,0,0,1,1,245,386,245,386,1,1487,1487
1518,0,5.0.0,0,591,1,70,0,70,0,0,70,70,0,0,0,1,1,199,386,199,386,1,1487,1487
1518,1,0.1.50,1,570,0,60,50,110,50,0,110,110,-50,50,50,2,1,214,242,264,242,2,1487,1437
1518,1,1.0.50,0,570,0,14,50,64,0,50,64,64,0,0,0,1,2,144,336,144,386,2,1487,1437
1518,1,2.0.50,0,615,2,96,50,146,0,50,146,146,0,0,0,1,2,349,336,349,386,2,1487,1437
1518,1,3.0.50,0,570,0,60,50,110,0,50,110,110,0,0,0,1,2,286,336,286,386,2,1487,1437
1518,1,4.0.50,0,623,3,96,50,146,0,50,146,146,0,0,0,1,2,245,336,245,386,2,1487,1437
1518,1,5.0.50,0,591,1,70,50,120,0,50,120,120,0,0,0,1,2,199,336,199,386,2,1487,1437
1518,2,0.2.110,1,570,0,42,110,152,110,0,152,152,-110,110,160,3,1,154,254,264,254,3,1487,1377
1518,2,1.0.50,0,570,0,14,50,64,0,50,64,110,0,0,50,1,2,144,336,144,386,3,1487,1377
1518,2,2.0.50,0,615,2,96,50,146,0,50,146,146,0,0,50,1,2,349,336,349,386,3,1487,1377
1518,2,3.0.50,0,570,0,60,50,110,0,50,110,110,0,0,50,1,2,286,336,286,386,3,1487,1377
1518,2,4.0.50,0,623,3,96,50,146,0,50,146,146,0,0,50,1,2,245,336,245,386,3,1487,1377
1518,2,5.0.50,0,591,1,70,50,120,0,50,120,120,0,0,50,1,2,199,336,199,386,3,1487,1377
1518,3,0.3.152,1,615,2,68,152,220,152,0,220,220,-152,152,312,4,1,112,210,264,210,4,1487,1335
1518,3,1.0.50,0,570,0,14,50,64,0,50,64,152,0,0,160,1,2,144,336,144,386,4,1487,1335
1518,3,2.0.50,0,615,2,96,50,146,0,50,146,152,0,0,160,1,2,349,336,349,386,4,1487,1335
1518,3,3.0.50,0,570,0,60,50,110,0,50,110,152,0,0,160,1,2,286,336,286,386,4,1487,1335
1518,3,4.0.50,0,623,3,96,50,146,0,50,146,152,0,0,160,1,2,245,336,245,386,4,1487,1335
1518,3,5.0.50,0,591,1,70,50,120,0,50,120,152,0,0,160,1,2,199,336,199,386,4,1487,1335
1518,4,0.4.220,1,615,0,44,220,264,220,0,264,264,-220,220,532,5,1,44,395,264,395,5,1487,1267
1518,4,1.0.50,0,615,0,14,50,64,0,50,64,220,0,0,312,1,2,144,336,144,386,5,1487,1267
1518,4,2.0.50,0,615,0,96,50,146,0,50,146,220,0,0,312,1,2,349,336,349,386,5,1487,1267
1518,4,3.0.50,0,615,0,60,50,110,0,50,110,220,0,0,312,1,2,286,336,286,386,5,1487,1267
1518,4,4.0.50,0,623,1,96,50,146,0,50,146,220,0,0,312,1,2,245,336,245,386,5,1487,1267
1518,4,5.0.50,0,615,0,70,50,120,0,50,120,220,0,0,312,1,2,199,336,199,386,5,1487,1267
1518,5,1.0.50,0,615,0,14,50,64,0,50,64,264,0,0,532,1,2,144,336,144,386,6,1487,1223
1518,5,2.0.50,0,615,0,96,50,146,0,50,146,264,0,0,532,1,2,349,336,349,386,6,1487,1223
1518,5,3.0.50,1,615,0,60,50,110,0,50,110,264,0,0,532,1,2,286,336,286,386,6,1487,1223
1518,5,4.0.50,0,623,1,96,50,146,0,50,146,264,0,0,532,1,2,245,336,245,386,6,1487,1223
1518,5,5.0.50,0,615,0,70,50,120,0,50,120,264,0,0,532,1,2,199,336,199,386,6,1487,1223
1518,6,1.0.110,0,615,0,14,110,124,0,110,124,264,0,0,532,1,3,144,276,144,386,7,1487,1163
1518,6,2.0.110,0,615,0,96,110,206,0,110,206,264,0,0,532,1,3,349,276,349,386,7,1487,1163
1518,6,3.1.110,1,615,0,50,110,160,110,0,160,264,0,50,532,2,2,226,182,286,242,7,1487,1163
1518,6,4.0.110,0,623,1,96,110,206,0,110,206,264,0,0,532,1,3,245,276,245,386,7,1487,1163
1518,6,5.0.110,0,615,0,70,110,180,0,110,180,264,0,0,532,1,3,199,276,199,386,7,1487,1163
1518,7,1.0.110,0,615,0,14,110,124,0,110,124,264,0,0,532,1,3,144,276,144,386,8,1487,1113
1518,7,2.0.110,0,615,0,96,110,206,0,110,206,264,0,0,532,1,3,349,276,349,386,8,1487,1113
1518,7,3.2.160,1,615,0,28,160,188,160,0,188,264,-8,118,540,3,2,176,212,286,254,8,1487,1113
1518,7,4.0.110,0,623,1,96,110,206,0,110,206,264,0,0,532,1,3,245,276,245,386,8,1487,1113
1518,7,5.0.110,0,615,0,70,110,180,0,110,180,264,0,0,532,1,3,199,276,199,386,8,1487,1113
1518,8,1.0.110,0,615,0,14,110,124,0,110,124,264,0,0,540,1,3,144,276,144,386,9,1487,1085
1518,8,2.0.110,0,615,0,96,110,206,0,110,206,264,0,0,540,1,3,349,276,349,386,9,1487,1085
1518,8,3.3.220,1,632,2,61,220,281,188,32,281,281,0,152,540,4,2,148,142,286,210,9,1487,1085
1518,8,4.0.110,0,623,1,96,110,206,0,110,206,264,0,0,540,1,3,245,276,245,386,9,1487,1085
1518,8,5.0.110,0,615,0,70,110,180,0,110,180,264,0,0,540,1,3,199,276,199,386,9,1487,1085
1518,9,1.0.110,0,632,0,14,110,124,0,110,124,281,0,0,540,1,3,144,276,144,386,10,1487,1024
1518,9,2.0.110,0,632,0,96,110,206,0,110,206,281,0,0,540,1,3,349,276,349,386,10,1487,1024
1518,9,3.4.281,1,632,0,87,281,368,281,0,368,368,-17,237,557,5,2,87,351,286,395,10,1487,1024
1518,9,4.0.110,0,632,0,96,110,206,0,110,206,281,0,0,540,1,3,245,276,245,386,10,1487,1024
1518,9,5.0.110,0,632,0,70,110,180,0,110,180,281,0,0,540,1,3,199,276,199,386,10,1487,1024
1518,10,1.0.110,1,632,0,14,110,124,0,110,124,368,0,0,557,1,3,144,276,144,386,11,1487,937
1518,10,2.0.110,0,632,0,96,110,206,0,110,206,368,0,0,557,1,3,349,276,349,386,11,1487,937
1518,10,4.0.110,0,632,0,96,110,206,0,110,206,368,0,0,557,1,3,245,276,245,386,11,1487,937
1518,10,5.0.110,0,632,0,70,110,180,0,110,180,368,0,0,557,1,3,199,276,199,386,11,1487,937
1518,11,1.1.160,1,632,0,21,160,181,124,36,181,368,0,50,557,2,3,130,132,144,242,12,1487,923
1518,11,2.0.124,0,632,0,96,124,220,0,124,220,368,0,0,557,1,4,349,262,349,386,12,1487,923
1518,11,4.0.124,0,632,0,96,124,220,0,124,220,368,0,0,557,1,4,245,262,245,386,12,1487,923
1518,11,5.0.124,0,632,0,70,124,194,0,124,194,368,0,0,557,1,4,199,262,199,386,12,1487,923
1518,12,1.2.188,1,632,0,13,188,201,181,7,201,368,0,118,557,3,3,109,184,144,254,13,1487,902
1518,12,2.0.124,0,632,0,96,124,220,0,124,220,368,0,0,557,1,4,349,262,349,386,13,1487,902
1518,12,4.0.124,0,632,0,96,124,220,0,124,220,368,0,0,557,1,4,245,262,245,386,13,1487,902
1518,12,5.0.124,0,632,0,70,124,194,0,124,194,368,0,0,557,1,4,199,262,199,386,13,1487,902
1518,13,1.3.281,1,632,0,1,281,282,201,80,282,368,0,152,557,4,3,96,81,144,210,14,1487,889
1518,13,2.0.124,0,632,0,96,124,220,0,124,220,368,0,0,557,1,4,349,262,349,386,14,1487,889
1518,13,4.0.124,0,632,0,96,124,220,0,124,220,368,0,0,557,1,4,245,262,245,386,14,1487,889
1518,13,5.0.124,0,632,0,70,124,194,0,124,194,368,0,0,557,1,4,199,262,199,386,14,1487,889
1518,14,1.4.368,1,632,0,95,368,463,282,86,463,463,0,237,557,5,3,95,264,144,395,15,1487,888
1518,14,2.0.124,0,632,0,96,124,220,0,124,220,368,0,0,557,1,4,349,262,349,386,15,1487,888
1518,14,4.0.124,0,632,0,96,124,220,0,124,220,368,0,0,557,1,4,245,262,245,386,15,1487,888
1518,14,5.0.124,0,632,0,70,124,194,0,124,194,368,0,0,557,1,4,199,262,199,386,15,1487,888
1518,15,2.0.124,1,632,0,96,124,220,0,124,220,463,0,0,557,1,4,349,262,349,386,16,1487,793
1518,15,4.0.124,0,632,0,96,124,220,0,124,220,463,0,0,557,1,4,245,262,245,386,16,1487,793
1518,15,5.0.124,0,632,0,70,124,194,0,124,194,463,0,0,557,1,4,199,262,199,386,16,1487,793
1518,16,2.1.220,1,632,0,89,220,309,220,0,309,463,-39,89,596,2,4,253,111,349,242,17,1487,697
1518,16,4.0.220,0,632,0,96,220,316,0,220,316,463,0,0,557,1,5,245,166,245,386,17,1487,697
1518,16,5.0.220,0,632,0,70,220,290,0,220,290,463,0,0,557,1,5,199,166,199,386,17,1487,697
1518,17,2.2.309,1,632,0,91,309,400,309,0,400,463,-108,226,704,3,4,164,171,349,254,18,1487,608
1518,17,4.0.220,0,632,0,96,220,316,0,220,316,463,0,0,596,1,5,245,166,245,386,18,1487,608
1518,17,5.0.220,0,632,0,70,220,290,0,220,290,463,0,0,596,1,5,199,166,199,386,18,1487,608
1518,18,2.3.400,1,632,0,17,400,417,400,0,417,463,-118,270,822,4,4,73,80,349,210,19,1487,517
1518,18,4.0.220,0,632,0,96,220,316,0,220,316,463,0,0,704,1,5,245,166,245,386,19,1487,517
1518,18,5.0.220,0,632,0,70,220,290,0,220,290,463,0,0,704,1,5,199,166,199,386,19,1487,517
1518,19,2.4.463,1,632,0,56,463,519,417,46,519,519,0,237,822,5,4,56,169,349,395,20,1487,500
1518,19,4.0.220,0,632,0,96,220,316,0,220,316,463,0,0,822,1,5,245,166,245,386,20,1487,500
1518,19,5.0.220,0,632,0,70,220,290,0,220,290,463,0,0,822,1,5,199,166,199,386,20,1487,500
1518,20,4.0.220,0,632,0,96,220,316,0,220,316,519,0,0,822,1,5,245,166,245,386,21,1487,444
1518,20,5.0.220,1,632,0,70,220,290,0,220,290,519,0,0,822,1,5,199,166,199,386,21,1487,444
1518,21,4.0.290,0,632,0,96,290,386,0,290,386,519,0,0,822,1,6,245,96,245,386,22,1487,374
1518,21,5.1.309,1,632,0,2,309,311,290,19,311,519,0,89,822,2,5,129,22,199,242,22,1487,374
1518,22,4.0.290,1,632,0,96,290,386,0,290,386,519,0,0,822,1,6,245,96,245,386,23,1487,372
1518,22,5.2.400,0,632,0,64,400,464,311,89,464,519,0,226,822,3,5,127,80,199,254,23,1487,372
1518,23,4.1.386,1,632,0,20,386,406,386,0,406,519,-75,164,897,2,6,149,20,245,242,24,1487,276
1518,23,5.2.400,0,632,0,64,400,464,311,89,464,519,0,226,822,3,5,127,80,199,254,24,1487,276
1518,24,4.2.406,1,632,0,16,406,422,406,0,422,519,-6,232,903,3,5,129,80,245,254,25,1487,256
1518,24,5.2.400,0,632,0,64,400,464,311,89,464,519,0,226,897,3,5,127,80,199,254,25,1487,256
1518,25,4.3.422,1,632,0,43,422,465,422,0,465,519,-5,275,908,4,5,113,63,245,210,26,1487,240
1518,25,5.2.422,0,632,0,64,422,486,311,111,486,519,0,232,903,3,6,127,64,199,254,26,1487,240
1518,26,4.4.519,0,632,0,70,519,589,465,54,589,589,0,237,908,5,5,70,113,245,395,27,1487,197
1518,26,5.2.422,1,632,0,64,422,486,311,111,486,519,0,232,908,3,6,127,64,199,254,27,1487,197
1518,27,4.4.519,0,632,0,70,519,589,465,54,589,589,0,237,908,5,5,70,113,245,395,28,1487,133
1518,27,5.3.486,1,632,0,20,486,506,486,0,506,519,-21,296,929,4,6,63,20,199,210,28,1487,133
1518,28,4.4.519,1,632,0,70,519,589,465,54,589,589,0,237,929,5,5,70,113,245,395,29,1487,113
1518,28,5.4.519,0,632,0,43,519,562,506,13,562,562,0,237,929,5,5,43,113,199,395,29,1487,113
1518,29,5.4.589,1,632,0,43,589,632,506,83,632,632,0,237,929,5,6,43,43,199,395,30,1487,43
1519,0,0.0.0,0,546,3,63,0,63,0,0,63,63,0,0,0,1,1,308,303,308,303,1,1459,1459
1519,0,1.0.0,0,586,5,89,0,89,0,0,89,89,0,0,0,1,1,242,303,242,303,1,1459,1459
1519,0,2.0.0,0,526,2,43,0,43,0,0,43,43,0,0,0,1,1,277,303,277,303,1,1459,1459
1519,0,3.0.0,1,497,0,14,0,14,0,0,14,14,0,0,0,1,1,247,303,247,303,1,1459,1459
1519,0,4.0.0,0,508,1,19,0,19,0,0,19,19,0,0,0,1,1,185,303,185,303,1,1459,1459
1519,0,5.0.0,0,572,4,75,0,75,0,0,75,75,0,0,0,1,1,200,303,200,303,1,1459,1459
1519,1,0.0.14,0,497,0,63,14,77,0,14,77,77,0,0,0,1,2,308,289,308,303,2,1459,1445
1519,1,1.0.14,0,524,4,89,14,103,0,14,103,103,0,0,0,1,2,242,289,242,303,2,1459,1445
1519,1,2.0.14,1,500,2,43,14,57,0,14,57,57,0,0,0,1,2,277,289,277,303,2,1459,1445
1519,1,3.1.14,0,497,0,88,14,102,14,0,102,102,-14,14,14,2,1,233,442,247,442,2,1459,1445
1519,1,4.0.14,0,498,1,19,14,33,0,14,33,33,0,0,0,1,2,185,289,185,303,2,1459,1445
1519,1,5.0.14,0,516,3,75,14,89,0,14,89,89,0,0,0,1,2,200,289,200,303,2,1459,1445
1519,2,0.0.57,0,515,1,63,57,120,0,57,120,120,0,0,0,1,3,308,246,308,303,3,1459,1402
1519,2,1.0.57,0,555,4,89,57,146,0,57,146,146,0,0,0,1,3,242,246,242,303,3,1459,1402
1519,2,2.1.57,0,540,2,83,57,140,57,0,140,140,-57,57,57,2,1,234,442,277,442,3,1459,1402
1519,2,3.1.14,0,500,0,88,14,102,14,0,102,102,-14,14,14,2,1,233,442,247,442,3,1459,1402
1519,2,4.0.57,1,500,0,19,57,76,0,57,76,76,0,0,0,1,3,185,246,185,303,3,1459,1402
1519,2,5.0.57,0,541,3,75,57,132,0,57,132,132,0,0,0,1,3,200,246,200,303,3,1459,1402
1519,3,0.0.76,1,500,0,63,76,139,0,76,139,139,0,0,0,1,4,308,227,308,303,4,1459,1383
1519,3,1.0.76,0,552,3,89,76,165,0,76,165,165,0,0,0,1,4,242,227,242,303,4,1459,1383
1519,3,2.1.57,0,540,2,83,57,140,57,0,140,140,-57,57,57,2,1,234,442,277,442,4,1459,1383
1519,3,3.1.14,0,500,0,88,14,102,14,0,102,102,-14,14,14,2,1,233,442,247,442,4,1459,1383
1519,3,4.1.76,0,559,4,71,76,147,76,0,147,147,-76,76,76,2,1,166,442,185,442,4,1459,1383
1519,3,5.0.76,0,538,1,75,76,151,0,76,151,151,0,0,0,1,4,200,227,200,303,4,1459,1383
1519,4,0.1.139,0,534,2,28,139,167,139,0,167,167,-139,139,139,2,1,245,442,308,442,5,1459,1320
1519,4,1.0.139,0,500,0,89,139,228,0,139,228,228,0,0,0,1,5,242,164,242,303,5,1459,1320
1519,4,2.1.57,0,540,3,83,57,140,57,0,140,140,-57,57,57,2,1,234,442,277,442,5,1459,1320
1519,4,3.1.14,0,500,0,88,14,102,14,0,102,139,-14,14,14,2,1,233,442,247,442,5,1459,1320
1519,4,4.1.76,0,559,4,71,76,147,76,0,147,147,-76,76,76,2,1,166,442,185,442,5,1459,1320
1519,4,5.0.139,1,516,1,75,139,214,0,139,214,214,0,0,0,1,5,200,164,200,303,5,1459,1320
1519,5,0.1.139,0,534,2,28,139,167,139,0,167,214,-139,139,139,2,1,245,442,308,442,6,1459,1245
1519,5,1.0.214,1,516,0,89,214,303,0,214,303,303,0,0,0,1,6,242,89,242,303,6,1459,1245
1519,5,2.1.57,0,540,3,83,57,140,57,0,140,214,-57,57,57,2,1,234,442,277,442,6,1459,1245
1519,5,3.1.14,0,516,0,88,14,102,14,0,102,214,-14,14,14,2,1,233,442,247,442,6,1459,1245
1519,5,4.1.76,0,559,4,71,76,147,76,0,147,214,-76,76,76,2,1,166,442,185,442,6,1459,1245
1519,5,5.1.214,0,531,1,84,214,298,214,0,298,298,-214,214,214,2,1,125,442,200,442,6,1459,1245
1519,6,0.1.139,0,534,2,28,139,167,139,0,167,303,-139,139,139,2,1,245,442,308,442,7,1459,1156
1519,6,1.1.303,0,516,0,88,303,391,303,0,391,391,-303,303,303,2,1,153,442,242,442,7,1459,1156
1519,6,2.1.57,0,540,3,83,57,140,57,0,140,303,-57,57,57,2,1,234,442,277,442,7,1459,1156
1519,6,3.1.14,1,516,0,88,14,102,14,0,102,303,-14,14,14,2,1,233,442,247,442,7,1459,1156
1519,6,4.1.76,0,559,4,71,76,147,76,0,147,303,-76,76,76,2,1,166,442,185,442,7,1459,1156
1519,6,5.1.214,0,531,1,84,214,298,214,0,298,303,-214,214,214,2,1,125,442,200,442,7,1459,1156
1519,7,0.1.139,0,534,2,28,139,167,139,0,167,303,-37,51,51,2,2,245,354,308,442,8,1459,1068
1519,7,1.1.303,0,516,0,88,303,391,303,0,391,391,-201,215,215,2,2,153,354,242,442,8,1459,1068
1519,7,2.1.102,0,531,1,83,102,185,57,45,185,303,0,14,14,2,2,234,354,277,442,8,1459,1068
1519,7,3.2.102,1,516,0,95,102,197,102,0,197,303,-102,102,116,3,1,145,223,247,223,8,1459,1068
1519,7,4.1.102,0,516,0,71,102,173,76,26,173,303,0,14,14,2,2,166,354,185,442,8,1459,1068
1519,7,5.1.214,0,531,1,84,214,298,214,0,298,303,-112,126,126,2,2,125,354,200,442,8,1459,1068
1519,8,0.1.139,0,534,2,28,139,167,139,0,167,303,-37,51,153,2,2,245,354,308,442,9,1459,973
1519,8,1.1.303,0,516,0,88,303,391,303,0,391,391,-201,215,317,2,2,153,354,242,442,9,1459,973
1519,8,2.1.102,0,531,1,83,102,185,57,45,185,303,0,14,116,2,2,234,354,277,442,9,1459,973
1519,8,3.3.197,1,516,0,20,197,217,197,0,217,303,-197,197,313,4,1,50,263,247,263,9,1459,973
1519,8,4.1.102,0,516,0,71,102,173,76,26,173,303,0,14,116,2,2,166,354,185,442,9,1459,973
1519,8,5.1.214,0,531,1,84,214,298,214,0,298,303,-112,126,228,2,2,125,354,200,442,9,1459,973
1519,9,0.1.139,0,534,2,28,139,167,139,0,167,303,-37,51,350,2,2,245,354,308,442,10,1459,953
1519,9,1.1.303,0,516,0,88,303,391,303,0,391,391,-201,215,514,2,2,153,354,242,442,10,1459,953
1519,9,2.1.102,0,531,1,83,102,185,57,45,185,303,0,14,313,2,2,234,354,277,442,10,1459,953
1519,9,3.4.217,1,516,0,30,217,247,217,0,247,303,-217,217,530,5,1,30,228,247,228,10,1459,953
1519,9,4.1.102,0,516,0,71,102,173,76,26,173,303,0,14,313,2,2,166,354,185,442,10,1459,953
1519,9,5.1.214,0,531,1,84,214,298,214,0,298,303,-112,126,425,2,2,125,354,200,442,10,1459,953
1519,10,0.1.139,1,534,2,28,139,167,139,0,167,303,-37,51,567,2,2,245,354,308,442,11,1459,923
1519,10,1.1.303,0,516,0,88,303,391,303,0,391,391,-201,215,731,2,2,153,354,242,442,11,1459,923
1519,10,2.1.102,0,531,1,83,102,185,57,45,185,303,0,14,530,2,2,234,354,277,442,11,1459,923
1519,10,4.1.102,0,516,0,71,102,173,76,26,173,303,0,14,530,2,2,166,354,185,442,11,1459,923
1519,10,5.1.214,0,531,1,84,214,298,214,0,298,303,-112,126,642,2,2,125,354,200,442,11,1459,923
1519,11,0.2.197,1,534,0,45,197,242,167,30,242,303,0,102,567,3,2,217,128,308,223,12,1459,895
1519,11,1.1.303,0,591,1,88,303,391,303,0,391,391,-136,187,703,2,3,153,326,242,442,12,1459,895
1519,11,2.1.167,0,534,0,83,167,250,57,110,250,303,0,51,567,2,3,234,326,277,442,12,1459,895
1519,11,4.1.167,0,534,0,71,167,238,76,91,238,303,0,51,567,2,3,166,326,185,442,12,1459,895
1519,11,5.1.214,0,605,2,84,214,298,214,0,298,303,-47,98,614,2,3,125,326,200,442,12,1459,895
1519,12,0.3.242,1,534,0,75,242,317,242,0,317,317,-25,222,592,4,2,172,243,308,263,13,1459,850
1519,12,1.1.303,0,591,1,88,303,391,303,0,391,391,-136,187,703,2,3,153,326,242,442,13,1459,850
1519,12,2.1.167,0,534,0,83,167,250,57,110,250,303,0,51,567,2,3,234,326,277,442,13,1459,850
1519,12,4.1.167,0,534,0,71,167,238,76,91,238,303,0,51,567,2,3,166,326,185,442,13,1459,850
1519,12,5.1.214,0,605,2,84,214,298,214,0,298,303,-47,98,614,2,3,125,326,200,442,13,1459,850
1519,13,0.4.317,1,534,0,97,317,414,317,0,414,414,-70,287,662,5,2,97,198,308,228,14,1459,775
1519,13,1.1.303,0,591,1,88,303,391,303,0,391,391,-136,187,728,2,3,153,326,242,442,14,1459,775
1519,13,2.1.167,0,534,0,83,167,250,57,110,250,317,0,51,592,2,3,234,326,277,442,14,1459,775
1519,13,4.1.167,0,534,0,71,167,238,76,91,238,317,0,51,592,2,3,166,326,185,442,14,1459,775
1519,13,5.1.214,0,605,2,84,214,298,214,0,298,317,-47,98,639,2,3,125,326,200,442,14,1459,775
1519,14,1.1.303,0,591,1,88,303,391,303,0,391,414,-136,187,798,2,3,153,326,242,442,15,1459,678
1519,14,2.1.167,1,534,0,83,167,250,57,110,250,414,0,51,662,2,3,234,326,277,442,15,1459,678
1519,14,4.1.167,0,534,0,71,167,238,76,91,238,414,0,51,662,2,3,166,326,185,442,15,1459,678
1519,14,5.1.214,0,605,2,84,214,298,214,0,298,414,-47,98,709,2,3,125,326,200,442,15,1459,678
1519,15,1.1.303,0,591,2,88,303,391,303,0,391,414,-53,104,715,2,4,153,243,242,442,16,1459,595
1519,15,2.2.250,1,534,0,45,250,295,250,0,295,414,-8,110,670,3,3,151,83,277,223,16,1459,595
1519,15,4.1.250,0,534,0,71,250,321,76,174,321,414,0,51,662,2,4,166,243,185,442,16,1459,595
1519,15,5.1.250,0,558,1,84,250,334,214,36,334,414,0,51,662,2,4,125,243,200,442,16,1459,595
1519,16,1.1.303,0,591,2,88,303,391,303,0,391,414,-53,104,723,2,4,153,243,242,442,17,1459,550
1519,16,2.3.317,1,534,0,85,317,402,295,22,402,414,0,222,670,4,3,106,168,277,263,17,1459,550
1519,16,4.1.250,0,534,0,71,250,321,76,174,321,414,0,51,670,2,4,166,243,185,442,17,1459,550
1519,16,5.1.250,0,558,1,84,250,334,214,36,334,414,0,51,670,2,4,125,243,200,442,17,1459,550
1519,17,1.1.303,0,591,2,88,303,391,303,0,391,414,-53,104,723,2,4,153,243,242,442,18,1459,465
1519,17,2.4.414,1,534,0,21,414,435,402,12,435,435,0,287,670,5,3,21,101,277,228,18,1459,465
1519,17,4.1.250,0,534,0,71,250,321,76,174,321,414,0,51,670,2,4,166,243,185,442,18,1459,465
1519,17,5.1.250,0,558,1,84,250,334,214,36,334,414,0,51,670,2,4,125,243,200,442,18,1459,465
1519,18,1.1.303,0,591,2,88,303,391,303,0,391,435,-53,104,723,2,4,153,243,242,442,19,1459,444
1519,18,4.1.250,1,534,0,71,250,321,76,174,321,435,0,51,670,2,4,166,243,185,442,19,1459,444
1519,18,5.1.250,0,558,1,84,250,334,214,36,334,435,0,51,670,2,4,125,243,200,442,19,1459,444
1519,19,1.1.321,0,534,0,88,321,409,303,18,409,435,0,51,670,2,5,153,172,242,442,20,1459,373
1519,19,4.2.321,1,534,0,17,321,338,321,0,338,435,-26,136,696,3,4,95,38,185,223,20,1459,373
1519,19,5.1.321,0,558,1,84,321,405,214,107,405,435,0,51,670,2,5,125,172,200,442,20,1459,373
1519,20,1.1.321,0,534,0,88,321,409,303,18,409,435,0,51,696,2,5,153,172,242,442,21,1459,356
1519,20,4.3.402,1,534,0,37,402,439,338,64,439,439,0,222,696,4,4,78,83,185,263,21,1459,356
1519,20,5.1.321,0,558,1,84,321,405,214,107,405,435,0,51,696,2,5,125,172,200,442,21,1459,356
1519,21,1.1.321,0,534,0,88,321,409,303,18,409,439,0,51,696,2,5,153,172,242,442,22,1459,319
1519,21,4.4.439,1,534,0,41,439,480,439,0,480,480,-4,291,700,5,4,41,80,185,228,22,1459,319
1519,21,5.1.321,0,558,1,84,321,405,214,107,405,439,0,51,696,2,5,125,172,200,442,22,1459,319
1519,22,1.1.321,0,534,0,88,321,409,303,18,409,480,0,51,700,2,5,153,172,242,442,23,1459,278
1519,22,5.1.321,1,558,1,84,321,405,214,107,405,480,0,51,700,2,5,125,172,200,442,23,1459,278
1519,23,1.1.405,0,558,0,88,405,493,303,102,493,493,0,51,700,2,6,153,88,242,442,24,1459,194
1519,23,5.2.405,1,558,0,3,405,408,405,0,408,480,-67,203,767,3,5,41,21,200,223,24,1459,194
1519,24,1.1.405,0,558,0,88,405,493,303,102,493,493,0,51,767,2,6,153,88,242,442,25,1459,191
1519,24,5.3.439,1,558,0,4,439,443,408,31,443,480,0,222,767,4,5,38,46,200,263,25,1459,191
1519,25,1.1.405,0,558,0,88,405,493,303,102,493,493,0,51,767,2,6,153,88,242,442,26,1459,187
1519,25,5.4.480,1,558,0,34,480,514,443,37,514,514,0,291,767,5,5,34,39,200,228,26,1459,187
1519,26,1.1.405,1,558,0,88,405,493,303,102,493,514,0,51,767,2,6,153,88,242,442,27,1459,153
1519,27,1.2.493,1,558,0,18,493,511,493,0,511,514,-85,288,852,3,6,65,18,242,223,28,1459,65
1519,28,1.3.511,1,558,0,42,511,553,511,0,553,553,-68,290,920,4,6,47,42,242,263,29,1459,47
1519,29,1.4.553,1,558,0,5,553,558,553,0,558,558,-39,330,959,5,6,5,5,242,228,30,1459,5
1520,0,0.0.0,0,653,0,76,0,76,0,0,76,76,0,0,0,1,1,352,417,352,417,1,1726,1726
1520,0,1.0.0,0,653,0,65,0,65,0,0,65,65,0,0,0,1,1,243,417,243,417,1,1726,1726
1520,0,2.0.0,1,672,2,88,0,88,0,0,88,88,0,0,0,1,1,402,417,402,417,1,1726,1726
1520,0,3.0.0,0,653,0,67,0,67,0,0,67,67,0,0,0,1,1,304,417,304,417,1,1726,1726
1520,0,4.0.0,0,678,3,41,0,41,0,0,41,41,0,0,0,1,1,123,417,123,417,1,1726,1726
1520,0,5.0.0,0,664,1,80,0,80,0,0,80,80,0,0,0,1,1,302,417,302,417,1,1726,1726
1520,1,0.0.88,0,689,2,76,88,164,0,88,164,164,0,0,0,1,2,352,329,352,417,2,1726,1638
1520,1,1.0.88,0,672,0,65,88,153,0,88,153,153,0,0,0,1,2,243,329,243,417,2,1726,1638
1520,1,2.1.88,1,672,0,77,88,165,88,0,165,165,-88,88,88,2,1,314,348,402,348,2,1726,1638
1520,1,3.0.88,0,680,1,67,88,155,0,88,155,155,0,0,0,1,2,304,329,304,417,2,1726,1638
1520,1,4.0.88,0,692,3,41,88,129,0,88,129,129,0,0,0,1,2,123,329,123,417,2,1726,1638
1520,1,5.0.88,0,689,2,80,88,168,0,88,168,168,0,0,0,1,2,302,329,302,417,2,1726,1638
1520,2,0.0.88,0,689,2,76,88,164,0,88,164,165,0,0,88,1,2,352,329,352,417,3,1726,1561
1520,2,1.0.88,0,672,0,65,88,153,0,88,153,165,0,0,88,1,2,243,329,243,417,3,1726,1561
1520,2,2.2.165,1,689,2,97,165,262,165,0,262,262,-165,165,253,3,1,237,288,402,288,3,1726,1561
1520,2,3.0.88,0,680,1,67,88,155,0,88,155,165,0,0,88,1,2,304,329,304,417,3,1726,1561
1520,2,4.0.88,0,692,3,41,88,129,0,88,129,165,0,0,88,1,2,123,329,123,417,3,1726,1561
1520,2,5.0.88,0,689,2,80,88,168,0,88,168,168,0,0,88,1,2,302,329,302,417,3,1726,1561
1520,3,0.0.88,0,689,0,76,88,164,0,88,164,262,0,0,253,1,2,352,329,352,417,4,1726,1464
1520,3,1.0.88,0,689,0,65,88,153,0,88,153,262,0,0,253,1,2,243,329,243,417,4,1726,1464
1520,3,2.3.262,1,689,0,54,262,316,262,0,316,316,-262,262,515,4,1,140,416,402,416,4,1726,1464
1520,3,3.0.88,0,689,0,67,88,155,0,88,155,262,0,0,253,1,2,304,329,304,417,4,1726,1464
1520,3,4.0.88,0,692,1,41,88,129,0,88,129,262,0,0,253,1,2,123,329,123,417,4,1726,1464
1520,3,5.0.88,0,689,0,80,88,168,0,88,168,262,0,0,253,1,2,302,329,302,417,4,1726,1464
1520,4,0.0.88,0,689,0,76,88,164,0,88,164,316,0,0,515,1,2,352,329,352,417,5,1726,1410
1520,4,1.0.88,0,689,0,65,88,153,0,88,153,316,0,0,515,1,2,243,329,243,417,5,1726,1410
1520,4,2.4.316,1,689,0,86,316,402,316,0,402,402,-316,316,831,5,1,86,257,402,257,5,1726,1410
1520,4,3.0.88,0,689,0,67,88,155,0,88,155,316,0,0,515,1,2,304,329,304,417,5,1726,1410
1520,4,4.0.88,0,692,1,41,88,129,0,88,129,316,0,0,515,1,2,123,329,123,417,5,1726,1410
1520,4,5.0.88,0,689,0,80,88,168,0,88,168,316,0,0,515,1,2,302,329,302,417,5,1726,1410
1520,5,0.0.88,1,689,0,76,88,164,0,88,164,402,0,0,831,1,2,352,329,352,417,6,1726,1324
1520,5,1.0.88,0,689,0,65,88,153,0,88,153,402,0,0,831,1,2,243,329,243,417,6,1726,1324
1520,5,3.0.88,0,689,0,67,88,155,0,88,155,402,0,0,831,1,2,304,329,304,417,6,1726,1324
1520,5,4.0.88,0,692,1,41,88,129,0,88,129,402,0,0,831,1,2,123,329,123,417,6,1726,1324
1520,5,5.0.88,0,689,0,80,88,168,0,88,168,402,0,0,831,1,2,302,329,302,417,6,1726,1324
1520,6,0.1.165,0,689,0,96,165,261,164,1,261,402,0,88,831,2,2,276,271,352,348,7,1726,1248
1520,6,1.0.164,0,689,0,65,164,229,0,164,229,402,0,0,831,1,3,243,253,243,417,7,1726,1248
1520,6,3.0.164,1,689,0,67,164,231,0,164,231,402,0,0,831,1,3,304,253,304,417,7,1726,1248
1520,6,4.0.164,0,689,0,41,164,205,0,164,205,402,0,0,831,1,3,123,253,123,417,7,1726,1248
1520,6,5.0.164,0,689,0,80,164,244,0,164,244,402,0,0,831,1,3,302,253,302,417,7,1726,1248
1520,7,0.1.165,0,689,0,96,165,261,164,1,261,402,0,88,831,2,2,276,271,352,348,8,1726,1181
1520,7,1.0.231,0,689,0,65,231,296,0,231,296,402,0,0,831,1,4,243,186,243,417,8,1726,1181
1520,7,3.1.231,0,697,1,26,231,257,231,0,257,402,-66,154,897,2,2,237,271,304,348,8,1726,1181
1520,7,4.0.231,0,689,0,41,231,272,0,231,272,402,0,0,831,1,4,123,186,123,417,8,1726,1181
1520,7,5.0.231,1,689,0,80,231,311,0,231,311,402,0,0,831,1,4,302,186,302,417,8,1726,1181
1520,8,0.1.165,0,689,0,96,165,261,164,1,261,402,0,88,831,2,2,276,271,352,348,9,1726,1101
1520,8,1.0.311,1,689,0,65,311,376,0,311,376,402,0,0,831,1,5,243,106,243,417,9,1726,1101
1520,8,3.1.231,0,697,1,26,231,257,231,0,257,402,-66,154,897,2,2,237,271,304,348,9,1726,1101
1520,8,4.0.311,0,689,0,41,311,352,0,311,352,402,0,0,831,1,5,123,106,123,417,9,1726,1101
1520,8,5.1.311,0,689,0,68,311,379,311,0,379,402,-146,234,977,2,2,222,271,302,348,9,1726,1101
1520,9,0.1.165,0,689,0,96,165,261,164,1,261,402,0,88,831,2,2,276,271,352,348,10,1726,1036
1520,9,1.1.376,0,689,0,57,376,433,376,0,433,433,-211,299,1042,2,2,178,271,243,348,10,1726,1036
1520,9,3.1.231,0,697,1,26,231,257,231,0,257,402,-66,154,897,2,2,237,271,304,348,10,1726,1036
1520,9,4.0.376,1,689,0,41,376,417,0,376,417,417,0,0,831,1,6,123,41,123,417,10,1726,1036
1520,9,5.1.311,0,689,0,68,311,379,311,0,379,402,-146,234,977,2,2,222,271,302,348,10,1726,1036
1520,10,0.1.165,0,689,0,96,165,261,164,1,261,417,0,88,831,2,2,276,271,352,348,11,1726,995
1520,10,1.1.376,0,689,0,57,376,433,376,0,433,433,-211,299,1042,2,2,178,271,243,348,11,1726,995
1520,10,3.1.231,1,697,1,26,231,257,231,0,257,417,-66,154,897,2,2,237,271,304,348,11,1726,995
1520,10,4.1.417,0,689,0,24,417,441,417,0,441,441,-252,340,1083,2,2,82,271,123,348,11,1726,995
1520,10,5.1.311,0,689,0,68,311,379,311,0,379,417,-146,234,977,2,2,222,271,302,348,11,1726,995
1520,11,0.1.257,0,697,0,96,257,353,164,93,353,417,0,154,897,2,3,276,245,352,348,12,1726,969
1520,11,1.1.376,0,697,0,57,376,433,376,0,433,433,-119,273,1016,2,3,178,245,243,348,12,1726,969
1520,11,3.2.262,1,697,0,62,262,324,257,5,324,417,0,165,897,3,2,211,191,304,288,12,1726,969
1520,11,4.1.417,0,720,1,24,417,441,417,0,441,441,-160,314,1057,2,3,82,245,123,348,12,1726,969
1520,11,5.1.311,0,730,2,68,311,379,311,0,379,417,-54,208,951,2,3,222,245,302,348,12,1726,969
1520,12,0.1.257,1,697,0,96,257,353,164,93,353,417,0,154,897,2,3,276,245,352,348,13,1726,907
1520,12,1.1.376,0,697,0,57,376,433,376,0,433,433,-119,273,1016,2,3,178,245,243,348,13,1726,907
1520,12,3.3.324,0,697,0,78,324,402,324,0,402,417,-8,270,905,4,2,149,362,304,416,13,1726,907
1520,12,4.1.417,0,720,1,24,417,441,417,0,441,441,-160,314,1057,2,3,82,245,123,348,13,1726,907
1520,12,5.1.311,0,730,2,68,311,379,311,0,379,417,-54,208,951,2,3,222,245,302,348,13,1726,907
1520,13,0.2.353,1,697,0,48,353,401,353,0,401,417,-29,194,926,3,3,180,129,352,288,14,1726,811
1520,13,1.1.376,0,697,0,57,376,433,376,0,433,433,-23,177,920,2,4,178,149,243,348,14,1726,811
1520,13,3.3.324,0,697,0,78,324,402,324,0,402,417,-8,270,905,4,2,149,362,304,416,14,1726,811
1520,13,4.1.417,0,720,1,24,417,441,417,0,441,441,-64,218,961,2,4,82,149,123,348,14,1726,811
1520,13,5.1.353,0,697,0,68,353,421,311,42,421,421,0,154,897,2,4,222,149,302,348,14,1726,811
1520,14,0.3.401,0,774,2,82,401,483,401,0,483,483,-85,347,1011,4,2,132,362,352,416,15,1726,763
1520,14,1.1.376,0,697,0,57,376,433,376,0,433,433,-23,177,949,2,4,178,149,243,348,15,1726,763
1520,14,3.3.324,0,697,0,78,324,402,324,0,402,417,-8,270,934,4,2,149,362,304,416,15,1726,763
1520,14,4.1.417,0,720,1,24,417,441,417,0,441,441,-64,218,990,2,4,82,149,123,348,15,1726,763
1520,14,5.1.353,1,697,0,68,353,421,311,42,421,421,0,154,926,2,4,222,149,302,348,15,1726,763
1520,15,0.3.401,0,774,1,82,401,483,401,0,483,483,-85,347,1011,4,2,132,362,352,416,16,1726,695
1520,15,1.1.421,0,697,0,57,421,478,376,45,478,478,0,154,926,2,5,178,81,243,348,16,1726,695
1520,15,3.3.324,0,697,0,78,324,402,324,0,402,421,-8,270,934,4,2,149,362,304,416,16,1726,695
1520,15,4.1.421,0,697,0,24,421,445,417,4,445,445,0,154,926,2,5,82,81,123,348,16,1726,695
1520,15,5.2.421,1,697,0,41,421,462,421,0,462,462,-20,214,946,3,4,154,81,302,288,16,1726,695
1520,16,0.3.401,0,774,2,82,401,483,401,0,483,483,-85,347,1031,4,2,132,362,352,416,17,1726,654
1520,16,1.1.421,1,697,0,57,421,478,376,45,478,478,0,154,946,2,5,178,81,243,348,17,1726,654
1520,16,3.3.324,0,697,0,78,324,402,324,0,402,462,-8,270,954,4,2,149,362,304,416,17,1726,654
1520,16,4.1.421,0,697,0,24,421,445,417,4,445,462,0,154,946,2,5,82,81,123,348,17,1726,654
1520,16,5.3.462,0,757,1,88,462,550,462,0,550,550,-146,408,1092,4,2,113,362,302,416,17,1726,654
1520,17,0.3.401,0,774,2,82,401,483,401,0,483,483,-85,347,1031,4,2,132,362,352,416,18,1726,597
1520,17,1.2.478,1,697,0,23,478,501,478,0,501,501,-16,230,962,3,5,121,40,243,288,18,1726,597
1520,17,3.3.324,0,697,0,78,324,402,324,0,402,478,-8,270,954,4,2,149,362,304,416,18,1726,597
1520,17,4.1.478,0,697,0,24,478,502,417,61,502,502,0,154,946,2,6,82,24,123,348,18,1726,597
1520,17,5.3.462,0,757,1,88,462,550,462,0,550,550,-146,408,1092,4,2,113,362,302,416,18,1726,597
1520,18,0.3.401,0,774,3,82,401,483,401,0,483,501,-85,347,1047,4,2,132,362,352,416,19,1726,574
1520,18,1.3.501,0,714,1,84,501,585,501,0,585,585,-185,447,1147,4,2,98,362,243,416,19,1726,574
1520,18,3.3.324,0,697,0,78,324,402,324,0,402,501,-8,270,970,4,2,149,362,304,416,19,1726,574
1520,18,4.1.478,1,697,0,24,478,502,417,61,502,502,0,154,962,2,6,82,24,123,348,19,1726,574
1520,18,5.3.462,0,757,2,88,462,550,462,0,550,550,-146,408,1108,4,2,113,362,302,416,19,1726,574
1520,19,0.3.401,0,774,3,82,401,483,401,0,483,502,-85,347,1047,4,2,132,362,352,416,20,1726,550
1520,19,1.3.501,0,714,1,84,501,585,501,0,585,585,-185,447,1147,4,2,98,362,243,416,20,1726,550
1520,19,3.3.324,0,697,0,78,324,402,324,0,402,502,-8,270,970,4,2,149,362,304,416,20,1726,550
1520,19,4.2.502,1,697,0,17,502,519,502,0,519,519,-1,231,963,3,6,58,17,123,288,20,1726,550
1520,19,5.3.462,0,757,2,88,462,550,462,0,550,550,-146,408,1108,4,2,113,362,302,416,20,1726,550
1520,20,0.3.401,0,774,4,82,401,483,401,0,483,519,-85,347,1048,4,2,132,362,352,416,21,1726,533
1520,20,1.3.501,0,714,1,84,501,585,501,0,585,585,-185,447,1148,4,2,98,362,243,416,21,1726,533
1520,20,3.3.324,1,697,0,78,324,402,324,0,402,519,-8,270,971,4,2,149,362,304,416,21,1726,533
1520,20,4.3.519,0,735,2,30,519,549,519,0,549,549,-203,465,1166,4,2,41,362,123,416,21,1726,533
1520,20,5.3.462,0,757,3,88,462,550,462,0,550,550,-146,408,1109,4,2,113,362,302,416,21,1726,533
1520,21,0.3.402,0,697,0,82,402,484,401,1,484,519,0,270,971,4,3,132,284,352,416,22,1726,455
1520,21,1.3.501,0,714,1,84,501,585,501,0,585,585,-99,369,1070,4,3,98,284,243,416,22,1726,455
1520,21,3.4.402,1,697,0,71,402,473,402,0,473,519,0,316,971,5,2,71,171,304,257,22,1726,455
1520,21,4.3.519,0,735,2,30,519,549,519,0,549,549,-117,387,1088,4,3,41,284,123,416,22,1726,455
1520,21,5.3.462,0,757,3,88,462,550,462,0,550,550,-60,330,1031,4,3,113,284,302,416,22,1726,455
1520,22,0.3.402,1,697,0,82,402,484,401,1,484,519,0,270,971,4,3,132,284,352,416,23,1726,384
1520,22,1.3.501,0,714,1,84,501,585,501,0,585,585,-99,369,1070,4,3,98,284,243,416,23,1726,384
1520,22,4.3.519,0,735,2,30,519,549,519,0,549,549,-117,387,1088,4,3,41,284,123,416,23,1726,384
1520,22,5.3.462,0,757,3,88,462,550,462,0,550,550,-60,330,1031,4,3,113,284,302,416,23,1726,384
1520,23,0.4.484,1,697,0,50,484,534,484,0,534,534,-11,327,982,5,3,50,100,352,257,24,1726,302
1520,23,1.3.501,0,714,1,84,501,585,501,0,585,585,-17,287,988,4,4,98,202,243,416,24,1726,302
1520,23,4.3.519,0,735,2,30,519,549,519,0,549,549,-35,305,1006,4,4,41,202,123,416,24,1726,302
1520,23,5.3.484,0,697,0,88,484,572,462,22,572,572,0,270,971,4,4,113,202,302,416,24,1726,302
1520,24,1.3.501,0,714,1,84,501,585,501,0,585,585,-17,287,999,4,4,98,202,243,416,25,1726,252
1520,24,4.3.519,0,735,2,30,519,549,519,0,549,549,-35,305,1017,4,4,41,202,123,416,25,1726,252
1520,24,5.3.484,1,697,0,88,484,572,462,22,572,572,0,270,982,4,4,113,202,302,416,25,1726,252
1520,25,1.3.572,0,697,0,84,572,656,501,71,656,656,0,270,982,4,5,98,114,243,416,26,1726,164
1520,25,4.3.572,0,700,1,30,572,602,519,53,602,602,0,270,982,4,5,41,114,123,416,26,1726,164
1520,25,5.4.572,1,697,0,25,572,597,572,0,597,597,-38,365,1020,5,4,25,50,302,257,26,1726,164
1520,26,1.3.572,0,697,0,84,572,656,501,71,656,656,0,270,1020,4,5,98,114,243,416,27,1726,139
1520,26,4.3.572,1,700,1,30,572,602,519,53,602,602,0,270,1020,4,5,41,114,123,416,27,1726,139
1520,27,1.3.602,0,700,0,84,602,686,501,101,686,686,0,270,1020,4,6,98,84,243,416,28,1726,109
1520,27,4.4.602,1,700,0,11,602,613,602,0,613,613,-5,370,1025,5,5,11,25,123,257,28,1726,109
1520,28,1.3.602,1,700,0,84,602,686,501,101,686,686,0,270,1025,4,6,98,84,243,416,29,1726,98
1520,29,1.4.686,1,700,0,14,686,700,686,0,700,700,-73,443,1098,5,6,14,14,243,257,30,1726,14
1521,0,0.0.0,0,543,2,89,0,89,0,0,89,89,0,0,0,1,1,296,332,296,332,1,1397,1397
1521,0,1.0.0,0,539,1,41,0,41,0,0,41,41,0,0,0,1,1,144,332,144,332,1,1397,1397
1521,0,2.0.0,1,529,0,35,0,35,0,0,35,35,0,0,0,1,1,231,332,231,332,1,1397,1397
1521,0,3.0.0,0,529,0,21,0,21,0,0,21,21,0,0,0,1,1,165,332,165,332,1,1397,1397
1521,0,4.0.0,0,549,3,62,0,62,0,0,62,62,0,0,0,1,1,258,332,258,332,1,1397,1397
1521,0,5.0.0,0,550,4,84,0,84,0,0,84,84,0,0,0,1,1,303,332,303,332,1,1397,1397
1521,1,0.0.35,0,535,1,89,35,124,0,35,124,124,0,0,0,1,2,296,297,296,332,2,1397,1362
1521,1,1.0.35,0,539,2,41,35,76,0,35,76,76,0,0,0,1,2,144,297,144,332,2,1397,1362
1521,1,2.1.35,0,529,0,70,35,105,35,0,105,105,-35,35,35,2,1,196,349,231,349,2,1397,1362
1521,1,3.0.35,1,529,0,21,35,56,0,35,56,56,0,0,0,1,2,165,297,165,332,2,1397,1362
1521,1,4.0.35,0,539,2,62,35,97,0,35,97,97,0,0,0,1,2,258,297,258,332,2,1397,1362
1521,1,5.0.35,0,539,2,84,35,119,0,35,119,119,0,0,0,1,2,303,297,303,332,2,1397,1362
1521,2,0.0.56,0,529,0,89,56,145,0,56,145,145,0,0,0,1,3,296,276,296,332,3,1397,1341
1521,2,1.0.56,0,539,1,41,56,97,0,56,97,97,0,0,0,1,3,144,276,144,332,3,1397,1341
1521,2,2.1.35,0,529,0,70,35,105,35,0,105,105,-35,35,35,2,1,196,349,231,349,3,1397,1341
1521,2,3.1.56,0,541,2,64,56,120,56,0,120,120,-56,56,56,2,1,144,349,165,349,3,1397,1341
1521,2,4.0.56,1,555,3,62,56,118,0,56,118,118,0,0,0,1,3,258,276,258,332,3,1397,1341
1521,2,5.0.56,0,539,1,84,56,140,0,56,140,140,0,0,0,1,3,303,276,303,332,3,1397,1341
1521,3,0.0.118,0,563,3,89,118,207,0,118,207,207,0,0,0,1,4,296,214,296,332,4,1397,1279
1521,3,1.0.118,0,562,2,41,118,159,0,118,159,159,0,0,0,1,4,144,214,144,332,4,1397,1279
1521,3,2.1.35,0,559,1,70,35,105,35,0,105,118,-35,35,35,2,1,196,349,231,349,4,1397,1279
1521,3,3.1.56,0,555,0,64,56,120,56,0,120,120,-56,56,56,2,1,144,349,165,349,4,1397,1279
1521,3,4.1.118,0,559,1,75,118,193,118,0,193,193,-118,118,118,2,1,196,349,258,349,4,1397,1279
1521,3,5.0.118,1,555,0,84,118,202,0,118,202,202,0,0,0,1,4,303,214,303,332,4,1397,1279
1521,4,0.0.202,1,564,2,89,202,291,0,202,291,291,0,0,0,1,5,296,130,296,332,5,1397,1195
1521,4,1.0.202,0,555,0,41,202,243,0,202,243,243,0,0,0,1,5,144,130,144,332,5,1397,1195
1521,4,2.1.35,0,559,1,70,35,105,35,0,105,202,-35,35,35,2,1,196,349,231,349,5,1397,1195
1521,4,3.1.56,0,555,0,64,56,120,56,0,120,202,-56,56,56,2,1,144,349,165,349,5,1397,1195
1521,4,4.1.118,0,559,1,75,118,193,118,0,193,202,-118,118,118,2,1,196,349,258,349,5,1397,1195
1521,4,5.1.202,0,555,0,51,202,253,202,0,253,253,-202,202,202,2,1,219,349,303,349,5,1397,1195
1521,5,0.1.291,0,571,1,64,291,355,291,0,355,355,-291,291,291,2,1,207,349,296,349,6,1397,1106
1521,5,1.0.291,1,564,0,41,291,332,0,291,332,332,0,0,0,1,6,144,41,144,332,6,1397,1106
1521,5,2.1.35,0,564,0,70,35,105,35,0,105,291,-35,35,35,2,1,196,349,231,349,6,1397,1106
1521,5,3.1.56,0,564,0,64,56,120,56,0,120,291,-56,56,56,2,1,144,349,165,349,6,1397,1106
1521,5,4.1.118,0,564,0,75,118,193,118,0,193,291,-118,118,118,2,1,196,349,258,349,6,1397,1106
1521,5,5.1.202,0,564,0,51,202,253,202,0,253,291,-202,202,202,2,1,219,349,303,349,6,1397,1106
1521,6,0.1.291,0,571,1,64,291,355,291,0,355,355,-291,291,291,2,1,207,349,296,349,7,1397,1065
1521,6,1.1.332,0,564,0,25,332,357,332,0,357,357,-332,332,332,2,1,103,349,144,349,7,1397,1065
1521,6,2.1.35,1,564,0,70,35,105,35,0,105,332,-35,35,35,2,1,196,349,231,349,7,1397,1065
1521,6,3.1.56,0,564,0,64,56,120,56,0,120,332,-56,56,56,2,1,144,349,165,349,7,1397,1065
1521,6,4.1.118,0,564,0,75,118,193,118,0,193,332,-118,118,118,2,1,196,349,258,349,7,1397,1065
1521,6,5.1.202,0,564,0,51,202,253,202,0,253,332,-202,202,202,2,1,219,349,303,349,7,1397,1065
1521,7,0.1.291,0,571,1,64,291,355,291,0,355,355,-186,221,221,2,2,207,279,296,349,8,1397,995
1521,7,1.1.332,0,564,0,25,332,357,332,0,357,357,-227,262,262,2,2,103,279,144,349,8,1397,995
1521,7,2.2.105,1,564,0,51,105,156,105,0,156,332,-105,105,140,3,1,126,259,231,259,8,1397,995
1521,7,3.1.105,0,564,0,64,105,169,56,49,169,332,0,35,35,2,2,144,279,165,349,8,1397,995
1521,7,4.1.118,0,564,0,75,118,193,118,0,193,332,-13,48,48,2,2,196,279,258,349,8,1397,995
1521,7,5.1.202,0,564,0,51,202,253,202,0,253,332,-97,132,132,2,2,219,279,303,349,8,1397,995
1521,8,0.1.291,0,571,1,64,291,355,291,0,355,355,-186,221,326,2,2,207,279,296,349,9,1397,944
1521,8,1.1.332,0,564,0,25,332,357,332,0,357,357,-227,262,367,2,2,103,279,144,349,9,1397,944
1521,8,2.3.156,1,564,0,23,156,179,156,0,179,332,-156,156,296,4,1,75,270,231,270,9,1397,944
1521,8,3.1.105,0,564,0,64,105,169,56,49,169,332,0,35,140,2,2,144,279,165,349,9,1397,944
1521,8,4.1.118,0,564,0,75,118,193,118,0,193,332,-13,48,153,2,2,196,279,258,349,9,1397,944
1521,8,5.1.202,0,564,0,51,202,253,202,0,253,332,-97,132,237,2,2,219,279,303,349,9,1397,944
1521,9,0.1.291,0,571,1,64,291,355,291,0,355,355,-186,221,482,2,2,207,279,296,349,10,1397,921
1521,9,1.1.332,0,564,0,25,332,357,332,0,357,357,-227,262,523,2,2,103,279,144,349,10,1397,921
1521,9,2.4.179,1,564,0,52,179,231,179,0,231,332,-179,179,475,5,1,52,187,231,187,10,1397,921
1521,9,3.1.105,0,564,0,64,105,169,56,49,169,332,0,35,296,2,2,144,279,165,349,10,1397,921
1521,9,4.1.118,0,564,0,75,118,193,118,0,193,332,-13,48,309,2,2,196,279,258,349,10,1397,921
1521,9,5.1.202,0,564,0,51,202,253,202,0,253,332,-97,132,393,2,2,219,279,303,349,10,1397,921
1521,10,0.1.291,0,571,1,64,291,355,291,0,355,355,-186,221,661,2,2,207,279,296,349,11,1397,869
1521,10,1.1.332,0,564,0,25,332,357,332,0,357,357,-227,262,702,2,2,103,279,144,349,11,1397,869
1521,10,3.1.105,1,564,0,64,105,169,56,49,169,332,0,35,475,2,2,144,279,165,349,11,1397,869
1521,10,4.1.118,0,564,0,75,118,193,118,0,193,332,-13,48,488,2,2,196,279,258,349,11,1397,869
1521,10,5.1.202,0,564,0,51,202,253,202,0,253,332,-97,132,572,2,2,219,279,303,349,11,1397,869
1521,11,0.1.291,0,587,1,64,291,355,291,0,355,355,-122,157,597,2,3,207,215,296,349,12,1397,805
1521,11,1.1.332,0,564,0,25,332,357,332,0,357,357,-163,198,638,2,3,103,215,144,349,12,1397,805
1521,11,3.2.169,1,564,0,30,169,199,169,0,199,332,-13,118,488,3,2,80,208,165,259,12,1397,805
1521,11,4.1.169,0,564,0,75,169,244,118,51,244,332,0,35,475,2,3,196,215,258,349,12,1397,805
1521,11,5.1.202,0,564,0,51,202,253,202,0,253,332,-33,68,508,2,3,219,215,303,349,12,1397,805
1521,12,0.1.291,0,587,1,64,291,355,291,0,355,355,-122,157,610,2,3,207,215,296,349,13,1397,775
1521,12,1.1.332,0,564,0,25,332,357,332,0,357,357,-163,198,651,2,3,103,215,144,349,13,1397,775
1521,12,3.3.199,1,564,0,37,199,236,199,0,236,332,-20,176,508,4,2,50,247,165,270,13,1397,775
1521,12,4.1.169,0,564,0,75,169,244,118,51,244,332,0,35,488,2,3,196,215,258,349,13,1397,775
1521,12,5.1.202,0,564,0,51,202,253,202,0,253,332,-33,68,521,2,3,219,215,303,349,13,1397,775
1521,13,0.1.291,0,587,1,64,291,355,291,0,355,355,-122,157,630,2,3,207,215,296,349,14,1397,738
1521,13,1.1.332,0,564,0,25,332,357,332,0,357,357,-163,198,671,2,3,103,215,144,349,14,1397,738
1521,13,3.4.236,1,564,0,13,236,249,236,0,249,332,-5,184,513,5,2,13,135,165,187,14,1397,738
1521,13,4.1.169,0,564,0,75,169,244,118,51,244,332,0,35,508,2,3,196,215,258,349,14,1397,738
1521,13,5.1.202,0,564,0,51,202,253,202,0,253,332,-33,68,541,2,3,219,215,303,349,14,1397,738
1521,14,0.1.291,0,587,1,64,291,355,291,0,355,355,-122,157,635,2,3,207,215,296,349,15,1397,725
1521,14,1.1.332,0,564,0,25,332,357,332,0,357,357,-163,198,676,2,3,103,215,144,349,15,1397,725
1521,14,4.1.169,1,564,0,75,169,244,118,51,244,332,0,35,513,2,3,196,215,258,349,15,1397,725
1521,14,5.1.202,0,564,0,51,202,253,202,0,253,332,-33,68,546,2,3,219,215,303,349,15,1397,725
1521,15,0.1.291,0,610,1,64,291,355,291,0,355,355,-47,82,560,2,4,207,140,296,349,16,1397,650
1521,15,1.1.332,0,564,0,25,332,357,332,0,357,357,-88,123,601,2,4,103,140,144,349,16,1397,650
1521,15,4.2.244,1,564,0,18,244,262,244,0,262,332,-45,163,558,3,3,121,178,258,259,16,1397,650
1521,15,5.1.244,0,564,0,51,244,295,202,42,295,332,0,35,513,2,4,219,140,303,349,16,1397,650
1521,16,0.1.291,0,610,1,64,291,355,291,0,355,355,-47,82,605,2,4,207,140,296,349,17,1397,632
1521,16,1.1.332,0,564,0,25,332,357,332,0,357,357,-88,123,646,2,4,103,140,144,349,17,1397,632
1521,16,4.3.262,1,564,0,23,262,285,262,0,285,332,-26,202,584,4,3,103,210,258,270,17,1397,632
1521,16,5.1.244,0,564,0,51,244,295,202,42,295,332,0,35,558,2,4,219,140,303,349,17,1397,632
1521,17,0.1.291,0,610,1,64,291,355,291,0,355,355,-47,82,631,2,4,207,140,296,349,18,1397,609
1521,17,1.1.332,0,564,0,25,332,357,332,0,357,357,-88,123,672,2,4,103,140,144,349,18,1397,609
1521,17,4.4.285,1,564,0,80,285,365,285,0,365,365,-36,220,620,5,3,80,122,258,187,18,1397,609
1521,17,5.1.244,0,564,0,51,244,295,202,42,295,332,0,35,584,2,4,219,140,303,349,18,1397,609
1521,18,0.1.291,0,610,1,64,291,355,291,0,355,365,-47,82,667,2,4,207,140,296,349,19,1397,529
1521,18,1.1.332,0,564,0,25,332,357,332,0,357,365,-88,123,708,2,4,103,140,144,349,19,1397,529
1521,18,5.1.244,1,564,0,51,244,295,202,42,295,365,0,35,620,2,4,219,140,303,349,19,1397,529
1521,19,0.1.295,1,564,0,64,295,359,291,4,359,365,0,35,620,2,5,207,89,296,349,20,1397,478
1521,19,1.1.332,0,564,0,25,332,357,332,0,357,365,-37,72,657,2,5,103,89,144,349,20,1397,478
1521,19,5.2.295,0,564,0,79,295,374,295,0,374,374,-33,196,653,3,4,168,160,303,259,20,1397,478
1521,20,0.2.359,0,614,1,52,359,411,359,0,411,411,-97,260,717,3,4,143,160,296,259,21,1397,414
1521,20,1.1.359,1,564,0,25,359,384,332,27,384,384,0,35,620,2,6,103,25,144,349,21,1397,414
1521,20,5.2.295,0,564,0,79,295,374,295,0,374,374,-33,196,653,3,4,168,160,303,259,21,1397,414
1521,21,0.2.359,0,614,1,52,359,411,359,0,411,411,-97,260,717,3,4,143,160,296,259,22,1397,389
1521,21,1.2.384,0,564,0,29,384,413,384,0,413,413,-122,285,742,3,4,78,160,144,259,22,1397,389
1521,21,5.2.295,1,564,0,79,295,374,295,0,374,384,-33,196,653,3,4,168,160,303,259,22,1397,389
1521,22,0.2.374,1,572,1,52,374,426,359,15,426,426,0,196,653,3,5,143,81,296,259,23,1397,310
1521,22,1.2.384,0,564,0,29,384,413,384,0,413,413,-10,206,663,3,5,78,81,144,259,23,1397,310
1521,22,5.3.374,0,564,0,73,374,447,374,0,447,447,-89,291,742,4,4,89,187,303,270,23,1397,310
1521,23,0.3.426,0,629,1,88,426,514,426,0,514,514,-141,343,794,4,4,91,187,296,270,24,1397,258
1521,23,1.2.426,1,572,0,29,426,455,384,42,455,455,0,196,653,3,6,78,29,144,259,24,1397,258
1521,23,5.3.374,0,572,0,73,374,447,374,0,447,447,-89,291,742,4,4,89,187,303,270,24,1397,258
1521,24,0.3.426,0,629,1,88,426,514,426,0,514,514,-141,343,794,4,4,91,187,296,270,25,1397,229
1521,24,1.3.455,0,572,0,26,455,481,455,0,481,481,-170,372,823,4,4,49,187,144,270,25,1397,229
1521,24,5.3.374,1,572,0,73,374,447,374,0,447,455,-89,291,742,4,4,89,187,303,270,25,1397,229
1521,25,0.3.447,0,584,1,88,447,535,426,21,535,535,0,291,742,4,5,91,114,296,270,26,1397,156
1521,25,1.3.455,0,572,0,26,455,481,455,0,481,481,-8,299,750,4,5,49,114,144,270,26,1397,156
1521,25,5.4.447,1,572,0,16,447,463,447,0,463,463,-82,302,824,5,4,16,42,303,187,26,1397,156
1521,26,0.3.447,0,584,1,88,447,535,426,21,535,535,0,291,824,4,5,91,114,296,270,27,1397,140
1521,26,1.3.455,1,572,0,26,455,481,455,0,481,481,-8,299,832,4,5,49,114,144,270,27,1397,140
1521,27,0.3.481,0,572,0,88,481,569,426,55,569,569,0,299,832,4,6,91,88,296,270,28,1397,114
1521,27,1.4.481,1,572,0,23,481,504,481,0,504,504,-18,320,850,5,5,23,26,144,187,28,1397,114
1521,28,0.3.481,1,572,0,88,481,569,426,55,569,569,0,299,850,4,6,91,88,296,270,29,1397,91
1521,29,0.4.569,1,572,0,3,569,572,569,0,572,572,-65,385,915,5,6,3,3,296,187,30,1397,3
1522,0,0.0.0,1,520,0,3,0,3,0,0,3,3,0,0,0,1,1,240,345,240,345,1,1464,1464
1522,0,1.0.0,0,536,1,16,0,16,0,0,16,16,0,0,0,1,1,241,345,241,345,1,1464,1464
1522,0,2.0.0,0,578,2,80,0,80,0,0,80,80,0,0,0,1,1,257,345,257,345,1,1464,1464
1522,0,3.0.0,0,593,3,73,0,73,0,0,73,73,0,0,0,1,1,322,345,322,345,1,1464,1464
1522,0,4.0.0,0,604,5,84,0,84,0,0,84,84,0,0,0,1,1,198,345,198,345,1,1464,1464
1522,0,5.0.0,0,594,4,89,0,89,0,0,89,89,0,0,0,1,1,206,345,206,345,1,1464,1464
1522,1,0.1.3,1,520,0,32,3,35,3,0,35,35,-3,3,3,2,1,237,253,240,253,2,1464,1461
1522,1,1.0.3,0,520,0,16,3,19,0,3,19,19,0,0,0,1,2,241,342,241,345,2,1464,1461
1522,1,2.0.3,0,520,0,80,3,83,0,3,83,83,0,0,0,1,2,257,342,257,345,2,1464,1461
1522,1,3.0.3,0,521,1,73,3,76,0,3,76,76,0,0,0,1,2,322,342,322,345,2,1464,1461
1522,1,4.0.3,0,560,3,84,3,87,0,3,87,87,0,0,0,1,2,198,342,198,345,2,1464,1461
1522,1,5.0.3,0,552,2,89,3,92,0,3,92,92,0,0,0,1,2,206,342,206,345,2,1464,1461
1522,2,0.2.35,1,520,0,55,35,90,35,0,90,90,-35,35,38,3,1,205,226,240,226,3,1464,1429
1522,2,1.0.3,0,520,0,16,3,19,0,3,19,35,0,0,3,1,2,241,342,241,345,3,1464,1429
1522,2,2.0.3,0,520,0,80,3,83,0,3,83,83,0,0,3,1,2,257,342,257,345,3,1464,1429
1522,2,3.0.3,0,521,1,73,3,76,0,3,76,76,0,0,3,1,2,322,342,322,345,3,1464,1429
1522,2,4.0.3,0,560,3,84,3,87,0,3,87,87,0,0,3,1,2,198,342,198,345,3,1464,1429
1522,2,5.0.3,0,552,2,89,3,92,0,3,92,92,0,0,3,1,2,206,342,206,345,3,1464,1429
1522,3,0.3.90,1,520,0,95,90,185,90,0,185,185,-90,90,128,4,1,150,423,240,423,4,1464,1374
1522,3,1.0.3,0,520,0,16,3,19,0,3,19,90,0,0,38,1,2,241,342,241,345,4,1464,1374
1522,3,2.0.3,0,520,0,80,3,83,0,3,83,90,0,0,38,1,2,257,342,257,345,4,1464,1374
1522,3,3.0.3,0,521,1,73,3,76,0,3,76,90,0,0,38,1,2,322,342,322,345,4,1464,1374
1522,3,4.0.3,0,560,3,84,3,87,0,3,87,90,0,0,38,1,2,198,342,198,345,4,1464,1374
1522,3,5.0.3,0,552,2,89,3,92,0,3,92,92,0,0,38,1,2,206,342,206,345,4,1464,1374
1522,4,0.4.185,1,520,0,55,185,240,185,0,240,240,-185,185,313,5,1,55,217,240,217,5,1464,1279
1522,4,1.0.3,0,520,0,16,3,19,0,3,19,185,0,0,128,1,2,241,342,241,345,5,1464,1279
1522,4,2.0.3,0,520,0,80,3,83,0,3,83,185,0,0,128,1,2,257,342,257,345,5,1464,1279
1522,4,3.0.3,0,521,1,73,3,76,0,3,76,185,0,0,128,1,2,322,342,322,345,5,1464,1279
1522,4,4.0.3,0,560,3,84,3,87,0,3,87,185,0,0,128,1,2,198,342,198,345,5,1464,1279
1522,4,5.0.3,0,552,2,89,3,92,0,3,92,185,0,0,128,1,2,206,342,206,345,5,1464,1279
1522,5,1.0.3,1,520,0,16,3,19,0,3,19,240,0,0,313,1,2,241,342,241,345,6,1464,1224
1522,5,2.0.3,0,520,0,80,3,83,0,3,83,240,0,0,313,1,2,257,342,257,345,6,1464,1224
1522,5,3.0.3,0,521,1,73,3,76,0,3,76,240,0,0,313,1,2,322,342,322,345,6,1464,1224
1522,5,4.0.3,0,560,3,84,3,87,0,3,87,240,0,0,313,1,2,198,342,198,345,6,1464,1224
1522,5,5.0.3,0,552,2,89,3,92,0,3,92,240,0,0,313,1,2,206,342,206,345,6,1464,1224
1522,6,1.1.35,1,520,0,92,35,127,19,16,127,240,0,3,313,2,2,225,221,241,253,7,1464,1208
1522,6,2.0.19,0,520,0,80,19,99,0,19,99,240,0,0,313,1,3,257,326,257,345,7,1464,1208
1522,6,3.0.19,0,525,1,73,19,92,0,19,92,240,0,0,313,1,3,322,326,322,345,7,1464,1208
1522,6,4.0.19,0,520,0,84,19,103,0,19,103,240,0,0,313,1,3,198,326,198,345,7,1464,1208
1522,6,5.0.19,0,531,2,89,19,108,0,19,108,240,0,0,313,1,3,206,326,206,345,7,1464,1208
1522,7,1.2.127,1,520,0,34,127,161,127,0,161,240,-37,72,350,3,2,133,171,241,226,8,1464,1116
1522,7,2.0.19,0,520,0,80,19,99,0,19,99,240,0,0,313,1,3,257,326,257,345,8,1464,1116
1522,7,3.0.19,0,525,1,73,19,92,0,19,92,240,0,0,313,1,3,322,326,322,345,8,1464,1116
1522,7,4.0.19,0,520,0,84,19,103,0,19,103,240,0,0,313,1,3,198,326,198,345,8,1464,1116
1522,7,5.0.19,0,531,2,89,19,108,0,19,108,240,0,0,313,1,3,206,326,206,345,8,1464,1116
1522,8,1.3.185,1,520,0,67,185,252,161,24,252,252,0,90,350,4,2,99,328,241,423,9,1464,1082
1522,8,2.0.19,0,520,0,80,19,99,0,19,99,240,0,0,350,1,3,257,326,257,345,9,1464,1082
1522,8,3.0.19,0,525,1,73,19,92,0,19,92,240,0,0,350,1,3,322,326,322,345,9,1464,1082
1522,8,4.0.19,0,520,0,84,19,103,0,19,103,240,0,0,350,1,3,198,326,198,345,9,1464,1082
1522,8,5.0.19,0,531,2,89,19,108,0,19,108,240,0,0,350,1,3,206,326,206,345,9,1464,1082
1522,9,1.4.252,1,520,0,32,252,284,252,0,284,284,-12,197,362,5,2,32,162,241,217,10,1464,1015
1522,9,2.0.19,0,520,0,80,19,99,0,19,99,252,0,0,350,1,3,257,326,257,345,10,1464,1015
1522,9,3.0.19,0,525,1,73,19,92,0,19,92,252,0,0,350,1,3,322,326,322,345,10,1464,1015
1522,9,4.0.19,0,520,0,84,19,103,0,19,103,252,0,0,350,1,3,198,326,198,345,10,1464,1015
1522,9,5.0.19,0,531,2,89,19,108,0,19,108,252,0,0,350,1,3,206,326,206,345,10,1464,1015
1522,10,2.0.19,0,520,0,80,19,99,0,19,99,284,0,0,362,1,3,257,326,257,345,11,1464,983
1522,10,3.0.19,1,525,1,73,19,92,0,19,92,284,0,0,362,1,3,322,326,322,345,11,1464,983
1522,10,4.0.19,0,520,0,84,19,103,0,19,103,284,0,0,362,1,3,198,326,198,345,11,1464,983
1522,10,5.0.19,0,531,2,89,19,108,0,19,108,284,0,0,362,1,3,206,326,206,345,11,1464,983
1522,11,2.0.92,0,525,0,80,92,172,0,92,172,284,0,0,362,1,4,257,253,257,345,12,1464,910
1522,11,3.1.127,1,525,0,3,127,130,92,35,130,284,0,3,362,2,3,249,129,322,253,12,1464,910
1522,11,4.0.92,0,525,0,84,92,176,0,92,176,284,0,0,362,1,4,198,253,198,345,12,1464,910
1522,11,5.0.92,0,525,0,89,92,181,0,92,181,284,0,0,362,1,4,206,253,206,345,12,1464,910
1522,12,2.0.92,0,525,0,80,92,172,0,92,172,284,0,0,362,1,4,257,253,257,345,13,1464,907
1522,12,3.2.161,1,525,0,96,161,257,130,31,257,284,0,72,362,3,3,246,137,322,226,13,1464,907
1522,12,4.0.92,0,525,0,84,92,176,0,92,176,284,0,0,362,1,4,198,253,198,345,13,1464,907
1522,12,5.0.92,0,525,0,89,92,181,0,92,181,284,0,0,362,1,4,206,253,206,345,13,1464,907
1522,13,2.0.92,0,525,0,80,92,172,0,92,172,284,0,0,362,1,4,257,253,257,345,14,1464,811
1522,13,3.3.257,1,525,0,96,257,353,257,0,353,353,-5,95,367,4,3,150,261,322,423,14,1464,811
1522,13,4.0.92,0,525,0,84,92,176,0,92,176,284,0,0,362,1,4,198,253,198,345,14,1464,811
1522,13,5.0.92,0,525,0,89,92,181,0,92,181,284,0,0,362,1,4,206,253,206,345,14,1464,811
1522,14,2.0.92,0,525,0,80,92,172,0,92,172,353,0,0,367,1,4,257,253,257,345,15,1464,715
1522,14,3.4.353,1,525,0,54,353,407,353,0,407,407,-69,266,436,5,3,54,130,322,217,15,1464,715
1522,14,4.0.92,0,525,0,84,92,176,0,92,176,353,0,0,367,1,4,198,253,198,345,15,1464,715
1522,14,5.0.92,0,525,0,89,92,181,0,92,181,353,0,0,367,1,4,206,253,206,345,15,1464,715
1522,15,2.0.92,1,525,0,80,92,172,0,92,172,407,0,0,436,1,4,257,253,257,345,16,1464,661
1522,15,4.0.92,0,525,0,84,92,176,0,92,176,407,0,0,436,1,4,198,253,198,345,16,1464,661
1522,15,5.0.92,0,525,0,89,92,181,0,92,181,407,0,0,436,1,4,206,253,206,345,16,1464,661
1522,16,2.1.172,1,525,0,64,172,236,172,0,236,407,-42,45,478,2,4,177,126,257,253,17,1464,581
1522,16,4.0.172,0,525,0,84,172,256,0,172,256,407,0,0,436,1,5,198,173,198,345,17,1464,581
1522,16,5.0.172,0,525,0,89,172,261,0,172,261,407,0,0,436,1,5,206,173,206,345,17,1464,581
1522,17,2.2.257,1,525,0,4,257,261,236,21,261,407,0,72,478,3,4,113,41,257,226,18,1464,517
1522,17,4.0.172,0,525,0,84,172,256,0,172,256,407,0,0,478,1,5,198,173,198,345,18,1464,517
1522,17,5.0.172,0,525,0,89,172,261,0,172,261,407,0,0,478,1,5,206,173,206,345,18,1464,517
1522,18,2.3.353,1,525,0,91,353,444,261,92,444,444,0,95,478,4,4,109,165,257,423,19,1464,513
1522,18,4.0.172,0,525,0,84,172,256,0,172,256,407,0,0,478,1,5,198,173,198,345,19,1464,513
1522,18,5.0.172,0,525,0,89,172,261,0,172,261,407,0,0,478,1,5,206,173,206,345,19,1464,513
1522,19,2.4.444,1,525,0,18,444,462,444,0,462,462,-37,303,515,5,4,18,76,257,217,20,1464,422
1522,19,4.0.172,0,525,0,84,172,256,0,172,256,444,0,0,478,1,5,198,173,198,345,20,1464,422
1522,19,5.0.172,0,525,0,89,172,261,0,172,261,444,0,0,478,1,5,206,173,206,345,20,1464,422
1522,20,4.0.172,1,525,0,84,172,256,0,172,256,462,0,0,515,1,5,198,173,198,345,21,1464,404
1522,20,5.0.172,0,525,0,89,172,261,0,172,261,462,0,0,515,1,5,206,173,206,345,21,1464,404
1522,21,4.1.256,1,525,0,28,256,284,256,0,284,462,-20,65,535,2,5,114,62,198,253,22,1464,320
1522,21,5.0.256,0,525,0,89,256,345,0,256,345,462,0,0,515,1,6,206,89,206,345,22,1464,320
1522,22,4.2.284,1,525,0,19,284,303,284,0,303,462,-23,95,558,3,5,86,37,198,226,23,1464,292
1522,22,5.0.256,0,525,0,89,256,345,0,256,345,462,0,0,535,1,6,206,89,206,345,23,1464,292
1522,23,4.3.444,1,525,0,16,444,460,303,141,460,462,0,95,558,4,5,67,74,198,423,24,1464,273
1522,23,5.0.256,0,525,0,89,256,345,0,256,345,462,0,0,558,1,6,206,89,206,345,24,1464,273
1522,24,4.4.462,1,525,0,51,462,513,460,2,513,513,0,303,558,5,5,51,58,198,217,25,1464,257
1522,24,5.0.256,0,525,0,89,256,345,0,256,345,462,0,0,558,1,6,206,89,206,345,25,1464,257
1522,25,5.0.256,1,525,0,89,256,345,0,256,345,513,0,0,558,1,6,206,89,206,345,26,1464,206
1522,26,5.1.345,1,525,0,34,345,379,345,0,379,513,-61,126,619,2,6,117,34,206,253,27,1464,117
1522,27,5.2.379,1,525,0,18,379,397,379,0,397,513,-76,171,695,3,6,83,18,206,226,28,1464,83
1522,28,5.3.460,1,525,0,58,460,518,397,63,518,518,0,95,695,4,6,65,58,206,423,29,1464,65
1522,29,5.4.518,1,525,0,7,518,525,518,0,525,525,-5,308,700,5,6,7,7,206,217,30,1464,7
1523,0,0.0.0,0,549,3,17,0,17,0,0,17,17,0,0,0,1,1,186,263,186,263,1,1435,1435
1523,0,1.0.0,0,604,5,91,0,91,0,0,91,91,0,0,0,1,1,241,263,241,263,1,1435,1435
1523,0,2.0.0,1,546,2,27,0,27,0,0,27,27,0,0,0,1,1,283,263,283,263,1,1435,1435
1523,0,3.0.0,0,532,0,27,0,27,0,0,27,27,0,0,0,1,1,282,263,282,263,1,1435,1435
1523,0,4.0.0,0,539,1,7,0,7,0,0,7,7,0,0,0,1,1,136,263,136,263,1,1435,1435
1523,0,5.0.0,0,554,4,94,0,94,0,0,94,94,0,0,0,1,1,307,263,307,263,1,1435,1435
1523,1,0.0.27,0,546,0,17,27,44,0,27,44,44,0,0,0,1,2,186,236,186,263,2,1435,1408
1523,1,1.0.27,0,549,1,91,27,118,0,27,118,118,0,0,0,1,2,241,236,241,263,2,1435,1408
1523,1,2.1.27,0,546,0,57,27,84,27,0,84,84,-27,27,27,2,1,256,353,283,353,2,1435,1408
1523,1,3.0.27,1,546,0,27,27,54,0,27,54,54,0,0,0,1,2,282,236,282,263,2,1435,1408
1523,1,4.0.27,0,546,0,7,27,34,0,27,34,34,0,0,0,1,2,136,236,136,263,2,1435,1408
1523,1,5.0.27,0,546,0,94,27,121,0,27,121,121,0,0,0,1,2,307,236,307,263,2,1435,1408
1523,2,0.0.54,1,546,0,17,54,71,0,54,71,71,0,0,0,1,3,186,209,186,263,3,1435,1381
1523,2,1.0.54,0,546,0,91,54,145,0,54,145,145,0,0,0,1,3,241,209,241,263,3,1435,1381
1523,2,2.1.27,0,546,0,57,27,84,27,0,84,84,-27,27,27,2,1,256,353,283,353,3,1435,1381
1523,2,3.1.54,0,559,1,41,54,95,54,0,95,95,-54,54,54,2,1,255,353,282,353,3,1435,1381
1523,2,4.0.54,0,546,0,7,54,61,0,54,61,61,0,0,0,1,3,136,209,136,263,3,1435,1381
1523,2,5.0.54,0,546,0,94,54,148,0,54,148,148,0,0,0,1,3,307,209,307,263,3,1435,1381
1523,3,0.1.71,0,630,2,99,71,170,71,0,170,170,-71,71,71,2,1,169,353,186,353,4,1435,1364
1523,3,1.0.71,0,546,0,91,71,162,0,71,162,162,0,0,0,1,4,241,192,241,263,4,1435,1364
1523,3,2.1.27,0,546,0,57,27,84,27,0,84,84,-27,27,27,2,1,256,353,283,353,4,1435,1364
1523,3,3.1.54,0,559,1,41,54,95,54,0,95,95,-54,54,54,2,1,255,353,282,353,4,1435,1364
1523,3,4.0.71,1,546,0,7,71,78,0,71,78,78,0,0,0,1,4,136,192,136,263,4,1435,1364
1523,3,5.0.71,0,546,0,94,71,165,0,71,165,165,0,0,0,1,4,307,192,307,263,4,1435,1364
1523,4,0.1.71,0,632,3,99,71,170,71,0,170,170,-71,71,71,2,1,169,353,186,353,5,1435,1357
1523,4,1.0.78,0,546,0,91,78,169,0,78,169,169,0,0,0,1,5,241,185,241,263,5,1435,1357
1523,4,2.1.27,0,546,0,57,27,84,27,0,84,84,-27,27,27,2,1,256,353,283,353,5,1435,1357
1523,4,3.1.54,0,559,1,41,54,95,54,0,95,95,-54,54,54,2,1,255,353,282,353,5,1435,1357
1523,4,4.1.78,0,611,2,79,78,157,78,0,157,157,-78,78,78,2,1,129,353,136,353,5,1435,1357
1523,4,5.0.78,1,546,0,94,78,172,0,78,172,172,0,0,0,1,5,307,185,307,263,5,1435,1357
1523,5,0.1.71,0,632,3,99,71,170,71,0,170,172,-71,71,71,2,1,169,353,186,353,6,1435,1263
1523,5,1.0.172,1,546,0,91,172,263,0,172,263,263,0,0,0,1,6,241,91,241,263,6,1435,1263
1523,5,2.1.27,0,546,0,57,27,84,27,0,84,172,-27,27,27,2,1,256,353,283,353,6,1435,1263
1523,5,3.1.54,0,559,1,41,54,95,54,0,95,172,-54,54,54,2,1,255,353,282,353,6,1435,1263
1523,5,4.1.78,0,611,2,79,78,157,78,0,157,172,-78,78,78,2,1,129,353,136,353,6,1435,1263
1523,5,5.1.172,0,546,0,17,172,189,172,0,189,189,-172,172,172,2,1,213,353,307,353,6,1435,1263
1523,6,0.1.71,0,632,3,99,71,170,71,0,170,263,-71,71,71,2,1,169,353,186,353,7,1435,1172
1523,6,1.1.263,0,546,0,60,263,323,263,0,323,323,-263,263,263,2,1,150,353,241,353,7,1435,1172
1523,6,2.1.27,1,546,0,57,27,84,27,0,84,263,-27,27,27,2,1,256,353,283,353,7,1435,1172
1523,6,3.1.54,0,559,1,41,54,95,54,0,95,263,-54,54,54,2,1,255,353,282,353,7,1435,1172
1523,6,4.1.78,0,611,2,79,78,157,78,0,157,263,-78,78,78,2,1,129,353,136,353,7,1435,1172
1523,6,5.1.172,0,546,0,17,172,189,172,0,189,263,-172,172,172,2,1,213,353,307,353,7,1435,1172
1523,7,0.1.84,0,561,1,99,84,183,71,13,183,263,0,27,27,2,2,169,296,186,353,8,1435,1115
1523,7,1.1.263,0,546,0,60,263,323,263,0,323,323,-179,206,206,2,2,150,296,241,353,8,1435,1115
1523,7,2.2.84,1,546,0,57,84,141,84,0,141,263,-84,84,111,3,1,199,295,283,295,8,1435,1115
1523,7,3.1.84,0,546,0,41,84,125,54,30,125,263,0,27,27,2,2,255,296,282,353,8,1435,1115
1523,7,4.1.84,0,546,0,79,84,163,78,6,163,263,0,27,27,2,2,129,296,136,353,8,1435,1115
1523,7,5.1.172,0,546,0,17,172,189,172,0,189,263,-88,115,115,2,2,213,296,307,353,8,1435,1115
1523,8,0.1.84,0,561,1,99,84,183,71,13,183,263,0,27,111,2,2,169,296,186,353,9,1435,1058
1523,8,1.1.263,0,546,0,60,263,323,263,0,323,323,-179,206,290,2,2,150,296,241,353,9,1435,1058
1523,8,2.3.141,1,546,0,60,141,201,141,0,201,263,-141,141,252,4,1,142,179,283,179,9,1435,1058
1523,8,3.1.84,0,546,0,41,84,125,54,30,125,263,0,27,111,2,2,255,296,282,353,9,1435,1058
1523,8,4.1.84,0,546,0,79,84,163,78,6,163,263,0,27,111,2,2,129,296,136,353,9,1435,1058
1523,8,5.1.172,0,546,0,17,172,189,172,0,189,263,-88,115,199,2,2,213,296,307,353,9,1435,1058
1523,9,0.1.84,0,561,1,99,84,183,71,13,183,263,0,27,252,2,2,169,296,186,353,10,1435,998
1523,9,1.1.263,0,546,0,60,263,323,263,0,323,323,-179,206,431,2,2,150,296,241,353,10,1435,998
1523,9,2.4.201,1,546,0,82,201,283,201,0,283,283,-201,201,453,5,1,82,345,283,345,10,1435,998
1523,9,3.1.84,0,546,0,41,84,125,54,30,125,263,0,27,252,2,2,255,296,282,353,10,1435,998
1523,9,4.1.84,0,546,0,79,84,163,78,6,163,263,0,27,252,2,2,129,296,136,353,10,1435,998
1523,9,5.1.172,0,546,0,17,172,189,172,0,189,263,-88,115,340,2,2,213,296,307,353,10,1435,998
1523,10,0.1.84,0,561,1,99,84,183,71,13,183,283,0,27,453,2,2,169,296,186,353,11,1435,916
1523,10,1.1.263,0,546,0,60,263,323,263,0,323,323,-179,206,632,2,2,150,296,241,353,11,1435,916
1523,10,3.1.84,1,546,0,41,84,125,54,30,125,283,0,27,453,2,2,255,296,282,353,11,1435,916
1523,10,4.1.84,0,546,0,79,84,163,78,6,163,283,0,27,453,2,2,129,296,136,353,11,1435,916
1523,10,5.1.172,0,546,0,17,172,189,172,0,189,283,-88,115,541,2,2,213,296,307,353,11,1435,916
1523,11,0.1.125,0,546,0,99,125,224,71,54,224,283,0,27,453,2,3,169,255,186,353,12,1435,875
1523,11,1.1.263,0,546,0,60,263,323,263,0,323,323,-138,165,591,2,3,150,255,241,353,12,1435,875
1523,11,3.2.141,1,546,0,64,141,205,125,16,205,283,0,84,453,3,2,214,238,282,295,12,1435,875
1523,11,4.1.125,0,546,0,79,125,204,78,47,204,283,0,27,453,2,3,129,255,136,353,12,1435,875
1523,11,5.1.172,0,546,0,17,172,189,172,0,189,283,-47,74,500,2,3,213,255,307,353,12,1435,875
1523,12,0.1.125,0,546,0,99,125,224,71,54,224,283,0,27,453,2,3,169,255,186,353,13,1435,811
1523,12,1.1.263,0,546,0,60,263,323,263,0,323,323,-138,165,591,2,3,150,255,241,353,13,1435,811
1523,12,3.3.205,1,546,0,55,205,260,205,0,260,283,-4,145,457,4,2,150,119,282,179,13,1435,811
1523,12,4.1.125,0,546,0,79,125,204,78,47,204,283,0,27,453,2,3,129,255,136,353,13,1435,811
1523,12,5.1.172,0,546,0,17,172,189,172,0,189,283,-47,74,500,2,3,213,255,307,353,13,1435,811
1523,13,0.1.125,0,546,0,99,125,224,71,54,224,283,0,27,457,2,3,169,255,186,353,14,1435,756
1523,13,1.1.263,0,546,0,60,263,323,263,0,323,323,-138,165,595,2,3,150,255,241,353,14,1435,756
1523,13,3.4.283,1,546,0,95,283,378,260,23,378,378,0,201,457,5,2,95,263,282,345,14,1435,756
1523,13,4.1.125,0,546,0,79,125,204,78,47,204,283,0,27,457,2,3,129,255,136,353,14,1435,756
1523,13,5.1.172,0,546,0,17,172,189,172,0,189,283,-47,74,504,2,3,213,255,307,353,14,1435,756
1523,14,0.1.125,0,546,0,99,125,224,71,54,224,378,0,27,457,2,3,169,255,186,353,15,1435,661
1523,14,1.1.263,0,546,0,60,263,323,263,0,323,378,-138,165,595,2,3,150,255,241,353,15,1435,661
1523,14,4.1.125,0,546,0,79,125,204,78,47,204,378,0,27,457,2,3,129,255,136,353,15,1435,661
1523,14,5.1.172,1,546,0,17,172,189,172,0,189,378,-47,74,504,2,3,213,255,307,353,15,1435,661
1523,15,0.1.189,0,546,0,99,189,288,71,118,288,378,0,74,504,2,4,169,238,186,353,16,1435,644
1523,15,1.1.263,0,551,1,60,263,323,263,0,323,378,-74,148,578,2,4,150,238,241,353,16,1435,644
1523,15,4.1.189,0,546,0,79,189,268,78,111,268,378,0,74,504,2,4,129,238,136,353,16,1435,644
1523,15,5.2.205,1,546,0,56,205,261,189,16,261,378,0,84,504,3,3,196,174,307,295,16,1435,644
1523,16,0.1.189,0,546,0,99,189,288,71,118,288,378,0,74,504,2,4,169,238,186,353,17,1435,588
1523,16,1.1.263,0,551,1,60,263,323,263,0,323,378,-74,148,578,2,4,150,238,241,353,17,1435,588
1523,16,4.1.189,0,546,0,79,189,268,78,111,268,378,0,74,504,2,4,129,238,136,353,17,1435,588
1523,16,5.3.261,1,546,0,42,261,303,261,0,303,378,-1,146,505,4,3,140,64,307,179,17,1435,588
1523,17,0.1.189,0,546,0,99,189,288,71,118,288,378,0,74,505,2,4,169,238,186,353,18,1435,546
1523,17,1.1.263,0,551,1,60,263,323,263,0,323,378,-74,148,579,2,4,150,238,241,353,18,1435,546
1523,17,4.1.189,0,546,0,79,189,268,78,111,268,378,0,74,505,2,4,129,238,136,353,18,1435,546
1523,17,5.4.378,1,546,0,98,378,476,303,75,476,476,0,201,505,5,3,98,168,307,345,18,1435,546
1523,18,0.1.189,1,546,0,99,189,288,71,118,288,476,0,74,505,2,4,169,238,186,353,19,1435,448
1523,18,1.1.263,0,551,1,60,263,323,263,0,323,476,-74,148,579,2,4,150,238,241,353,19,1435,448
1523,18,4.1.189,0,546,0,79,189,268,78,111,268,476,0,74,505,2,4,129,238,136,353,19,1435,448
1523,19,0.2.288,1,546,0,59,288,347,288,0,347,476,-27,111,532,3,4,70,118,186,295,20,1435,349
1523,19,1.1.288,0,546,0,60,288,348,263,25,348,476,0,74,505,2,5,150,139,241,353,20,1435,349
1523,19,4.1.288,0,546,0,79,288,367,78,210,367,476,0,74,505,2,5,129,139,136,353,20,1435,349
1523,20,0.3.347,1,546,0,3,347,350,347,0,350,476,-44,190,576,4,4,11,22,186,179,21,1435,290
1523,20,1.1.288,0,546,0,60,288,348,263,25,348,476,0,74,532,2,5,150,139,241,353,21,1435,290
1523,20,4.1.288,0,546,0,79,288,367,78,210,367,476,0,74,532,2,5,129,139,136,353,21,1435,290
1523,21,0.4.476,1,546,0,8,476,484,350,126,484,484,0,201,576,5,4,8,70,186,345,22,1435,287
1523,21,1.1.288,0,546,0,60,288,348,263,25,348,476,0,74,576,2,5,150,139,241,353,22,1435,287
1523,21,4.1.288,0,546,0,79,288,367,78,210,367,476,0,74,576,2,5,129,139,136,353,22,1435,287
1523,22,1.1.288,0,546,0,60,288,348,263,25,348,484,0,74,576,2,5,150,139,241,353,23,1435,279
1523,22,4.1.288,1,546,0,79,288,367,78,210,367,484,0,74,576,2,5,129,139,136,353,23,1435,279
1523,23,1.1.367,0,546,0,60,367,427,263,104,427,484,0,74,576,2,6,150,60,241,353,24,1435,200
1523,23,4.2.367,1,546,0,20,367,387,367,0,387,484,-20,131,596,3,5,50,59,136,295,24,1435,200
1523,24,1.1.367,0,546,0,60,367,427,263,104,427,484,0,74,596,2,6,150,60,241,353,25,1435,180
1523,24,4.3.387,1,546,0,9,387,396,387,0,396,484,-37,227,633,4,5,30,19,136,179,25,1435,180
1523,25,1.1.367,0,546,0,60,367,427,263,104,427,484,0,74,633,2,6,150,60,241,353,26,1435,171
1523,25,4.4.484,1,546,0,21,484,505,396,88,505,505,0,201,633,5,5,21,62,136,345,26,1435,171
1523,26,1.1.367,1,546,0,60,367,427,263,104,427,505,0,74,633,2,6,150,60,241,353,27,1435,150
1523,27,1.2.427,1,546,0,39,427,466,427,0,466,505,-40,171,673,3,6,90,39,241,295,28,1435,90
1523,28,1.3.466,1,546,0,10,466,476,466,0,476,505,-70,297,743,4,6,51,10,241,179,29,1435,51
1523,29,1.4.505,1,546,0,41,505,546,476,29,546,546,0,201,743,5,6,41,41,241,345,30,1435,41
1524,0,0.0.0,1,537,1,30,0,30,0,0,30,30,0,0,0,1,1,228,375,228,375,1,1403,1403
1524,0,1.0.0,0,544,2,67,0,67,0,0,67,67,0,0,0,1,1,242,375,242,375,1,1403,1403
1524,0,2.0.0,0,557,3,72,0,72,0,0,72,72,0,0,0,1,1,210,375,210,375,1,1403,1403
1524,0,3.0.0,0,580,4,80,0,80,0,0,80,80,0,0,0,1,1,242,375,242,375,1,1403,1403
1524,0,4.0.0,0,529,0,28,0,28,0,0,28,28,0,0,0,1,1,172,375,172,375,1,1403,1403
1524,0,5.0.0,0,583,5,98,0,98,0,0,98,98,0,0,0,1,1,309,375,309,375,1,1403,1403
1524,1,0.1.30,1,537,0,67,30,97,30,0,97,97,-30,30,30,2,1,198,258,228,258,2,1403,1373
1524,1,1.0.30,0,544,1,67,30,97,0,30,97,97,0,0,0,1,2,242,345,242,375,2,1403,1373
1524,1,2.0.30,0,544,1,72,30,102,0,30,102,102,0,0,0,1,2,210,345,210,375,2,1403,1373
1524,1,3.0.30,0,550,2,80,30,110,0,30,110,110,0,0,0,1,2,242,345,242,375,2,1403,1373
1524,1,4.0.30,0,537,0,28,30,58,0,30,58,58,0,0,0,1,2,172,345,172,375,2,1403,1373
1524,1,5.0.30,0,553,3,98,30,128,0,30,128,128,0,0,0,1,2,309,345,309,375,2,1403,1373
1524,2,0.2.97,1,544,1,62,97,159,97,0,159,159,-97,97,127,3,1,131,262,228,262,3,1403,1306
1524,2,1.0.30,0,544,1,67,30,97,0,30,97,97,0,0,30,1,2,242,345,242,375,3,1403,1306
1524,2,2.0.30,0,544,1,72,30,102,0,30,102,102,0,0,30,1,2,210,345,210,375,3,1403,1306
1524,2,3.0.30,0,550,2,80,30,110,0,30,110,110,0,0,30,1,2,242,345,242,375,3,1403,1306
1524,2,4.0.30,0,537,0,28,30,58,0,30,58,97,0,0,30,1,2,172,345,172,375,3,1403,1306
1524,2,5.0.30,0,553,3,98,30,128,0,30,128,128,0,0,30,1,2,309,345,309,375,3,1403,1306
1524,3,0.3.159,1,544,0,9,159,168,159,0,168,168,-159,159,286,4,1,69,132,228,132,4,1403,1244
1524,3,1.0.30,0,544,0,67,30,97,0,30,97,159,0,0,127,1,2,242,345,242,375,4,1403,1244
1524,3,2.0.30,0,544,0,72,30,102,0,30,102,159,0,0,127,1,2,210,345,210,375,4,1403,1244
1524,3,3.0.30,0,550,1,80,30,110,0,30,110,159,0,0,127,1,2,242,345,242,375,4,1403,1244
1524,3,4.0.30,0,544,0,28,30,58,0,30,58,159,0,0,127,1,2,172,345,172,375,4,1403,1244
1524,3,5.0.30,0,553,2,98,30,128,0,30,128,159,0,0,127,1,2,309,345,309,375,4,1403,1244
1524,4,0.4.168,1,544,0,60,168,228,168,0,228,228,-168,168,454,5,1,60,376,228,376,5,1403,1235
1524,4,1.0.30,0,544,0,67,30,97,0,30,97,168,0,0,286,1,2,242,345,242,375,5,1403,1235
1524,4,2.0.30,0,544,0,72,30,102,0,30,102,168,0,0,286,1,2,210,345,210,375,5,1403,1235
1524,4,3.0.30,0,550,1,80,30,110,0,30,110,168,0,0,286,1,2,242,345,242,375,5,1403,1235
1524,4,4.0.30,0,544,0,28,30,58,0,30,58,168,0,0,286,1,2,172,345,172,375,5,1403,1235
1524,4,5.0.30,0,553,2,98,30,128,0,30,128,168,0,0,286,1,2,309,345,309,375,5,1403,1235
1524,5,1.0.30,0,544,0,67,30,97,0,30,97,228,0,0,454,1,2,242,345,242,375,6,1403,1175
1524,5,2.0.30,0,544,0,72,30,102,0,30,102,228,0,0,454,1,2,210,345,210,375,6,1403,1175
1524,5,3.0.30,0,550,1,80,30,110,0,30,110,228,0,0,454,1,2,242,345,242,375,6,1403,1175
1524,5,4.0.30,1,544,0,28,30,58,0,30,58,228,0,0,454,1,2,172,345,172,375,6,1403,1175
1524,5,5.0.30,0,553,2,98,30,128,0,30,128,228,0,0,454,1,2,309,345,309,375,6,1403,1175
1524,6,1.0.58,0,544,0,67,58,125,0,58,125,228,0,0,454,1,3,242,317,242,375,7,1403,1147
1524,6,2.0.58,0,544,0,72,58,130,0,58,130,228,0,0,454,1,3,210,317,210,375,7,1403,1147
1524,6,3.0.58,0,556,1,80,58,138,0,58,138,228,0,0,454,1,3,242,317,242,375,7,1403,1147
1524,6,4.1.97,1,544,0,31,97,128,58,39,128,228,0,30,454,2,2,144,191,172,258,7,1403,1147
1524,6,5.0.58,0,544,0,98,58,156,0,58,156,228,0,0,454,1,3,309,317,309,375,7,1403,1147
1524,7,1.0.58,0,544,0,67,58,125,0,58,125,228,0,0,454,1,3,242,317,242,375,8,1403,1116
1524,7,2.0.58,0,544,0,72,58,130,0,58,130,228,0,0,454,1,3,210,317,210,375,8,1403,1116
1524,7,3.0.58,0,556,1,80,58,138,0,58,138,228,0,0,454,1,3,242,317,242,375,8,1403,1116
1524,7,4.2.159,1,544,0,20,159,179,128,31,179,228,0,97,454,3,2,113,200,172,262,8,1403,1116
1524,7,5.0.58,0,544,0,98,58,156,0,58,156,228,0,0,454,1,3,309,317,309,375,8,1403,1116
1524,8,1.0.58,0,544,0,67,58,125,0,58,125,228,0,0,454,1,3,242,317,242,375,9,1403,1096
1524,8,2.0.58,0,544,0,72,58,130,0,58,130,228,0,0,454,1,3,210,317,210,375,9,1403,1096
1524,8,3.0.58,0,556,1,80,58,138,0,58,138,228,0,0,454,1,3,242,317,242,375,9,1403,1096
1524,8,4.3.179,1,544,0,2,179,181,179,0,181,228,-11,170,465,4,2,93,123,172,132,9,1403,1096
1524,8,5.0.58,0,544,0,98,58,156,0,58,156,228,0,0,454,1,3,309,317,309,375,9,1403,1096
1524,9,1.0.58,0,544,0,67,58,125,0,58,125,228,0,0,465,1,3,242,317,242,375,10,1403,1094
1524,9,2.0.58,0,544,0,72,58,130,0,58,130,228,0,0,465,1,3,210,317,210,375,10,1403,1094
1524,9,3.0.58,0,556,1,80,58,138,0,58,138,228,0,0,465,1,3,242,317,242,375,10,1403,1094
1524,9,4.4.228,1,544,0,91,228,319,181,47,319,319,0,168,465,5,2,91,316,172,376,10,1403,1094
1524,9,5.0.58,0,544,0,98,58,156,0,58,156,228,0,0,465,1,3,309,317,309,375,10,1403,1094
1524,10,1.0.58,1,544,0,67,58,125,0,58,125,319,0,0,465,1,3,242,317,242,375,11,1403,1003
1524,10,2.0.58,0,544,0,72,58,130,0,58,130,319,0,0,465,1,3,210,317,210,375,11,1403,1003
1524,10,3.0.58,0,556,1,80,58,138,0,58,138,319,0,0,465,1,3,242,317,242,375,11,1403,1003
1524,10,5.0.58,0,544,0,98,58,156,0,58,156,319,0,0,465,1,3,309,317,309,375,11,1403,1003
1524,11,1.1.128,1,544,0,29,128,157,125,3,157,319,0,30,465,2,3,175,160,242,258,12,1403,936
1524,11,2.0.125,0,544,0,72,125,197,0,125,197,319,0,0,465,1,4,210,250,210,375,12,1403,936
1524,11,3.0.125,0,573,1,80,125,205,0,125,205,319,0,0,465,1,4,242,250,242,375,12,1403,936
1524,11,5.0.125,0,544,0,98,125,223,0,125,223,319,0,0,465,1,4,309,250,309,375,12,1403,936
1524,12,1.2.179,1,544,0,45,179,224,157,22,224,319,0,97,465,3,3,146,180,242,262,13,1403,907
1524,12,2.0.125,0,544,0,72,125,197,0,125,197,319,0,0,465,1,4,210,250,210,375,13,1403,907
1524,12,3.0.125,0,573,1,80,125,205,0,125,205,319,0,0,465,1,4,242,250,242,375,13,1403,907
1524,12,5.0.125,0,544,0,98,125,223,0,125,223,319,0,0,465,1,4,309,250,309,375,13,1403,907
1524,13,1.3.224,1,544,0,51,224,275,224,0,275,319,-43,213,508,4,3,101,121,242,132,14,1403,862
1524,13,2.0.125,0,544,0,72,125,197,0,125,197,319,0,0,465,1,4,210,250,210,375,14,1403,862
1524,13,3.0.125,0,573,1,80,125,205,0,125,205,319,0,0,465,1,4,242,250,242,375,14,1403,862
1524,13,5.0.125,0,544,0,98,125,223,0,125,223,319,0,0,465,1,4,309,250,309,375,14,1403,862
1524,14,1.4.319,1,544,0,50,319,369,275,44,369,369,0,168,508,5,3,50,225,242,376,15,1403,811
1524,14,2.0.125,0,544,0,72,125,197,0,125,197,319,0,0,508,1,4,210,250,210,375,15,1403,811
1524,14,3.0.125,0,573,1,80,125,205,0,125,205,319,0,0,508,1,4,242,250,242,375,15,1403,811
1524,14,5.0.125,0,544,0,98,125,223,0,125,223,319,0,0,508,1,4,309,250,309,375,15,1403,811
1524,15,2.0.125,0,544,0,72,125,197,0,125,197,369,0,0,508,1,4,210,250,210,375,16,1403,761
1524,15,3.0.125,0,573,1,80,125,205,0,125,205,369,0,0,508,1,4,242,250,242,375,16,1403,761
1524,15,5.0.125,1,544,0,98,125,223,0,125,223,369,0,0,508,1,4,309,250,309,375,16,1403,761
1524,16,2.0.223,0,544,0,72,223,295,0,223,295,369,0,0,508,1,5,210,152,210,375,17,1403,663
1524,16,3.0.223,0,544,0,80,223,303,0,223,303,369,0,0,508,1,5,242,152,242,375,17,1403,663
1524,16,5.1.223,1,544,0,1,223,224,223,0,224,369,-66,96,574,2,4,211,131,309,258,17,1403,663
1524,17,2.0.223,0,544,0,72,223,295,0,223,295,369,0,0,574,1,5,210,152,210,375,18,1403,662
1524,17,3.0.223,0,544,0,80,223,303,0,223,303,369,0,0,574,1,5,242,152,242,375,18,1403,662
1524,17,5.2.224,1,544,0,94,224,318,224,0,318,369,0,97,574,3,4,210,135,309,262,18,1403,662
1524,18,2.0.223,0,544,0,72,223,295,0,223,295,369,0,0,574,1,5,210,152,210,375,19,1403,568
1524,18,3.0.223,0,544,0,80,223,303,0,223,303,369,0,0,574,1,5,242,152,242,375,19,1403,568
1524,18,5.3.318,1,544,0,27,318,345,318,0,345,369,-43,256,617,4,4,116,70,309,132,19,1403,568
1524,19,2.0.223,0,544,0,72,223,295,0,223,295,369,0,0,617,1,5,210,152,210,375,20,1403,541
1524,19,3.0.223,0,544,0,80,223,303,0,223,303,369,0,0,617,1,5,242,152,242,375,20,1403,541
1524,19,5.4.369,1,544,0,89,369,458,345,24,458,458,0,168,617,5,4,89,175,309,376,20,1403,541
1524,20,2.0.223,0,544,0,72,223,295,0,223,295,458,0,0,617,1,5,210,152,210,375,21,1403,452
1524,20,3.0.223,1,544,0,80,223,303,0,223,303,458,0,0,617,1,5,242,152,242,375,21,1403,452
1524,21,2.0.303,1,544,0,72,303,375,0,303,375,458,0,0,617,1,6,210,72,210,375,22,1403,372
1524,21,3.1.303,0,544,0,79,303,382,303,0,382,458,-79,175,696,2,5,162,130,242,258,22,1403,372
1524,22,2.1.375,0,588,1,51,375,426,375,0,426,458,-151,247,768,2,5,138,130,210,258,23,1403,300
1524,22,3.1.303,1,544,0,79,303,382,303,0,382,458,-79,175,696,2,5,162,130,242,258,23,1403,300
1524,23,2.1.382,0,544,0,51,382,433,375,7,433,458,0,175,696,2,6,138,51,210,258,24,1403,221
1524,23,3.2.382,1,544,0,31,382,413,382,0,413,458,-64,161,760,3,5,83,41,242,262,24,1403,221
1524,24,2.1.382,0,544,0,51,382,433,375,7,433,458,0,175,760,2,6,138,51,210,258,25,1403,190
1524,24,3.3.413,1,544,0,14,413,427,413,0,427,458,-68,324,828,4,5,52,43,242,132,25,1403,190
1524,25,2.1.382,0,544,0,51,382,433,375,7,433,458,0,175,828,2,6,138,51,210,258,26,1403,176
1524,25,3.4.458,1,544,0,38,458,496,427,31,496,496,0,168,828,5,5,38,86,242,376,26,1403,176
1524,26,2.1.382,1,544,0,51,382,433,375,7,433,496,0,175,828,2,6,138,51,210,258,27,1403,138
1524,27,2.2.433,1,544,0,10,433,443,433,0,443,496,-20,181,848,3,6,87,10,210,262,28,1403,87
1524,28,2.3.443,1,544,0,29,443,472,443,0,472,496,-16,340,864,4,6,77,29,210,132,29,1403,77
1524,29,2.4.496,1,544,0,48,496,544,472,24,544,544,0,168,864,5,6,48,48,210,376,30,1403,48
1525,0,0.0.0,0,608,5,43,0,43,0,0,43,43,0,0,0,1,1,175,192,175,192,1,1572,1572
1525,0,1.0.0,1,599,4,43,0,43,0,0,43,43,0,0,0,1,1,340,192,340,192,1,1572,1572
1525,0,2.0.0,0,584,3,18,0,18,0,0,18,18,0,0,0,1,1,235,192,235,192,1,1572,1572
1525,0,3.0.0,0,575,0,34,0,34,0,0,34,34,0,0,0,1,1,301,192,301,192,1,1572,1572
1525,0,4.0.0,0,583,2,50,0,50,0,0,50,50,0,0,0,1,1,309,192,309,192,1,1572,1572
1525,0,5.0.0,0,579,1,4,0,4,0,0,4,4,0,0,0,1,1,212,192,212,192,1,1572,1572
1525,1,0.0.43,0,607,2,43,43,86,0,43,86,86,0,0,0,1,2,175,149,175,192,2,1572,1529
1525,1,1.1.43,0,607,2,96,43,139,43,0,139,139,-43,43,43,2,1,297,360,340,360,2,1572,1529
1525,1,2.0.43,0,607,2,18,43,61,0,43,61,61,0,0,0,1,2,235,149,235,192,2,1572,1529
1525,1,3.0.43,0,599,0,34,43,77,0,43,77,77,0,0,0,1,2,301,149,301,192,2,1572,1529
1525,1,4.0.43,0,607,2,50,43,93,0,43,93,93,0,0,0,1,2,309,149,309,192,2,1572,1529
1525,1,5.0.43,1,603,1,4,43,47,0,43,47,47,0,0,0,1,2,212,149,212,192,2,1572,1529
1525,2,0.0.47,0,607,1,43,47,90,0,47,90,90,0,0,0,1,3,175,145,175,192,3,1572,1525
1525,2,1.1.43,0,607,1,96,43,139,43,0,139,139,-43,43,43,2,1,297,360,340,360,3,1572,1525
1525,2,2.0.47,0,607,1,18,47,65,0,47,65,65,0,0,0,1,3,235,145,235,192,3,1572,1525
1525,2,3.0.47,1,603,0,34,47,81,0,47,81,81,0,0,0,1,3,301,145,301,192,3,1572,1525
1525,2,4.0.47,0,607,1,50,47,97,0,47,97,97,0,0,0,1,3,309,145,309,192,3,1572,1525
1525,2,5.1.47,0,623,2,83,47,130,47,0,130,130,-47,47,47,2,1,208,360,212,360,3,1572,1525
1525,3,0.0.81,0,603,0,43,81,124,0,81,124,124,0,0,0,1,4,175,111,175,192,4,1572,1491
1525,3,1.1.43,0,607,1,96,43,139,43,0,139,139,-43,43,43,2,1,297,360,340,360,4,1572,1491
1525,3,2.0.81,1,603,0,18,81,99,0,81,99,99,0,0,0,1,4,235,111,235,192,4,1572,1491
1525,3,3.1.81,0,603,0,18,81,99,81,0,99,99,-81,81,81,2,1,267,360,301,360,4,1572,1491
1525,3,4.0.81,0,603,0,50,81,131,0,81,131,131,0,0,0,1,4,309,111,309,192,4,1572,1491
1525,3,5.1.47,0,624,2,83,47,130,47,0,130,130,-47,47,47,2,1,208,360,212,360,4,1572,1491
1525,4,0.0.99,0,603,0,43,99,142,0,99,142,142,0,0,0,1,5,175,93,175,192,5,1572,1473
1525,4,1.1.43,0,607,1,96,43,139,43,0,139,139,-43,43,43,2,1,297,360,340,360,5,1572,1473
1525,4,2.1.99,0,637,2,44,99,143,99,0,143,143,-99,99,99,2,1,217,360,235,360,5,1572,1473
1525,4,3.1.81,0,603,0,18,81,99,81,0,99,99,-81,81,81,2,1,267,360,301,360,5,1572,1473
1525,4,4.0.99,1,603,0,50,99,149,0,99,149,149,0,0,0,1,5,309,93,309,192,5,1572,1473
1525,4,5.1.47,0,642,3,83,47,130,47,0,130,130,-47,47,47,2,1,208,360,212,360,5,1572,1473
1525,5,0.0.149,1,603,0,43,149,192,0,149,192,192,0,0,0,1,6,175,43,175,192,6,1572,1423
1525,5,1.1.43,0,607,1,96,43,139,43,0,139,149,-43,43,43,2,1,297,360,340,360,6,1572,1423
1525,5,2.1.99,0,637,3,44,99,143,99,0,143,149,-99,99,99,2,1,217,360,235,360,6,1572,1423
1525,5,3.1.81,0,603,0,18,81,99,81,0,99,149,-81,81,81,2,1,267,360,301,360,6,1572,1423
1525,5,4.1.149,0,623,2,83,149,232,149,0,232,232,-149,149,149,2,1,259,360,309,360,6,1572,1423
1525,5,5.1.47,0,642,4,83,47,130,47,0,130,149,-47,47,47,2,1,208,360,212,360,6,1572,1423
1525,6,0.1.192,0,620,2,36,192,228,192,0,228,228,-192,192,192,2,1,132,360,175,360,7,1572,1380
1525,6,1.1.43,0,607,1,96,43,139,43,0,139,192,-43,43,43,2,1,297,360,340,360,7,1572,1380
1525,6,2.1.99,0,637,4,44,99,143,99,0,143,192,-99,99,99,2,1,217,360,235,360,7,1572,1380
1525,6,3.1.81,1,603,0,18,81,99,81,0,99,192,-81,81,81,2,1,267,360,301,360,7,1572,1380
1525,6,4.1.149,0,623,3,83,149,232,149,0,232,232,-149,149,149,2,1,259,360,309,360,7,1572,1380
1525,6,5.1.47,0,642,5,83,47,130,47,0,130,192,-47,47,47,2,1,208,360,212,360,7,1572,1380
1525,7,0.1.192,0,660,3,36,192,228,192,0,228,228,-93,174,174,2,2,132,342,175,360,8,1572,1362
1525,7,1.1.99,0,603,0,96,99,195,43,56,195,195,0,81,81,2,2,297,342,340,360,8,1572,1362
1525,7,2.1.99,0,637,2,44,99,143,99,0,143,192,0,81,81,2,2,217,342,235,360,8,1572,1362
1525,7,3.2.99,1,603,0,97,99,196,99,0,196,196,-99,99,180,3,1,249,329,301,329,8,1572,1362
1525,7,4.1.149,0,637,2,83,149,232,149,0,232,232,-50,131,131,2,2,259,342,309,360,8,1572,1362
1525,7,5.1.99,0,630,1,83,99,182,47,52,182,192,0,81,81,2,2,208,342,212,360,8,1572,1362
1525,8,0.1.192,0,660,3,36,192,228,192,0,228,228,-93,174,273,2,2,132,342,175,360,9,1572,1265
1525,8,1.1.99,0,603,0,96,99,195,43,56,195,196,0,81,180,2,2,297,342,340,360,9,1572,1265
1525,8,2.1.99,0,637,2,44,99,143,99,0,143,196,0,81,180,2,2,217,342,235,360,9,1572,1265
1525,8,3.3.196,1,603,0,73,196,269,196,0,269,269,-196,196,376,4,1,152,384,301,384,9,1572,1265
1525,8,4.1.149,0,637,2,83,149,232,149,0,232,232,-50,131,230,2,2,259,342,309,360,9,1572,1265
1525,8,5.1.99,0,630,1,83,99,182,47,52,182,196,0,81,180,2,2,208,342,212,360,9,1572,1265
1525,9,0.1.192,0,660,3,36,192,228,192,0,228,269,-93,174,469,2,2,132,342,175,360,10,1572,1192
1525,9,1.1.99,0,603,0,96,99,195,43,56,195,269,0,81,376,2,2,297,342,340,360,10,1572,1192
1525,9,2.1.99,0,637,2,44,99,143,99,0,143,269,0,81,376,2,2,217,342,235,360,10,1572,1192
1525,9,3.4.269,1,603,0,79,269,348,269,0,348,348,-269,269,645,5,1,79,307,301,307,10,1572,1192
1525,9,4.1.149,0,637,2,83,149,232,149,0,232,269,-50,131,426,2,2,259,342,309,360,10,1572,1192
1525,9,5.1.99,0,630,1,83,99,182,47,52,182,269,0,81,376,2,2,208,342,212,360,10,1572,1192
1525,10,0.1.192,0,660,3,36,192,228,192,0,228,348,-93,174,738,2,2,132,342,175,360,11,1572,1113
1525,10,1.1.99,1,603,0,96,99,195,43,56,195,348,0,81,645,2,2,297,342,340,360,11,1572,1113
1525,10,2.1.99,0,637,2,44,99,143,99,0,143,348,0,81,645,2,2,217,342,235,360,11,1572,1113
1525,10,4.1.149,0,637,2,83,149,232,149,0,232,348,-50,131,695,2,2,259,342,309,360,11,1572,1113
1525,10,5.1.99,0,630,1,83,99,182,47,52,182,348,0,81,645,2,2,208,342,212,360,11,1572,1113
1525,11,0.1.195,0,623,1,36,195,231,192,3,231,348,0,81,645,2,3,132,246,175,360,12,1572,1017
1525,11,1.2.196,1,603,0,50,196,246,195,1,246,348,0,99,645,3,2,201,232,340,329,12,1572,1017
1525,11,2.1.195,0,624,2,44,195,239,99,96,239,348,0,81,645,2,3,217,246,235,360,12,1572,1017
1525,11,4.1.195,0,624,2,83,195,278,149,46,278,348,0,81,645,2,3,259,246,309,360,12,1572,1017
1525,11,5.1.195,0,603,0,83,195,278,47,148,278,348,0,81,645,2,3,208,246,212,360,12,1572,1017
1525,12,0.1.195,0,623,1,36,195,231,192,3,231,348,0,81,645,2,3,132,246,175,360,13,1572,967
1525,12,1.3.269,0,603,0,92,269,361,246,23,361,361,0,196,645,4,2,151,311,340,384,13,1572,967
1525,12,2.1.195,1,624,2,44,195,239,99,96,239,348,0,81,645,2,3,217,246,235,360,13,1572,967
1525,12,4.1.195,0,624,2,83,195,278,149,46,278,348,0,81,645,2,3,259,246,309,360,13,1572,967
1525,12,5.1.195,0,603,0,83,195,278,47,148,278,348,0,81,645,2,3,208,246,212,360,13,1572,967
1525,13,0.1.239,0,628,1,36,239,275,192,47,275,348,0,81,645,2,4,132,202,175,360,14,1572,923
1525,13,1.3.269,0,624,0,92,269,361,246,23,361,361,0,196,645,4,2,151,311,340,384,14,1572,923
1525,13,2.2.246,1,624,0,62,246,308,239,7,308,348,0,99,645,3,3,173,182,235,329,14,1572,923
1525,13,4.1.239,0,624,0,83,239,322,149,90,322,348,0,81,645,2,4,259,202,309,360,14,1572,923
1525,13,5.1.239,0,639,2,83,239,322,47,192,322,348,0,81,645,2,4,208,202,212,360,14,1572,923
1525,14,0.1.239,0,639,1,36,239,275,192,47,275,348,0,81,645,2,4,132,202,175,360,15,1572,861
1525,14,1.3.269,0,624,0,92,269,361,246,23,361,361,0,196,645,4,2,151,311,340,384,15,1572,861
1525,14,2.3.308,0,678,2,97,308,405,308,0,405,405,-39,235,684,4,2,111,311,235,384,15,1572,861
1525,14,4.1.239,0,624,0,83,239,322,149,90,322,348,0,81,645,2,4,259,202,309,360,15,1572,861
1525,14,5.1.239,1,639,1,83,239,322,47,192,322,348,0,81,645,2,4,208,202,212,360,15,1572,861
1525,15,0.1.322,0,639,0,36,322,358,192,130,358,358,0,81,645,2,5,132,119,175,360,16,1572,778
1525,15,1.3.269,0,639,0,92,269,361,246,23,361,361,0,196,645,4,2,151,311,340,384,16,1572,778
1525,15,2.3.308,0,678,1,97,308,405,308,0,405,405,-39,235,684,4,2,111,311,235,384,16,1572,778
1525,15,4.1.322,0,639,0,83,322,405,149,173,405,405,0,81,645,2,5,259,119,309,360,16,1572,778
1525,15,5.2.322,1,639,0,33,322,355,322,0,355,355,-14,113,659,3,4,125,120,212,329,16,1572,778
1525,16,0.1.322,0,639,0,36,322,358,192,130,358,358,0,81,659,2,5,132,119,175,360,17,1572,745
1525,16,1.3.269,0,639,0,92,269,361,246,23,361,361,0,196,659,4,2,151,311,340,384,17,1572,745
1525,16,2.3.308,0,678,1,97,308,405,308,0,405,405,-39,235,698,4,2,111,311,235,384,17,1572,745
1525,16,4.1.322,1,639,0,83,322,405,149,173,405,405,0,81,659,2,5,259,119,309,360,17,1572,745
1525,16,5.3.355,0,680,2,12,355,367,355,0,367,367,-86,282,745,4,2,92,311,212,384,17,1572,745
1525,17,0.1.405,1,639,0,36,405,441,192,213,441,441,0,81,659,2,6,132,36,175,360,18,1572,662
1525,17,1.3.269,0,639,0,92,269,361,246,23,361,405,0,196,659,4,2,151,311,340,384,18,1572,662
1525,17,2.3.308,0,678,1,97,308,405,308,0,405,405,-39,235,698,4,2,111,311,235,384,18,1572,662
1525,17,4.2.405,0,639,0,21,405,426,405,0,426,426,-50,163,709,3,5,176,87,309,329,18,1572,662
1525,17,5.3.355,0,680,2,12,355,367,355,0,367,405,-86,282,745,4,2,92,311,212,384,18,1572,662
1525,18,0.2.441,0,639,0,66,441,507,441,0,507,507,-86,199,745,3,5,96,87,175,329,19,1572,626
1525,18,1.3.269,0,639,0,92,269,361,246,23,361,441,0,196,659,4,2,151,311,340,384,19,1572,626
1525,18,2.3.308,0,678,1,97,308,405,308,0,405,441,-39,235,698,4,2,111,311,235,384,19,1572,626
1525,18,4.2.405,1,639,0,21,405,426,405,0,426,441,-50,163,709,3,5,176,87,309,329,19,1572,626
1525,18,5.3.355,0,680,2,12,355,367,355,0,367,441,-86,282,745,4,2,92,311,212,384,19,1572,626
1525,19,0.2.441,1,639,0,66,441,507,441,0,507,507,-15,178,724,3,6,96,66,175,329,20,1572,605
1525,19,1.3.269,0,639,0,92,269,361,246,23,361,441,0,196,709,4,2,151,311,340,384,20,1572,605
1525,19,2.3.308,0,678,2,97,308,405,308,0,405,441,-39,235,748,4,2,111,311,235,384,20,1572,605
1525,19,4.3.426,0,647,1,94,426,520,426,0,520,520,-157,353,866,4,2,155,311,309,384,20,1572,605
1525,19,5.3.355,0,680,3,12,355,367,355,0,367,441,-86,282,795,4,2,92,311,212,384,20,1572,605
1525,20,0.3.507,0,678,2,16,507,523,507,0,523,523,-238,434,962,4,2,30,311,175,384,21,1572,539
1525,20,1.3.269,1,639,0,92,269,361,246,23,361,507,0,196,724,4,2,151,311,340,384,21,1572,539
1525,20,2.3.308,0,678,2,97,308,405,308,0,405,507,-39,235,763,4,2,111,311,235,384,21,1572,539
1525,20,4.3.426,0,647,1,94,426,520,426,0,520,520,-157,353,881,4,2,155,311,309,384,21,1572,539
1525,20,5.3.355,0,680,3,12,355,367,355,0,367,507,-86,282,810,4,2,92,311,212,384,21,1572,539
1525,21,0.3.507,0,678,2,16,507,523,507,0,523,523,-146,342,870,4,3,30,219,175,384,22,1572,447
1525,21,1.4.361,1,639,0,59,361,420,361,0,420,507,-13,282,737,5,2,59,228,340,307,22,1572,447
1525,21,2.3.361,0,639,0,97,361,458,308,53,458,507,0,196,724,4,3,111,219,235,384,22,1572,447
1525,21,4.3.426,0,647,1,94,426,520,426,0,520,520,-65,261,789,4,3,155,219,309,384,22,1572,447
1525,21,5.3.361,0,639,0,12,361,373,355,6,373,507,0,196,724,4,3,92,219,212,384,22,1572,447
1525,22,0.3.507,0,678,2,16,507,523,507,0,523,523,-146,342,883,4,3,30,219,175,384,23,1572,388
1525,22,2.3.361,0,639,0,97,361,458,308,53,458,507,0,196,737,4,3,111,219,235,384,23,1572,388
1525,22,4.3.426,0,647,1,94,426,520,426,0,520,520,-65,261,802,4,3,155,219,309,384,23,1572,388
1525,22,5.3.361,1,639,0,12,361,373,355,6,373,507,0,196,737,4,3,92,219,212,384,23,1572,388
1525,23,0.3.507,0,678,2,16,507,523,507,0,523,523,-134,330,871,4,4,30,207,175,384,24,1572,376
1525,23,2.3.373,0,639,0,97,373,470,308,65,470,507,0,196,737,4,4,111,207,235,384,24,1572,376
1525,23,4.3.426,0,647,1,94,426,520,426,0,520,520,-53,249,790,4,4,155,207,309,384,24,1572,376
1525,23,5.4.420,1,639,0,80,420,500,373,47,500,507,0,282,737,5,3,80,169,212,307,24,1572,376
1525,24,0.3.507,0,678,2,16,507,523,507,0,523,523,-134,330,871,4,4,30,207,175,384,25,1572,296
1525,24,2.3.373,1,639,0,97,373,470,308,65,470,507,0,196,737,4,4,111,207,235,384,25,1572,296
1525,24,4.3.426,0,647,1,94,426,520,426,0,520,520,-53,249,790,4,4,155,207,309,384,25,1572,296
1525,25,0.3.507,0,678,1,16,507,523,507,0,523,523,-37,233,774,4,5,30,110,175,384,26,1572,199
1525,25,2.4.500,1,639,0,14,500,514,470,30,514,514,0,282,737,5,4,14,89,235,307,26,1572,199
1525,25,4.3.470,0,639,0,94,470,564,426,44,564,564,0,196,737,4,5,155,110,309,384,26,1572,199
1525,26,0.3.507,0,678,1,16,507,523,507,0,523,523,-37,233,774,4,5,30,110,175,384,27,1572,185
1525,26,4.3.470,1,639,0,94,470,564,426,44,564,564,0,196,737,4,5,155,110,309,384,27,1572,185
1525,27,0.3.564,1,639,0,16,564,580,507,57,580,580,0,196,737,4,6,30,16,175,384,28,1572,91
1525,27,4.4.564,0,639,0,61,564,625,564,0,625,625,-50,332,787,5,5,61,75,309,307,28,1572,91
1525,28,0.4.580,1,655,1,14,580,594,580,0,594,594,-66,348,803,5,5,14,75,175,307,29,1572,75
1525,28,4.4.564,0,639,0,61,564,625,564,0,625,625,-50,332,787,5,5,61,75,309,307,29,1572,75
1525,29,4.4.594,1,655,0,61,594,655,564,30,655,655,0,348,803,5,6,61,61,309,307,30,1572,61
1526,0,0.0.0,0,543,2,56,0,56,0,0,56,56,0,0,0,1,1,217,306,217,306,1,1540,1540
1526,0,1.0.0,0,530,0,19,0,19,0,0,19,19,0,0,0,1,1,241,306,241,306,1,1540,1540
1526,0,2.0.0,0,553,3,64,0,64,0,0,64,64,0,0,0,1,1,262,306,262,306,1,1540,1540
1526,0,3.0.0,0,616,5,86,0,86,0,0,86,86,0,0,0,1,1,260,306,260,306,1,1540,1540
1526,0,4.0.0,0,570,4,72,0,72,0,0,72,72,0,0,0,1,1,247,306,247,306,1,1540,1540
1526,0,5.0.0,1,539,1,9,0,9,0,0,9,9,0,0,0,1,1,313,306,313,306,1,1540,1540
1526,1,0.0.9,0,540,1,56,9,65,0,9,65,65,0,0,0,1,2,217,297,217,306,2,1540,1531
1526,1,1.0.9,0,539,0,19,9,28,0,9,28,28,0,0,0,1,2,241,297,241,306,2,1540,1531
1526,1,2.0.9,0,553,2,64,9,73,0,9,73,73,0,0,0,1,2,262,297,262,306,2,1540,1531
1526,1,3.0.9,0,577,4,86,9,95,0,9,95,95,0,0,0,1,2,260,297,260,306,2,1540,1531
1526,1,4.0.9,0,564,3,72,9,81,0,9,81,81,0,0,0,1,2,247,297,247,306,2,1540,1531
1526,1,5.1.9,1,540,1,66,9,75,9,0,75,75,-9,9,9,2,1,304,263,313,263,2,1540,1531
1526,2,0.0.9,0,540,0,56,9,65,0,9,65,75,0,0,9,1,2,217,297,217,306,3,1540,1465
1526,2,1.0.9,0,549,1,19,9,28,0,9,28,75,0,0,9,1,2,241,297,241,306,3,1540,1465
1526,2,2.0.9,0,553,2,64,9,73,0,9,73,75,0,0,9,1,2,262,297,262,306,3,1540,1465
1526,2,3.0.9,0,577,5,86,9,95,0,9,95,95,0,0,9,1,2,260,297,260,306,3,1540,1465
1526,2,4.0.9,0,564,4,72,9,81,0,9,81,81,0,0,9,1,2,247,297,247,306,3,1540,1465
1526,2,5.2.75,1,563,3,71,75,146,75,0,146,146,-75,75,84,3,1,238,298,313,298,3,1540,1465
1526,3,0.0.9,0,573,1,56,9,65,0,9,65,146,0,0,84,1,2,217,297,217,306,4,1540,1394
1526,3,1.0.9,0,563,0,19,9,28,0,9,28,146,0,0,84,1,2,241,297,241,306,4,1540,1394
1526,3,2.0.9,0,563,0,64,9,73,0,9,73,146,0,0,84,1,2,262,297,262,306,4,1540,1394
1526,3,3.0.9,0,577,2,86,9,95,0,9,95,146,0,0,84,1,2,260,297,260,306,4,1540,1394
1526,3,4.0.9,0,577,2,72,9,81,0,9,81,146,0,0,84,1,2,247,297,247,306,4,1540,1394
1526,3,5.3.146,1,577,2,96,146,242,146,0,242,242,-146,146,230,4,1,167,338,313,338,4,1540,1394
1526,4,0.0.9,0,577,0,56,9,65,0,9,65,242,0,0,230,1,2,217,297,217,306,5,1540,1298
1526,4,1.0.9,0,577,0,19,9,28,0,9,28,242,0,0,230,1,2,241,297,241,306,5,1540,1298
1526,4,2.0.9,0,577,0,64,9,73,0,9,73,242,0,0,230,1,2,262,297,262,306,5,1540,1298
1526,4,3.0.9,0,577,0,86,9,95,0,9,95,242,0,0,230,1,2,260,297,260,306,5,1540,1298
1526,4,4.0.9,0,577,0,72,9,81,0,9,81,242,0,0,230,1,2,247,297,247,306,5,1540,1298
1526,4,5.4.242,1,577,0,71,242,313,242,0,313,313,-242,242,472,5,1,71,335,313,335,5,1540,1298
1526,5,0.0.9,0,577,0,56,9,65,0,9,65,313,0,0,472,1,2,217,297,217,306,6,1540,1227
1526,5,1.0.9,1,577,0,19,9,28,0,9,28,313,0,0,472,1,2,241,297,241,306,6,1540,1227
1526,5,2.0.9,0,577,0,64,9,73,0,9,73,313,0,0,472,1,2,262,297,262,306,6,1540,1227
1526,5,3.0.9,0,577,0,86,9,95,0,9,95,313,0,0,472,1,2,260,297,260,306,6,1540,1227
1526,5,4.0.9,0,577,0,72,9,81,0,9,81,313,0,0,472,1,2,247,297,247,306,6,1540,1227
1526,6,0.0.28,0,577,0,56,28,84,0,28,84,313,0,0,472,1,3,217,278,217,306,7,1540,1208
1526,6,1.1.75,1,577,0,64,75,139,28,47,139,313,0,9,472,2,2,222,197,241,263,7,1540,1208
1526,6,2.0.28,0,577,0,64,28,92,0,28,92,313,0,0,472,1,3,262,278,262,306,7,1540,1208
1526,6,3.0.28,0,577,0,86,28,114,0,28,114,313,0,0,472,1,3,260,278,260,306,7,1540,1208
1526,6,4.0.28,0,577,0,72,28,100,0,28,100,313,0,0,472,1,3,247,278,247,306,7,1540,1208
1526,7,0.0.28,0,577,0,56,28,84,0,28,84,313,0,0,472,1,3,217,278,217,306,8,1540,1144
1526,7,1.2.146,1,577,0,55,146,201,139,7,201,313,0,75,472,3,2,158,227,241,298,8,1540,1144
1526,7,2.0.28,0,577,0,64,28,92,0,28,92,313,0,0,472,1,3,262,278,262,306,8,1540,1144
1526,7,3.0.28,0,577,0,86,28,114,0,28,114,313,0,0,472,1,3,260,278,260,306,8,1540,1144
1526,7,4.0.28,0,577,0,72,28,100,0,28,100,313,0,0,472,1,3,247,278,247,306,8,1540,1144
1526,8,0.0.28,0,577,0,56,28,84,0,28,84,313,0,0,472,1,3,217,278,217,306,9,1540,1089
1526,8,1.3.242,1,577,0,35,242,277,201,41,277,313,0,146,472,4,2,103,242,241,338,9,1540,1089
1526,8,2.0.28,0,577,0,64,28,92,0,28,92,313,0,0,472,1,3,262,278,262,306,9,1540,1089
1526,8,3.0.28,0,577,0,86,28,114,0,28,114,313,0,0,472,1,3,260,278,260,306,9,1540,1089
1526,8,4.0.28,0,577,0,72,28,100,0,28,100,313,0,0,472,1,3,247,278,247,306,9,1540,1089
1526,9,0.0.28,0,577,0,56,28,84,0,28,84,313,0,0,472,1,3,217,278,217,306,10,1540,1054
1526,9,1.4.313,1,577,0,68,313,381,277,36,381,381,0,242,472,5,2,68,264,241,335,10,1540,1054
1526,9,2.0.28,0,577,0,64,28,92,0,28,92,313,0,0,472,1,3,262,278,262,306,10,1540,1054
1526,9,3.0.28,0,577,0,86,28,114,0,28,114,313,0,0,472,1,3,260,278,260,306,10,1540,1054
1526,9,4.0.28,0,577,0,72,28,100,0,28,100,313,0,0,472,1,3,247,278,247,306,10,1540,1054
1526,10,0.0.28,0,577,0,56,28,84,0,28,84,381,0,0,472,1,3,217,278,217,306,11,1540,986
1526,10,2.0.28,1,577,0,64,28,92,0,28,92,381,0,0,472,1,3,262,278,262,306,11,1540,986
1526,10,3.0.28,0,577,0,86,28,114,0,28,114,381,0,0,472,1,3,260,278,260,306,11,1540,986
1526,10,4.0.28,0,577,0,72,28,100,0,28,100,381,0,0,472,1,3,247,278,247,306,11,1540,986
1526,11,0.0.92,0,577,0,56,92,148,0,92,148,381,0,0,472,1,4,217,214,217,306,12,1540,922
1526,11,2.1.139,1,577,0,38,139,177,92,47,177,381,0,9,472,2,3,198,133,262,263,12,1540,922
1526,11,3.0.92,0,577,0,86,92,178,0,92,178,381,0,0,472,1,4,260,214,260,306,12,1540,922
1526,11,4.0.92,0,577,0,72,92,164,0,92,164,381,0,0,472,1,4,247,214,247,306,12,1540,922
1526,12,0.0.92,0,577,0,56,92,148,0,92,148,381,0,0,472,1,4,217,214,217,306,13,1540,884
1526,12,2.2.201,1,577,0,16,201,217,177,24,217,381,0,75,472,3,3,160,172,262,298,13,1540,884
1526,12,3.0.92,0,577,0,86,92,178,0,92,178,381,0,0,472,1,4,260,214,260,306,13,1540,884
1526,12,4.0.92,0,577,0,72,92,164,0,92,164,381,0,0,472,1,4,247,214,247,306,13,1540,884
1526,13,0.0.92,0,577,0,56,92,148,0,92,148,381,0,0,472,1,4,217,214,217,306,14,1540,868
1526,13,2.3.277,1,577,0,66,277,343,217,60,343,381,0,146,472,4,3,144,207,262,338,14,1540,868
1526,13,3.0.92,0,577,0,86,92,178,0,92,178,381,0,0,472,1,4,260,214,260,306,14,1540,868
1526,13,4.0.92,0,577,0,72,92,164,0,92,164,381,0,0,472,1,4,247,214,247,306,14,1540,868
1526,14,0.0.92,0,577,0,56,92,148,0,92,148,381,0,0,472,1,4,217,214,217,306,15,1540,802
1526,14,2.4.381,1,577,0,78,381,459,343,38,459,459,0,242,472,5,3,78,196,262,335,15,1540,802
1526,14,3.0.92,0,577,0,86,92,178,0,92,178,381,0,0,472,1,4,260,214,260,306,15,1540,802
1526,14,4.0.92,0,577,0,72,92,164,0,92,164,381,0,0,472,1,4,247,214,247,306,15,1540,802
1526,15,0.0.92,1,577,0,56,92,148,0,92,148,459,0,0,472,1,4,217,214,217,306,16,1540,724
1526,15,3.0.92,0,577,0,86,92,178,0,92,178,459,0,0,472,1,4,260,214,260,306,16,1540,724
1526,15,4.0.92,0,577,0,72,92,164,0,92,164,459,0,0,472,1,4,247,214,247,306,16,1540,724
1526,16,0.1.177,1,577,0,4,177,181,148,29,181,459,0,9,472,2,4,161,95,217,263,17,1540,668
1526,16,3.0.148,0,577,0,86,148,234,0,148,234,459,0,0,472,1,5,260,158,260,306,17,1540,668
1526,16,4.0.148,0,577,0,72,148,220,0,148,220,459,0,0,472,1,5,247,158,247,306,17,1540,668
1526,17,0.2.217,1,577,0,69,217,286,181,36,286,459,0,75,472,3,4,157,156,217,298,18,1540,664
1526,17,3.0.148,0,577,0,86,148,234,0,148,234,459,0,0,472,1,5,260,158,260,306,18,1540,664
1526,17,4.0.148,0,577,0,72,148,220,0,148,220,459,0,0,472,1,5,247,158,247,306,18,1540,664
1526,18,0.3.343,1,577,0,22,343,365,286,57,365,459,0,146,472,4,4,88,141,217,338,19,1540,595
1526,18,3.0.148,0,577,0,86,148,234,0,148,234,459,0,0,472,1,5,260,158,260,306,19,1540,595
1526,18,4.0.148,0,577,0,72,148,220,0,148,220,459,0,0,472,1,5,247,158,247,306,19,1540,595
1526,19,0.4.459,1,577,0,66,459,525,365,94,525,525,0,242,472,5,4,66,118,217,335,20,1540,573
1526,19,3.0.148,0,577,0,86,148,234,0,148,234,459,0,0,472,1,5,260,158,260,306,20,1540,573
1526,19,4.0.148,0,577,0,72,148,220,0,148,220,459,0,0,472,1,5,247,158,247,306,20,1540,573
1526,20,3.0.148,0,577,0,86,148,234,0,148,234,525,0,0,472,1,5,260,158,260,306,21,1540,507
1526,20,4.0.148,1,577,0,72,148,220,0,148,220,525,0,0,472,1,5,247,158,247,306,21,1540,507
1526,21,3.0.220,0,577,0,86,220,306,0,220,306,525,0,0,472,1,6,260,86,260,306,22,1540,435
1526,21,4.1.220,1,577,0,35,220,255,220,0,255,525,-39,48,511,2,5,175,91,247,263,22,1540,435
1526,22,3.0.220,0,577,0,86,220,306,0,220,306,525,0,0,511,1,6,260,86,260,306,23,1540,400
1526,22,4.2.286,1,577,0,22,286,308,255,31,308,525,0,75,511,3,5,140,87,247,298,23,1540,400
1526,23,3.0.220,1,577,0,86,220,306,0,220,306,525,0,0,511,1,6,260,86,260,306,24,1540,378
1526,23,4.3.365,0,577,0,87,365,452,308,57,452,525,0,146,511,4,5,118,119,247,338,24,1540,378
1526,24,3.1.306,0,577,0,56,306,362,306,0,362,525,-51,99,562,2,6,174,56,260,263,25,1540,292
1526,24,4.3.365,1,577,0,87,365,452,308,57,452,525,0,146,511,4,5,118,119,247,338,25,1540,292
1526,25,3.1.306,0,577,0,56,306,362,306,0,362,525,-51,99,562,2,6,174,56,260,263,26,1540,205
1526,25,4.4.525,1,577,0,31,525,556,452,73,556,556,0,242,511,5,5,31,52,247,335,26,1540,205
1526,26,3.1.306,1,577,0,56,306,362,306,0,362,556,-51,99,562,2,6,174,56,260,263,27,1540,174
1526,27,3.2.362,1,577,0,65,362,427,362,0,427,556,-54,129,616,3,6,118,65,260,298,28,1540,118
1526,28,3.3.452,1,577,0,32,452,484,427,25,484,556,0,146,616,4,6,53,32,260,338,29,1540,53
1526,29,3.4.556,1,577,0,21,556,577,484,72,577,577,0,242,616,5,6,21,21,260,335,30,1540,21
1527,0,0.0.0,0,562,2,69,0,69,0,0,69,69,0,0,0,1,1,260,318,260,318,1,1605,1605
1527,0,1.0.0,0,575,3,93,0,93,0,0,93,93,0,0,0,1,1,340,318,340,318,1,1605,1605
1527,0,2.0.0,0,510,0,10,0,10,0,0,10,10,0,0,0,1,1,188,318,188,318,1,1605,1605
1527,0,3.0.0,1,533,1,40,0,40,0,0,40,40,0,0,0,1,1,318,318,318,318,1,1605,1605
1527,0,4.0.0,0,586,4,93,0,93,0,0,93,93,0,0,0,1,1,285,318,285,318,1,1605,1605
1527,0,5.0.0,0,510,0,13,0,13,0,0,13,13,0,0,0,1,1,214,318,214,318,1,1605,1605
1527,1,0.0.40,0,558,2,69,40,109,0,40,109,109,0,0,0,1,2,260,278,260,318,2,1605,1565
1527,1,1.0.40,0,558,2,93,40,133,0,40,133,133,0,0,0,1,2,340,278,340,318,2,1605,1565
1527,1,2.0.40,0,533,0,10,40,50,0,40,50,50,0,0,0,1,2,188,278,188,318,2,1605,1565
1527,1,3.1.40,0,558,2,94,40,134,40,0,134,134,-40,40,40,2,1,278,364,318,364,2,1605,1565
1527,1,4.0.40,0,575,3,93,40,133,0,40,133,133,0,0,0,1,2,285,278,285,318,2,1605,1565
1527,1,5.0.40,1,536,1,13,40,53,0,40,53,53,0,0,0,1,2,214,278,214,318,2,1605,1565
1527,2,0.0.53,0,544,2,69,53,122,0,53,122,122,0,0,0,1,3,260,265,260,318,3,1605,1552
1527,2,1.0.53,0,540,1,93,53,146,0,53,146,146,0,0,0,1,3,340,265,340,318,3,1605,1552
1527,2,2.0.53,1,536,0,10,53,63,0,53,63,63,0,0,0,1,3,188,265,188,318,3,1605,1552
1527,2,3.1.40,0,558,3,94,40,134,40,0,134,134,-40,40,40,2,1,278,364,318,364,3,1605,1552
1527,2,4.0.53,0,561,4,93,53,146,0,53,146,146,0,0,0,1,3,285,265,285,318,3,1605,1552
1527,2,5.1.53,0,536,0,49,53,102,53,0,102,102,-53,53,53,2,1,201,364,214,364,3,1605,1552
1527,3,0.0.63,0,536,0,69,63,132,0,63,132,132,0,0,0,1,4,260,255,260,318,4,1605,1542
1527,3,1.0.63,1,536,0,93,63,156,0,63,156,156,0,0,0,1,4,340,255,340,318,4,1605,1542
1527,3,2.1.63,0,546,1,31,63,94,63,0,94,94,-63,63,63,2,1,178,364,188,364,4,1605,1542
1527,3,3.1.40,0,558,2,94,40,134,40,0,134,134,-40,40,40,2,1,278,364,318,364,4,1605,1542
1527,3,4.0.63,0,559,3,93,63,156,0,63,156,156,0,0,0,1,4,285,255,285,318,4,1605,1542
1527,3,5.1.53,0,536,0,49,53,102,53,0,102,102,-53,53,53,2,1,201,364,214,364,4,1605,1542
1527,4,0.0.156,1,536,0,69,156,225,0,156,225,225,0,0,0,1,5,260,162,260,318,5,1605,1449
1527,4,1.1.156,0,545,1,32,156,188,156,0,188,188,-156,156,156,2,1,247,364,340,364,5,1605,1449
1527,4,2.1.63,0,546,2,31,63,94,63,0,94,156,-63,63,63,2,1,178,364,188,364,5,1605,1449
1527,4,3.1.40,0,558,4,94,40,134,40,0,134,156,-40,40,40,2,1,278,364,318,364,5,1605,1449
1527,4,4.0.156,0,553,3,93,156,249,0,156,249,249,0,0,0,1,5,285,162,285,318,5,1605,1449
1527,4,5.1.53,0,536,0,49,53,102,53,0,102,156,-53,53,53,2,1,201,364,214,364,5,1605,1449
1527,5,0.1.225,0,558,3,71,225,296,225,0,296,296,-225,225,225,2,1,191,364,260,364,6,1605,1380
1527,5,1.1.156,0,545,1,32,156,188,156,0,188,225,-156,156,156,2,1,247,364,340,364,6,1605,1380
1527,5,2.1.63,0,546,2,31,63,94,63,0,94,225,-63,63,63,2,1,178,364,188,364,6,1605,1380
1527,5,3.1.40,0,558,3,94,40,134,40,0,134,225,-40,40,40,2,1,278,364,318,364,6,1605,1380
1527,5,4.0.225,1,536,0,93,225,318,0,225,318,318,0,0,0,1,6,285,93,285,318,6,1605,1380
1527,5,5.1.53,0,536,0,49,53,102,53,0,102,225,-53,53,53,2,1,201,364,214,364,6,1605,1380
1527,6,0.1.225,0,558,3,71,225,296,225,0,296,318,-225,225,225,2,1,191,364,260,364,7,1605,1287
1527,6,1.1.156,0,545,1,32,156,188,156,0,188,318,-156,156,156,2,1,247,364,340,364,7,1605,1287
1527,6,2.1.63,0,546,2,31,63,94,63,0,94,318,-63,63,63,2,1,178,364,188,364,7,1605,1287
1527,6,3.1.40,1,558,3,94,40,134,40,0,134,318,-40,40,40,2,1,278,364,318,364,7,1605,1287
1527,6,4.1.318,0,558,3,87,318,405,318,0,405,405,-318,318,318,2,1,192,364,285,364,7,1605,1287
1527,6,5.1.53,0,536,0,49,53,102,53,0,102,318,-53,53,53,2,1,201,364,214,364,7,1605,1287
1527,7,0.1.225,0,558,0,71,225,296,225,0,296,318,-91,131,131,2,2,191,270,260,364,8,1605,1193
1527,7,1.1.156,0,558,0,32,156,188,156,0,188,318,-22,62,62,2,2,247,270,340,364,8,1605,1193
1527,7,2.1.134,0,558,0,31,134,165,63,71,165,318,0,40,40,2,2,178,270,188,364,8,1605,1193
1527,7,3.2.134,1,558,0,32,134,166,134,0,166,318,-134,134,174,3,1,184,266,318,266,8,1605,1193
1527,7,4.1.318,0,558,0,87,318,405,318,0,405,405,-184,224,224,2,2,192,270,285,364,8,1605,1193
1527,7,5.1.134,0,558,0,49,134,183,53,81,183,318,0,40,40,2,2,201,270,214,364,8,1605,1193
1527,8,0.1.225,0,558,0,71,225,296,225,0,296,318,-91,131,265,2,2,191,270,260,364,9,1605,1161
1527,8,1.1.156,1,558,0,32,156,188,156,0,188,318,-22,62,196,2,2,247,270,340,364,9,1605,1161
1527,8,2.1.134,0,558,0,31,134,165,63,71,165,318,0,40,174,2,2,178,270,188,364,9,1605,1161
1527,8,3.3.166,0,558,0,90,166,256,166,0,256,318,-166,166,340,4,1,152,390,318,390,9,1605,1161
1527,8,4.1.318,0,558,0,87,318,405,318,0,405,405,-184,224,358,2,2,192,270,285,364,9,1605,1161
1527,8,5.1.134,0,558,0,49,134,183,53,81,183,318,0,40,174,2,2,201,270,214,364,9,1605,1161
1527,9,0.1.225,0,558,0,71,225,296,225,0,296,318,-37,99,233,2,3,191,238,260,364,10,1605,1129
1527,9,1.2.188,1,558,0,61,188,249,188,0,249,318,-22,156,218,3,2,215,234,340,266,10,1605,1129
1527,9,2.1.188,0,558,0,31,188,219,63,125,219,318,0,62,196,2,3,178,238,188,364,10,1605,1129
1527,9,3.3.166,0,558,0,90,166,256,166,0,256,318,-166,166,362,4,1,152,390,318,390,10,1605,1129
1527,9,4.1.318,0,596,1,87,318,405,318,0,405,405,-130,192,326,2,3,192,238,285,364,10,1605,1129
1527,9,5.1.188,0,558,0,49,188,237,53,135,237,318,0,62,196,2,3,201,238,214,364,10,1605,1129
1527,10,0.1.225,0,558,0,71,225,296,225,0,296,318,-37,99,255,2,3,191,238,260,364,11,1605,1068
1527,10,1.3.249,0,641,2,76,249,325,249,0,325,325,-249,249,467,4,1,154,390,340,390,11,1605,1068
1527,10,2.1.188,1,558,0,31,188,219,63,125,219,318,0,62,218,2,3,178,238,188,364,11,1605,1068
1527,10,3.3.166,0,558,0,90,166,256,166,0,256,318,-166,166,384,4,1,152,390,318,390,11,1605,1068
1527,10,4.1.318,0,596,1,87,318,405,318,0,405,405,-130,192,348,2,3,192,238,285,364,11,1605,1068
1527,10,5.1.188,0,558,0,49,188,237,53,135,237,318,0,62,218,2,3,201,238,214,364,11,1605,1068
1527,11,0.1.225,0,558,0,71,225,296,225,0,296,318,-6,68,224,2,4,191,207,260,364,12,1605,1037
1527,11,1.3.249,0,641,2,76,249,325,249,0,325,325,-249,249,467,4,1,154,390,340,390,12,1605,1037
1527,11,2.2.249,0,558,0,68,249,317,219,30,317,318,0,156,218,3,3,147,173,188,266,12,1605,1037
1527,11,3.3.166,0,558,0,90,166,256,166,0,256,318,-166,166,384,4,1,152,390,318,390,12,1605,1037
1527,11,4.1.318,0,596,1,87,318,405,318,0,405,405,-99,161,317,2,4,192,207,285,364,12,1605,1037
1527,11,5.1.219,1,558,0,49,219,268,53,166,268,318,0,62,218,2,4,201,207,214,364,12,1605,1037
1527,12,0.1.268,0,558,0,71,268,339,225,43,339,339,0,62,218,2,5,191,158,260,364,13,1605,988
1527,12,1.3.249,0,641,2,76,249,325,249,0,325,325,-249,249,467,4,1,154,390,340,390,13,1605,988
1527,12,2.2.249,0,558,0,68,249,317,219,30,317,318,0,156,218,3,3,147,173,188,266,13,1605,988
1527,12,3.3.166,0,558,0,90,166,256,166,0,256,318,-166,166,384,4,1,152,390,318,390,13,1605,988
1527,12,4.1.318,0,596,1,87,318,405,318,0,405,405,-50,112,268,2,5,192,158,285,364,13,1605,988
1527,12,5.2.268,1,558,0,10,268,278,268,0,278,318,-19,175,237,3,3,152,173,214,266,13,1605,988
1527,13,0.1.268,0,558,0,71,268,339,225,43,339,339,0,62,237,2,5,191,158,260,364,14,1605,978
1527,13,1.3.249,0,641,3,76,249,325,249,0,325,325,-249,249,486,4,1,154,390,340,390,14,1605,978
1527,13,2.2.278,1,558,0,68,278,346,219,59,346,346,0,175,237,3,4,147,163,188,266,14,1605,978
1527,13,3.3.166,0,558,0,90,166,256,166,0,256,318,-166,166,403,4,1,152,390,318,390,14,1605,978
1527,13,4.1.318,0,596,2,87,318,405,318,0,405,405,-50,112,287,2,5,192,158,285,364,14,1605,978
1527,13,5.3.278,0,580,1,80,278,358,278,0,358,358,-278,278,515,4,1,142,390,214,390,14,1605,978
1527,14,0.1.268,1,558,0,71,268,339,225,43,339,346,0,62,237,2,5,191,158,260,364,15,1605,910
1527,14,1.3.249,0,641,4,76,249,325,249,0,325,346,-249,249,486,4,1,154,390,340,390,15,1605,910
1527,14,2.3.346,0,572,1,35,346,381,346,0,381,381,-346,346,583,4,1,79,390,188,390,15,1605,910
1527,14,3.3.166,0,558,0,90,166,256,166,0,256,346,-166,166,403,4,1,152,390,318,390,15,1605,910
1527,14,4.1.318,0,596,3,87,318,405,318,0,405,405,-50,112,287,2,5,192,158,285,364,15,1605,910
1527,14,5.3.278,0,580,2,80,278,358,278,0,358,358,-278,278,515,4,1,142,390,214,390,15,1605,910
1527,15,0.2.346,1,558,0,72,346,418,339,7,418,418,0,175,237,3,5,120,95,260,266,16,1605,839
1527,15,1.3.249,0,641,3,76,249,325,249,0,325,346,-249,249,486,4,1,154,390,340,390,16,1605,839
1527,15,2.3.346,0,572,1,35,346,381,346,0,381,381,-346,346,583,4,1,79,390,188,390,16,1605,839
1527,15,3.3.166,0,558,0,90,166,256,166,0,256,346,-166,166,403,4,1,152,390,318,390,16,1605,839
1527,15,4.1.339,0,558,0,87,339,426,318,21,426,426,0,62,237,2,6,192,87,285,364,16,1605,839
1527,15,5.3.278,0,580,2,80,278,358,278,0,358,358,-278,278,515,4,1,142,390,214,390,16,1605,839
1527,16,0.3.418,0,564,1,29,418,447,418,0,447,447,-418,418,655,4,1,48,390,260,390,17,1605,767
1527,16,1.3.249,0,641,4,76,249,325,249,0,325,418,-249,249,486,4,1,154,390,340,390,17,1605,767
1527,16,2.3.346,0,572,2,35,346,381,346,0,381,418,-346,346,583,4,1,79,390,188,390,17,1605,767
1527,16,3.3.166,0,558,0,90,166,256,166,0,256,418,-166,166,403,4,1,152,390,318,390,17,1605,767
1527,16,4.1.339,1,558,0,87,339,426,318,21,426,426,0,62,237,2,6,192,87,285,364,17,1605,767
1527,16,5.3.278,0,580,3,80,278,358,278,0,358,418,-278,278,515,4,1,142,390,214,390,17,1605,767
1527,17,0.3.418,0,564,1,29,418,447,418,0,447,447,-418,418,655,4,1,48,390,260,390,18,1605,680
1527,17,1.3.249,0,641,4,76,249,325,249,0,325,426,-249,249,486,4,1,154,390,340,390,18,1605,680
1527,17,2.3.346,0,572,2,35,346,381,346,0,381,426,-346,346,583,4,1,79,390,188,390,18,1605,680
1527,17,3.3.166,0,558,0,90,166,256,166,0,256,426,-166,166,403,4,1,152,390,318,390,18,1605,680
1527,17,4.2.426,1,558,0,23,426,449,426,0,449,449,-8,183,245,3,6,105,23,285,266,18,1605,680
1527,17,5.3.278,0,580,3,80,278,358,278,0,358,426,-278,278,515,4,1,142,390,214,390,18,1605,680
1527,18,0.3.418,0,564,1,29,418,447,418,0,447,449,-418,418,663,4,1,48,390,260,390,19,1605,657
1527,18,1.3.249,0,641,5,76,249,325,249,0,325,449,-249,249,494,4,1,154,390,340,390,19,1605,657
1527,18,2.3.346,0,572,2,35,346,381,346,0,381,449,-346,346,591,4,1,79,390,188,390,19,1605,657
1527,18,3.3.166,1,558,0,90,166,256,166,0,256,449,-166,166,411,4,1,152,390,318,390,19,1605,657
1527,18,4.3.449,0,577,3,80,449,529,449,0,529,529,-449,449,694,4,1,82,390,285,390,19,1605,657
1527,18,5.3.278,0,580,4,80,278,358,278,0,358,449,-278,278,523,4,1,142,390,214,390,19,1605,657
1527,19,0.3.418,0,564,1,29,418,447,418,0,447,449,-162,328,573,4,2,48,300,260,390,20,1605,567
1527,19,1.3.256,0,558,0,76,256,332,249,7,332,449,0,166,411,4,2,154,300,340,390,20,1605,567
1527,19,2.3.346,0,572,2,35,346,381,346,0,381,449,-90,256,501,4,2,79,300,188,390,20,1605,567
1527,19,3.4.256,1,558,0,62,256,318,256,0,318,449,-256,256,667,5,1,62,267,318,267,20,1605,567
1527,19,4.3.449,0,577,3,80,449,529,449,0,529,529,-193,359,604,4,2,82,300,285,390,20,1605,567
1527,19,5.3.278,0,580,4,80,278,358,278,0,358,449,-22,188,433,4,2,142,300,214,390,20,1605,567
1527,20,0.3.418,0,564,1,29,418,447,418,0,447,449,-162,328,829,4,2,48,300,260,390,21,1605,505
1527,20,1.3.256,1,558,0,76,256,332,249,7,332,449,0,166,667,4,2,154,300,340,390,21,1605,505
1527,20,2.3.346,0,572,2,35,346,381,346,0,381,449,-90,256,757,4,2,79,300,188,390,21,1605,505
1527,20,4.3.449,0,577,3,80,449,529,449,0,529,529,-193,359,860,4,2,82,300,285,390,21,1605,505
1527,20,5.3.278,0,580,4,80,278,358,278,0,358,449,-22,188,689,4,2,142,300,214,390,21,1605,505
1527,21,0.3.418,0,564,1,29,418,447,418,0,447,449,-86,252,753,4,3,48,224,260,390,22,1605,429
1527,21,1.4.332,1,558,0,78,332,410,332,0,410,449,-14,270,681,5,2,78,205,340,267,22,1605,429
1527,21,2.3.346,0,572,2,35,346,381,346,0,381,449,-14,180,681,4,3,79,224,188,390,22,1605,429
1527,21,4.3.449,0,577,3,80,449,529,449,0,529,529,-117,283,784,4,3,82,224,285,390,22,1605,429
1527,21,5.3.332,0,558,0,80,332,412,278,54,412,449,0,166,667,4,3,142,224,214,390,22,1605,429
1527,22,0.3.418,0,564,1,29,418,447,418,0,447,449,-86,252,767,4,3,48,224,260,390,23,1605,351
1527,22,2.3.346,0,572,2,35,346,381,346,0,381,449,-14,180,695,4,3,79,224,188,390,23,1605,351
1527,22,4.3.449,0,577,3,80,449,529,449,0,529,529,-117,283,798,4,3,82,224,285,390,23,1605,351
1527,22,5.3.332,1,558,0,80,332,412,278,54,412,449,0,166,681,4,3,142,224,214,390,23,1605,351
1527,23,0.3.418,0,564,1,29,418,447,418,0,447,449,-6,172,687,4,4,48,144,260,390,24,1605,271
1527,23,2.3.412,0,558,0,35,412,447,346,66,447,449,0,166,681,4,4,79,144,188,390,24,1605,271
1527,23,4.3.449,0,577,2,80,449,529,449,0,529,529,-37,203,718,4,4,82,144,285,390,24,1605,271
1527,23,5.4.412,1,558,0,62,412,474,412,0,474,474,-2,272,683,5,3,62,127,214,267,24,1605,271
1527,24,0.3.418,0,564,1,29,418,447,418,0,447,474,-6,172,689,4,4,48,144,260,390,25,1605,209
1527,24,2.3.412,1,558,0,35,412,447,346,66,447,474,0,166,683,4,4,79,144,188,390,25,1605,209
1527,24,4.3.449,0,577,2,80,449,529,449,0,529,529,-37,203,720,4,4,82,144,285,390,25,1605,209
1527,25,0.3.447,0,558,0,29,447,476,418,29,476,476,0,166,683,4,5,48,109,260,390,26,1605,174
1527,25,2.4.474,1,558,0,44,474,518,447,27,518,518,0,272,683,5,4,44,65,188,267,26,1605,174
1527,25,4.3.449,0,577,1,80,449,529,449,0,529,529,-2,168,685,4,5,82,109,285,390,26,1605,174
1527,26,0.3.447,1,558,0,29,447,476,418,29,476,518,0,166,683,4,5,48,109,260,390,27,1605,130
1527,26,4.3.449,0,577,1,80,449,529,449,0,529,529,-2,168,685,4,5,82,109,285,390,27,1605,130
1527,27,0.4.518,1,558,0,19,518,537,476,42,537,537,0,272,683,5,5,19,21,260,267,28,1605,101
1527,27,4.3.476,0,558,0,80,476,556,449,27,556,556,0,166,683,4,6,82,80,285,390,28,1605,101
1527,28,4.3.476,1,558,0,80,476,556,449,27,556,556,0,166,683,4,6,82,80,285,390,29,1605,82
1527,29,4.4.556,1,558,0,2,556,558,556,0,558,558,-19,291,702,5,6,2,2,285,267,30,1605,2
1528,0,0.0.0,0,529,2,82,0,82,0,0,82,82,0,0,0,1,1,304,334,304,334,1,1381,1381
1528,0,1.0.0,0,474,0,69,0,69,0,0,69,69,0,0,0,1,1,241,334,241,334,1,1381,1381
1528,0,2.0.0,0,520,1,56,0,56,0,0,56,56,0,0,0,1,1,117,334,117,334,1,1381,1381
1528,0,3.0.0,0,553,3,93,0,93,0,0,93,93,0,0,0,1,1,279,334,279,334,1,1381,1381
1528,0,4.0.0,1,474,0,16,0,16,0,0,16,16,0,0,0,1,1,223,334,223,334,1,1381,1381
1528,0,5.0.0,0,474,0,18,0,18,0,0,18,18,0,0,0,1,1,217,334,217,334,1,1381,1381
1528,1,0.0.16,0,490,1,82,16,98,0,16,98,98,0,0,0,1,2,304,318,304,334,2,1381,1365
1528,1,1.0.16,0,474,0,69,16,85,0,16,85,85,0,0,0,1,2,241,318,241,334,2,1381,1365
1528,1,2.0.16,0,520,2,56,16,72,0,16,72,72,0,0,0,1,2,117,318,117,334,2,1381,1365
1528,1,3.0.16,0,553,3,93,16,109,0,16,109,109,0,0,0,1,2,279,318,279,334,2,1381,1365
1528,1,4.1.16,1,474,0,39,16,55,16,0,55,55,-16,16,16,2,1,207,170,223,170,2,1381,1365
1528,1,5.0.16,0,474,0,18,16,34,0,16,34,34,0,0,0,1,2,217,318,217,334,2,1381,1365
1528,2,0.0.16,0,490,1,82,16,98,0,16,98,98,0,0,16,1,2,304,318,304,334,3,1381,1326
1528,2,1.0.16,0,474,0,69,16,85,0,16,85,85,0,0,16,1,2,241,318,241,334,3,1381,1326
1528,2,2.0.16,0,520,2,56,16,72,0,16,72,72,0,0,16,1,2,117,318,117,334,3,1381,1326
1528,2,3.0.16,0,553,3,93,16,109,0,16,109,109,0,0,16,1,2,279,318,279,334,3,1381,1326
1528,2,4.2.55,1,474,0,23,55,78,55,0,78,78,-55,55,71,3,1,168,334,223,334,3,1381,1326
1528,2,5.0.16,0,474,0,18,16,34,0,16,34,55,0,0,16,1,2,217,318,217,334,3,1381,1326
1528,3,0.0.16,0,490,1,82,16,98,0,16,98,98,0,0,71,1,2,304,318,304,334,4,1381,1303
1528,3,1.0.16,0,474,0,69,16,85,0,16,85,85,0,0,71,1,2,241,318,241,334,4,1381,1303
1528,3,2.0.16,0,520,2,56,16,72,0,16,72,78,0,0,71,1,2,117,318,117,334,4,1381,1303
1528,3,3.0.16,0,553,3,93,16,109,0,16,109,109,0,0,71,1,2,279,318,279,334,4,1381,1303
1528,3,4.3.78,1,474,0,74,78,152,78,0,152,152,-78,78,149,4,1,145,247,223,247,4,1381,1303
1528,3,5.0.16,0,474,0,18,16,34,0,16,34,78,0,0,71,1,2,217,318,217,334,4,1381,1303
1528,4,0.0.16,0,490,1,82,16,98,0,16,98,152,0,0,149,1,2,304,318,304,334,5,1381,1229
1528,4,1.0.16,0,474,0,69,16,85,0,16,85,152,0,0,149,1,2,241,318,241,334,5,1381,1229
1528,4,2.0.16,0,520,2,56,16,72,0,16,72,152,0,0,149,1,2,117,318,117,334,5,1381,1229
1528,4,3.0.16,0,553,3,93,16,109,0,16,109,152,0,0,149,1,2,279,318,279,334,5,1381,1229
1528,4,4.4.152,1,474,0,71,152,223,152,0,223,223,-152,152,301,5,1,71,296,223,296,5,1381,1229
1528,4,5.0.16,0,474,0,18,16,34,0,16,34,152,0,0,149,1,2,217,318,217,334,5,1381,1229
1528,5,0.0.16,0,490,1,82,16,98,0,16,98,223,0,0,301,1,2,304,318,304,334,6,1381,1158
1528,5,1.0.16,0,474,0,69,16,85,0,16,85,223,0,0,301,1,2,241,318,241,334,6,1381,1158
1528,5,2.0.16,0,520,2,56,16,72,0,16,72,223,0,0,301,1,2,117,318,117,334,6,1381,1158
1528,5,3.0.16,0,553,3,93,16,109,0,16,109,223,0,0,301,1,2,279,318,279,334,6,1381,1158
1528,5,5.0.16,1,474,0,18,16,34,0,16,34,223,0,0,301,1,2,217,318,217,334,6,1381,1158
1528,6,0.0.34,0,474,0,82,34,116,0,34,116,223,0,0,301,1,3,304,300,304,334,7,1381,1140
1528,6,1.0.34,0,474,0,69,34,103,0,34,103,223,0,0,301,1,3,241,300,241,334,7,1381,1140
1528,6,2.0.34,0,520,2,56,34,90,0,34,90,223,0,0,301,1,3,117,300,117,334,7,1381,1140
1528,6,3.0.34,0,518,1,93,34,127,0,34,127,223,0,0,301,1,3,279,300,279,334,7,1381,1140
1528,6,5.1.55,1,474,0,33,55,88,34,21,88,223,0,16,301,2,2,199,131,217,170,7,1381,1140
1528,7,0.0.34,0,474,0,82,34,116,0,34,116,223,0,0,301,1,3,304,300,304,334,8,1381,1107
1528,7,1.0.34,0,474,0,69,34,103,0,34,103,223,0,0,301,1,3,241,300,241,334,8,1381,1107
1528,7,2.0.34,0,520,2,56,34,90,0,34,90,223,0,0,301,1,3,117,300,117,334,8,1381,1107
1528,7,3.0.34,0,518,1,93,34,127,0,34,127,223,0,0,301,1,3,279,300,279,334,8,1381,1107
1528,7,5.2.88,1,474,0,48,88,136,88,0,136,223,-10,65,311,3,2,166,311,217,334,8,1381,1107
1528,8,0.0.34,0,474,0,82,34,116,0,34,116,223,0,0,311,1,3,304,300,304,334,9,1381,1059
1528,8,1.0.34,0,474,0,69,34,103,0,34,103,223,0,0,311,1,3,241,300,241,334,9,1381,1059
1528,8,2.0.34,0,520,2,56,34,90,0,34,90,223,0,0,311,1,3,117,300,117,334,9,1381,1059
1528,8,3.0.34,0,518,1,93,34,127,0,34,127,223,0,0,311,1,3,279,300,279,334,9,1381,1059
1528,8,5.3.152,1,474,0,65,152,217,136,16,217,223,0,78,311,4,2,118,173,217,247,9,1381,1059
1528,9,0.0.34,0,474,0,82,34,116,0,34,116,223,0,0,311,1,3,304,300,304,334,10,1381,994
1528,9,1.0.34,0,474,0,69,34,103,0,34,103,223,0,0,311,1,3,241,300,241,334,10,1381,994
1528,9,2.0.34,0,520,2,56,34,90,0,34,90,223,0,0,311,1,3,117,300,117,334,10,1381,994
1528,9,3.0.34,0,518,1,93,34,127,0,34,127,223,0,0,311,1,3,279,300,279,334,10,1381,994
1528,9,5.4.223,1,474,0,53,223,276,217,6,276,276,0,152,311,5,2,53,225,217,296,10,1381,994
1528,10,0.0.34,1,474,0,82,34,116,0,34,116,276,0,0,311,1,3,304,300,304,334,11,1381,941
1528,10,1.0.34,0,474,0,69,34,103,0,34,103,276,0,0,311,1,3,241,300,241,334,11,1381,941
1528,10,2.0.34,0,520,2,56,34,90,0,34,90,276,0,0,311,1,3,117,300,117,334,11,1381,941
1528,10,3.0.34,0,518,1,93,34,127,0,34,127,276,0,0,311,1,3,279,300,279,334,11,1381,941
1528,11,0.1.116,1,474,0,39,116,155,116,0,155,276,-28,44,339,2,3,222,98,304,170,12,1381,859
1528,11,1.0.116,0,474,0,69,116,185,0,116,185,276,0,0,311,1,4,241,218,241,334,12,1381,859
1528,11,2.0.116,0,520,2,56,116,172,0,116,172,276,0,0,311,1,4,117,218,117,334,12,1381,859
1528,11,3.0.116,0,508,1,93,116,209,0,116,209,276,0,0,311,1,4,279,218,279,334,12,1381,859
1528,12,0.2.155,1,474,0,76,155,231,155,0,231,276,-19,84,358,3,3,183,263,304,334,13,1381,820
1528,12,1.0.116,0,474,0,69,116,185,0,116,185,276,0,0,339,1,4,241,218,241,334,13,1381,820
1528,12,2.0.116,0,520,2,56,116,172,0,116,172,276,0,0,339,1,4,117,218,117,334,13,1381,820
1528,12,3.0.116,0,508,1,93,116,209,0,116,209,276,0,0,339,1,4,279,218,279,334,13,1381,820
1528,13,0.3.231,1,474,0,36,231,267,231,0,267,276,-14,92,372,4,3,107,108,304,247,14,1381,744
1528,13,1.0.116,0,474,0,69,116,185,0,116,185,276,0,0,358,1,4,241,218,241,334,14,1381,744
1528,13,2.0.116,0,520,2,56,116,172,0,116,172,276,0,0,358,1,4,117,218,117,334,14,1381,744
1528,13,3.0.116,0,508,1,93,116,209,0,116,209,276,0,0,358,1,4,279,218,279,334,14,1381,744
1528,14,0.4.276,1,474,0,71,276,347,267,9,347,347,0,152,372,5,3,71,172,304,296,15,1381,708
1528,14,1.0.116,0,474,0,69,116,185,0,116,185,276,0,0,372,1,4,241,218,241,334,15,1381,708
1528,14,2.0.116,0,520,2,56,116,172,0,116,172,276,0,0,372,1,4,117,218,117,334,15,1381,708
1528,14,3.0.116,0,508,1,93,116,209,0,116,209,276,0,0,372,1,4,279,218,279,334,15,1381,708
1528,15,1.0.116,1,474,0,69,116,185,0,116,185,347,0,0,372,1,4,241,218,241,334,16,1381,637
1528,15,2.0.116,0,520,2,56,116,172,0,116,172,347,0,0,372,1,4,117,218,117,334,16,1381,637
1528,15,3.0.116,0,508,1,93,116,209,0,116,209,347,0,0,372,1,4,279,218,279,334,16,1381,637
1528,16,1.1.185,1,474,0,1,185,186,185,0,186,347,-30,74,402,2,4,172,59,241,170,17,1381,568
1528,16,2.0.185,0,520,1,56,185,241,0,185,241,347,0,0,372,1,5,117,149,117,334,17,1381,568
1528,16,3.0.185,0,474,0,93,185,278,0,185,278,347,0,0,372,1,5,279,149,279,334,17,1381,568
1528,17,1.2.231,1,474,0,66,231,297,186,45,297,347,0,84,402,3,4,171,187,241,334,18,1381,567
1528,17,2.0.185,0,520,1,56,185,241,0,185,241,347,0,0,402,1,5,117,149,117,334,18,1381,567
1528,17,3.0.185,0,474,0,93,185,278,0,185,278,347,0,0,402,1,5,279,149,279,334,18,1381,567
1528,18,1.3.297,1,474,0,18,297,315,297,0,315,347,-30,122,432,4,4,105,72,241,247,19,1381,501
1528,18,2.0.185,0,520,1,56,185,241,0,185,241,347,0,0,402,1,5,117,149,117,334,19,1381,501
1528,18,3.0.185,0,474,0,93,185,278,0,185,278,347,0,0,402,1,5,279,149,279,334,19,1381,501
1528,19,1.4.347,1,474,0,87,347,434,315,32,434,434,0,152,432,5,4,87,101,241,296,20,1381,483
1528,19,2.0.185,0,520,1,56,185,241,0,185,241,347,0,0,432,1,5,117,149,117,334,20,1381,483
1528,19,3.0.185,0,474,0,93,185,278,0,185,278,347,0,0,432,1,5,279,149,279,334,20,1381,483
1528,20,2.0.185,0,520,1,56,185,241,0,185,241,434,0,0,432,1,5,117,149,117,334,21,1381,396
1528,20,3.0.185,1,474,0,93,185,278,0,185,278,434,0,0,432,1,5,279,149,279,334,21,1381,396
1528,21,2.0.278,0,474,0,56,278,334,0,278,334,434,0,0,432,1,6,117,56,117,334,22,1381,303
1528,21,3.1.278,1,474,0,33,278,311,278,0,311,434,-92,166,524,2,5,186,58,279,170,22,1381,303
1528,22,2.0.278,1,474,0,56,278,334,0,278,334,434,0,0,524,1,6,117,56,117,334,23,1381,270
1528,22,3.2.311,0,474,0,99,311,410,311,0,410,434,-14,98,538,3,5,153,121,279,334,23,1381,270
1528,23,2.1.334,1,474,0,25,334,359,334,0,359,434,-23,189,547,2,6,61,25,117,170,24,1381,214
1528,23,3.2.311,0,474,0,99,311,410,311,0,410,434,-14,98,538,3,5,153,121,279,334,24,1381,214
1528,24,2.2.359,0,534,1,22,359,381,359,0,381,434,-62,146,609,3,5,36,121,117,334,25,1381,189
1528,24,3.2.311,1,474,0,99,311,410,311,0,410,434,-14,98,561,3,5,153,121,279,334,25,1381,189
1528,25,2.2.410,0,474,0,22,410,432,359,51,432,434,0,98,561,3,6,36,22,117,334,26,1381,90
1528,25,3.3.410,1,474,0,50,410,460,410,0,460,460,-95,217,656,4,5,54,54,279,247,26,1381,90
1528,26,2.2.410,0,474,0,22,410,432,359,51,432,460,0,98,656,3,6,36,22,117,334,27,1381,40
1528,26,3.4.460,1,474,0,4,460,464,460,0,464,464,-26,178,682,5,5,4,14,279,296,27,1381,40
1528,27,2.2.410,1,474,0,22,410,432,359,51,432,464,0,98,682,3,6,36,22,117,334,28,1381,36
1528,28,2.3.460,1,474,0,4,460,464,432,28,464,464,0,217,682,4,6,14,4,117,247,29,1381,14
1528,29,2.4.464,1,474,0,10,464,474,464,0,474,474,0,178,682,5,6,10,10,117,296,30,1381,10
1529,0,0.0.0,0,595,5,95,0,95,0,0,95,95,0,0,0,1,1,247,250,247,250,1,1547,1547
1529,0,1.0.0,0,537,2,45,0,45,0,0,45,45,0,0,0,1,1,340,250,340,250,1,1547,1547
1529,0,2.0.0,1,500,0,2,0,2,0,0,2,2,0,0,0,1,1,241,250,241,250,1,1547,1547
1529,0,3.0.0,0,547,4,47,0,47,0,0,47,47,0,0,0,1,1,238,250,238,250,1,1547,1547
1529,0,4.0.0,0,538,3,38,0,38,0,0,38,38,0,0,0,1,1,262,250,262,250,1,1547,1547
1529,0,5.0.0,0,523,1,23,0,23,0,0,23,23,0,0,0,1,1,219,250,219,250,1,1547,1547
1529,1,0.0.2,0,568,3,95,2,97,0,2,97,97,0,0,0,1,2,247,248,247,250,2,1547,1545
1529,1,1.0.2,0,500,0,45,2,47,0,2,47,47,0,0,0,1,2,340,248,340,250,2,1547,1545
1529,1,2.1.2,1,500,0,18,2,20,2,0,20,20,-2,2,2,2,1,239,271,241,271,2,1547,1545
1529,1,3.0.2,0,523,2,47,2,49,0,2,49,49,0,0,0,1,2,238,248,238,250,2,1547,1545
1529,1,4.0.2,0,518,1,38,2,40,0,2,40,40,0,0,0,1,2,262,248,262,250,2,1547,1545
1529,1,5.0.2,0,518,1,23,2,25,0,2,25,25,0,0,0,1,2,219,248,219,250,2,1547,1545
1529,2,0.0.2,0,568,3,95,2,97,0,2,97,97,0,0,2,1,2,247,248,247,250,3,1547,1527
1529,2,1.0.2,1,500,0,45,2,47,0,2,47,47,0,0,2,1,2,340,248,340,250,3,1547,1527
1529,2,2.2.20,0,500,0,74,20,94,20,0,94,94,-20,20,22,3,1,221,400,241,400,3,1547,1527
1529,2,3.0.2,0,523,2,47,2,49,0,2,49,49,0,0,2,1,2,238,248,238,250,3,1547,1527
1529,2,4.0.2,0,518,1,38,2,40,0,2,40,40,0,0,2,1,2,262,248,262,250,3,1547,1527
1529,2,5.0.2,0,518,1,23,2,25,0,2,25,25,0,0,2,1,2,219,248,219,250,3,1547,1527
1529,3,0.0.47,0,517,1,95,47,142,0,47,142,142,0,0,2,1,3,247,203,247,250,4,1547,1482
1529,3,1.1.47,0,500,0,68,47,115,47,0,115,115,-27,29,29,2,2,295,253,340,271,4,1547,1482
1529,3,2.2.20,0,500,0,74,20,94,20,0,94,94,-20,20,22,3,1,221,400,241,400,4,1547,1482
1529,3,3.0.47,0,500,0,47,47,94,0,47,94,94,0,0,2,1,3,238,203,238,250,4,1547,1482
1529,3,4.0.47,0,500,0,38,47,85,0,47,85,85,0,0,2,1,3,262,203,262,250,4,1547,1482
1529,3,5.0.47,1,500,0,23,47,70,0,47,70,70,0,0,2,1,3,219,203,219,250,4,1547,1482
1529,4,0.0.70,0,517,1,95,70,165,0,70,165,165,0,0,2,1,4,247,180,247,250,5,1547,1459
1529,4,1.1.47,0,500,0,68,47,115,47,0,115,115,-27,29,29,2,2,295,253,340,271,5,1547,1459
1529,4,2.2.20,0,500,0,74,20,94,20,0,94,94,-20,20,22,3,1,221,400,241,400,5,1547,1459
1529,4,3.0.70,0,500,0,47,70,117,0,70,117,117,0,0,2,1,4,238,180,238,250,5,1547,1459
1529,4,4.0.70,1,500,0,38,70,108,0,70,108,108,0,0,2,1,4,262,180,262,250,5,1547,1459
1529,4,5.1.70,0,518,2,16,70,86,70,0,86,86,-50,52,52,2,2,196,253,219,271,5,1547,1459
1529,5,0.0.108,0,500,0,95,108,203,0,108,203,203,0,0,2,1,5,247,142,247,250,6,1547,1421
1529,5,1.1.47,0,500,0,68,47,115,47,0,115,115,-27,29,29,2,2,295,253,340,271,6,1547,1421
1529,5,2.2.20,0,500,0,74,20,94,20,0,94,108,-20,20,22,3,1,221,400,241,400,6,1547,1421
1529,5,3.0.108,1,500,0,47,108,155,0,108,155,155,0,0,2,1,5,238,142,238,250,6,1547,1421
1529,5,4.1.108,0,563,2,91,108,199,108,0,199,199,-88,90,90,2,2,224,253,262,271,6,1547,1421
1529,5,5.1.70,0,518,1,16,70,86,70,0,86,108,-50,52,52,2,2,196,253,219,271,6,1547,1421
1529,6,0.0.155,1,500,0,95,155,250,0,155,250,250,0,0,2,1,6,247,95,247,250,7,1547,1374
1529,6,1.1.47,0,500,0,68,47,115,47,0,115,155,-27,29,29,2,2,295,253,340,271,7,1547,1374
1529,6,2.2.20,0,500,0,74,20,94,20,0,94,155,-20,20,22,3,1,221,400,241,400,7,1547,1374
1529,6,3.1.155,0,507,1,71,155,226,155,0,226,226,-135,137,137,2,2,191,253,238,271,7,1547,1374
1529,6,4.1.108,0,563,3,91,108,199,108,0,199,199,-88,90,90,2,2,224,253,262,271,7,1547,1374
1529,6,5.1.70,0,518,2,16,70,86,70,0,86,155,-50,52,52,2,2,196,253,219,271,7,1547,1374
1529,7,0.1.250,0,500,0,7,250,257,250,0,257,257,-230,232,232,2,2,152,253,247,271,8,1547,1279
1529,7,1.1.47,1,500,0,68,47,115,47,0,115,250,-27,29,29,2,2,295,253,340,271,8,1547,1279
1529,7,2.2.20,0,500,0,74,20,94,20,0,94,250,-20,20,22,3,1,221,400,241,400,8,1547,1279
1529,7,3.1.155,0,507,1,71,155,226,155,0,226,250,-135,137,137,2,2,191,253,238,271,8,1547,1279
1529,7,4.1.108,0,563,3,91,108,199,108,0,199,250,-88,90,90,2,2,224,253,262,271,8,1547,1279
1529,7,5.1.70,0,518,2,16,70,86,70,0,86,250,-50,52,52,2,2,196,253,219,271,8,1547,1279
1529,8,0.1.250,0,500,0,7,250,257,250,0,257,257,-135,164,164,2,3,152,185,247,271,9,1547,1211
1529,8,1.2.115,0,500,0,71,115,186,115,0,186,250,-115,115,144,3,1,227,400,340,400,9,1547,1211
1529,8,2.2.20,0,500,0,74,20,94,20,0,94,250,-20,20,49,3,1,221,400,241,400,9,1547,1211
1529,8,3.1.155,0,507,1,71,155,226,155,0,226,250,-40,69,69,2,3,191,185,238,271,9,1547,1211
1529,8,4.1.115,0,515,2,91,115,206,108,7,206,250,0,29,29,2,3,224,185,262,271,9,1547,1211
1529,8,5.1.115,1,500,0,16,115,131,70,45,131,250,0,29,29,2,3,196,185,219,271,9,1547,1211
1529,9,0.1.250,0,500,0,7,250,257,250,0,257,257,-119,148,148,2,4,152,169,247,271,10,1547,1195
1529,9,1.2.115,0,500,0,71,115,186,115,0,186,250,-115,115,144,3,1,227,400,340,400,10,1547,1195
1529,9,2.2.20,0,500,0,74,20,94,20,0,94,250,-20,20,49,3,1,221,400,241,400,10,1547,1195
1529,9,3.1.155,0,507,1,71,155,226,155,0,226,250,-24,53,53,2,4,191,169,238,271,10,1547,1195
1529,9,4.1.131,1,500,0,91,131,222,108,23,222,250,0,29,29,2,4,224,169,262,271,10,1547,1195
1529,9,5.2.131,0,555,2,86,131,217,131,0,217,250,-131,131,160,3,1,180,400,219,400,10,1547,1195
1529,10,0.1.250,1,500,0,7,250,257,250,0,257,257,-28,57,57,2,5,152,78,247,271,11,1547,1104
1529,10,1.2.115,0,500,0,71,115,186,115,0,186,250,-115,115,144,3,1,227,400,340,400,11,1547,1104
1529,10,2.2.20,0,500,0,74,20,94,20,0,94,250,-20,20,49,3,1,221,400,241,400,11,1547,1104
1529,10,3.1.222,0,500,0,71,222,293,155,67,293,293,0,29,29,2,5,191,78,238,271,11,1547,1104
1529,10,4.2.222,0,531,1,24,222,246,222,0,246,250,-222,222,251,3,1,133,400,262,400,11,1547,1104
1529,10,5.2.131,0,555,2,86,131,217,131,0,217,250,-131,131,160,3,1,180,400,219,400,11,1547,1104
1529,11,0.2.257,0,561,3,79,257,336,257,0,336,336,-257,257,314,3,1,145,400,247,400,12,1547,1097
1529,11,1.2.115,0,500,0,71,115,186,115,0,186,257,-115,115,172,3,1,227,400,340,400,12,1547,1097
1529,11,2.2.20,0,500,0,74,20,94,20,0,94,257,-20,20,77,3,1,221,400,241,400,12,1547,1097
1529,11,3.1.257,1,500,0,71,257,328,155,102,328,328,0,57,57,2,6,191,71,238,271,12,1547,1097
1529,11,4.2.222,0,531,1,24,222,246,222,0,246,257,-222,222,279,3,1,133,400,262,400,12,1547,1097
1529,11,5.2.131,0,555,2,86,131,217,131,0,217,257,-131,131,188,3,1,180,400,219,400,12,1547,1097
1529,12,0.2.257,0,561,4,79,257,336,257,0,336,336,-257,257,314,3,1,145,400,247,400,13,1547,1026
1529,12,1.2.115,0,500,0,71,115,186,115,0,186,328,-115,115,172,3,1,227,400,340,400,13,1547,1026
1529,12,2.2.20,1,500,0,74,20,94,20,0,94,328,-20,20,77,3,1,221,400,241,400,13,1547,1026
1529,12,3.2.328,0,539,2,66,328,394,328,0,394,394,-328,328,385,3,1,120,400,238,400,13,1547,1026
1529,12,4.2.222,0,531,1,24,222,246,222,0,246,328,-222,222,279,3,1,133,400,262,400,13,1547,1026
1529,12,5.2.131,0,555,3,86,131,217,131,0,217,328,-131,131,188,3,1,180,400,219,400,13,1547,1026
1529,13,0.2.257,0,561,4,79,257,336,257,0,336,336,-163,183,240,3,2,145,326,247,400,14,1547,952
1529,13,1.2.115,0,500,0,71,115,186,115,0,186,328,-21,41,98,3,2,227,326,340,400,14,1547,952
1529,13,2.3.94,1,500,0,72,94,166,94,0,166,328,-94,94,171,4,1,147,300,241,300,14,1547,952
1529,13,3.2.328,0,539,2,66,328,394,328,0,394,394,-234,254,311,3,2,120,326,238,400,14,1547,952
1529,13,4.2.222,0,531,1,24,222,246,222,0,246,328,-128,148,205,3,2,133,326,262,400,14,1547,952
1529,13,5.2.131,0,555,3,86,131,217,131,0,217,328,-37,57,114,3,2,180,326,219,400,14,1547,952
1529,14,0.2.257,0,561,4,79,257,336,257,0,336,336,-163,183,334,3,2,145,326,247,400,15,1547,880
1529,14,1.2.115,0,500,0,71,115,186,115,0,186,328,-21,41,192,3,2,227,326,340,400,15,1547,880
1529,14,2.4.166,1,500,0,75,166,241,166,0,241,328,-166,166,337,5,1,75,326,241,326,15,1547,880
1529,14,3.2.328,0,539,2,66,328,394,328,0,394,394,-234,254,405,3,2,120,326,238,400,15,1547,880
1529,14,4.2.222,0,531,1,24,222,246,222,0,246,328,-128,148,299,3,2,133,326,262,400,15,1547,880
1529,14,5.2.131,0,555,3,86,131,217,131,0,217,328,-37,57,208,3,2,180,326,219,400,15,1547,880
1529,15,0.2.257,0,561,4,79,257,336,257,0,336,336,-163,183,500,3,2,145,326,247,400,16,1547,805
1529,15,1.2.115,1,500,0,71,115,186,115,0,186,328,-21,41,358,3,2,227,326,340,400,16,1547,805
1529,15,3.2.328,0,539,2,66,328,394,328,0,394,394,-234,254,571,3,2,120,326,238,400,16,1547,805
1529,15,4.2.222,0,531,1,24,222,246,222,0,246,328,-128,148,465,3,2,133,326,262,400,16,1547,805
1529,15,5.2.131,0,555,3,86,131,217,131,0,217,328,-37,57,374,3,2,180,326,219,400,16,1547,805
1529,16,0.2.257,0,561,3,79,257,336,257,0,336,336,-71,112,429,3,3,145,255,247,400,17,1547,734
1529,16,1.3.186,1,500,0,60,186,246,186,0,246,328,-20,114,378,4,2,156,228,340,300,17,1547,734
1529,16,3.2.328,0,539,2,66,328,394,328,0,394,394,-142,183,500,3,3,120,255,238,400,17,1547,734
1529,16,4.2.222,0,531,1,24,222,246,222,0,246,328,-36,77,394,3,3,133,255,262,400,17,1547,734
1529,16,5.2.186,0,500,0,86,186,272,131,55,272,328,0,41,358,3,3,180,255,219,400,17,1547,734
1529,17,0.2.257,0,561,3,79,257,336,257,0,336,336,-71,112,449,3,3,145,255,247,400,18,1547,674
1529,17,1.4.246,1,500,0,96,246,342,246,0,342,342,-5,171,383,5,2,96,251,340,326,18,1547,674
1529,17,3.2.328,0,539,2,66,328,394,328,0,394,394,-142,183,520,3,3,120,255,238,400,18,1547,674
1529,17,4.2.222,0,531,1,24,222,246,222,0,246,328,-36,77,414,3,3,133,255,262,400,18,1547,674
1529,17,5.2.186,0,500,0,86,186,272,131,55,272,328,0,41,378,3,3,180,255,219,400,18,1547,674
1529,18,0.2.257,0,561,3,79,257,336,257,0,336,342,-71,112,454,3,3,145,255,247,400,19,1547,578
1529,18,3.2.328,0,539,2,66,328,394,328,0,394,394,-142,183,525,3,3,120,255,238,400,19,1547,578
1529,18,4.2.222,1,531,1,24,222,246,222,0,246,342,-36,77,419,3,3,133,255,262,400,19,1547,578
1529,18,5.2.186,0,500,0,86,186,272,131,55,272,342,0,41,383,3,3,180,255,219,400,19,1547,578
1529,19,0.2.257,0,561,1,79,257,336,257,0,336,342,-11,88,430,3,4,145,231,247,400,20,1547,554
1529,19,3.2.328,0,625,2,66,328,394,328,0,394,394,-82,159,501,3,4,120,231,238,400,20,1547,554
1529,19,4.3.246,1,531,0,67,246,313,246,0,313,342,0,114,419,4,3,109,168,262,300,20,1547,554
1529,19,5.2.246,0,531,0,86,246,332,131,115,332,342,0,77,419,3,4,180,231,219,400,20,1547,554
1529,20,0.2.257,0,561,1,79,257,336,257,0,336,342,-11,88,430,3,4,145,231,247,400,21,1547,487
1529,20,3.2.328,0,625,2,66,328,394,328,0,394,394,-82,159,501,3,4,120,231,238,400,21,1547,487
1529,20,4.4.342,1,531,0,42,342,384,313,29,384,384,0,171,419,5,3,42,155,262,326,21,1547,487
1529,20,5.2.246,0,531,0,86,246,332,131,115,332,342,0,77,419,3,4,180,231,219,400,21,1547,487
1529,21,0.2.257,0,561,1,79,257,336,257,0,336,384,-11,88,430,3,4,145,231,247,400,22,1547,445
1529,21,3.2.328,0,625,2,66,328,394,328,0,394,394,-82,159,501,3,4,120,231,238,400,22,1547,445
1529,21,5.2.246,1,531,0,86,246,332,131,115,332,384,0,77,419,3,4,180,231,219,400,22,1547,445
1529,22,0.2.332,0,531,0,79,332,411,257,75,411,411,0,77,419,3,5,145,145,247,400,23,1547,359
1529,22,3.2.332,0,543,1,66,332,398,328,4,398,398,0,77,419,3,5,120,145,238,400,23,1547,359
1529,22,5.3.332,1,531,0,50,332,382,332,0,382,384,-19,133,438,4,4,94,101,219,300,23,1547,359
1529,23,0.2.332,0,531,0,79,332,411,257,75,411,411,0,77,438,3,5,145,145,247,400,24,1547,309
1529,23,3.2.332,0,543,1,66,332,398,328,4,398,398,0,77,438,3,5,120,145,238,400,24,1547,309
1529,23,5.4.384,1,531,0,44,384,428,382,2,428,428,0,171,438,5,4,44,113,219,326,24,1547,309
1529,24,0.2.332,1,531,0,79,332,411,257,75,411,428,0,77,438,3,5,145,145,247,400,25,1547,265
1529,24,3.2.332,0,543,1,66,332,398,328,4,398,428,0,77,438,3,5,120,145,238,400,25,1547,265
1529,25,0.3.411,1,531,0,42,411,453,411,0,453,453,-29,162,467,4,5,66,51,247,300,26,1547,186
1529,25,3.2.411,0,531,0,66,411,477,328,83,477,477,0,77,438,3,6,120,66,238,400,26,1547,186
1529,26,0.4.453,1,531,0,24,453,477,453,0,477,477,-25,196,492,5,5,24,69,247,326,27,1547,144
1529,26,3.2.411,0,531,0,66,411,477,328,83,477,477,0,77,467,3,6,120,66,238,400,27,1547,144
1529,27,3.2.411,1,531,0,66,411,477,328,83,477,477,0,77,492,3,6,120,66,238,400,28,1547,120
1529,28,3.3.477,1,531,0,9,477,486,477,0,486,486,-24,186,516,4,6,54,9,238,300,29,1547,54
1529,29,3.4.486,1,531,0,45,486,531,486,0,531,531,-9,205,525,5,6,45,45,238,326,30,1547,45
1530,0,0.0.0,1,472,0,9,0,9,0,0,9,9,0,0,0,1,1,292,262,292,262,1,1317,1317
1530,0,1.0.0,0,493,4,21,0,21,0,0,21,21,0,0,0,1,1,141,262,141,262,1,1317,1317
1530,0,2.0.0,0,482,2,47,0,47,0,0,47,47,0,0,0,1,1,168,262,168,262,1,1317,1317
1530,0,3.0.0,0,485,3,99,0,99,0,0,99,99,0,0,0,1,1,297,262,297,262,1,1317,1317
1530,0,4.0.0,0,529,5,59,0,59,0,0,59,59,0,0,0,1,1,199,262,199,262,1,1317,1317
1530,0,5.0.0,0,477,1,27,0,27,0,0,27,27,0,0,0,1,1,220,262,220,262,1,1317,1317
1530,1,0.1.9,1,472,0,75,9,84,9,0,84,84,-9,9,9,2,1,283,274,292,274,2,1317,1308
1530,1,1.0.9,0,472,0,21,9,30,0,9,30,30,0,0,0,1,2,141,253,141,262,2,1317,1308
1530,1,2.0.9,0,472,0,47,9,56,0,9,56,56,0,0,0,1,2,168,253,168,262,2,1317,1308
1530,1,3.0.9,0,472,0,99,9,108,0,9,108,108,0,0,0,1,2,297,253,297,262,2,1317,1308
1530,1,4.0.9,0,472,0,59,9,68,0,9,68,68,0,0,0,1,2,199,253,199,262,2,1317,1308
1530,1,5.0.9,0,472,0,27,9,36,0,9,36,36,0,0,0,1,2,220,253,220,262,2,1317,1308
1530,2,0.2.84,1,472,0,83,84,167,84,0,167,167,-84,84,93,3,1,208,271,292,271,3,1317,1233
1530,2,1.0.9,0,472,0,21,9,30,0,9,30,84,0,0,9,1,2,141,253,141,262,3,1317,1233
1530,2,2.0.9,0,472,0,47,9,56,0,9,56,84,0,0,9,1,2,168,253,168,262,3,1317,1233
1530,2,3.0.9,0,472,0,99,9,108,0,9,108,108,0,0,9,1,2,297,253,297,262,3,1317,1233
1530,2,4.0.9,0,472,0,59,9,68,0,9,68,84,0,0,9,1,2,199,253,199,262,3,1317,1233
1530,2,5.0.9,0,472,0,27,9,36,0,9,36,84,0,0,9,1,2,220,253,220,262,3,1317,1233
1530,3,0.3.167,1,472,0,49,167,216,167,0,216,216,-167,167,260,4,1,125,254,292,254,4,1317,1150
1530,3,1.0.9,0,472,0,21,9,30,0,9,30,167,0,0,93,1,2,141,253,141,262,4,1317,1150
1530,3,2.0.9,0,472,0,47,9,56,0,9,56,167,0,0,93,1,2,168,253,168,262,4,1317,1150
1530,3,3.0.9,0,472,0,99,9,108,0,9,108,167,0,0,93,1,2,297,253,297,262,4,1317,1150
1530,3,4.0.9,0,472,0,59,9,68,0,9,68,167,0,0,93,1,2,199,253,199,262,4,1317,1150
1530,3,5.0.9,0,472,0,27,9,36,0,9,36,167,0,0,93,1,2,220,253,220,262,4,1317,1150
1530,4,0.4.216,1,472,0,76,216,292,216,0,292,292,-216,216,476,5,1,76,256,292,256,5,1317,1101
1530,4,1.0.9,0,472,0,21,9,30,0,9,30,216,0,0,260,1,2,141,253,141,262,5,1317,1101
1530,4,2.0.9,0,472,0,47,9,56,0,9,56,216,0,0,260,1,2,168,253,168,262,5,1317,1101
1530,4,3.0.9,0,472,0,99,9,108,0,9,108,216,0,0,260,1,2,297,253,297,262,5,1317,1101
1530,4,4.0.9,0,472,0,59,9,68,0,9,68,216,0,0,260,1,2,199,253,199,262,5,1317,1101
1530,4,5.0.9,0,472,0,27,9,36,0,9,36,216,0,0,260,1,2,220,253,220,262,5,1317,1101
1530,5,1.0.9,0,472,0,21,9,30,0,9,30,292,0,0,476,1,2,141,253,141,262,6,1317,1025
1530,5,2.0.9,0,472,0,47,9,56,0,9,56,292,0,0,476,1,2,168,253,168,262,6,1317,1025
1530,5,3.0.9,0,472,0,99,9,108,0,9,108,292,0,0,476,1,2,297,253,297,262,6,1317,1025
1530,5,4.0.9,0,472,0,59,9,68,0,9,68,292,0,0,476,1,2,199,253,199,262,6,1317,1025
1530,5,5.0.9,1,472,0,27,9,36,0,9,36,292,0,0,476,1,2,220,253,220,262,6,1317,1025
1530,6,1.0.36,0,472,0,21,36,57,0,36,57,292,0,0,476,1,3,141,226,141,262,7,1317,998
1530,6,2.0.36,0,472,0,47,36,83,0,36,83,292,0,0,476,1,3,168,226,168,262,7,1317,998
1530,6,3.0.36,0,472,0,99,36,135,0,36,135,292,0,0,476,1,3,297,226,297,262,7,1317,998
1530,6,4.0.36,0,472,0,59,36,95,0,36,95,292,0,0,476,1,3,199,226,199,262,7,1317,998
1530,6,5.1.84,1,472,0,98,84,182,36,48,182,292,0,9,476,2,2,193,199,220,274,7,1317,998
1530,7,1.0.36,0,472,0,21,36,57,0,36,57,292,0,0,476,1,3,141,226,141,262,8,1317,900
1530,7,2.0.36,0,472,0,47,36,83,0,36,83,292,0,0,476,1,3,168,226,168,262,8,1317,900
1530,7,3.0.36,0,472,0,99,36,135,0,36,135,292,0,0,476,1,3,297,226,297,262,8,1317,900
1530,7,4.0.36,0,472,0,59,36,95,0,36,95,292,0,0,476,1,3,199,226,199,262,8,1317,900
1530,7,5.2.182,1,472,0,25,182,207,182,0,207,292,-15,99,491,3,2,95,188,220,271,8,1317,900
1530,8,1.0.36,0,472,0,21,36,57,0,36,57,292,0,0,491,1,3,141,226,141,262,9,1317,875
1530,8,2.0.36,0,472,0,47,36,83,0,36,83,292,0,0,491,1,3,168,226,168,262,9,1317,875
1530,8,3.0.36,0,472,0,99,36,135,0,36,135,292,0,0,491,1,3,297,226,297,262,9,1317,875
1530,8,4.0.36,0,472,0,59,36,95,0,36,95,292,0,0,491,1,3,199,226,199,262,9,1317,875
1530,8,5.3.216,1,472,0,35,216,251,207,9,251,292,0,167,491,4,2,70,205,220,254,9,1317,875
1530,9,1.0.36,0,472,0,21,36,57,0,36,57,292,0,0,491,1,3,141,226,141,262,10,1317,840
1530,9,2.0.36,0,472,0,47,36,83,0,36,83,292,0,0,491,1,3,168,226,168,262,10,1317,840
1530,9,3.0.36,0,472,0,99,36,135,0,36,135,292,0,0,491,1,3,297,226,297,262,10,1317,840
1530,9,4.0.36,0,472,0,59,36,95,0,36,95,292,0,0,491,1,3,199,226,199,262,10,1317,840
1530,9,5.4.292,1,472,0,35,292,327,251,41,327,327,0,216,491,5,2,35,180,220,256,10,1317,840
1530,10,1.0.36,1,472,0,21,36,57,0,36,57,327,0,0,491,1,3,141,226,141,262,11,1317,805
1530,10,2.0.36,0,472,0,47,36,83,0,36,83,327,0,0,491,1,3,168,226,168,262,11,1317,805
1530,10,3.0.36,0,472,0,99,36,135,0,36,135,327,0,0,491,1,3,297,226,297,262,11,1317,805
1530,10,4.0.36,0,472,0,59,36,95,0,36,95,327,0,0,491,1,3,199,226,199,262,11,1317,805
1530,11,1.1.182,1,472,0,36,182,218,57,125,218,327,0,9,491,2,3,120,101,141,274,12,1317,784
1530,11,2.0.57,0,472,0,47,57,104,0,57,104,327,0,0,491,1,4,168,205,168,262,12,1317,784
1530,11,3.0.57,0,472,0,99,57,156,0,57,156,327,0,0,491,1,4,297,205,297,262,12,1317,784
1530,11,4.0.57,0,472,0,59,57,116,0,57,116,327,0,0,491,1,4,199,205,199,262,12,1317,784
1530,12,1.2.218,0,529,2,76,218,294,218,0,294,327,-11,110,502,3,3,84,163,141,271,13,1317,748
1530,12,2.0.57,0,472,0,47,57,104,0,57,104,327,0,0,491,1,4,168,205,168,262,13,1317,748
1530,12,3.0.57,0,472,0,99,57,156,0,57,156,327,0,0,491,1,4,297,205,297,262,13,1317,748
1530,12,4.0.57,1,474,1,59,57,116,0,57,116,327,0,0,491,1,4,199,205,199,262,13,1317,748
1530,13,1.2.218,0,529,3,76,218,294,218,0,294,327,-11,110,502,3,3,84,163,141,271,14,1317,689
1530,13,2.0.116,0,478,1,47,116,163,0,116,163,327,0,0,491,1,5,168,146,168,262,14,1317,689
1530,13,3.0.116,0,474,0,99,116,215,0,116,215,327,0,0,491,1,5,297,146,297,262,14,1317,689
1530,13,4.1.218,1,514,2,43,218,261,116,102,261,327,0,9,491,2,4,140,65,199,274,14,1317,689
1530,14,1.2.218,0,529,3,76,218,294,218,0,294,327,-11,110,502,3,3,84,163,141,271,15,1317,646
1530,14,2.0.116,1,514,0,47,116,163,0,116,163,327,0,0,491,1,5,168,146,168,262,15,1317,646
1530,14,3.0.116,0,515,1,99,116,215,0,116,215,327,0,0,491,1,5,297,146,297,262,15,1317,646
1530,14,4.2.261,0,527,2,25,261,286,261,0,286,327,-54,153,545,3,3,97,163,199,271,15,1317,646
1530,15,1.2.218,0,529,2,76,218,294,218,0,294,327,-11,110,502,3,3,84,163,141,271,16,1317,599
1530,15,2.1.261,1,514,0,12,261,273,163,98,273,327,0,9,491,2,5,121,22,168,274,16,1317,599
1530,15,3.0.163,0,514,0,99,163,262,0,163,262,327,0,0,491,1,6,297,99,297,262,16,1317,599
1530,15,4.2.261,0,527,1,25,261,286,261,0,286,327,-54,153,545,3,3,97,163,199,271,16,1317,599
1530,16,1.2.218,0,529,2,76,218,294,218,0,294,327,-11,110,502,3,3,84,163,141,271,17,1317,587
1530,16,2.2.273,0,514,0,28,273,301,273,0,301,327,-66,165,557,3,3,109,163,168,271,17,1317,587
1530,16,3.0.163,1,514,0,99,163,262,0,163,262,327,0,0,491,1,6,297,99,297,262,17,1317,587
1530,16,4.2.261,0,527,1,25,261,286,261,0,286,327,-54,153,545,3,3,97,163,199,271,17,1317,587
1530,17,1.2.218,0,529,2,76,218,294,218,0,294,327,-11,110,502,3,3,84,163,141,271,18,1317,488
1530,17,2.2.273,0,514,0,28,273,301,273,0,301,327,-66,165,557,3,3,109,163,168,271,18,1317,488
1530,17,3.1.273,1,514,0,10,273,283,262,11,283,327,0,9,491,2,6,198,10,297,274,18,1317,488
1530,17,4.2.261,0,527,1,25,261,286,261,0,286,327,-54,153,545,3,3,97,163,199,271,18,1317,488
1530,18,1.2.218,0,529,2,76,218,294,218,0,294,327,-11,110,502,3,3,84,163,141,271,19,1317,478
1530,18,2.2.273,0,514,0,28,273,301,273,0,301,327,-66,165,557,3,3,109,163,168,271,19,1317,478
1530,18,3.2.283,1,529,2,34,283,317,283,0,317,327,-76,175,567,3,3,188,163,297,271,19,1317,478
1530,18,4.2.261,0,527,1,25,261,286,261,0,286,327,-54,153,545,3,3,97,163,199,271,19,1317,478
1530,19,1.2.317,0,534,1,76,317,393,218,99,393,393,0,175,567,3,4,84,129,141,271,20,1317,444
1530,19,2.2.317,0,529,0,28,317,345,273,44,345,345,0,175,567,3,4,109,129,168,271,20,1317,444
1530,19,3.3.317,1,529,0,67,317,384,317,0,384,384,-66,233,633,4,3,154,170,297,254,20,1317,444
1530,19,4.2.317,0,529,0,25,317,342,261,56,342,342,0,175,567,3,4,97,129,199,271,20,1317,444
1530,20,1.2.317,0,534,1,76,317,393,218,99,393,393,0,175,633,3,4,84,129,141,271,21,1317,377
1530,20,2.2.317,0,529,0,28,317,345,273,44,345,384,0,175,633,3,4,109,129,168,271,21,1317,377
1530,20,3.4.384,1,529,0,87,384,471,384,0,471,471,-57,273,690,5,3,87,145,297,256,21,1317,377
1530,20,4.2.317,0,529,0,25,317,342,261,56,342,384,0,175,633,3,4,97,129,199,271,21,1317,377
1530,21,1.2.317,0,534,1,76,317,393,218,99,393,471,0,175,690,3,4,84,129,141,271,22,1317,290
1530,21,2.2.317,0,529,0,28,317,345,273,44,345,471,0,175,690,3,4,109,129,168,271,22,1317,290
1530,21,4.2.317,1,529,0,25,317,342,261,56,342,471,0,175,690,3,4,97,129,199,271,22,1317,290
1530,22,1.2.342,0,529,0,76,342,418,218,124,418,471,0,175,690,3,5,84,104,141,271,23,1317,265
1530,22,2.2.342,1,529,0,28,342,370,273,69,370,471,0,175,690,3,5,109,104,168,271,23,1317,265
1530,22,4.3.384,0,529,0,60,384,444,342,42,444,471,0,233,690,4,4,72,103,199,254,23,1317,265
1530,23,1.2.370,1,529,0,76,370,446,218,152,446,471,0,175,690,3,6,84,76,141,271,24,1317,237
1530,23,2.3.384,0,529,0,41,384,425,370,14,425,471,0,233,690,4,4,81,103,168,254,24,1317,237
1530,23,4.3.384,0,529,0,60,384,444,342,42,444,471,0,233,690,4,4,72,103,199,254,24,1317,237
1530,24,1.3.446,0,529,0,2,446,448,446,0,448,471,-62,295,752,4,4,8,103,141,254,25,1317,161
1530,24,2.3.384,0,529,0,41,384,425,370,14,425,471,0,233,690,4,4,81,103,168,254,25,1317,161
1530,24,4.3.384,1,529,0,60,384,444,342,42,444,471,0,233,690,4,4,72,103,199,254,25,1317,161
1530,25,1.3.446,0,529,0,2,446,448,446,0,448,471,-2,235,692,4,5,8,43,141,254,26,1317,101
1530,25,2.3.444,0,531,1,41,444,485,370,74,485,485,0,233,690,4,5,81,43,168,254,26,1317,101
1530,25,4.4.471,1,529,0,12,471,483,444,27,483,483,0,273,690,5,4,12,58,199,256,26,1317,101
1530,26,1.3.446,0,529,0,2,446,448,446,0,448,483,-2,235,692,4,5,8,43,141,254,27,1317,89
1530,26,2.3.444,1,531,1,41,444,485,370,74,485,485,0,233,690,4,5,81,43,168,254,27,1317,89
1530,27,1.3.485,1,531,0,2,485,487,446,39,487,487,0,233,690,4,6,8,2,141,254,28,1317,48
1530,27,2.4.485,0,531,0,40,485,525,485,0,525,525,-2,275,692,5,5,40,46,168,256,28,1317,48
1530,28,1.4.487,1,533,1,6,487,493,487,0,493,493,-4,277,694,5,5,6,46,141,256,29,1317,46
1530,28,2.4.485,0,531,0,40,485,525,485,0,525,525,-2,275,692,5,5,40,46,168,256,29,1317,46
1530,29,2.4.493,1,533,0,40,493,533,485,8,533,533,0,277,694,5,6,40,40,168,256,30,1317,40
1531,0,0.0.0,1,478,0,22,0,22,0,0,22,22,0,0,0,1,1,236,377,236,377,1,1388,1388
1531,0,1.0.0,0,533,4,96,0,96,0,0,96,96,0,0,0,1,1,240,377,240,377,1,1388,1388
1531,0,2.0.0,0,539,5,93,0,93,0,0,93,93,0,0,0,1,1,194,377,194,377,1,1388,1388
1531,0,3.0.0,0,505,2,53,0,53,0,0,53,53,0,0,0,1,1,158,377,158,377,1,1388,1388
1531,0,4.0.0,0,508,3,81,0,81,0,0,81,81,0,0,0,1,1,336,377,336,377,1,1388,1388
1531,0,5.0.0,0,484,1,32,0,32,0,0,32,32,0,0,0,1,1,224,377,224,377,1,1388,1388
1531,1,0.1.22,1,478,0,43,22,65,22,0,65,65,-22,22,22,2,1,214,276,236,276,2,1388,1366
1531,1,1.0.22,0,522,2,96,22,118,0,22,118,118,0,0,0,1,2,240,355,240,377,2,1388,1366
1531,1,2.0.22,0,528,3,93,22,115,0,22,115,115,0,0,0,1,2,194,355,194,377,2,1388,1366
1531,1,3.0.22,0,494,1,53,22,75,0,22,75,75,0,0,0,1,2,158,355,158,377,2,1388,1366
1531,1,4.0.22,0,478,0,81,22,103,0,22,103,103,0,0,0,1,2,336,355,336,377,2,1388,1366
1531,1,5.0.22,0,478,0,32,22,54,0,22,54,54,0,0,0,1,2,224,355,224,377,2,1388,1366
1531,2,0.2.65,1,478,0,86,65,151,65,0,151,151,-65,65,87,3,1,171,338,236,338,3,1388,1323
1531,2,1.0.22,0,522,2,96,22,118,0,22,118,118,0,0,22,1,2,240,355,240,377,3,1388,1323
1531,2,2.0.22,0,528,3,93,22,115,0,22,115,115,0,0,22,1,2,194,355,194,377,3,1388,1323
1531,2,3.0.22,0,494,1,53,22,75,0,22,75,75,0,0,22,1,2,158,355,158,377,3,1388,1323
1531,2,4.0.22,0,478,0,81,22,103,0,22,103,103,0,0,22,1,2,336,355,336,377,3,1388,1323
1531,2,5.0.22,0,478,0,32,22,54,0,22,54,65,0,0,22,1,2,224,355,224,377,3,1388,1323
1531,3,0.3.151,1,478,0,56,151,207,151,0,207,207,-151,151,238,4,1,85,209,236,209,4,1388,1237
1531,3,1.0.22,0,522,2,96,22,118,0,22,118,151,0,0,87,1,2,240,355,240,377,4,1388,1237
1531,3,2.0.22,0,528,3,93,22,115,0,22,115,151,0,0,87,1,2,194,355,194,377,4,1388,1237
1531,3,3.0.22,0,494,1,53,22,75,0,22,75,151,0,0,87,1,2,158,355,158,377,4,1388,1237
1531,3,4.0.22,0,478,0,81,22,103,0,22,103,151,0,0,87,1,2,336,355,336,377,4,1388,1237
1531,3,5.0.22,0,478,0,32,22,54,0,22,54,151,0,0,87,1,2,224,355,224,377,4,1388,1237
1531,4,0.4.207,1,478,0,29,207,236,207,0,236,236,-207,207,445,5,1,29,188,236,188,5,1388,1181
1531,4,1.0.22,0,522,2,96,22,118,0,22,118,207,0,0,238,1,2,240,355,240,377,5,1388,1181
1531,4,2.0.22,0,528,3,93,22,115,0,22,115,207,0,0,238,1,2,194,355,194,377,5,1388,1181
1531,4,3.0.22,0,494,1,53,22,75,0,22,75,207,0,0,238,1,2,158,355,158,377,5,1388,1181
1531,4,4.0.22,0,478,0,81,22,103,0,22,103,207,0,0,238,1,2,336,355,336,377,5,1388,1181
1531,4,5.0.22,0,478,0,32,22,54,0,22,54,207,0,0,238,1,2,224,355,224,377,5,1388,1181
1531,5,1.0.22,0,522,2,96,22,118,0,22,118,236,0,0,445,1,2,240,355,240,377,6,1388,1152
1531,5,2.0.22,0,528,3,93,22,115,0,22,115,236,0,0,445,1,2,194,355,194,377,6,1388,1152
1531,5,3.0.22,0,494,1,53,22,75,0,22,75,236,0,0,445,1,2,158,355,158,377,6,1388,1152
1531,5,4.0.22,0,478,0,81,22,103,0,22,103,236,0,0,445,1,2,336,355,336,377,6,1388,1152
1531,5,5.0.22,1,478,0,32,22,54,0,22,54,236,0,0,445,1,2,224,355,224,377,6,1388,1152
1531,6,1.0.54,0,521,2,96,54,150,0,54,150,236,0,0,445,1,3,240,323,240,377,7,1388,1120
1531,6,2.0.54,0,527,3,93,54,147,0,54,147,236,0,0,445,1,3,194,323,194,377,7,1388,1120
1531,6,3.0.54,0,493,1,53,54,107,0,54,107,236,0,0,445,1,3,158,323,158,377,7,1388,1120
1531,6,4.0.54,0,478,0,81,54,135,0,54,135,236,0,0,445,1,3,336,323,336,377,7,1388,1120
1531,6,5.1.65,1,478,0,82,65,147,54,11,147,236,0,22,445,2,2,192,233,224,276,7,1388,1120
1531,7,1.0.54,0,521,2,96,54,150,0,54,150,236,0,0,445,1,3,240,323,240,377,8,1388,1038
1531,7,2.0.54,0,527,3,93,54,147,0,54,147,236,0,0,445,1,3,194,323,194,377,8,1388,1038
1531,7,3.0.54,0,493,1,53,54,107,0,54,107,236,0,0,445,1,3,158,323,158,377,8,1388,1038
1531,7,4.0.54,0,478,0,81,54,135,0,54,135,236,0,0,445,1,3,336,323,336,377,8,1388,1038
1531,7,5.2.151,1,478,0,63,151,214,147,4,214,236,0,65,445,3,2,110,252,224,338,8,1388,1038
1531,8,1.0.54,0,521,2,96,54,150,0,54,150,236,0,0,445,1,3,240,323,240,377,9,1388,975
1531,8,2.0.54,0,527,3,93,54,147,0,54,147,236,0,0,445,1,3,194,323,194,377,9,1388,975
1531,8,3.0.54,0,493,1,53,54,107,0,54,107,236,0,0,445,1,3,158,323,158,377,9,1388,975
1531,8,4.0.54,0,478,0,81,54,135,0,54,135,236,0,0,445,1,3,336,323,336,377,9,1388,975
1531,8,5.3.214,1,478,0,20,214,234,214,0,234,236,-7,158,452,4,2,47,153,224,209,9,1388,975
1531,9,1.0.54,0,521,2,96,54,150,0,54,150,236,0,0,452,1,3,240,323,240,377,10,1388,955
1531,9,2.0.54,0,527,3,93,54,147,0,54,147,236,0,0,452,1,3,194,323,194,377,10,1388,955
1531,9,3.0.54,0,493,1,53,54,107,0,54,107,236,0,0,452,1,3,158,323,158,377,10,1388,955
1531,9,4.0.54,0,478,0,81,54,135,0,54,135,236,0,0,452,1,3,336,323,336,377,10,1388,955
1531,9,5.4.236,1,478,0,27,236,263,234,2,263,263,0,207,452,5,2,27,159,224,188,10,1388,955
1531,10,1.0.54,0,521,2,96,54,150,0,54,150,263,0,0,452,1,3,240,323,240,377,11,1388,928
1531,10,2.0.54,0,527,3,93,54,147,0,54,147,263,0,0,452,1,3,194,323,194,377,11,1388,928
1531,10,3.0.54,0,493,1,53,54,107,0,54,107,263,0,0,452,1,3,158,323,158,377,11,1388,928
1531,10,4.0.54,1,478,0,81,54,135,0,54,135,263,0,0,452,1,3,336,323,336,377,11,1388,928
1531,11,1.0.135,0,478,0,96,135,231,0,135,231,263,0,0,452,1,4,240,242,240,377,12,1388,847
1531,11,2.0.135,0,515,1,93,135,228,0,135,228,263,0,0,452,1,4,194,242,194,377,12,1388,847
1531,11,3.0.135,0,478,0,53,135,188,0,135,188,263,0,0,452,1,4,158,242,158,377,12,1388,847
1531,11,4.1.147,1,478,0,94,147,241,135,12,241,263,0,22,452,2,3,255,151,336,276,12,1388,847
1531,12,1.0.135,0,478,0,96,135,231,0,135,231,263,0,0,452,1,4,240,242,240,377,13,1388,753
1531,12,2.0.135,0,515,1,93,135,228,0,135,228,263,0,0,452,1,4,194,242,194,377,13,1388,753
1531,12,3.0.135,0,478,0,53,135,188,0,135,188,263,0,0,452,1,4,158,242,158,377,13,1388,753
1531,12,4.2.241,1,478,0,26,241,267,241,0,267,267,-27,92,479,3,3,161,189,336,338,13,1388,753
1531,13,1.0.135,0,478,0,96,135,231,0,135,231,267,0,0,479,1,4,240,242,240,377,14,1388,727
1531,13,2.0.135,0,515,1,93,135,228,0,135,228,267,0,0,479,1,4,194,242,194,377,14,1388,727
1531,13,3.0.135,0,478,0,53,135,188,0,135,188,267,0,0,479,1,4,158,242,158,377,14,1388,727
1531,13,4.3.267,1,478,0,53,267,320,267,0,320,320,-33,191,512,4,3,135,133,336,209,14,1388,727
1531,14,1.0.135,0,478,0,96,135,231,0,135,231,320,0,0,512,1,4,240,242,240,377,15,1388,674
1531,14,2.0.135,0,515,1,93,135,228,0,135,228,320,0,0,512,1,4,194,242,194,377,15,1388,674
1531,14,3.0.135,0,478,0,53,135,188,0,135,188,320,0,0,512,1,4,158,242,158,377,15,1388,674
1531,14,4.4.320,1,478,0,82,320,402,320,0,402,402,-57,264,569,5,3,82,132,336,188,15,1388,674
1531,15,1.0.135,0,478,0,96,135,231,0,135,231,402,0,0,569,1,4,240,242,240,377,16,1388,592
1531,15,2.0.135,0,515,1,93,135,228,0,135,228,402,0,0,569,1,4,194,242,194,377,16,1388,592
1531,15,3.0.135,1,478,0,53,135,188,0,135,188,402,0,0,569,1,4,158,242,158,377,16,1388,592
1531,16,1.0.188,0,478,0,96,188,284,0,188,284,402,0,0,569,1,5,240,189,240,377,17,1388,539
1531,16,2.0.188,0,521,1,93,188,281,0,188,281,402,0,0,569,1,5,194,189,194,377,17,1388,539
1531,16,3.1.241,1,478,0,48,241,289,188,53,289,402,0,22,569,2,4,105,57,158,276,17,1388,539
1531,17,1.0.188,0,478,0,96,188,284,0,188,284,402,0,0,569,1,5,240,189,240,377,18,1388,491
1531,17,2.0.188,0,521,1,93,188,281,0,188,281,402,0,0,569,1,5,194,189,194,377,18,1388,491
1531,17,3.2.289,1,478,0,1,289,290,289,0,290,402,-22,114,591,3,4,57,163,158,338,18,1388,491
1531,18,1.0.188,0,478,0,96,188,284,0,188,284,402,0,0,591,1,5,240,189,240,377,19,1388,490
1531,18,2.0.188,0,521,1,93,188,281,0,188,281,402,0,0,591,1,5,194,189,194,377,19,1388,490
1531,18,3.3.320,1,478,0,27,320,347,290,30,347,402,0,191,591,4,4,56,80,158,209,19,1388,490
1531,19,1.0.188,0,478,0,96,188,284,0,188,284,402,0,0,591,1,5,240,189,240,377,20,1388,463
1531,19,2.0.188,0,521,1,93,188,281,0,188,281,402,0,0,591,1,5,194,189,194,377,20,1388,463
1531,19,3.4.402,1,478,0,29,402,431,347,55,431,431,0,264,591,5,4,29,50,158,188,20,1388,463
1531,20,1.0.188,1,478,0,96,188,284,0,188,284,431,0,0,591,1,5,240,189,240,377,21,1388,434
1531,20,2.0.188,0,521,1,93,188,281,0,188,281,431,0,0,591,1,5,194,189,194,377,21,1388,434
1531,21,1.1.289,1,478,0,4,289,293,284,5,293,431,0,22,591,2,5,144,9,240,276,22,1388,338
1531,21,2.0.284,0,478,0,93,284,377,0,284,377,431,0,0,591,1,6,194,93,194,377,22,1388,338
1531,22,1.2.293,0,478,0,82,293,375,293,0,375,431,-3,117,594,3,5,140,162,240,338,23,1388,334
1531,22,2.0.284,1,478,0,93,284,377,0,284,377,431,0,0,591,1,6,194,93,194,377,23,1388,334
1531,23,1.2.293,0,478,0,82,293,375,293,0,375,431,-3,117,594,3,5,140,162,240,338,24,1388,241
1531,23,2.1.377,1,478,0,5,377,382,377,0,382,431,-84,106,675,2,6,101,5,194,276,24,1388,241
1531,24,1.2.293,1,478,0,82,293,375,293,0,375,431,-3,117,678,3,5,140,162,240,338,25,1388,236
1531,24,2.2.382,0,478,0,80,382,462,382,0,462,462,-92,206,767,3,5,96,162,194,338,25,1388,236
1531,25,1.3.375,1,478,0,43,375,418,375,0,418,431,-28,219,706,4,5,58,53,240,209,26,1388,154
1531,25,2.2.382,0,478,0,80,382,462,382,0,462,462,-7,124,685,3,6,96,80,194,338,26,1388,154
1531,26,1.4.431,1,478,0,15,431,446,418,13,446,446,0,264,706,5,5,15,21,240,188,27,1388,111
1531,26,2.2.382,0,478,0,80,382,462,382,0,462,462,-7,124,713,3,6,96,80,194,338,27,1388,111
1531,27,2.2.382,1,478,0,80,382,462,382,0,462,462,-7,124,713,3,6,96,80,194,338,28,1388,96
1531,28,2.3.462,1,478,0,10,462,472,462,0,472,472,-44,263,757,4,6,16,10,194,209,29,1388,16
1531,29,2.4.472,1,478,0,6,472,478,472,0,478,478,-26,290,783,5,6,6,6,194,188,30,1388,6
1532,0,0.0.0,0,551,2,35,0,35,0,0,35,35,0,0,0,1,1,280,193,280,193,1,1557,1557
1532,0,1.0.0,0,591,5,71,0,71,0,0,71,71,0,0,0,1,1,339,193,339,193,1,1557,1557
1532,0,2.0.0,0,559,4,39,0,39,0,0,39,39,0,0,0,1,1,320,193,320,193,1,1557,1557
1532,0,3.0.0,1,527,1,7,0,7,0,0,7,7,0,0,0,1,1,316,193,316,193,1,1557,1557
1532,0,4.0.0,0,520,0,4,0,4,0,0,4,4,0,0,0,1,1,176,193,176,193,1,1557,1557
1532,0,5.0.0,0,557,3,37,0,37,0,0,37,37,0,0,0,1,1,126,193,126,193,1,1557,1557
1532,1,0.0.7,0,558,1,35,7,42,0,7,42,42,0,0,0,1,2,280,186,280,193,2,1557,1550
1532,1,1.0.7,0,563,2,71,7,78,0,7,78,78,0,0,0,1,2,339,186,339,193,2,1557,1550
1532,1,2.0.7,1,563,2,39,7,46,0,7,46,46,0,0,0,1,2,320,186,320,193,2,1557,1550
1532,1,3.1.7,0,563,2,86,7,93,7,0,93,93,-7,7,7,2,1,309,379,316,379,2,1557,1550
1532,1,4.0.7,0,527,0,4,7,11,0,7,11,11,0,0,0,1,2,176,186,176,193,2,1557,1550
1532,1,5.0.7,0,563,2,37,7,44,0,7,44,44,0,0,0,1,2,126,186,126,193,2,1557,1550
1532,2,0.0.46,1,563,0,35,46,81,0,46,81,81,0,0,0,1,3,280,147,280,193,3,1557,1511
1532,2,1.0.46,0,563,0,71,46,117,0,46,117,117,0,0,0,1,3,339,147,339,193,3,1557,1511
1532,2,2.1.46,0,576,1,98,46,144,46,0,144,144,-46,46,46,2,1,281,379,320,379,3,1557,1511
1532,2,3.1.7,0,563,0,86,7,93,7,0,93,93,-7,7,7,2,1,309,379,316,379,3,1557,1511
1532,2,4.0.46,0,563,0,4,46,50,0,46,50,50,0,0,0,1,3,176,147,176,193,3,1557,1511
1532,2,5.0.46,0,563,0,37,46,83,0,46,83,83,0,0,0,1,3,126,147,126,193,3,1557,1511
1532,3,0.1.81,0,597,2,11,81,92,81,0,92,92,-81,81,81,2,1,245,379,280,379,4,1557,1476
1532,3,1.0.81,0,563,0,71,81,152,0,81,152,152,0,0,0,1,4,339,112,339,193,4,1557,1476
1532,3,2.1.46,0,576,1,98,46,144,46,0,144,144,-46,46,46,2,1,281,379,320,379,4,1557,1476
1532,3,3.1.7,0,563,0,86,7,93,7,0,93,93,-7,7,7,2,1,309,379,316,379,4,1557,1476
1532,3,4.0.81,1,563,0,4,81,85,0,81,85,85,0,0,0,1,4,176,112,176,193,4,1557,1476
1532,3,5.0.81,0,563,0,37,81,118,0,81,118,118,0,0,0,1,4,126,112,126,193,4,1557,1476
1532,4,0.1.81,0,597,2,11,81,92,81,0,92,92,-81,81,81,2,1,245,379,280,379,5,1557,1472
1532,4,1.0.85,1,563,0,71,85,156,0,85,156,156,0,0,0,1,5,339,108,339,193,5,1557,1472
1532,4,2.1.46,0,576,1,98,46,144,46,0,144,144,-46,46,46,2,1,281,379,320,379,5,1557,1472
1532,4,3.1.7,0,563,0,86,7,93,7,0,93,93,-7,7,7,2,1,309,379,316,379,5,1557,1472
1532,4,4.1.85,0,601,3,47,85,132,85,0,132,132,-85,85,85,2,1,172,379,176,379,5,1557,1472
1532,4,5.0.85,0,563,0,37,85,122,0,85,122,122,0,0,0,1,5,126,108,126,193,5,1557,1472
1532,5,0.1.81,0,597,2,11,81,92,81,0,92,156,-81,81,81,2,1,245,379,280,379,6,1557,1401
1532,5,1.1.156,0,563,0,72,156,228,156,0,228,228,-156,156,156,2,1,268,379,339,379,6,1557,1401
1532,5,2.1.46,0,576,1,98,46,144,46,0,144,156,-46,46,46,2,1,281,379,320,379,6,1557,1401
1532,5,3.1.7,0,563,0,86,7,93,7,0,93,156,-7,7,7,2,1,309,379,316,379,6,1557,1401
1532,5,4.1.85,0,601,3,47,85,132,85,0,132,156,-85,85,85,2,1,172,379,176,379,6,1557,1401
1532,5,5.0.156,1,563,0,37,156,193,0,156,193,193,0,0,0,1,6,126,37,126,193,6,1557,1401
1532,6,0.1.81,1,597,3,11,81,92,81,0,92,193,-81,81,81,2,1,245,379,280,379,7,1557,1364
1532,6,1.1.156,0,563,0,72,156,228,156,0,228,228,-156,156,156,2,1,268,379,339,379,7,1557,1364
1532,6,2.1.46,0,576,1,98,46,144,46,0,144,193,-46,46,46,2,1,281,379,320,379,7,1557,1364
1532,6,3.1.7,0,563,0,86,7,93,7,0,93,193,-7,7,7,2,1,309,379,316,379,7,1557,1364
1532,6,4.1.85,0,601,4,47,85,132,85,0,132,193,-85,85,85,2,1,172,379,176,379,7,1557,1364
1532,6,5.1.193,0,584,2,65,193,258,193,0,258,258,-193,193,193,2,1,89,379,126,379,7,1557,1364
1532,7,0.2.92,1,597,0,90,92,182,92,0,182,193,-92,92,173,3,1,234,308,280,308,8,1557,1353
1532,7,1.1.156,0,641,1,72,156,228,156,0,228,228,-64,145,145,2,2,268,368,339,379,8,1557,1353
1532,7,2.1.92,0,597,0,98,92,190,46,46,190,193,0,81,81,2,2,281,368,320,379,8,1557,1353
1532,7,3.1.92,0,597,0,86,92,178,7,85,178,193,0,81,81,2,2,309,368,316,379,8,1557,1353
1532,7,4.1.92,0,597,0,47,92,139,85,7,139,193,0,81,81,2,2,172,368,176,379,8,1557,1353
1532,7,5.1.193,0,659,2,65,193,258,193,0,258,258,-101,182,182,2,2,89,368,126,379,8,1557,1353
1532,8,0.3.182,1,597,0,62,182,244,182,0,244,244,-182,182,355,4,1,144,360,280,360,9,1557,1263
1532,8,1.1.156,0,641,1,72,156,228,156,0,228,228,-64,145,237,2,2,268,368,339,379,9,1557,1263
1532,8,2.1.92,0,597,0,98,92,190,46,46,190,193,0,81,173,2,2,281,368,320,379,9,1557,1263
1532,8,3.1.92,0,597,0,86,92,178,7,85,178,193,0,81,173,2,2,309,368,316,379,9,1557,1263
1532,8,4.1.92,0,597,0,47,92,139,85,7,139,193,0,81,173,2,2,172,368,176,379,9,1557,1263
1532,8,5.1.193,0,659,2,65,193,258,193,0,258,258,-101,182,274,2,2,89,368,126,379,9,1557,1263
1532,9,0.4.244,1,597,0,82,244,326,244,0,326,326,-244,244,599,5,1,82,317,280,317,10,1557,1201
1532,9,1.1.156,0,641,1,72,156,228,156,0,228,244,-64,145,419,2,2,268,368,339,379,10,1557,1201
1532,9,2.1.92,0,597,0,98,92,190,46,46,190,244,0,81,355,2,2,281,368,320,379,10,1557,1201
1532,9,3.1.92,0,597,0,86,92,178,7,85,178,244,0,81,355,2,2,309,368,316,379,10,1557,1201
1532,9,4.1.92,0,597,0,47,92,139,85,7,139,244,0,81,355,2,2,172,368,176,379,10,1557,1201
1532,9,5.1.193,0,659,2,65,193,258,193,0,258,258,-101,182,456,2,2,89,368,126,379,10,1557,1201
1532,10,1.1.156,0,641,1,72,156,228,156,0,228,326,-64,145,663,2,2,268,368,339,379,11,1557,1119
1532,10,2.1.92,0,597,0,98,92,190,46,46,190,326,0,81,599,2,2,281,368,320,379,11,1557,1119
1532,10,3.1.92,1,597,0,86,92,178,7,85,178,326,0,81,599,2,2,309,368,316,379,11,1557,1119
1532,10,4.1.92,0,597,0,47,92,139,85,7,139,326,0,81,599,2,2,172,368,176,379,11,1557,1119
1532,10,5.1.193,0,659,2,65,193,258,193,0,258,326,-101,182,700,2,2,89,368,126,379,11,1557,1119
1532,11,1.1.178,0,620,1,72,178,250,156,22,250,326,0,81,599,2,3,268,282,339,379,12,1557,1033
1532,11,2.1.178,0,597,0,98,178,276,46,132,276,326,0,81,599,2,3,281,282,320,379,12,1557,1033
1532,11,3.2.182,1,597,0,68,182,250,178,4,250,326,0,92,599,3,2,223,218,316,308,12,1557,1033
1532,11,4.1.178,0,597,0,47,178,225,85,93,225,326,0,81,599,2,3,172,282,176,379,12,1557,1033
1532,11,5.1.193,0,671,2,65,193,258,193,0,258,326,-15,96,614,2,3,89,282,126,379,12,1557,1033
1532,12,1.1.178,0,620,1,72,178,250,156,22,250,326,0,81,599,2,3,268,282,339,379,13,1557,965
1532,12,2.1.178,0,597,0,98,178,276,46,132,276,326,0,81,599,2,3,281,282,320,379,13,1557,965
1532,12,3.3.250,1,597,0,85,250,335,250,0,335,335,-6,188,605,4,2,155,298,316,360,13,1557,965
1532,12,4.1.178,0,597,0,47,178,225,85,93,225,326,0,81,599,2,3,172,282,176,379,13,1557,965
1532,12,5.1.193,0,671,2,65,193,258,193,0,258,326,-15,96,614,2,3,89,282,126,379,13,1557,965
1532,13,1.1.178,0,620,1,72,178,250,156,22,250,335,0,81,605,2,3,268,282,339,379,14,1557,880
1532,13,2.1.178,0,597,0,98,178,276,46,132,276,335,0,81,605,2,3,281,282,320,379,14,1557,880
1532,13,3.4.335,1,597,0,70,335,405,335,0,405,405,-9,253,614,5,2,70,235,316,317,14,1557,880
1532,13,4.1.178,0,597,0,47,178,225,85,93,225,335,0,81,605,2,3,172,282,176,379,14,1557,880
1532,13,5.1.193,0,671,2,65,193,258,193,0,258,335,-15,96,620,2,3,89,282,126,379,14,1557,880
1532,14,1.1.178,0,620,1,72,178,250,156,22,250,405,0,81,614,2,3,268,282,339,379,15,1557,810
1532,14,2.1.178,1,597,0,98,178,276,46,132,276,405,0,81,614,2,3,281,282,320,379,15,1557,810
1532,14,4.1.178,0,597,0,47,178,225,85,93,225,405,0,81,614,2,3,172,282,176,379,15,1557,810
1532,14,5.1.193,0,671,2,65,193,258,193,0,258,405,-15,96,629,2,3,89,282,126,379,15,1557,810
1532,15,1.1.276,0,621,1,72,276,348,156,120,348,405,0,81,614,2,4,268,184,339,379,16,1557,712
1532,15,2.2.276,1,597,0,34,276,310,276,0,310,405,-26,118,640,3,3,183,150,320,308,16,1557,712
1532,15,4.1.276,0,597,0,47,276,323,85,191,323,405,0,81,614,2,4,172,184,176,379,16,1557,712
1532,15,5.1.276,0,656,2,65,276,341,193,83,341,405,0,81,614,2,4,89,184,126,379,16,1557,712
1532,16,1.1.276,0,621,1,72,276,348,156,120,348,405,0,81,640,2,4,268,184,339,379,17,1557,678
1532,16,2.3.335,1,597,0,78,335,413,310,25,413,413,0,188,640,4,3,149,213,320,360,17,1557,678
1532,16,4.1.276,0,597,0,47,276,323,85,191,323,405,0,81,640,2,4,172,184,176,379,17,1557,678
1532,16,5.1.276,0,656,2,65,276,341,193,83,341,405,0,81,640,2,4,89,184,126,379,17,1557,678
1532,17,1.1.276,0,621,1,72,276,348,156,120,348,413,0,81,640,2,4,268,184,339,379,18,1557,600
1532,17,2.4.413,1,597,0,71,413,484,413,0,484,484,-8,261,648,5,3,71,165,320,317,18,1557,600
1532,17,4.1.276,0,597,0,47,276,323,85,191,323,413,0,81,640,2,4,172,184,176,379,18,1557,600
1532,17,5.1.276,0,656,2,65,276,341,193,83,341,413,0,81,640,2,4,89,184,126,379,18,1557,600
1532,18,1.1.276,0,621,1,72,276,348,156,120,348,484,0,81,648,2,4,268,184,339,379,19,1557,529
1532,18,4.1.276,1,597,0,47,276,323,85,191,323,484,0,81,648,2,4,172,184,176,379,19,1557,529
1532,18,5.1.276,0,656,2,65,276,341,193,83,341,484,0,81,648,2,4,89,184,126,379,19,1557,529
1532,19,1.1.323,1,597,0,72,323,395,156,167,395,484,0,81,648,2,5,268,137,339,379,20,1557,482
1532,19,4.2.323,0,597,0,27,323,350,323,0,350,484,-13,131,661,3,4,125,116,176,308,20,1557,482
1532,19,5.1.323,0,656,1,65,323,388,193,130,388,484,0,81,648,2,5,89,137,126,379,20,1557,482
1532,20,1.2.395,0,597,0,87,395,482,395,0,482,484,-85,203,733,3,4,196,116,339,308,21,1557,410
1532,20,4.2.323,1,597,0,27,323,350,323,0,350,484,-13,131,661,3,4,125,116,176,308,21,1557,410
1532,20,5.1.395,0,597,0,65,395,460,193,202,460,484,0,81,648,2,6,89,65,126,379,21,1557,410
1532,21,1.2.395,0,597,0,87,395,482,395,0,482,484,-45,176,706,3,5,196,89,339,308,22,1557,383
1532,21,4.3.413,1,597,0,46,413,459,350,63,459,484,0,188,661,4,4,98,135,176,360,22,1557,383
1532,21,5.1.395,0,597,0,65,395,460,193,202,460,484,0,81,661,2,6,89,65,126,379,22,1557,383
1532,22,1.2.395,0,597,0,87,395,482,395,0,482,484,-45,176,706,3,5,196,89,339,308,23,1557,337
1532,22,4.4.484,1,597,0,52,484,536,459,25,536,536,0,261,661,5,4,52,94,176,317,23,1557,337
1532,22,5.1.395,0,597,0,65,395,460,193,202,460,484,0,81,661,2,6,89,65,126,379,23,1557,337
1532,23,1.2.395,1,597,0,87,395,482,395,0,482,536,-45,176,706,3,5,196,89,339,308,24,1557,285
1532,23,5.1.395,0,597,0,65,395,460,193,202,460,536,0,81,661,2,6,89,65,126,379,24,1557,285
1532,24,1.3.482,1,609,1,85,482,567,482,0,567,567,-23,211,729,4,5,109,89,339,360,25,1557,198
1532,24,5.1.395,0,597,0,65,395,460,193,202,460,536,0,81,706,2,6,89,65,126,379,25,1557,198
1532,25,1.4.567,1,609,0,24,567,591,567,0,591,591,-31,292,760,5,5,24,42,339,317,26,1557,113
1532,25,5.1.395,0,609,0,65,395,460,193,202,460,567,0,81,729,2,6,89,65,126,379,26,1557,113
1532,26,5.1.395,1,609,0,65,395,460,193,202,460,591,0,81,760,2,6,89,65,126,379,27,1557,89
1532,27,5.2.482,1,609,0,2,482,484,460,22,484,591,0,176,760,3,6,24,2,126,308,28,1557,24
1532,28,5.3.567,1,609,0,4,567,571,484,83,571,591,0,211,760,4,6,22,4,126,360,29,1557,22
1532,29,5.4.591,1,609,0,18,591,609,571,20,609,609,0,292,760,5,6,18,18,126,317,30,1557,18
1533,0,0.0.0,1,565,2,48,0,48,0,0,48,48,0,0,0,1,1,323,305,323,305,1,1520,1520
1533,0,1.0.0,0,540,0,47,0,47,0,0,47,47,0,0,0,1,1,239,305,239,305,1,1520,1520
1533,0,2.0.0,0,609,3,85,0,85,0,0,85,85,0,0,0,1,1,346,305,346,305,1,1520,1520
1533,0,3.0.0,0,565,2,59,0,59,0,0,59,59,0,0,0,1,1,175,305,175,305,1,1520,1520
1533,0,4.0.0,0,565,2,25,0,25,0,0,25,25,0,0,0,1,1,211,305,211,305,1,1520,1520
1533,0,5.0.0,0,542,1,41,0,41,0,0,41,41,0,0,0,1,1,226,305,226,305,1,1520,1520
1533,1,0.1.48,0,565,0,78,48,126,48,0,126,126,-48,48,48,2,1,275,380,323,380,2,1520,1472
1533,1,1.0.48,0,579,2,47,48,95,0,48,95,95,0,0,0,1,2,239,257,239,305,2,1520,1472
1533,1,2.0.48,0,567,1,85,48,133,0,48,133,133,0,0,0,1,2,346,257,346,305,2,1520,1472
1533,1,3.0.48,0,580,3,59,48,107,0,48,107,107,0,0,0,1,2,175,257,175,305,2,1520,1472
1533,1,4.0.48,1,579,2,25,48,73,0,48,73,73,0,0,0,1,2,211,257,211,305,2,1520,1472
1533,1,5.0.48,0,565,0,41,48,89,0,48,89,89,0,0,0,1,2,226,257,226,305,2,1520,1472
1533,2,0.1.48,0,579,0,78,48,126,48,0,126,126,-48,48,48,2,1,275,380,323,380,3,1520,1447
1533,2,1.0.73,0,579,0,47,73,120,0,73,120,120,0,0,0,1,3,239,232,239,305,3,1520,1447
1533,2,2.0.73,0,592,2,85,73,158,0,73,158,158,0,0,0,1,3,346,232,346,305,3,1520,1447
1533,2,3.0.73,0,590,1,59,73,132,0,73,132,132,0,0,0,1,3,175,232,175,305,3,1520,1447
1533,2,4.1.73,0,625,3,98,73,171,73,0,171,171,-73,73,73,2,1,186,380,211,380,3,1520,1447
1533,2,5.0.73,1,579,0,41,73,114,0,73,114,114,0,0,0,1,3,226,232,226,305,3,1520,1447
1533,3,0.1.48,0,579,0,78,48,126,48,0,126,126,-48,48,48,2,1,275,380,323,380,4,1520,1406
1533,3,1.0.114,1,579,0,47,114,161,0,114,161,161,0,0,0,1,4,239,191,239,305,4,1520,1406
1533,3,2.0.114,0,590,1,85,114,199,0,114,199,199,0,0,0,1,4,346,191,346,305,4,1520,1406
1533,3,3.0.114,0,590,1,59,114,173,0,114,173,173,0,0,0,1,4,175,191,175,305,4,1520,1406
1533,3,4.1.73,0,625,3,98,73,171,73,0,171,171,-73,73,73,2,1,186,380,211,380,4,1520,1406
1533,3,5.1.114,0,615,2,48,114,162,114,0,162,162,-114,114,114,2,1,185,380,226,380,4,1520,1406
1533,4,0.1.48,0,579,0,78,48,126,48,0,126,161,-48,48,48,2,1,275,380,323,380,5,1520,1359
1533,4,1.1.161,0,581,1,40,161,201,161,0,201,201,-161,161,161,2,1,192,380,239,380,5,1520,1359
1533,4,2.0.161,1,579,0,85,161,246,0,161,246,246,0,0,0,1,5,346,144,346,305,5,1520,1359
1533,4,3.0.161,0,590,2,59,161,220,0,161,220,220,0,0,0,1,5,175,144,175,305,5,1520,1359
1533,4,4.1.73,0,625,4,98,73,171,73,0,171,171,-73,73,73,2,1,186,380,211,380,5,1520,1359
1533,4,5.1.114,0,615,3,48,114,162,114,0,162,162,-114,114,114,2,1,185,380,226,380,5,1520,1359
1533,5,0.1.48,0,579,0,78,48,126,48,0,126,246,-48,48,48,2,1,275,380,323,380,6,1520,1274
1533,5,1.1.161,0,581,1,40,161,201,161,0,201,246,-161,161,161,2,1,192,380,239,380,6,1520,1274
1533,5,2.1.246,0,579,0,91,246,337,246,0,337,337,-246,246,246,2,1,261,380,346,380,6,1520,1274
1533,5,3.0.246,1,579,0,59,246,305,0,246,305,305,0,0,0,1,6,175,59,175,305,6,1520,1274
1533,5,4.1.73,0,625,3,98,73,171,73,0,171,246,-73,73,73,2,1,186,380,211,380,6,1520,1274
1533,5,5.1.114,0,615,2,48,114,162,114,0,162,246,-114,114,114,2,1,185,380,226,380,6,1520,1274
1533,6,0.1.48,1,579,0,78,48,126,48,0,126,305,-48,48,48,2,1,275,380,323,380,7,1520,1215
1533,6,1.1.161,0,581,1,40,161,201,161,0,201,305,-161,161,161,2,1,192,380,239,380,7,1520,1215
1533,6,2.1.246,0,579,0,91,246,337,246,0,337,337,-246,246,246,2,1,261,380,346,380,7,1520,1215
1533,6,3.1.305,0,615,2,25,305,330,305,0,330,330,-305,305,305,2,1,116,380,175,380,7,1520,1215
1533,6,4.1.73,0,625,3,98,73,171,73,0,171,305,-73,73,73,2,1,186,380,211,380,7,1520,1215
1533,6,5.1.114,0,615,2,48,114,162,114,0,162,305,-114,114,114,2,1,185,380,226,380,7,1520,1215
1533,7,0.2.126,1,579,0,93,126,219,126,0,219,305,-126,126,174,3,1,197,373,323,373,8,1520,1137
1533,7,1.1.161,0,581,1,40,161,201,161,0,201,305,-35,83,83,2,2,192,302,239,380,8,1520,1137
1533,7,2.1.246,0,579,0,91,246,337,246,0,337,337,-120,168,168,2,2,261,302,346,380,8,1520,1137
1533,7,3.1.305,0,615,3,25,305,330,305,0,330,330,-179,227,227,2,2,116,302,175,380,8,1520,1137
1533,7,4.1.126,0,592,2,98,126,224,73,53,224,305,0,48,48,2,2,186,302,211,380,8,1520,1137
1533,7,5.1.126,0,579,0,48,126,174,114,12,174,305,0,48,48,2,2,185,302,226,380,8,1520,1137
1533,8,0.3.219,1,579,0,69,219,288,219,0,288,305,-219,219,393,4,1,104,314,323,314,9,1520,1044
1533,8,1.1.161,0,581,1,40,161,201,161,0,201,305,-35,83,209,2,2,192,302,239,380,9,1520,1044
1533,8,2.1.246,0,579,0,91,246,337,246,0,337,337,-120,168,294,2,2,261,302,346,380,9,1520,1044
1533,8,3.1.305,0,615,3,25,305,330,305,0,330,330,-179,227,353,2,2,116,302,175,380,9,1520,1044
1533,8,4.1.126,0,592,2,98,126,224,73,53,224,305,0,48,174,2,2,186,302,211,380,9,1520,1044
1533,8,5.1.126,0,579,0,48,126,174,114,12,174,305,0,48,174,2,2,185,302,226,380,9,1520,1044
1533,9,0.4.288,1,579,0,35,288,323,288,0,323,323,-288,288,681,5,1,35,148,323,148,10,1520,975
1533,9,1.1.161,0,581,1,40,161,201,161,0,201,305,-35,83,428,2,2,192,302,239,380,10,1520,975
1533,9,2.1.246,0,579,0,91,246,337,246,0,337,337,-120,168,513,2,2,261,302,346,380,10,1520,975
1533,9,3.1.305,0,615,3,25,305,330,305,0,330,330,-179,227,572,2,2,116,302,175,380,10,1520,975
1533,9,4.1.126,0,592,2,98,126,224,73,53,224,305,0,48,393,2,2,186,302,211,380,10,1520,975
1533,9,5.1.126,0,579,0,48,126,174,114,12,174,305,0,48,393,2,2,185,302,226,380,10,1520,975
1533,10,1.1.161,0,581,1,40,161,201,161,0,201,323,-35,83,716,2,2,192,302,239,380,11,1520,940
1533,10,2.1.246,0,579,0,91,246,337,246,0,337,337,-120,168,801,2,2,261,302,346,380,11,1520,940
1533,10,3.1.305,0,615,3,25,305,330,305,0,330,330,-179,227,860,2,2,116,302,175,380,11,1520,940
1533,10,4.1.126,0,592,2,98,126,224,73,53,224,323,0,48,681,2,2,186,302,211,380,11,1520,940
1533,10,5.1.126,1,579,0,48,126,174,114,12,174,323,0,48,681,2,2,185,302,226,380,11,1520,940
1533,11,1.1.174,0,579,0,40,174,214,161,13,214,323,0,48,681,2,3,192,254,239,380,12,1520,892
1533,11,2.1.246,0,579,0,91,246,337,246,0,337,337,-72,120,753,2,3,261,254,346,380,12,1520,892
1533,11,3.1.305,0,615,2,25,305,330,305,0,330,330,-131,179,812,2,3,116,254,175,380,12,1520,892
1533,11,4.1.174,0,593,1,98,174,272,73,101,272,323,0,48,681,2,3,186,254,211,380,12,1520,892
1533,11,5.2.219,1,579,0,40,219,259,174,45,259,323,0,126,681,3,2,137,280,226,373,12,1520,892
1533,12,1.1.174,0,579,0,40,174,214,161,13,214,323,0,48,681,2,3,192,254,239,380,13,1520,852
1533,12,2.1.246,0,579,0,91,246,337,246,0,337,337,-72,120,753,2,3,261,254,346,380,13,1520,852
1533,12,3.1.305,0,615,2,25,305,330,305,0,330,330,-131,179,812,2,3,116,254,175,380,13,1520,852
1533,12,4.1.174,0,593,1,98,174,272,73,101,272,323,0,48,681,2,3,186,254,211,380,13,1520,852
1533,12,5.3.288,1,579,0,88,288,376,259,29,376,376,0,219,681,4,2,97,245,226,314,13,1520,852
1533,13,1.1.174,0,579,0,40,174,214,161,13,214,376,0,48,681,2,3,192,254,239,380,14,1520,764
1533,13,2.1.246,0,579,0,91,246,337,246,0,337,376,-72,120,753,2,3,261,254,346,380,14,1520,764
1533,13,3.1.305,0,615,2,25,305,330,305,0,330,376,-131,179,812,2,3,116,254,175,380,14,1520,764
1533,13,4.1.174,0,593,1,98,174,272,73,101,272,376,0,48,681,2,3,186,254,211,380,14,1520,764
1533,13,5.4.376,1,579,0,9,376,385,376,0,385,385,-53,341,734,5,2,9,113,226,148,14,1520,764
1533,14,1.1.174,1,579,0,40,174,214,161,13,214,385,0,48,734,2,3,192,254,239,380,15,1520,755
1533,14,2.1.246,0,579,0,91,246,337,246,0,337,385,-72,120,806,2,3,261,254,346,380,15,1520,755
1533,14,3.1.305,0,615,2,25,305,330,305,0,330,385,-131,179,865,2,3,116,254,175,380,15,1520,755
1533,14,4.1.174,0,593,1,98,174,272,73,101,272,385,0,48,734,2,3,186,254,211,380,15,1520,755
1533,15,1.2.259,0,579,0,92,259,351,214,45,351,385,0,126,734,3,3,152,240,239,373,16,1520,715
1533,15,2.1.246,0,579,0,91,246,337,246,0,337,385,-32,80,766,2,4,261,214,346,380,16,1520,715
1533,15,3.1.305,0,615,2,25,305,330,305,0,330,385,-91,139,825,2,4,116,214,175,380,16,1520,715
1533,15,4.1.214,1,592,1,98,214,312,73,141,312,385,0,48,734,2,4,186,214,211,380,16,1520,715
1533,16,1.2.259,0,592,0,92,259,351,214,45,351,385,0,126,734,3,3,152,240,239,373,17,1520,617
1533,16,2.1.312,1,592,0,91,312,403,246,66,403,403,0,48,734,2,5,261,116,346,380,17,1520,617
1533,16,3.1.312,0,598,1,25,312,337,305,7,337,385,0,48,734,2,5,116,116,175,380,17,1520,617
1533,16,4.2.312,0,620,2,27,312,339,312,0,339,385,-53,179,787,3,3,88,240,211,373,17,1520,617
1533,17,1.2.259,0,592,0,92,259,351,214,45,351,403,0,126,734,3,3,152,240,239,373,18,1520,526
1533,17,2.2.403,0,592,0,86,403,489,403,0,489,489,-144,270,878,3,3,170,240,346,373,18,1520,526
1533,17,3.1.403,1,592,0,25,403,428,305,98,428,428,0,48,734,2,6,116,25,175,380,18,1520,526
1533,17,4.2.312,0,620,1,27,312,339,312,0,339,403,-53,179,787,3,3,88,240,211,373,18,1520,526
1533,18,1.2.259,1,592,0,92,259,351,214,45,351,428,0,126,734,3,3,152,240,239,373,19,1520,501
1533,18,2.2.403,0,592,0,86,403,489,403,0,489,489,-144,270,878,3,3,170,240,346,373,19,1520,501
1533,18,3.2.428,0,633,2,35,428,463,428,0,463,463,-169,295,903,3,3,91,240,175,373,19,1520,501
1533,18,4.2.312,0,620,1,27,312,339,312,0,339,428,-53,179,787,3,3,88,240,211,373,19,1520,501
1533,19,1.3.376,1,592,0,27,376,403,351,25,403,428,0,219,734,4,3,60,157,239,314,20,1520,409
1533,19,2.2.403,0,592,0,86,403,489,403,0,489,489,-52,178,786,3,4,170,148,346,373,20,1520,409
1533,19,3.2.428,0,633,1,35,428,463,428,0,463,463,-77,203,811,3,4,91,148,175,373,20,1520,409
1533,19,4.2.351,0,592,0,27,351,378,312,39,378,428,0,126,734,3,4,88,148,211,373,20,1520,409
1533,20,1.4.403,1,592,0,33,403,436,403,0,436,436,-18,359,752,5,3,33,104,239,148,21,1520,382
1533,20,2.2.403,0,592,0,86,403,489,403,0,489,489,-52,178,786,3,4,170,148,346,373,21,1520,382
1533,20,3.2.428,0,633,1,35,428,463,428,0,463,463,-77,203,811,3,4,91,148,175,373,21,1520,382
1533,20,4.2.351,0,592,0,27,351,378,312,39,378,428,0,126,734,3,4,88,148,211,373,21,1520,382
1533,21,2.2.403,0,592,0,86,403,489,403,0,489,489,-52,178,804,3,4,170,148,346,373,22,1520,349
1533,21,3.2.428,0,633,1,35,428,463,428,0,463,463,-77,203,829,3,4,91,148,175,373,22,1520,349
1533,21,4.2.351,1,592,0,27,351,378,312,39,378,436,0,126,752,3,4,88,148,211,373,22,1520,349
1533,22,2.2.403,0,592,0,86,403,489,403,0,489,489,-25,151,777,3,5,170,121,346,373,23,1520,322
1533,22,3.2.428,0,633,1,35,428,463,428,0,463,463,-50,176,802,3,5,91,121,175,373,23,1520,322
1533,22,4.3.403,1,592,0,39,403,442,378,25,442,442,0,219,752,4,4,61,130,211,314,23,1520,322
1533,23,2.2.403,0,592,0,86,403,489,403,0,489,489,-25,151,777,3,5,170,121,346,373,24,1520,283
1533,23,3.2.428,0,633,1,35,428,463,428,0,463,463,-50,176,802,3,5,91,121,175,373,24,1520,283
1533,23,4.4.442,1,592,0,22,442,464,442,0,464,464,-6,365,758,5,4,22,71,211,148,24,1520,283
1533,24,2.2.403,1,592,0,86,403,489,403,0,489,489,-25,151,783,3,5,170,121,346,373,25,1520,261
1533,24,3.2.428,0,633,1,35,428,463,428,0,463,464,-50,176,808,3,5,91,121,175,373,25,1520,261
1533,25,2.3.489,1,592,0,47,489,536,489,0,536,536,-47,266,830,4,5,84,91,346,314,26,1520,175
1533,25,3.2.489,0,592,0,35,489,524,428,61,524,524,0,151,783,3,6,91,35,175,373,26,1520,175
1533,26,2.4.536,1,592,0,37,536,573,536,0,573,573,-72,437,902,5,5,37,49,346,148,27,1520,128
1533,26,3.2.489,0,592,0,35,489,524,428,61,524,536,0,151,830,3,6,91,35,175,373,27,1520,128
1533,27,3.2.489,1,592,0,35,489,524,428,61,524,573,0,151,902,3,6,91,35,175,373,28,1520,91
1533,28,3.3.536,1,592,0,44,536,580,524,12,580,580,0,266,902,4,6,56,44,175,314,29,1520,56
1533,29,3.4.580,1,592,0,12,580,592,580,0,592,592,-7,444,909,5,6,12,12,175,148,30,1520,12
1534,0,0.0.0,0,586,4,61,0,61,0,0,61,61,0,0,0,1,1,365,221,365,221,1,1489,1489
1534,0,1.0.0,0,525,0,23,0,23,0,0,23,23,0,0,0,1,1,239,221,239,221,1,1489,1489
1534,0,2.0.0,0,556,3,31,0,31,0,0,31,31,0,0,0,1,1,173,221,173,221,1,1489,1489
1534,0,3.0.0,0,538,1,13,0,13,0,0,13,13,0,0,0,1,1,135,221,135,221,1,1489,1489
1534,0,4.0.0,0,544,2,47,0,47,0,0,47,47,0,0,0,1,1,250,221,250,221,1,1489,1489
1534,0,5.0.0,1,556,3,46,0,46,0,0,46,46,0,0,0,1,1,327,221,327,221,1,1489,1489
1534,1,0.0.46,1,584,2,61,46,107,0,46,107,107,0,0,0,1,2,365,175,365,221,2,1489,1443
1534,1,1.0.46,0,556,0,23,46,69,0,46,69,69,0,0,0,1,2,239,175,239,221,2,1489,1443
1534,1,2.0.46,0,556,0,31,46,77,0,46,77,77,0,0,0,1,2,173,175,173,221,2,1489,1443
1534,1,3.0.46,0,556,0,13,46,59,0,46,59,59,0,0,0,1,2,135,175,135,221,2,1489,1443
1534,1,4.0.46,0,570,1,47,46,93,0,46,93,93,0,0,0,1,2,250,175,250,221,2,1489,1443
1534,1,5.1.46,0,556,0,31,46,77,46,0,77,77,-46,46,46,2,1,281,284,327,284,2,1489,1443
1534,2,0.1.107,0,603,1,46,107,153,107,0,153,153,-107,107,107,2,1,304,284,365,284,3,1489,1382
1534,2,1.0.107,1,603,1,23,107,130,0,107,130,130,0,0,0,1,3,239,114,239,221,3,1489,1382
1534,2,2.0.107,0,603,1,31,107,138,0,107,138,138,0,0,0,1,3,173,114,173,221,3,1489,1382
1534,2,3.0.107,0,584,0,13,107,120,0,107,120,120,0,0,0,1,3,135,114,135,221,3,1489,1382
1534,2,4.0.107,0,603,1,47,107,154,0,107,154,154,0,0,0,1,3,250,114,250,221,3,1489,1382
1534,2,5.1.46,0,584,0,31,46,77,46,0,77,107,-46,46,46,2,1,281,284,327,284,3,1489,1382
1534,3,0.1.107,0,603,0,46,107,153,107,0,153,153,-107,107,107,2,1,304,284,365,284,4,1489,1359
1534,3,1.1.130,0,603,0,8,130,138,130,0,138,138,-130,130,130,2,1,216,284,239,284,4,1489,1359
1534,3,2.0.130,0,603,0,31,130,161,0,130,161,161,0,0,0,1,4,173,91,173,221,4,1489,1359
1534,3,3.0.130,0,603,0,13,130,143,0,130,143,143,0,0,0,1,4,135,91,135,221,4,1489,1359
1534,3,4.0.130,1,603,0,47,130,177,0,130,177,177,0,0,0,1,4,250,91,250,221,4,1489,1359
1534,3,5.1.46,0,603,0,31,46,77,46,0,77,130,-46,46,46,2,1,281,284,327,284,4,1489,1359
1534,4,0.1.107,0,603,0,46,107,153,107,0,153,177,-107,107,107,2,1,304,284,365,284,5,1489,1312
1534,4,1.1.130,0,603,0,8,130,138,130,0,138,177,-130,130,130,2,1,216,284,239,284,5,1489,1312
1534,4,2.0.177,0,603,0,31,177,208,0,177,208,208,0,0,0,1,5,173,44,173,221,5,1489,1312
1534,4,3.0.177,1,603,0,13,177,190,0,177,190,190,0,0,0,1,5,135,44,135,221,5,1489,1312
1534,4,4.1.177,0,603,0,51,177,228,177,0,228,228,-177,177,177,2,1,203,284,250,284,5,1489,1312
1534,4,5.1.46,0,603,0,31,46,77,46,0,77,177,-46,46,46,2,1,281,284,327,284,5,1489,1312
1534,5,0.1.107,0,603,0,46,107,153,107,0,153,190,-107,107,107,2,1,304,284,365,284,6,1489,1299
1534,5,1.1.130,0,603,0,8,130,138,130,0,138,190,-130,130,130,2,1,216,284,239,284,6,1489,1299
1534,5,2.0.190,1,603,0,31,190,221,0,190,221,221,0,0,0,1,6,173,31,173,221,6,1489,1299
1534,5,3.1.190,0,603,0,63,190,253,190,0,253,253,-190,190,190,2,1,122,284,135,284,6,1489,1299
1534,5,4.1.177,0,603,0,51,177,228,177,0,228,228,-177,177,177,2,1,203,284,250,284,6,1489,1299
1534,5,5.1.46,0,603,0,31,46,77,46,0,77,190,-46,46,46,2,1,281,284,327,284,6,1489,1299
1534,6,0.1.107,0,603,0,46,107,153,107,0,153,221,-107,107,107,2,1,304,284,365,284,7,1489,1268
1534,6,1.1.130,0,603,0,8,130,138,130,0,138,221,-130,130,130,2,1,216,284,239,284,7,1489,1268
1534,6,2.1.221,0,603,0,85,221,306,221,0,306,306,-221,221,221,2,1,142,284,173,284,7,1489,1268
1534,6,3.1.190,0,603,0,63,190,253,190,0,253,253,-190,190,190,2,1,122,284,135,284,7,1489,1268
1534,6,4.1.177,0,603,0,51,177,228,177,0,228,228,-177,177,177,2,1,203,284,250,284,7,1489,1268
1534,6,5.1.46,1,603,0,31,46,77,46,0,77,221,-46,46,46,2,1,281,284,327,284,7,1489,1268
1534,7,0.1.107,1,603,0,46,107,153,107,0,153,221,-30,76,76,2,2,304,253,365,284,8,1489,1237
1534,7,1.1.130,0,603,0,8,130,138,130,0,138,221,-53,99,99,2,2,216,253,239,284,8,1489,1237
1534,7,2.1.221,0,603,0,85,221,306,221,0,306,306,-144,190,190,2,2,142,253,173,284,8,1489,1237
1534,7,3.1.190,0,603,0,63,190,253,190,0,253,253,-113,159,159,2,2,122,253,135,284,8,1489,1237
1534,7,4.1.177,0,603,0,51,177,228,177,0,228,228,-100,146,146,2,2,203,253,250,284,8,1489,1237
1534,7,5.2.77,0,603,0,78,77,155,77,0,155,221,-77,77,123,3,1,250,341,327,341,8,1489,1237
1534,8,0.2.153,0,656,1,96,153,249,153,0,249,249,-153,153,229,3,1,258,341,365,341,9,1489,1191
1534,8,1.1.153,1,603,0,8,153,161,130,23,161,221,0,76,76,2,3,216,207,239,284,9,1489,1191
1534,8,2.1.221,0,603,0,85,221,306,221,0,306,306,-68,144,144,2,3,142,207,173,284,9,1489,1191
1534,8,3.1.190,0,603,0,63,190,253,190,0,253,253,-37,113,113,2,3,122,207,135,284,9,1489,1191
1534,8,4.1.177,0,603,0,51,177,228,177,0,228,228,-24,100,100,2,3,203,207,250,284,9,1489,1191
1534,8,5.2.77,0,603,0,78,77,155,77,0,155,221,-77,77,153,3,1,250,341,327,341,9,1489,1191
1534,9,0.2.153,0,656,1,96,153,249,153,0,249,249,-153,153,229,3,1,258,341,365,341,10,1489,1183
1534,9,1.2.161,0,603,0,98,161,259,161,0,259,259,-161,161,237,3,1,208,341,239,341,10,1489,1183
1534,9,2.1.221,0,603,0,85,221,306,221,0,306,306,-60,136,136,2,4,142,199,173,284,10,1489,1183
1534,9,3.1.190,0,603,0,63,190,253,190,0,253,253,-29,105,105,2,4,122,199,135,284,10,1489,1183
1534,9,4.1.177,1,603,0,51,177,228,177,0,228,228,-16,92,92,2,4,203,199,250,284,10,1489,1183
1534,9,5.2.77,0,603,0,78,77,155,77,0,155,221,-77,77,153,3,1,250,341,327,341,10,1489,1183
1534,10,0.2.153,0,672,1,96,153,249,153,0,249,249,-153,153,245,3,1,258,341,365,341,11,1489,1132
1534,10,1.2.161,0,603,0,98,161,259,161,0,259,259,-161,161,253,3,1,208,341,239,341,11,1489,1132
1534,10,2.1.228,0,603,0,85,228,313,221,7,313,313,0,92,92,2,5,142,148,173,284,11,1489,1132
1534,10,3.1.228,0,603,0,63,228,291,190,38,291,291,0,92,92,2,5,122,148,135,284,11,1489,1132
1534,10,4.2.228,0,603,0,28,228,256,228,0,256,256,-228,228,320,3,1,152,341,250,341,11,1489,1132
1534,10,5.2.77,1,603,0,78,77,155,77,0,155,228,-77,77,169,3,1,250,341,327,341,11,1489,1132
1534,11,0.2.155,0,603,0,96,155,251,153,2,251,251,0,77,169,3,2,258,263,365,341,12,1489,1054
1534,11,1.2.161,0,603,0,98,161,259,161,0,259,259,-6,83,175,3,2,208,263,239,341,12,1489,1054
1534,11,2.1.228,0,603,0,85,228,313,221,7,313,313,0,92,169,2,5,142,148,173,284,12,1489,1054
1534,11,3.1.228,0,603,0,63,228,291,190,38,291,291,0,92,169,2,5,122,148,135,284,12,1489,1054
1534,11,4.2.228,0,603,0,28,228,256,228,0,256,256,-73,150,242,3,2,152,263,250,341,12,1489,1054
1534,11,5.3.155,1,603,0,73,155,228,155,0,228,228,-155,155,324,4,1,172,268,327,268,12,1489,1054
1534,12,0.2.155,1,603,0,96,155,251,153,2,251,251,0,77,324,3,2,258,263,365,341,13,1489,981
1534,12,1.2.161,0,603,0,98,161,259,161,0,259,259,-6,83,330,3,2,208,263,239,341,13,1489,981
1534,12,2.1.228,0,603,0,85,228,313,221,7,313,313,0,92,324,2,5,142,148,173,284,13,1489,981
1534,12,3.1.228,0,603,0,63,228,291,190,38,291,291,0,92,324,2,5,122,148,135,284,13,1489,981
1534,12,4.2.228,0,603,0,28,228,256,228,0,256,256,-73,150,397,3,2,152,263,250,341,13,1489,981
1534,12,5.4.228,0,603,0,99,228,327,228,0,327,327,-228,228,552,5,1,99,375,327,375,13,1489,981
1534,13,0.3.251,1,603,0,75,251,326,251,0,326,326,-23,178,347,4,2,162,195,365,268,14,1489,885
1534,13,1.2.251,0,603,0,98,251,349,161,90,349,349,0,77,324,3,3,208,167,239,341,14,1489,885
1534,13,2.1.228,0,603,0,85,228,313,221,7,313,313,0,92,324,2,5,142,148,173,284,14,1489,885
1534,13,3.1.228,0,603,0,63,228,291,190,38,291,291,0,92,324,2,5,122,148,135,284,14,1489,885
1534,13,4.2.251,0,603,0,28,251,279,228,23,279,279,0,77,324,3,3,152,167,250,341,14,1489,885
1534,13,5.4.228,0,603,0,99,228,327,228,0,327,327,-228,228,552,5,1,99,375,327,375,14,1489,885
1534,14,0.4.326,0,701,1,87,326,413,326,0,413,413,-326,326,673,5,1,87,375,365,375,15,1489,810
1534,14,1.2.251,0,603,0,98,251,349,161,90,349,349,0,77,347,3,3,208,167,239,341,15,1489,810
1534,14,2.1.228,0,603,0,85,228,313,221,7,313,326,0,92,347,2,5,142,148,173,284,15,1489,810
1534,14,3.1.228,0,603,0,63,228,291,190,38,291,326,0,92,347,2,5,122,148,135,284,15,1489,810
1534,14,4.2.251,1,603,0,28,251,279,228,23,279,326,0,77,347,3,3,152,167,250,341,15,1489,810
1534,14,5.4.228,0,603,0,99,228,327,228,0,327,327,-228,228,575,5,1,99,375,327,375,15,1489,810
1534,15,0.4.326,0,701,1,87,326,413,326,0,413,413,-326,326,673,5,1,87,375,365,375,16,1489,782
1534,15,1.2.279,0,603,0,98,279,377,161,118,377,377,0,77,347,3,4,208,139,239,341,16,1489,782
1534,15,2.1.228,0,603,0,85,228,313,221,7,313,326,0,92,347,2,5,142,148,173,284,16,1489,782
1534,15,3.1.228,0,603,0,63,228,291,190,38,291,326,0,92,347,2,5,122,148,135,284,16,1489,782
1534,15,4.3.326,1,603,0,32,326,358,279,47,358,358,0,178,347,4,3,124,120,250,268,16,1489,782
1534,15,5.4.228,0,603,0,99,228,327,228,0,327,327,-228,228,575,5,1,99,375,327,375,16,1489,782
1534,16,0.4.326,0,701,2,87,326,413,326,0,413,413,-326,326,673,5,1,87,375,365,375,17,1489,750
1534,16,1.2.279,1,603,0,98,279,377,161,118,377,377,0,77,347,3,4,208,139,239,341,17,1489,750
1534,16,2.1.228,0,603,0,85,228,313,221,7,313,358,0,92,347,2,5,142,148,173,284,17,1489,750
1534,16,3.1.228,0,603,0,63,228,291,190,38,291,358,0,92,347,2,5,122,148,135,284,17,1489,750
1534,16,4.4.358,0,634,1,92,358,450,358,0,450,450,-358,358,705,5,1,92,375,250,375,17,1489,750
1534,16,5.4.228,0,603,0,99,228,327,228,0,327,358,-228,228,575,5,1,99,375,327,375,17,1489,750
1534,17,0.4.326,0,701,2,87,326,413,326,0,413,413,-326,326,673,5,1,87,375,365,375,18,1489,652
1534,17,1.3.377,1,603,0,68,377,445,377,0,445,445,-19,197,366,4,4,110,88,239,268,18,1489,652
1534,17,2.1.228,0,603,0,85,228,313,221,7,313,377,0,92,347,2,5,142,148,173,284,18,1489,652
1534,17,3.1.228,0,603,0,63,228,291,190,38,291,377,0,92,347,2,5,122,148,135,284,18,1489,652
1534,17,4.4.358,0,634,1,92,358,450,358,0,450,450,-358,358,705,5,1,92,375,250,375,18,1489,652
1534,17,5.4.228,0,603,0,99,228,327,228,0,327,377,-228,228,575,5,1,99,375,327,375,18,1489,652
1534,18,0.4.326,0,701,2,87,326,413,326,0,413,445,-326,326,692,5,1,87,375,365,375,19,1489,584
1534,18,1.4.445,0,634,1,42,445,487,445,0,487,487,-445,445,811,5,1,42,375,239,375,19,1489,584
1534,18,2.1.228,0,603,0,85,228,313,221,7,313,445,0,92,366,2,5,142,148,173,284,19,1489,584
1534,18,3.1.228,0,603,0,63,228,291,190,38,291,445,0,92,366,2,5,122,148,135,284,19,1489,584
1534,18,4.4.358,0,634,1,92,358,450,358,0,450,450,-358,358,724,5,1,92,375,250,375,19,1489,584
1534,18,5.4.228,1,603,0,99,228,327,228,0,327,445,-228,228,594,5,1,99,375,327,375,19,1489,584
1534,19,0.4.327,1,603,0,87,327,414,326,1,414,445,0,228,594,5,2,87,276,365,375,20,1489,485
1534,19,1.4.445,0,634,1,42,445,487,445,0,487,487,-118,346,712,5,2,42,276,239,375,20,1489,485
1534,19,2.1.228,0,603,0,85,228,313,221,7,313,445,0,92,594,2,5,142,148,173,284,20,1489,485
1534,19,3.1.228,0,603,0,63,228,291,190,38,291,445,0,92,594,2,5,122,148,135,284,20,1489,485
1534,19,4.4.358,0,634,1,92,358,450,358,0,450,450,-31,259,625,5,2,92,276,250,375,20,1489,485
1534,20,1.4.445,0,634,1,42,445,487,445,0,487,487,-31,259,625,5,3,42,189,239,375,21,1489,398
1534,20,2.1.228,0,603,0,85,228,313,221,7,313,445,0,92,594,2,5,142,148,173,284,21,1489,398
1534,20,3.1.228,0,603,0,63,228,291,190,38,291,445,0,92,594,2,5,122,148,135,284,21,1489,398
1534,20,4.4.414,1,603,0,92,414,506,358,56,506,506,0,228,594,5,3,92,189,250,375,21,1489,398
1534,21,1.4.506,1,603,0,42,506,548,445,61,548,548,0,228,594,5,4,42,97,239,375,22,1489,306
1534,21,2.1.228,0,603,0,85,228,313,221,7,313,506,0,92,594,2,5,142,148,173,284,22,1489,306
1534,21,3.1.228,0,603,0,63,228,291,190,38,291,506,0,92,594,2,5,122,148,135,284,22,1489,306
1534,22,2.1.228,0,603,0,85,228,313,221,7,313,548,0,92,594,2,5,142,148,173,284,23,1489,264
1534,22,3.1.228,1,603,0,63,228,291,190,38,291,548,0,92,594,2,5,122,148,135,284,23,1489,264
1534,23,2.1.291,0,603,0,85,291,376,221,70,376,548,0,92,594,2,6,142,85,173,284,24,1489,201
1534,23,3.2.377,1,603,0,2,377,379,291,86,379,548,0,77,594,3,5,59,41,135,341,24,1489,201
1534,24,2.1.291,0,603,0,85,291,376,221,70,376,548,0,92,594,2,6,142,85,173,284,25,1489,199
1534,24,3.3.445,1,603,0,4,445,449,379,66,449,548,0,197,594,4,5,57,20,135,268,25,1489,199
1534,25,2.1.291,0,603,0,85,291,376,221,70,376,548,0,92,594,2,6,142,85,173,284,26,1489,195
1534,25,3.4.548,1,603,0,53,548,601,449,99,601,601,0,228,594,5,5,53,55,135,375,26,1489,195
1534,26,2.1.291,1,603,0,85,291,376,221,70,376,601,0,92,594,2,6,142,85,173,284,27,1489,142
1534,27,2.2.379,1,603,0,39,379,418,376,3,418,601,0,77,594,3,6,57,39,173,341,28,1489,57
1534,28,2.3.449,1,603,0,16,449,465,418,31,465,601,0,197,594,4,6,18,16,173,268,29,1489,18
1534,29,2.4.601,1,603,0,2,601,603,465,136,603,603,0,228,594,5,6,2,2,173,375,30,1489,2
1535,0,0.0.0,0,649,3,74,0,74,0,0,74,74,0,0,0,1,1,212,434,212,434,1,1562,1562
1535,0,1.0.0,0,678,5,98,0,98,0,0,98,98,0,0,0,1,1,239,434,239,434,1,1562,1562
1535,0,2.0.0,1,641,2,76,0,76,0,0,76,76,0,0,0,1,1,398,434,398,434,1,1562,1562
1535,0,3.0.0,0,628,0,66,0,66,0,0,66,66,0,0,0,1,1,294,434,294,434,1,1562,1562
1535,0,4.0.0,0,651,4,69,0,69,0,0,69,69,0,0,0,1,1,188,434,188,434,1,1562,1562
1535,0,5.0.0,0,630,1,51,0,51,0,0,51,51,0,0,0,1,1,231,434,231,434,1,1562,1562
1535,1,0.0.76,0,675,4,74,76,150,0,76,150,150,0,0,0,1,2,212,358,212,434,2,1562,1486
1535,1,1.0.76,0,676,5,98,76,174,0,76,174,174,0,0,0,1,2,239,358,239,434,2,1562,1486
1535,1,2.1.76,1,650,1,79,76,155,76,0,155,155,-76,76,76,2,1,322,189,398,189,2,1562,1486
1535,1,3.0.76,0,673,3,66,76,142,0,76,142,142,0,0,0,1,2,294,358,294,434,2,1562,1486
1535,1,4.0.76,0,656,2,69,76,145,0,76,145,145,0,0,0,1,2,188,358,188,434,2,1562,1486
1535,1,5.0.76,0,641,0,51,76,127,0,76,127,127,0,0,0,1,2,231,358,231,434,2,1562,1486
1535,2,0.0.76,0,676,2,74,76,150,0,76,150,155,0,0,76,1,2,212,358,212,434,3,1562,1407
1535,2,1.0.76,0,676,2,98,76,174,0,76,174,174,0,0,76,1,2,239,358,239,434,3,1562,1407
1535,2,2.2.155,1,676,2,92,155,247,155,0,247,247,-155,155,231,3,1,243,212,398,212,3,1562,1407
1535,2,3.0.76,0,685,3,66,76,142,0,76,142,155,0,0,76,1,2,294,358,294,434,3,1562,1407
1535,2,4.0.76,0,656,1,69,76,145,0,76,145,155,0,0,76,1,2,188,358,188,434,3,1562,1407
1535,2,5.0.76,0,650,0,51,76,127,0,76,127,155,0,0,76,1,2,231,358,231,434,3,1562,1407
1535,3,0.0.76,0,706,1,74,76,150,0,76,150,247,0,0,231,1,2,212,358,212,434,4,1562,1315
1535,3,1.0.76,0,676,0,98,76,174,0,76,174,247,0,0,231,1,2,239,358,239,434,4,1562,1315
1535,3,2.3.247,1,736,2,84,247,331,247,0,331,331,-247,247,478,4,1,151,322,398,322,4,1562,1315
1535,3,3.0.76,0,706,1,66,76,142,0,76,142,247,0,0,231,1,2,294,358,294,434,4,1562,1315
1535,3,4.0.76,0,706,1,69,76,145,0,76,145,247,0,0,231,1,2,188,358,188,434,4,1562,1315
1535,3,5.0.76,0,706,1,51,76,127,0,76,127,247,0,0,231,1,2,231,358,231,434,4,1562,1315
1535,4,0.0.76,0,736,0,74,76,150,0,76,150,331,0,0,478,1,2,212,358,212,434,5,1562,1231
1535,4,1.0.76,0,736,0,98,76,174,0,76,174,331,0,0,478,1,2,239,358,239,434,5,1562,1231
1535,4,2.4.331,1,736,0,67,331,398,331,0,398,398,-331,331,809,5,1,67,405,398,405,5,1562,1231
1535,4,3.0.76,0,736,0,66,76,142,0,76,142,331,0,0,478,1,2,294,358,294,434,5,1562,1231
1535,4,4.0.76,0,736,0,69,76,145,0,76,145,331,0,0,478,1,2,188,358,188,434,5,1562,1231
1535,4,5.0.76,0,736,0,51,76,127,0,76,127,331,0,0,478,1,2,231,358,231,434,5,1562,1231
1535,5,0.0.76,0,736,0,74,76,150,0,76,150,398,0,0,809,1,2,212,358,212,434,6,1562,1164
1535,5,1.0.76,0,736,0,98,76,174,0,76,174,398,0,0,809,1,2,239,358,239,434,6,1562,1164
1535,5,3.0.76,1,736,0,66,76,142,0,76,142,398,0,0,809,1,2,294,358,294,434,6,1562,1164
1535,5,4.0.76,0,736,0,69,76,145,0,76,145,398,0,0,809,1,2,188,358,188,434,6,1562,1164
1535,5,5.0.76,0,736,0,51,76,127,0,76,127,398,0,0,809,1,2,231,358,231,434,6,1562,1164
1535,6,0.0.142,0,736,0,74,142,216,0,142,216,398,0,0,809,1,3,212,292,212,434,7,1562,1098
1535,6,1.0.142,0,736,0,98,142,240,0,142,240,398,0,0,809,1,3,239,292,239,434,7,1562,1098
1535,6,3.1.155,1,736,0,2,155,157,142,13,157,398,0,76,809,2,2,228,110,294,189,7,1562,1098
1535,6,4.0.142,0,736,0,69,142,211,0,142,211,398,0,0,809,1,3,188,292,188,434,7,1562,1098
1535,6,5.0.142,0,736,0,51,142,193,0,142,193,398,0,0,809,1,3,231,292,231,434,7,1562,1098
1535,7,0.0.142,0,736,0,74,142,216,0,142,216,398,0,0,809,1,3,212,292,212,434,8,1562,1096
1535,7,1.0.142,0,736,0,98,142,240,0,142,240,398,0,0,809,1,3,239,292,239,434,8,1562,1096
1535,7,3.2.247,1,736,0,69,247,316,157,90,316,398,0,155,809,3,2,226,120,294,212,8,1562,1096
1535,7,4.0.142,0,736,0,69,142,211,0,142,211,398,0,0,809,1,3,188,292,188,434,8,1562,1096
1535,7,5.0.142,0,736,0,51,142,193,0,142,193,398,0,0,809,1,3,231,292,231,434,8,1562,1096
1535,8,0.0.142,0,736,0,74,142,216,0,142,216,398,0,0,809,1,3,212,292,212,434,9,1562,1027
1535,8,1.0.142,0,736,0,98,142,240,0,142,240,398,0,0,809,1,3,239,292,239,434,9,1562,1027
1535,8,3.3.331,1,736,0,62,331,393,316,15,393,398,0,247,809,4,2,157,238,294,322,9,1562,1027
1535,8,4.0.142,0,736,0,69,142,211,0,142,211,398,0,0,809,1,3,188,292,188,434,9,1562,1027
1535,8,5.0.142,0,736,0,51,142,193,0,142,193,398,0,0,809,1,3,231,292,231,434,9,1562,1027
1535,9,0.0.142,0,736,0,74,142,216,0,142,216,398,0,0,809,1,3,212,292,212,434,10,1562,965
1535,9,1.0.142,0,736,0,98,142,240,0,142,240,398,0,0,809,1,3,239,292,239,434,10,1562,965
1535,9,3.4.398,0,736,0,95,398,493,393,5,493,493,0,331,809,5,2,95,338,294,405,10,1562,965
1535,9,4.0.142,0,736,0,69,142,211,0,142,211,398,0,0,809,1,3,188,292,188,434,10,1562,965
1535,9,5.0.142,1,736,0,51,142,193,0,142,193,398,0,0,809,1,3,231,292,231,434,10,1562,965
1535,10,0.0.193,0,736,0,74,193,267,0,193,267,398,0,0,809,1,4,212,241,212,434,11,1562,914
1535,10,1.0.193,0,736,0,98,193,291,0,193,291,398,0,0,809,1,4,239,241,239,434,11,1562,914
1535,10,3.4.398,0,736,0,95,398,493,393,5,493,493,0,331,809,5,2,95,338,294,405,11,1562,914
1535,10,4.0.193,0,736,0,69,193,262,0,193,262,398,0,0,809,1,4,188,241,188,434,11,1562,914
1535,10,5.1.193,1,736,0,15,193,208,193,0,208,398,-36,112,845,2,3,180,108,231,189,11,1562,914
1535,11,0.0.193,0,736,0,74,193,267,0,193,267,398,0,0,845,1,4,212,241,212,434,12,1562,899
1535,11,1.0.193,0,736,0,98,193,291,0,193,291,398,0,0,845,1,4,239,241,239,434,12,1562,899
1535,11,3.4.398,0,736,0,95,398,493,393,5,493,493,0,331,845,5,2,95,338,294,405,12,1562,899
1535,11,4.0.193,0,736,0,69,193,262,0,193,262,398,0,0,845,1,4,188,241,188,434,12,1562,899
1535,11,5.2.316,1,736,0,17,316,333,208,108,333,398,0,155,845,3,3,165,51,231,212,12,1562,899
1535,12,0.0.193,0,736,0,74,193,267,0,193,267,398,0,0,845,1,4,212,241,212,434,13,1562,882
1535,12,1.0.193,0,736,0,98,193,291,0,193,291,398,0,0,845,1,4,239,241,239,434,13,1562,882
1535,12,3.4.398,0,736,0,95,398,493,393,5,493,493,0,331,845,5,2,95,338,294,405,13,1562,882
1535,12,4.0.193,0,736,0,69,193,262,0,193,262,398,0,0,845,1,4,188,241,188,434,13,1562,882
1535,12,5.3.393,1,736,0,58,393,451,333,60,451,451,0,247,845,4,3,148,176,231,322,13,1562,882
1535,13,0.0.193,1,736,0,74,193,267,0,193,267,451,0,0,845,1,4,212,241,212,434,14,1562,824
1535,13,1.0.193,0,736,0,98,193,291,0,193,291,451,0,0,845,1,4,239,241,239,434,14,1562,824
1535,13,3.4.398,0,736,0,95,398,493,393,5,493,493,0,331,845,5,2,95,338,294,405,14,1562,824
1535,13,4.0.193,0,736,0,69,193,262,0,193,262,451,0,0,845,1,4,188,241,188,434,14,1562,824
1535,13,5.4.451,0,789,1,90,451,541,451,0,541,541,-53,384,898,5,2,90,338,231,405,14,1562,824
1535,14,0.1.267,1,736,0,15,267,282,267,0,282,451,-59,171,904,2,4,138,93,212,189,15,1562,750
1535,14,1.0.267,0,736,0,98,267,365,0,267,365,451,0,0,845,1,5,239,167,239,434,15,1562,750
1535,14,3.4.398,0,736,0,95,398,493,393,5,493,493,0,331,845,5,2,95,338,294,405,15,1562,750
1535,14,4.0.267,0,736,0,69,267,336,0,267,336,451,0,0,845,1,5,188,167,188,434,15,1562,750
1535,14,5.4.451,0,789,1,90,451,541,451,0,541,541,-53,384,898,5,2,90,338,231,405,15,1562,750
1535,15,0.2.333,1,736,0,1,333,334,282,51,334,451,0,155,904,3,4,123,34,212,212,16,1562,735
1535,15,1.0.267,0,736,0,98,267,365,0,267,365,451,0,0,904,1,5,239,167,239,434,16,1562,735
1535,15,3.4.398,0,736,0,95,398,493,393,5,493,493,0,331,904,5,2,95,338,294,405,16,1562,735
1535,15,4.0.267,0,736,0,69,267,336,0,267,336,451,0,0,904,1,5,188,167,188,434,16,1562,735
1535,15,5.4.451,0,789,1,90,451,541,451,0,541,541,-53,384,957,5,2,90,338,231,405,16,1562,735
1535,16,0.3.451,1,736,0,82,451,533,334,117,533,533,0,247,904,4,4,122,118,212,322,17,1562,734
1535,16,1.0.267,0,736,0,98,267,365,0,267,365,451,0,0,904,1,5,239,167,239,434,17,1562,734
1535,16,3.4.398,0,736,0,95,398,493,393,5,493,493,0,331,904,5,2,95,338,294,405,17,1562,734
1535,16,4.0.267,0,736,0,69,267,336,0,267,336,451,0,0,904,1,5,188,167,188,434,17,1562,734
1535,16,5.4.451,0,789,1,90,451,541,451,0,541,541,-53,384,957,5,2,90,338,231,405,17,1562,734
1535,17,0.4.533,0,776,1,40,533,573,533,0,573,573,-135,466,1039,5,2,40,338,212,405,18,1562,652
1535,17,1.0.267,0,736,0,98,267,365,0,267,365,533,0,0,904,1,5,239,167,239,434,18,1562,652
1535,17,3.4.398,0,736,0,95,398,493,393,5,493,533,0,331,904,5,2,95,338,294,405,18,1562,652
1535,17,4.0.267,1,736,0,69,267,336,0,267,336,533,0,0,904,1,5,188,167,188,434,18,1562,652
1535,17,5.4.451,0,789,2,90,451,541,451,0,541,541,-53,384,957,5,2,90,338,231,405,18,1562,652
1535,18,0.4.533,0,776,1,40,533,573,533,0,573,573,-135,466,1039,5,2,40,338,212,405,19,1562,583
1535,18,1.0.336,0,736,0,98,336,434,0,336,434,533,0,0,904,1,6,239,98,239,434,19,1562,583
1535,18,3.4.398,0,736,0,95,398,493,393,5,493,533,0,331,904,5,2,95,338,294,405,19,1562,583
1535,18,4.1.336,1,736,0,3,336,339,336,0,339,533,-54,225,958,2,5,119,78,188,189,19,1562,583
1535,18,5.4.451,0,789,2,90,451,541,451,0,541,541,-53,384,957,5,2,90,338,231,405,19,1562,583
1535,19,0.4.533,0,776,1,40,533,573,533,0,573,573,-135,466,1093,5,2,40,338,212,405,20,1562,580
1535,19,1.0.336,0,736,0,98,336,434,0,336,434,533,0,0,958,1,6,239,98,239,434,20,1562,580
1535,19,3.4.398,0,736,0,95,398,493,393,5,493,533,0,331,958,5,2,95,338,294,405,20,1562,580
1535,19,4.2.339,1,736,0,29,339,368,339,0,368,533,-5,160,963,3,5,116,33,188,212,20,1562,580
1535,19,5.4.451,0,789,2,90,451,541,451,0,541,541,-53,384,1011,5,2,90,338,231,405,20,1562,580
1535,20,0.4.533,0,776,1,40,533,573,533,0,573,573,-135,466,1098,5,2,40,338,212,405,21,1562,551
1535,20,1.0.336,0,736,0,98,336,434,0,336,434,533,0,0,963,1,6,239,98,239,434,21,1562,551
1535,20,3.4.398,0,736,0,95,398,493,393,5,493,533,0,331,963,5,2,95,338,294,405,21,1562,551
1535,20,4.3.533,1,736,0,25,533,558,368,165,558,558,0,247,963,4,5,87,36,188,322,21,1562,551
1535,20,5.4.451,0,789,2,90,451,541,451,0,541,541,-53,384,1016,5,2,90,338,231,405,21,1562,551
1535,21,0.4.533,0,776,1,40,533,573,533,0,573,573,-135,466,1098,5,2,40,338,212,405,22,1562,526
1535,21,1.0.336,1,736,0,98,336,434,0,336,434,558,0,0,963,1,6,239,98,239,434,22,1562,526
1535,21,3.4.398,0,736,0,95,398,493,393,5,493,558,0,331,963,5,2,95,338,294,405,22,1562,526
1535,21,4.4.558,0,801,3,62,558,620,558,0,620,620,-160,491,1123,5,2,62,338,188,405,22,1562,526
1535,21,5.4.451,0,789,2,90,451,541,451,0,541,558,-53,384,1016,5,2,90,338,231,405,22,1562,526
1535,22,0.4.533,0,776,1,40,533,573,533,0,573,573,-135,466,1098,5,2,40,338,212,405,23,1562,428
1535,22,1.1.434,1,736,0,75,434,509,434,0,509,558,-95,320,1058,2,6,141,75,239,189,23,1562,428
1535,22,3.4.398,0,736,0,95,398,493,393,5,493,558,0,331,963,5,2,95,338,294,405,23,1562,428
1535,22,4.4.558,0,801,3,62,558,620,558,0,620,620,-160,491,1123,5,2,62,338,188,405,23,1562,428
1535,22,5.4.451,0,789,2,90,451,541,451,0,541,558,-53,384,1016,5,2,90,338,231,405,23,1562,428
1535,23,0.4.533,0,776,1,40,533,573,533,0,573,573,-135,466,1193,5,2,40,338,212,405,24,1562,353
1535,23,1.2.509,1,736,0,4,509,513,509,0,513,558,-141,301,1199,3,6,66,4,239,212,24,1562,353
1535,23,3.4.398,0,736,0,95,398,493,393,5,493,558,0,331,1058,5,2,95,338,294,405,24,1562,353
1535,23,4.4.558,0,801,3,62,558,620,558,0,620,620,-160,491,1218,5,2,62,338,188,405,24,1562,353
1535,23,5.4.451,0,789,2,90,451,541,451,0,541,558,-53,384,1111,5,2,90,338,231,405,24,1562,353
1535,24,0.4.533,0,776,1,40,533,573,533,0,573,573,-135,466,1334,5,2,40,338,212,405,25,1562,349
1535,24,1.3.558,1,736,0,11,558,569,513,45,569,569,0,247,1199,4,6,62,11,239,322,25,1562,349
1535,24,3.4.398,0,736,0,95,398,493,393,5,493,558,0,331,1199,5,2,95,338,294,405,25,1562,349
1535,24,4.4.558,0,801,3,62,558,620,558,0,620,620,-160,491,1359,5,2,62,338,188,405,25,1562,349
1535,24,5.4.451,0,789,2,90,451,541,451,0,541,558,-53,384,1252,5,2,90,338,231,405,25,1562,349
1535,25,0.4.533,0,776,1,40,533,573,533,0,573,573,-135,466,1334,5,2,40,338,212,405,26,1562,338
1535,25,1.4.569,0,812,4,51,569,620,569,0,620,620,-171,502,1370,5,2,51,338,239,405,26,1562,338
1535,25,3.4.398,1,736,0,95,398,493,393,5,493,569,0,331,1199,5,2,95,338,294,405,26,1562,338
1535,25,4.4.558,0,801,3,62,558,620,558,0,620,620,-160,491,1359,5,2,62,338,188,405,26,1562,338
1535,25,5.4.451,0,789,2,90,451,541,451,0,541,569,-53,384,1252,5,2,90,338,231,405,26,1562,338
1535,26,0.4.533,0,776,1,40,533,573,533,0,573,573,-40,371,1239,5,3,40,243,212,405,27,1562,243
1535,26,1.4.569,0,812,3,51,569,620,569,0,620,620,-76,407,1275,5,3,51,243,239,405,27,1562,243
1535,26,4.4.558,0,801,2,62,558,620,558,0,620,620,-65,396,1264,5,3,62,243,188,405,27,1562,243
1535,26,5.4.493,1,736,0,90,493,583,451,42,583,583,0,331,1199,5,3,90,243,231,405,27,1562,243
1535,27,0.4.583,1,736,0,40,583,623,533,50,623,623,0,331,1199,5,4,40,153,212,405,28,1562,153
1535,27,1.4.583,0,736,0,51,583,634,569,14,634,634,0,331,1199,5,4,51,153,239,405,28,1562,153
1535,27,4.4.583,0,736,0,62,583,645,558,25,645,645,0,331,1199,5,4,62,153,188,405,28,1562,153
1535,28,1.4.623,1,736,0,51,623,674,569,54,674,674,0,331,1199,5,5,51,113,239,405,29,1562,113
1535,28,4.4.623,0,736,0,62,623,685,558,65,685,685,0,331,1199,5,5,62,113,188,405,29,1562,113
1535,29,4.4.674,1,736,0,62,674,736,558,116,736,736,0,331,1199,5,6,62,62,188,405,30,1562,62
1536,0,0.0.0,0,599,3,87,0,87,0,0,87,87,0,0,0,1,1,354,349,354,349,1,1530,1530
1536,0,1.0.0,0,599,3,74,0,74,0,0,74,74,0,0,0,1,1,240,349,240,349,1,1530,1530
1536,0,2.0.0,0,577,1,23,0,23,0,0,23,23,0,0,0,1,1,226,349,226,349,1,1530,1530
1536,0,3.0.0,0,569,0,20,0,20,0,0,20,20,0,0,0,1,1,154,349,154,349,1,1530,1530
1536,0,4.0.0,0,639,4,90,0,90,0,0,90,90,0,0,0,1,1,226,349,226,349,1,1530,1530
1536,0,5.0.0,1,586,2,55,0,55,0,0,55,55,0,0,0,1,1,330,349,330,349,1,1530,1530
1536,1,0.0.55,0,594,1,87,55,142,0,55,142,142,0,0,0,1,2,354,294,354,349,2,1530,1475
1536,1,1.0.55,0,586,0,74,55,129,0,55,129,129,0,0,0,1,2,240,294,240,349,2,1530,1475
1536,1,2.0.55,1,586,0,23,55,78,0,55,78,78,0,0,0,1,2,226,294,226,349,2,1530,1475
1536,1,3.0.55,0,586,0,20,55,75,0,55,75,75,0,0,0,1,2,154,294,154,349,2,1530,1475
1536,1,4.0.55,0,613,2,90,55,145,0,55,145,145,0,0,0,1,2,226,294,226,349,2,1530,1475
1536,1,5.1.55,0,586,0,97,55,152,55,0,152,152,-55,55,55,2,1,275,390,330,390,2,1530,1475
1536,2,0.0.78,0,596,2,87,78,165,0,78,165,165,0,0,0,1,3,354,271,354,349,3,1530,1452
1536,2,1.0.78,0,592,1,74,78,152,0,78,152,152,0,0,0,1,3,240,271,240,349,3,1530,1452
1536,2,2.1.78,0,632,4,72,78,150,78,0,150,150,-78,78,78,2,1,203,390,226,390,3,1530,1452
1536,2,3.0.78,1,586,0,20,78,98,0,78,98,98,0,0,0,1,3,154,271,154,349,3,1530,1452
1536,2,4.0.78,0,630,3,90,78,168,0,78,168,168,0,0,0,1,3,226,271,226,349,3,1530,1452
1536,2,5.1.55,0,586,0,97,55,152,55,0,152,152,-55,55,55,2,1,275,390,330,390,3,1530,1452
1536,3,0.0.98,1,586,0,87,98,185,0,98,185,185,0,0,0,1,4,354,251,354,349,4,1530,1432
1536,3,1.0.98,0,592,1,74,98,172,0,98,172,172,0,0,0,1,4,240,251,240,349,4,1530,1432
1536,3,2.1.78,0,632,3,72,78,150,78,0,150,150,-78,78,78,2,1,203,390,226,390,4,1530,1432
1536,3,3.1.98,0,632,3,40,98,138,98,0,138,138,-98,98,98,2,1,134,390,154,390,4,1530,1432
1536,3,4.0.98,0,630,2,90,98,188,0,98,188,188,0,0,0,1,4,226,251,226,349,4,1530,1432
1536,3,5.1.55,0,586,0,97,55,152,55,0,152,152,-55,55,55,2,1,275,390,330,390,4,1530,1432
1536,4,0.1.185,0,616,1,82,185,267,185,0,267,267,-185,185,185,2,1,267,390,354,390,5,1530,1345
1536,4,1.0.185,1,586,0,74,185,259,0,185,259,259,0,0,0,1,5,240,164,240,349,5,1530,1345
1536,4,2.1.78,0,632,2,72,78,150,78,0,150,185,-78,78,78,2,1,203,390,226,390,5,1530,1345
1536,4,3.1.98,0,636,3,40,98,138,98,0,138,185,-98,98,98,2,1,134,390,154,390,5,1530,1345
1536,4,4.0.185,0,586,0,90,185,275,0,185,275,275,0,0,0,1,5,226,164,226,349,5,1530,1345
1536,4,5.1.55,0,586,0,97,55,152,55,0,152,185,-55,55,55,2,1,275,390,330,390,5,1530,1345
1536,5,0.1.185,0,616,1,82,185,267,185,0,267,267,-185,185,185,2,1,267,390,354,390,6,1530,1271
1536,5,1.1.259,0,636,3,44,259,303,259,0,303,303,-259,259,259,2,1,166,390,240,390,6,1530,1271
1536,5,2.1.78,0,632,2,72,78,150,78,0,150,259,-78,78,78,2,1,203,390,226,390,6,1530,1271
1536,5,3.1.98,0,636,3,40,98,138,98,0,138,259,-98,98,98,2,1,134,390,154,390,6,1530,1271
1536,5,4.0.259,1,586,0,90,259,349,0,259,349,349,0,0,0,1,6,226,90,226,349,6,1530,1271
1536,5,5.1.55,0,586,0,97,55,152,55,0,152,259,-55,55,55,2,1,275,390,330,390,6,1530,1271
1536,6,0.1.185,0,616,1,82,185,267,185,0,267,349,-185,185,185,2,1,267,390,354,390,7,1530,1181
1536,6,1.1.259,0,636,3,44,259,303,259,0,303,349,-259,259,259,2,1,166,390,240,390,7,1530,1181
1536,6,2.1.78,0,632,2,72,78,150,78,0,150,349,-78,78,78,2,1,203,390,226,390,7,1530,1181
1536,6,3.1.98,0,636,3,40,98,138,98,0,138,349,-98,98,98,2,1,134,390,154,390,7,1530,1181
1536,6,4.1.349,0,586,0,55,349,404,349,0,404,404,-349,349,349,2,1,136,390,226,390,7,1530,1181
1536,6,5.1.55,1,586,0,97,55,152,55,0,152,349,-55,55,55,2,1,275,390,330,390,7,1530,1181
1536,7,0.1.185,0,616,2,82,185,267,185,0,267,349,-33,88,88,2,2,267,293,354,390,8,1530,1084
1536,7,1.1.259,0,636,3,44,259,303,259,0,303,349,-107,162,162,2,2,166,293,240,390,8,1530,1084
1536,7,2.1.152,0,609,1,72,152,224,78,74,224,349,0,55,55,2,2,203,293,226,390,8,1530,1084
1536,7,3.1.152,0,586,0,40,152,192,98,54,192,349,0,55,55,2,2,134,293,154,390,8,1530,1084
1536,7,4.1.349,0,586,0,55,349,404,349,0,404,404,-197,252,252,2,2,136,293,226,390,8,1530,1084
1536,7,5.2.152,1,586,0,55,152,207,152,0,207,349,-152,152,207,3,1,178,179,330,179,8,1530,1084
1536,8,0.1.185,0,616,2,82,185,267,185,0,267,349,-33,88,240,2,2,267,293,354,390,9,1530,1029
1536,8,1.1.259,0,636,3,44,259,303,259,0,303,349,-107,162,314,2,2,166,293,240,390,9,1530,1029
1536,8,2.1.152,0,609,1,72,152,224,78,74,224,349,0,55,207,2,2,203,293,226,390,9,1530,1029
1536,8,3.1.152,0,586,0,40,152,192,98,54,192,349,0,55,207,2,2,134,293,154,390,9,1530,1029
1536,8,4.1.349,0,586,0,55,349,404,349,0,404,404,-197,252,404,2,2,136,293,226,390,9,1530,1029
1536,8,5.3.207,1,586,0,42,207,249,207,0,249,349,-207,207,414,4,1,123,275,330,275,9,1530,1029
1536,9,0.1.185,0,616,2,82,185,267,185,0,267,349,-33,88,447,2,2,267,293,354,390,10,1530,987
1536,9,1.1.259,0,636,3,44,259,303,259,0,303,349,-107,162,521,2,2,166,293,240,390,10,1530,987
1536,9,2.1.152,0,609,1,72,152,224,78,74,224,349,0,55,414,2,2,203,293,226,390,10,1530,987
1536,9,3.1.152,0,586,0,40,152,192,98,54,192,349,0,55,414,2,2,134,293,154,390,10,1530,987
1536,9,4.1.349,0,586,0,55,349,404,349,0,404,404,-197,252,611,2,2,136,293,226,390,10,1530,987
1536,9,5.4.249,1,586,0,81,249,330,249,0,330,349,-249,249,663,5,1,81,337,330,337,10,1530,987
1536,10,0.1.185,0,616,2,82,185,267,185,0,267,349,-33,88,696,2,2,267,293,354,390,11,1530,906
1536,10,1.1.259,0,636,3,44,259,303,259,0,303,349,-107,162,770,2,2,166,293,240,390,11,1530,906
1536,10,2.1.152,1,609,1,72,152,224,78,74,224,349,0,55,663,2,2,203,293,226,390,11,1530,906
1536,10,3.1.152,0,586,0,40,152,192,98,54,192,349,0,55,663,2,2,134,293,154,390,11,1530,906
1536,10,4.1.349,0,586,0,55,349,404,349,0,404,404,-197,252,860,2,2,136,293,226,390,11,1530,906
1536,11,0.1.224,0,634,2,82,224,306,185,39,306,349,0,55,663,2,3,267,221,354,390,12,1530,834
1536,11,1.1.259,0,640,3,44,259,303,259,0,303,349,-35,90,698,2,3,166,221,240,390,12,1530,834
1536,11,2.2.224,1,609,0,45,224,269,224,0,269,349,-17,169,680,3,2,131,124,226,179,12,1530,834
1536,11,3.1.224,0,609,0,40,224,264,98,126,264,349,0,55,663,2,3,134,221,154,390,12,1530,834
1536,11,4.1.349,0,625,1,55,349,404,349,0,404,404,-125,180,788,2,3,136,221,226,390,12,1530,834
1536,12,0.1.224,0,634,2,82,224,306,185,39,306,349,0,55,680,2,3,267,221,354,390,13,1530,789
1536,12,1.1.259,0,640,3,44,259,303,259,0,303,349,-35,90,715,2,3,166,221,240,390,13,1530,789
1536,12,2.3.269,1,609,0,53,269,322,269,0,322,349,-20,227,700,4,2,86,233,226,275,13,1530,789
1536,12,3.1.224,0,609,0,40,224,264,98,126,264,349,0,55,680,2,3,134,221,154,390,13,1530,789
1536,12,4.1.349,0,625,1,55,349,404,349,0,404,404,-125,180,805,2,3,136,221,226,390,13,1530,789
1536,13,0.1.224,0,634,2,82,224,306,185,39,306,349,0,55,700,2,3,267,221,354,390,14,1530,736
1536,13,1.1.259,0,640,3,44,259,303,259,0,303,349,-35,90,735,2,3,166,221,240,390,14,1530,736
1536,13,2.4.330,1,609,0,33,330,363,322,8,363,363,0,249,700,5,2,33,256,226,337,14,1530,736
1536,13,3.1.224,0,609,0,40,224,264,98,126,264,349,0,55,700,2,3,134,221,154,390,14,1530,736
1536,13,4.1.349,0,625,1,55,349,404,349,0,404,404,-125,180,825,2,3,136,221,226,390,14,1530,736
1536,14,0.1.224,0,634,2,82,224,306,185,39,306,363,0,55,700,2,3,267,221,354,390,15,1530,703
1536,14,1.1.259,0,640,3,44,259,303,259,0,303,363,-35,90,735,2,3,166,221,240,390,15,1530,703
1536,14,3.1.224,1,609,0,40,224,264,98,126,264,363,0,55,700,2,3,134,221,154,390,15,1530,703
1536,14,4.1.349,0,625,1,55,349,404,349,0,404,404,-125,180,825,2,3,136,221,226,390,15,1530,703
1536,15,0.1.264,0,625,1,82,264,346,185,79,346,363,0,55,700,2,4,267,181,354,390,16,1530,663
1536,15,1.1.264,0,609,0,44,264,308,259,5,308,363,0,55,700,2,4,166,181,240,390,16,1530,663
1536,15,3.2.269,1,609,0,36,269,305,264,5,305,363,0,169,700,3,3,94,79,154,179,16,1530,663
1536,15,4.1.349,0,625,1,55,349,404,349,0,404,404,-85,140,785,2,4,136,181,226,390,16,1530,663
1536,16,0.1.264,0,625,1,82,264,346,185,79,346,363,0,55,700,2,4,267,181,354,390,17,1530,627
1536,16,1.1.264,0,609,0,44,264,308,259,5,308,363,0,55,700,2,4,166,181,240,390,17,1530,627
1536,16,3.3.322,1,609,0,21,322,343,305,17,343,363,0,227,700,4,3,58,180,154,275,17,1530,627
1536,16,4.1.349,0,625,1,55,349,404,349,0,404,404,-85,140,785,2,4,136,181,226,390,17,1530,627
1536,17,0.1.264,0,625,1,82,264,346,185,79,346,363,0,55,700,2,4,267,181,354,390,18,1530,606
1536,17,1.1.264,0,609,0,44,264,308,259,5,308,363,0,55,700,2,4,166,181,240,390,18,1530,606
1536,17,3.4.363,1,609,0,37,363,400,343,20,400,400,0,249,700,5,3,37,223,154,337,18,1530,606
1536,17,4.1.349,0,625,1,55,349,404,349,0,404,404,-85,140,785,2,4,136,181,226,390,18,1530,606
1536,18,0.1.264,1,625,1,82,264,346,185,79,346,400,0,55,700,2,4,267,181,354,390,19,1530,569
1536,18,1.1.264,0,609,0,44,264,308,259,5,308,400,0,55,700,2,4,166,181,240,390,19,1530,569
1536,18,4.1.349,0,625,1,55,349,404,349,0,404,404,-85,140,785,2,4,136,181,226,390,19,1530,569
1536,19,0.2.346,1,625,0,4,346,350,346,0,350,400,-41,210,741,3,4,185,43,354,179,20,1530,487
1536,19,1.1.346,0,625,0,44,346,390,259,87,390,400,0,55,700,2,5,166,99,240,390,20,1530,487
1536,19,4.1.349,0,625,0,55,349,404,349,0,404,404,-3,58,703,2,5,136,99,226,390,20,1530,487
1536,20,0.3.350,1,625,0,89,350,439,350,0,439,439,-7,234,748,4,4,181,159,354,275,21,1530,483
1536,20,1.1.346,0,625,0,44,346,390,259,87,390,400,0,55,741,2,5,166,99,240,390,21,1530,483
1536,20,4.1.349,0,625,0,55,349,404,349,0,404,404,-3,58,744,2,5,136,99,226,390,21,1530,483
1536,21,0.4.439,1,625,0,92,439,531,439,0,531,531,-39,288,787,5,4,92,186,354,337,22,1530,394
1536,21,1.1.346,0,625,0,44,346,390,259,87,390,439,0,55,748,2,5,166,99,240,390,22,1530,394
1536,21,4.1.349,0,625,0,55,349,404,349,0,404,439,-3,58,751,2,5,136,99,226,390,22,1530,394
1536,22,1.1.346,1,625,0,44,346,390,259,87,390,531,0,55,787,2,5,166,99,240,390,23,1530,302
1536,22,4.1.349,0,625,0,55,349,404,349,0,404,531,-3,58,790,2,5,136,99,226,390,23,1530,302
1536,23,1.2.390,1,625,0,9,390,399,390,0,399,531,-40,250,827,3,5,122,39,240,179,24,1530,258
1536,23,4.1.390,0,625,0,55,390,445,349,41,445,531,0,55,787,2,6,136,55,226,390,24,1530,258
1536,24,1.3.439,1,625,0,52,439,491,399,40,491,531,0,234,827,4,5,113,70,240,275,25,1530,249
1536,24,4.1.390,0,625,0,55,390,445,349,41,445,531,0,55,827,2,6,136,55,226,390,25,1530,249
1536,25,1.4.531,1,625,0,61,531,592,491,40,592,592,0,288,827,5,5,61,94,240,337,26,1530,197
1536,25,4.1.390,0,625,0,55,390,445,349,41,445,531,0,55,827,2,6,136,55,226,390,26,1530,197
1536,26,4.1.390,1,625,0,55,390,445,349,41,445,592,0,55,827,2,6,136,55,226,390,27,1530,136
1536,27,4.2.445,1,625,0,30,445,475,445,0,475,592,-46,296,873,3,6,81,30,226,179,28,1530,81
1536,28,4.3.491,1,625,0,18,491,509,475,16,509,592,0,234,873,4,6,51,18,226,275,29,1530,51
1536,29,4.4.592,1,625,0,33,592,625,509,83,625,625,0,288,873,5,6,33,33,226,337,30,1530,33
1537,0,0.0.0,1,560,1,1,0,1,0,0,1,1,0,0,0,1,1,199,263,199,263,1,1496,1496
1537,0,1.0.0,0,559,0,49,0,49,0,0,49,49,0,0,0,1,1,238,263,238,263,1,1496,1496
1537,0,2.0.0,0,611,3,68,0,68,0,0,68,68,0,0,0,1,1,352,263,352,263,1,1496,1496
1537,0,3.0.0,0,614,4,72,0,72,0,0,72,72,0,0,0,1,1,311,263,311,263,1,1496,1496
1537,0,4.0.0,0,569,2,13,0,13,0,0,13,13,0,0,0,1,1,65,263,65,263,1,1496,1496
1537,0,5.0.0,0,619,5,60,0,60,0,0,60,60,0,0,0,1,1,331,263,331,263,1,1496,1496
1537,1,0.1.1,0,561,1,50,1,51,1,0,51,51,-1,1,1,2,1,198,293,199,293,2,1496,1495
1537,1,1.0.1,0,560,0,49,1,50,0,1,50,50,0,0,0,1,2,238,262,238,263,2,1496,1495
1537,1,2.0.1,0,568,2,68,1,69,0,1,69,69,0,0,0,1,2,352,262,352,263,2,1496,1495
1537,1,3.0.1,0,570,3,72,1,73,0,1,73,73,0,0,0,1,2,311,262,311,263,2,1496,1495
1537,1,4.0.1,0,568,2,13,1,14,0,1,14,14,0,0,0,1,2,65,262,65,263,2,1496,1495
1537,1,5.0.1,1,579,4,60,1,61,0,1,61,61,0,0,0,1,2,331,262,331,263,2,1496,1495
1537,2,0.1.1,0,579,0,50,1,51,1,0,51,61,-1,1,1,2,1,198,293,199,293,3,1496,1435
1537,2,1.0.61,0,579,0,49,61,110,0,61,110,110,0,0,0,1,3,238,202,238,263,3,1496,1435
1537,2,2.0.61,1,602,3,68,61,129,0,61,129,129,0,0,0,1,3,352,202,352,263,3,1496,1435
1537,2,3.0.61,0,588,2,72,61,133,0,61,133,133,0,0,0,1,3,311,202,311,263,3,1496,1435
1537,2,4.0.61,0,581,1,13,61,74,0,61,74,74,0,0,0,1,3,65,202,65,263,3,1496,1435
1537,2,5.1.61,0,581,1,80,61,141,61,0,141,141,-61,61,61,2,1,271,293,331,293,3,1496,1435
1537,3,0.1.1,0,602,0,50,1,51,1,0,51,129,-1,1,1,2,1,198,293,199,293,4,1496,1367
1537,3,1.0.129,0,602,0,49,129,178,0,129,178,178,0,0,0,1,4,238,134,238,263,4,1496,1367
1537,3,2.1.129,0,635,1,66,129,195,129,0,195,195,-129,129,129,2,1,284,293,352,293,4,1496,1367
1537,3,3.0.129,1,602,0,72,129,201,0,129,201,201,0,0,0,1,4,311,134,311,263,4,1496,1367
1537,3,4.0.129,0,602,0,13,129,142,0,129,142,142,0,0,0,1,4,65,134,65,263,4,1496,1367
1537,3,5.1.61,0,602,0,80,61,141,61,0,141,141,-61,61,61,2,1,271,293,331,293,4,1496,1367
1537,4,0.1.1,0,602,0,50,1,51,1,0,51,201,-1,1,1,2,1,198,293,199,293,5,1496,1295
1537,4,1.0.201,1,602,0,49,201,250,0,201,250,250,0,0,0,1,5,238,62,238,263,5,1496,1295
1537,4,2.1.129,0,636,2,66,129,195,129,0,195,201,-129,129,129,2,1,284,293,352,293,5,1496,1295
1537,4,3.1.201,0,626,1,78,201,279,201,0,279,279,-201,201,201,2,1,239,293,311,293,5,1496,1295
1537,4,4.0.201,0,602,0,13,201,214,0,201,214,214,0,0,0,1,5,65,62,65,263,5,1496,1295
1537,4,5.1.61,0,602,0,80,61,141,61,0,141,201,-61,61,61,2,1,271,293,331,293,5,1496,1295
1537,5,0.1.1,0,602,0,50,1,51,1,0,51,250,-1,1,1,2,1,198,293,199,293,6,1496,1246
1537,5,1.1.250,0,602,0,12,250,262,250,0,262,262,-250,250,250,2,1,189,293,238,293,6,1496,1246
1537,5,2.1.129,0,636,2,66,129,195,129,0,195,250,-129,129,129,2,1,284,293,352,293,6,1496,1246
1537,5,3.1.201,0,626,1,78,201,279,201,0,279,279,-201,201,201,2,1,239,293,311,293,6,1496,1246
1537,5,4.0.250,1,602,0,13,250,263,0,250,263,263,0,0,0,1,6,65,13,65,263,6,1496,1246
1537,5,5.1.61,0,602,0,80,61,141,61,0,141,250,-61,61,61,2,1,271,293,331,293,6,1496,1246
1537,6,0.1.1,1,602,0,50,1,51,1,0,51,263,-1,1,1,2,1,198,293,199,293,7,1496,1233
1537,6,1.1.250,0,602,0,12,250,262,250,0,262,263,-250,250,250,2,1,189,293,238,293,7,1496,1233
1537,6,2.1.129,0,636,2,66,129,195,129,0,195,263,-129,129,129,2,1,284,293,352,293,7,1496,1233
1537,6,3.1.201,0,626,1,78,201,279,201,0,279,279,-201,201,201,2,1,239,293,311,293,7,1496,1233
1537,6,4.1.263,0,602,0,7,263,270,263,0,270,270,-263,263,263,2,1,52,293,65,293,7,1496,1233
1537,6,5.1.61,0,602,0,80,61,141,61,0,141,263,-61,61,61,2,1,271,293,331,293,7,1496,1233
1537,7,0.2.51,1,602,0,8,51,59,51,0,59,263,-51,51,52,3,1,148,246,199,246,8,1496,1183
1537,7,1.1.250,0,602,0,12,250,262,250,0,262,263,-199,200,200,2,2,189,243,238,293,8,1496,1183
1537,7,2.1.129,0,636,2,66,129,195,129,0,195,263,-78,79,79,2,2,284,243,352,293,8,1496,1183
1537,7,3.1.201,0,626,1,78,201,279,201,0,279,279,-150,151,151,2,2,239,243,311,293,8,1496,1183
1537,7,4.1.263,0,602,0,7,263,270,263,0,270,270,-212,213,213,2,2,52,243,65,293,8,1496,1183
1537,7,5.1.61,0,602,0,80,61,141,61,0,141,263,-10,11,11,2,2,271,243,331,293,8,1496,1183
1537,8,0.3.59,1,602,0,95,59,154,59,0,154,263,-59,59,111,4,1,140,328,199,328,9,1496,1175
1537,8,1.1.250,0,602,0,12,250,262,250,0,262,263,-199,200,251,2,2,189,243,238,293,9,1496,1175
1537,8,2.1.129,0,636,2,66,129,195,129,0,195,263,-78,79,130,2,2,284,243,352,293,9,1496,1175
1537,8,3.1.201,0,626,1,78,201,279,201,0,279,279,-150,151,202,2,2,239,243,311,293,9,1496,1175
1537,8,4.1.263,0,602,0,7,263,270,263,0,270,270,-212,213,264,2,2,52,243,65,293,9,1496,1175
1537,8,5.1.61,0,602,0,80,61,141,61,0,141,263,-10,11,62,2,2,271,243,331,293,9,1496,1175
1537,9,0.4.154,1,602,0,45,154,199,154,0,199,263,-154,154,265,5,1,45,366,199,366,10,1496,1080
1537,9,1.1.250,0,602,0,12,250,262,250,0,262,263,-199,200,310,2,2,189,243,238,293,10,1496,1080
1537,9,2.1.129,0,636,2,66,129,195,129,0,195,263,-78,79,189,2,2,284,243,352,293,10,1496,1080
1537,9,3.1.201,0,626,1,78,201,279,201,0,279,279,-150,151,261,2,2,239,243,311,293,10,1496,1080
1537,9,4.1.263,0,602,0,7,263,270,263,0,270,270,-212,213,323,2,2,52,243,65,293,10,1496,1080
1537,9,5.1.61,0,602,0,80,61,141,61,0,141,263,-10,11,121,2,2,271,243,331,293,10,1496,1080
1537,10,1.1.250,0,602,0,12,250,262,250,0,262,263,-199,200,464,2,2,189,243,238,293,11,1496,1035
1537,10,2.1.129,0,636,2,66,129,195,129,0,195,263,-78,79,343,2,2,284,243,352,293,11,1496,1035
1537,10,3.1.201,0,626,1,78,201,279,201,0,279,279,-150,151,415,2,2,239,243,311,293,11,1496,1035
1537,10,4.1.263,0,602,0,7,263,270,263,0,270,270,-212,213,477,2,2,52,243,65,293,11,1496,1035
1537,10,5.1.61,1,602,0,80,61,141,61,0,141,263,-10,11,275,2,2,271,243,331,293,11,1496,1035
1537,11,1.1.250,0,602,0,12,250,262,250,0,262,263,-109,120,384,2,3,189,163,238,293,12,1496,955
1537,11,2.1.141,1,602,0,66,141,207,129,12,207,263,0,11,275,2,3,284,163,352,293,12,1496,955
1537,11,3.1.201,0,626,1,78,201,279,201,0,279,279,-60,71,335,2,3,239,163,311,293,12,1496,955
1537,11,4.1.263,0,602,0,7,263,270,263,0,270,270,-122,133,397,2,3,52,163,65,293,12,1496,955
1537,11,5.2.141,0,602,0,92,141,233,141,0,233,263,-82,133,357,3,2,191,238,331,246,12,1496,955
1537,12,1.1.250,1,602,0,12,250,262,250,0,262,263,-43,54,318,2,4,189,97,238,293,13,1496,889
1537,12,2.2.207,0,648,1,98,207,305,207,0,305,305,-148,199,423,3,2,218,238,352,246,13,1496,889
1537,12,3.1.207,0,602,0,78,207,285,201,6,285,285,0,11,275,2,4,239,97,311,293,13,1496,889
1537,12,4.1.263,0,602,0,7,263,270,263,0,270,270,-56,67,331,2,4,52,97,65,293,13,1496,889
1537,12,5.2.141,0,602,0,92,141,233,141,0,233,263,-82,133,357,3,2,191,238,331,246,13,1496,889
1537,13,1.2.262,0,618,1,14,262,276,262,0,276,276,-203,254,521,3,2,177,238,238,246,14,1496,877
1537,13,2.2.207,0,648,2,98,207,305,207,0,305,305,-148,199,466,3,2,218,238,352,246,14,1496,877
1537,13,3.1.262,1,602,0,78,262,340,201,61,340,340,0,54,318,2,5,239,85,311,293,14,1496,877
1537,13,4.1.263,0,602,0,7,263,270,263,0,270,270,-1,55,319,2,5,52,85,65,293,14,1496,877
1537,13,5.2.141,0,602,0,92,141,233,141,0,233,263,-82,133,400,3,2,191,238,331,246,14,1496,877
1537,14,1.2.262,0,618,1,14,262,276,262,0,276,340,-203,254,521,3,2,177,238,238,246,15,1496,799
1537,14,2.2.207,0,648,2,98,207,305,207,0,305,340,-148,199,466,3,2,218,238,352,246,15,1496,799
1537,14,3.2.340,0,602,0,4,340,344,340,0,344,344,-281,332,599,3,2,161,238,311,246,15,1496,799
1537,14,4.1.340,1,602,0,7,340,347,263,77,347,347,0,54,318,2,6,52,7,65,293,15,1496,799
1537,14,5.2.141,0,602,0,92,141,233,141,0,233,340,-82,133,400,3,2,191,238,331,246,15,1496,799
1537,15,1.2.262,0,618,1,14,262,276,262,0,276,347,-203,254,521,3,2,177,238,238,246,16,1496,792
1537,15,2.2.207,0,648,2,98,207,305,207,0,305,347,-148,199,466,3,2,218,238,352,246,16,1496,792
1537,15,3.2.340,0,602,0,4,340,344,340,0,344,347,-281,332,599,3,2,161,238,311,246,16,1496,792
1537,15,4.2.347,0,602,0,30,347,377,347,0,377,377,-288,339,606,3,2,45,238,65,246,16,1496,792
1537,15,5.2.141,1,602,0,92,141,233,141,0,233,347,-82,133,400,3,2,191,238,331,246,16,1496,792
1537,16,1.2.262,0,618,1,14,262,276,262,0,276,347,-29,162,429,3,3,177,146,238,246,17,1496,700
1537,16,2.2.233,0,602,0,98,233,331,207,26,331,347,0,133,400,3,3,218,146,352,246,17,1496,700
1537,16,3.2.340,0,602,0,4,340,344,340,0,344,347,-107,240,507,3,3,161,146,311,246,17,1496,700
1537,16,4.2.347,0,602,0,30,347,377,347,0,377,377,-114,247,514,3,3,45,146,65,246,17,1496,700
1537,16,5.3.233,1,602,0,27,233,260,233,0,260,347,-79,138,479,4,2,99,233,331,328,17,1496,700
1537,17,1.2.262,1,618,1,14,262,276,262,0,276,347,-29,162,508,3,3,177,146,238,246,18,1496,673
1537,17,2.2.233,0,602,0,98,233,331,207,26,331,347,0,133,479,3,3,218,146,352,246,18,1496,673
1537,17,3.2.340,0,602,0,4,340,344,340,0,344,347,-107,240,586,3,3,161,146,311,246,18,1496,673
1537,17,4.2.347,0,602,0,30,347,377,347,0,377,377,-114,247,593,3,3,45,146,65,246,18,1496,673
1537,17,5.4.260,0,602,0,72,260,332,260,0,332,347,-61,215,540,5,2,72,321,331,366,18,1496,673
1537,18,1.3.276,0,618,0,93,276,369,276,0,369,369,-16,154,524,4,3,163,206,238,328,19,1496,659
1537,18,2.2.276,0,618,0,98,276,374,207,69,374,374,0,162,508,3,4,218,132,352,246,19,1496,659
1537,18,3.2.340,1,627,1,4,340,344,340,0,344,347,-64,226,572,3,4,161,132,311,246,19,1496,659
1537,18,4.2.347,0,627,1,30,347,377,347,0,377,377,-71,233,579,3,4,45,132,65,246,19,1496,659
1537,18,5.4.260,0,618,0,72,260,332,260,0,332,347,-61,215,569,5,2,72,321,331,366,19,1496,659
1537,19,1.3.276,0,627,0,93,276,369,276,0,369,369,-16,154,588,4,3,163,206,238,328,20,1496,655
1537,19,2.2.344,1,627,0,98,344,442,207,137,442,442,0,226,572,3,5,218,128,352,246,20,1496,655
1537,19,3.3.344,0,672,1,79,344,423,344,0,423,423,-84,222,656,4,3,157,206,311,328,20,1496,655
1537,19,4.2.347,0,627,0,30,347,377,347,0,377,377,-3,229,575,3,5,45,128,65,246,20,1496,655
1537,19,5.4.260,0,627,0,72,260,332,260,0,332,347,-61,215,633,5,2,72,321,331,366,20,1496,655
1537,20,1.3.276,0,627,0,93,276,369,276,0,369,442,-16,154,588,4,3,163,206,238,328,21,1496,557
1537,20,2.3.442,0,643,1,22,442,464,442,0,464,464,-182,320,754,4,3,120,206,352,328,21,1496,557
1537,20,3.3.344,0,672,2,79,344,423,344,0,423,442,-84,222,656,4,3,157,206,311,328,21,1496,557
1537,20,4.2.442,1,627,0,30,442,472,347,95,472,472,0,226,572,3,6,45,30,65,246,21,1496,557
1537,20,5.4.260,0,627,0,72,260,332,260,0,332,442,-61,215,633,5,2,72,321,331,366,21,1496,557
1537,21,1.3.276,0,627,0,93,276,369,276,0,369,472,-16,154,588,4,3,163,206,238,328,22,1496,527
1537,21,2.3.442,0,643,1,22,442,464,442,0,464,472,-182,320,754,4,3,120,206,352,328,22,1496,527
1537,21,3.3.344,0,672,2,79,344,423,344,0,423,472,-84,222,656,4,3,157,206,311,328,22,1496,527
1537,21,4.3.472,0,627,0,12,472,484,472,0,484,484,-212,350,784,4,3,15,206,65,328,22,1496,527
1537,21,5.4.260,1,627,0,72,260,332,260,0,332,472,-61,215,633,5,2,72,321,331,366,22,1496,527
1537,22,1.3.276,1,627,0,93,276,369,276,0,369,472,-16,154,649,4,3,163,206,238,328,23,1496,455
1537,22,2.3.442,0,643,1,22,442,464,442,0,464,472,-182,320,815,4,3,120,206,352,328,23,1496,455
1537,22,3.3.344,0,672,2,79,344,423,344,0,423,472,-84,222,717,4,3,157,206,311,328,23,1496,455
1537,22,4.3.472,0,627,0,12,472,484,472,0,484,484,-212,350,845,4,3,15,206,65,328,23,1496,455
1537,23,1.4.369,0,627,0,70,369,439,369,0,439,472,-37,252,686,5,3,70,249,238,366,24,1496,362
1537,23,2.3.442,1,643,1,22,442,464,442,0,464,472,-73,227,722,4,4,120,113,352,328,24,1496,362
1537,23,3.3.369,0,627,0,79,369,448,344,25,448,472,0,154,649,4,4,157,113,311,328,24,1496,362
1537,23,4.3.472,0,627,0,12,472,484,472,0,484,484,-103,257,752,4,4,15,113,65,328,24,1496,362
1537,24,1.4.369,0,643,0,70,369,439,369,0,439,472,-37,252,759,5,3,70,249,238,366,25,1496,340
1537,24,2.4.464,0,643,0,98,464,562,464,0,562,562,-132,347,854,5,3,98,249,352,366,25,1496,340
1537,24,3.3.464,1,643,0,79,464,543,344,120,543,543,0,227,722,4,5,157,91,311,328,25,1496,340
1537,24,4.3.472,0,643,0,12,472,484,472,0,484,484,-8,235,730,4,5,15,91,65,328,25,1496,340
1537,25,1.4.369,0,643,0,70,369,439,369,0,439,543,-37,252,759,5,3,70,249,238,366,26,1496,261
1537,25,2.4.464,0,643,0,98,464,562,464,0,562,562,-132,347,854,5,3,98,249,352,366,26,1496,261
1537,25,3.4.543,0,722,1,78,543,621,543,0,621,621,-211,426,933,5,3,78,249,311,366,26,1496,261
1537,25,4.3.543,1,643,0,12,543,555,472,71,555,555,0,227,722,4,6,15,12,65,328,26,1496,261
1537,26,1.4.369,1,643,0,70,369,439,369,0,439,555,-37,252,759,5,3,70,249,238,366,27,1496,249
1537,26,2.4.464,0,643,0,98,464,562,464,0,562,562,-132,347,854,5,3,98,249,352,366,27,1496,249
1537,26,3.4.543,0,722,1,78,543,621,543,0,621,621,-211,426,933,5,3,78,249,311,366,27,1496,249
1537,26,4.4.555,0,734,2,3,555,558,555,0,558,558,-223,438,945,5,3,3,249,65,366,27,1496,249
1537,27,2.4.464,1,643,0,98,464,562,464,0,562,562,-25,277,784,5,4,98,179,352,366,28,1496,179
1537,27,3.4.543,0,722,1,78,543,621,543,0,621,621,-104,356,863,5,4,78,179,311,366,28,1496,179
1537,27,4.4.555,0,734,2,3,555,558,555,0,558,558,-116,368,875,5,4,3,179,65,366,28,1496,179
1537,28,3.4.562,0,643,0,78,562,640,543,19,640,640,0,277,784,5,5,78,81,311,366,29,1496,81
1537,28,4.4.562,1,643,0,3,562,565,555,7,565,565,0,277,784,5,5,3,81,65,366,29,1496,81
1537,29,3.4.565,1,643,0,78,565,643,543,22,643,643,0,277,784,5,6,78,78,311,366,30,1496,78
1538,0,0.0.0,0,500,0,14,0,14,0,0,14,14,0,0,0,1,1,144,179,144,179,1,1267,1267
1538,0,1.0.0,0,522,3,25,0,25,0,0,25,25,0,0,0,1,1,239,179,239,179,1,1267,1267
1538,0,2.0.0,1,502,1,15,0,15,0,0,15,15,0,0,0,1,1,278,179,278,179,1,1267,1267
1538,0,3.0.0,0,513,2,26,0,26,0,0,26,26,0,0,0,1,1,172,179,172,179,1,1267,1267
1538,0,4.0.0,0,525,4,35,0,35,0,0,35,35,0,0,0,1,1,201,179,201,179,1,1267,1267
1538,0,5.0.0,0,554,5,64,0,64,0,0,64,64,0,0,0,1,1,233,179,233,179,1,1267,1267
1538,1,0.0.15,0,502,0,14,15,29,0,15,29,29,0,0,0,1,2,144,164,144,179,2,1267,1252
1538,1,1.0.15,1,505,1,25,15,40,0,15,40,40,0,0,0,1,2,239,164,239,179,2,1267,1252
1538,1,2.1.15,0,502,0,59,15,74,15,0,74,74,-15,15,15,2,1,263,294,278,294,2,1267,1252
1538,1,3.0.15,0,505,1,26,15,41,0,15,41,41,0,0,0,1,2,172,164,172,179,2,1267,1252
1538,1,4.0.15,0,505,1,35,15,50,0,15,50,50,0,0,0,1,2,201,164,201,179,2,1267,1252
1538,1,5.0.15,0,520,2,64,15,79,0,15,79,79,0,0,0,1,2,233,164,233,179,2,1267,1252
1538,2,0.0.40,1,505,0,14,40,54,0,40,54,54,0,0,0,1,3,144,139,144,179,3,1267,1227
1538,2,1.1.40,0,546,4,79,40,119,40,0,119,119,-40,40,40,2,1,214,294,239,294,3,1267,1227
1538,2,2.1.15,0,505,0,59,15,74,15,0,74,74,-15,15,15,2,1,263,294,278,294,3,1267,1227
1538,2,3.0.40,0,519,1,26,40,66,0,40,66,66,0,0,0,1,3,172,139,172,179,3,1267,1227
1538,2,4.0.40,0,520,2,35,40,75,0,40,75,75,0,0,0,1,3,201,139,201,179,3,1267,1227
1538,2,5.0.40,0,545,3,64,40,104,0,40,104,104,0,0,0,1,3,233,139,233,179,3,1267,1227
1538,3,0.1.54,0,537,3,18,54,72,54,0,72,72,-54,54,54,2,1,130,294,144,294,4,1267,1213
1538,3,1.1.40,0,546,4,79,40,119,40,0,119,119,-40,40,40,2,1,214,294,239,294,4,1267,1213
1538,3,2.1.15,0,505,0,59,15,74,15,0,74,74,-15,15,15,2,1,263,294,278,294,4,1267,1213
1538,3,3.0.54,0,519,1,26,54,80,0,54,80,80,0,0,0,1,4,172,125,172,179,4,1267,1213
1538,3,4.0.54,1,505,0,35,54,89,0,54,89,89,0,0,0,1,4,201,125,201,179,4,1267,1213
1538,3,5.0.54,0,524,2,64,54,118,0,54,118,118,0,0,0,1,4,233,125,233,179,4,1267,1213
1538,4,0.1.54,0,537,1,18,54,72,54,0,72,89,-54,54,54,2,1,130,294,144,294,5,1267,1178
1538,4,1.1.40,0,546,2,79,40,119,40,0,119,119,-40,40,40,2,1,214,294,239,294,5,1267,1178
1538,4,2.1.15,0,505,0,59,15,74,15,0,74,89,-15,15,15,2,1,263,294,278,294,5,1267,1178
1538,4,3.0.89,1,505,0,26,89,115,0,89,115,115,0,0,0,1,5,172,90,172,179,5,1267,1178
1538,4,4.1.89,0,561,3,58,89,147,89,0,147,147,-89,89,89,2,1,166,294,201,294,5,1267,1178
1538,4,5.0.89,0,505,0,64,89,153,0,89,153,153,0,0,0,1,5,233,90,233,179,5,1267,1178
1538,5,0.1.54,0,537,2,18,54,72,54,0,72,115,-54,54,54,2,1,130,294,144,294,6,1267,1152
1538,5,1.1.40,0,546,3,79,40,119,40,0,119,119,-40,40,40,2,1,214,294,239,294,6,1267,1152
1538,5,2.1.15,0,505,0,59,15,74,15,0,74,115,-15,15,15,2,1,263,294,278,294,6,1267,1152
1538,5,3.1.115,0,534,1,17,115,132,115,0,132,132,-115,115,115,2,1,146,294,172,294,6,1267,1152
1538,5,4.1.89,0,561,4,58,89,147,89,0,147,147,-89,89,89,2,1,166,294,201,294,6,1267,1152
1538,5,5.0.115,1,505,0,64,115,179,0,115,179,179,0,0,0,1,6,233,64,233,179,6,1267,1152
1538,6,0.1.54,0,537,2,18,54,72,54,0,72,179,-54,54,54,2,1,130,294,144,294,7,1267,1088
1538,6,1.1.40,0,546,3,79,40,119,40,0,119,179,-40,40,40,2,1,214,294,239,294,7,1267,1088
1538,6,2.1.15,1,505,0,59,15,74,15,0,74,179,-15,15,15,2,1,263,294,278,294,7,1267,1088
1538,6,3.1.115,0,534,1,17,115,132,115,0,132,179,-115,115,115,2,1,146,294,172,294,7,1267,1088
1538,6,4.1.89,0,561,4,58,89,147,89,0,147,179,-89,89,89,2,1,166,294,201,294,7,1267,1088
1538,6,5.1.179,0,505,0,63,179,242,179,0,242,242,-179,179,179,2,1,169,294,233,294,7,1267,1088
1538,7,0.1.74,0,505,0,18,74,92,54,20,92,179,0,15,15,2,2,130,235,144,294,8,1267,1029
1538,7,1.1.74,0,580,3,79,74,153,40,34,153,179,0,15,15,2,2,214,235,239,294,8,1267,1029
1538,7,2.2.74,1,534,1,51,74,125,74,0,125,179,-74,74,89,3,1,204,214,278,214,8,1267,1029
1538,7,3.1.115,0,534,1,17,115,132,115,0,132,179,-41,56,56,2,2,146,235,172,294,8,1267,1029
1538,7,4.1.89,0,574,2,58,89,147,89,0,147,179,-15,30,30,2,2,166,235,201,294,8,1267,1029
1538,7,5.1.179,0,505,0,63,179,242,179,0,242,242,-105,120,120,2,2,169,235,233,294,8,1267,1029
1538,8,0.1.74,0,534,0,18,74,92,54,20,92,179,0,15,89,2,2,130,235,144,294,9,1267,978
1538,8,1.1.74,0,580,2,79,74,153,40,34,153,179,0,15,89,2,2,214,235,239,294,9,1267,978
1538,8,2.3.125,1,610,3,90,125,215,125,0,215,215,-125,125,214,4,1,153,185,278,185,9,1267,978
1538,8,3.1.115,0,534,0,17,115,132,115,0,132,179,-41,56,130,2,2,146,235,172,294,9,1267,978
1538,8,4.1.89,0,574,1,58,89,147,89,0,147,179,-15,30,104,2,2,166,235,201,294,9,1267,978
1538,8,5.1.179,0,534,0,63,179,242,179,0,242,242,-105,120,194,2,2,169,235,233,294,9,1267,978
1538,9,0.1.74,1,610,0,18,74,92,54,20,92,215,0,15,214,2,2,130,235,144,294,10,1267,888
1538,9,1.1.74,0,610,0,79,74,153,40,34,153,215,0,15,214,2,2,214,235,239,294,10,1267,888
1538,9,2.4.215,0,610,0,63,215,278,215,0,278,278,-215,215,429,5,1,63,395,278,395,10,1267,888
1538,9,3.1.115,0,610,0,17,115,132,115,0,132,215,-41,56,255,2,2,146,235,172,294,10,1267,888
1538,9,4.1.89,0,610,0,58,89,147,89,0,147,215,-15,30,229,2,2,166,235,201,294,10,1267,888
1538,9,5.1.179,0,610,0,63,179,242,179,0,242,242,-105,120,319,2,2,169,235,233,294,10,1267,888
1538,10,0.2.125,1,610,0,11,125,136,92,33,136,215,0,74,214,3,2,112,163,144,214,11,1267,870
1538,10,1.1.92,0,610,0,79,92,171,40,52,171,215,0,15,214,2,3,214,217,239,294,11,1267,870
1538,10,2.4.215,0,610,0,63,215,278,215,0,278,278,-215,215,429,5,1,63,395,278,395,11,1267,870
1538,10,3.1.115,0,610,0,17,115,132,115,0,132,215,-23,38,237,2,3,146,217,172,294,11,1267,870
1538,10,4.1.92,0,610,0,58,92,150,89,3,150,215,0,15,214,2,3,166,217,201,294,11,1267,870
1538,10,5.1.179,0,610,0,63,179,242,179,0,242,242,-87,102,301,2,3,169,217,233,294,11,1267,870
1538,11,0.3.215,1,610,0,3,215,218,136,79,218,218,0,125,214,4,2,101,95,144,185,12,1267,859
1538,11,1.1.92,0,610,0,79,92,171,40,52,171,215,0,15,214,2,3,214,217,239,294,12,1267,859
1538,11,2.4.215,0,610,0,63,215,278,215,0,278,278,-215,215,429,5,1,63,395,278,395,12,1267,859
1538,11,3.1.115,0,610,0,17,115,132,115,0,132,215,-23,38,237,2,3,146,217,172,294,12,1267,859
1538,11,4.1.92,0,610,0,58,92,150,89,3,150,215,0,15,214,2,3,166,217,201,294,12,1267,859
1538,11,5.1.179,0,610,0,63,179,242,179,0,242,242,-87,102,301,2,3,169,217,233,294,12,1267,859
1538,12,0.4.218,0,613,1,98,218,316,218,0,316,316,-218,218,432,5,1,98,395,144,395,13,1267,856
1538,12,1.1.92,1,610,0,79,92,171,40,52,171,218,0,15,214,2,3,214,217,239,294,13,1267,856
1538,12,2.4.215,0,610,0,63,215,278,215,0,278,278,-215,215,429,5,1,63,395,278,395,13,1267,856
1538,12,3.1.115,0,610,0,17,115,132,115,0,132,218,-23,38,237,2,3,146,217,172,294,13,1267,856
1538,12,4.1.92,0,610,0,58,92,150,89,3,150,218,0,15,214,2,3,166,217,201,294,13,1267,856
1538,12,5.1.179,0,610,0,63,179,242,179,0,242,242,-87,102,301,2,3,169,217,233,294,13,1267,856
1538,13,0.4.218,0,613,1,98,218,316,218,0,316,316,-218,218,432,5,1,98,395,144,395,14,1267,777
1538,13,1.2.171,1,610,0,20,171,191,171,0,191,218,-35,109,249,3,3,135,152,239,214,14,1267,777
1538,13,2.4.215,0,610,0,63,215,278,215,0,278,278,-215,215,429,5,1,63,395,278,395,14,1267,777
1538,13,3.1.171,0,610,0,17,171,188,115,56,188,218,0,15,214,2,4,146,138,172,294,14,1267,777
1538,13,4.1.171,0,610,0,58,171,229,89,82,229,229,0,15,214,2,4,166,138,201,294,14,1267,777
1538,13,5.1.179,0,610,0,63,179,242,179,0,242,242,-8,23,222,2,4,169,138,233,294,14,1267,777
1538,14,0.4.218,0,613,1,98,218,316,218,0,316,316,-218,218,467,5,1,98,395,144,395,15,1267,757
1538,14,1.3.218,1,610,0,36,218,254,191,27,254,254,0,125,249,4,3,115,92,239,185,15,1267,757
1538,14,2.4.215,0,610,0,63,215,278,215,0,278,278,-215,215,464,5,1,63,395,278,395,15,1267,757
1538,14,3.1.171,0,610,0,17,171,188,115,56,188,218,0,15,249,2,4,146,138,172,294,15,1267,757
1538,14,4.1.171,0,610,0,58,171,229,89,82,229,229,0,15,249,2,4,166,138,201,294,15,1267,757
1538,14,5.1.179,0,610,0,63,179,242,179,0,242,242,-8,23,257,2,4,169,138,233,294,15,1267,757
1538,15,0.4.218,0,613,1,98,218,316,218,0,316,316,-218,218,467,5,1,98,395,144,395,16,1267,721
1538,15,1.4.254,0,649,2,79,254,333,254,0,333,333,-254,254,503,5,1,79,395,239,395,16,1267,721
1538,15,2.4.215,0,610,0,63,215,278,215,0,278,278,-215,215,464,5,1,63,395,278,395,16,1267,721
1538,15,3.1.171,1,610,0,17,171,188,115,56,188,254,0,15,249,2,4,146,138,172,294,16,1267,721
1538,15,4.1.171,0,610,0,58,171,229,89,82,229,254,0,15,249,2,4,166,138,201,294,16,1267,721
1538,15,5.1.179,0,610,0,63,179,242,179,0,242,254,-8,23,257,2,4,169,138,233,294,16,1267,721
1538,16,0.4.218,0,613,1,98,218,316,218,0,316,316,-218,218,467,5,1,98,395,144,395,17,1267,704
1538,16,1.4.254,0,649,2,79,254,333,254,0,333,333,-254,254,503,5,1,79,395,239,395,17,1267,704
1538,16,2.4.215,0,610,0,63,215,278,215,0,278,278,-215,215,464,5,1,63,395,278,395,17,1267,704
1538,16,3.2.191,0,610,0,70,191,261,188,3,261,261,0,109,249,3,4,129,132,172,214,17,1267,704
1538,16,4.1.188,1,610,0,58,188,246,89,99,246,254,0,15,249,2,5,166,121,201,294,17,1267,704
1538,16,5.1.188,0,610,0,63,188,251,179,9,251,254,0,15,249,2,5,169,121,233,294,17,1267,704
1538,17,0.4.218,0,613,1,98,218,316,218,0,316,316,-218,218,467,5,1,98,395,144,395,18,1267,646
1538,17,1.4.254,0,649,2,79,254,333,254,0,333,333,-254,254,503,5,1,79,395,239,395,18,1267,646
1538,17,2.4.215,0,610,0,63,215,278,215,0,278,278,-215,215,464,5,1,63,395,278,395,18,1267,646
1538,17,3.2.191,0,610,0,70,191,261,188,3,261,261,0,109,249,3,4,129,132,172,214,18,1267,646
1538,17,4.2.246,0,610,0,31,246,277,246,0,277,277,-55,164,304,3,4,108,132,201,214,18,1267,646
1538,17,5.1.246,1,610,0,63,246,309,179,67,309,309,0,15,249,2,6,169,63,233,294,18,1267,646
1538,18,0.4.218,0,613,1,98,218,316,218,0,316,316,-218,218,467,5,1,98,395,144,395,19,1267,583
1538,18,1.4.254,0,649,2,79,254,333,254,0,333,333,-254,254,503,5,1,79,395,239,395,19,1267,583
1538,18,2.4.215,0,610,0,63,215,278,215,0,278,309,-215,215,464,5,1,63,395,278,395,19,1267,583
1538,18,3.2.191,0,610,0,70,191,261,188,3,261,309,0,109,249,3,4,129,132,172,214,19,1267,583
1538,18,4.2.246,1,610,0,31,246,277,246,0,277,309,-55,164,304,3,4,108,132,201,214,19,1267,583
1538,18,5.2.309,0,610,0,31,309,340,309,0,340,340,-118,227,367,3,4,106,132,233,214,19,1267,583
1538,19,0.4.218,0,613,1,98,218,316,218,0,316,316,-218,218,522,5,1,98,395,144,395,20,1267,552
1538,19,1.4.254,0,649,2,79,254,333,254,0,333,333,-254,254,558,5,1,79,395,239,395,20,1267,552
1538,19,2.4.215,0,610,0,63,215,278,215,0,278,309,-215,215,519,5,1,63,395,278,395,20,1267,552
1538,19,3.2.277,0,610,0,70,277,347,188,89,347,347,0,164,304,3,5,129,101,172,214,20,1267,552
1538,19,4.3.277,1,610,0,5,277,282,277,0,282,309,-23,148,327,4,4,77,56,201,185,20,1267,552
1538,19,5.2.309,0,610,0,31,309,340,309,0,340,340,-32,196,336,3,5,106,101,233,214,20,1267,552
1538,20,0.4.218,0,613,1,98,218,316,218,0,316,316,-218,218,545,5,1,98,395,144,395,21,1267,547
1538,20,1.4.254,0,649,3,79,254,333,254,0,333,333,-254,254,581,5,1,79,395,239,395,21,1267,547
1538,20,2.4.215,0,610,0,63,215,278,215,0,278,309,-215,215,542,5,1,63,395,278,395,21,1267,547
1538,20,3.2.277,1,610,0,70,277,347,188,89,347,347,0,164,327,3,5,129,101,172,214,21,1267,547
1538,20,4.4.282,0,614,2,72,282,354,282,0,354,354,-282,282,609,5,1,72,395,201,395,21,1267,547
1538,20,5.2.309,0,610,0,31,309,340,309,0,340,340,-32,196,359,3,5,106,101,233,214,21,1267,547
1538,21,0.4.218,0,613,1,98,218,316,218,0,316,347,-218,218,545,5,1,98,395,144,395,22,1267,477
1538,21,1.4.254,0,649,3,79,254,333,254,0,333,347,-254,254,581,5,1,79,395,239,395,22,1267,477
1538,21,2.4.215,0,610,0,63,215,278,215,0,278,347,-215,215,542,5,1,63,395,278,395,22,1267,477
1538,21,3.3.347,1,610,0,39,347,386,347,0,386,386,-65,213,392,4,5,59,51,172,185,22,1267,477
1538,21,4.4.282,0,614,2,72,282,354,282,0,354,354,-282,282,609,5,1,72,395,201,395,22,1267,477
1538,21,5.2.347,0,610,0,31,347,378,309,38,378,378,0,164,327,3,6,106,31,233,214,22,1267,477
1538,22,0.4.218,0,613,1,98,218,316,218,0,316,386,-218,218,610,5,1,98,395,144,395,23,1267,438
1538,22,1.4.254,0,649,4,79,254,333,254,0,333,386,-254,254,646,5,1,79,395,239,395,23,1267,438
1538,22,2.4.215,0,610,0,63,215,278,215,0,278,386,-215,215,607,5,1,63,395,278,395,23,1267,438
1538,22,3.4.386,0,620,3,20,386,406,386,0,406,406,-386,386,778,5,1,20,395,172,395,23,1267,438
1538,22,4.4.282,0,614,2,72,282,354,282,0,354,386,-282,282,674,5,1,72,395,201,395,23,1267,438
1538,22,5.2.347,1,610,0,31,347,378,309,38,378,386,0,164,392,3,6,106,31,233,214,23,1267,438
1538,23,0.4.218,0,613,1,98,218,316,218,0,316,386,-218,218,610,5,1,98,395,144,395,24,1267,407
1538,23,1.4.254,0,649,4,79,254,333,254,0,333,386,-254,254,646,5,1,79,395,239,395,24,1267,407
1538,23,2.4.215,0,610,0,63,215,278,215,0,278,386,-215,215,607,5,1,63,395,278,395,24,1267,407
1538,23,3.4.386,0,620,3,20,386,406,386,0,406,406,-386,386,778,5,1,20,395,172,395,24,1267,407
1538,23,4.4.282,0,614,2,72,282,354,282,0,354,386,-282,282,674,5,1,72,395,201,395,24,1267,407
1538,23,5.3.386,1,610,0,12,386,398,378,8,398,398,0,213,392,4,6,75,12,233,185,24,1267,407
1538,24,0.4.218,0,613,1,98,218,316,218,0,316,398,-218,218,610,5,1,98,395,144,395,25,1267,395
1538,24,1.4.254,0,649,5,79,254,333,254,0,333,398,-254,254,646,5,1,79,395,239,395,25,1267,395
1538,24,2.4.215,1,610,0,63,215,278,215,0,278,398,-215,215,607,5,1,63,395,278,395,25,1267,395
1538,24,3.4.386,0,620,4,20,386,406,386,0,406,406,-386,386,778,5,1,20,395,172,395,25,1267,395
1538,24,4.4.282,0,614,2,72,282,354,282,0,354,398,-282,282,674,5,1,72,395,201,395,25,1267,395
1538,24,5.4.398,0,616,3,63,398,461,398,0,461,461,-398,398,790,5,1,63,395,233,395,25,1267,395
1538,25,0.4.278,0,610,0,98,278,376,218,60,376,398,0,215,607,5,2,98,332,144,395,26,1267,332
1538,25,1.4.278,1,610,0,79,278,357,254,24,357,398,0,215,607,5,2,79,332,239,395,26,1267,332
1538,25,3.4.386,0,620,2,20,386,406,386,0,406,406,-108,323,715,5,2,20,332,172,395,26,1267,332
1538,25,4.4.282,0,614,1,72,282,354,282,0,354,398,-4,219,611,5,2,72,332,201,395,26,1267,332
1538,25,5.4.398,0,632,3,63,398,461,398,0,461,461,-120,335,727,5,2,63,332,233,395,26,1267,332
1538,26,0.4.357,0,610,0,98,357,455,218,139,455,455,0,215,607,5,3,98,253,144,395,27,1267,253
1538,26,3.4.386,0,639,1,20,386,406,386,0,406,406,-29,244,636,5,3,20,253,172,395,27,1267,253
1538,26,4.4.357,1,610,0,72,357,429,282,75,429,429,0,215,607,5,3,72,253,201,395,27,1267,253
1538,26,5.4.398,0,651,2,63,398,461,398,0,461,461,-41,256,648,5,3,63,253,233,395,27,1267,253
1538,27,0.4.429,0,610,0,98,429,527,218,211,527,527,0,215,607,5,4,98,181,144,395,28,1267,181
1538,27,3.4.429,1,610,0,20,429,449,386,43,449,449,0,215,607,5,4,20,181,172,395,28,1267,181
1538,27,5.4.429,0,610,0,63,429,492,398,31,492,492,0,215,607,5,4,63,181,233,395,28,1267,181
1538,28,0.4.449,1,610,0,98,449,547,218,231,547,547,0,215,607,5,5,98,161,144,395,29,1267,161
1538,28,5.4.449,0,610,0,63,449,512,398,51,512,512,0,215,607,5,5,63,161,233,395,29,1267,161
1538,29,5.4.547,1,610,0,63,547,610,398,149,610,610,0,215,607,5,6,63,63,233,395,30,1267,63
1539,0,0.0.0,0,564,1,27,0,27,0,0,27,27,0,0,0,1,1,186,292,186,292,1,1535,1535
1539,0,1.0.0,1,539,0,1,0,1,0,0,1,1,0,0,0,1,1,238,292,238,292,1,1535,1535
1539,0,2.0.0,0,599,3,60,0,60,0,0,60,60,0,0,0,1,1,206,292,206,292,1,1535,1535
1539,0,3.0.0,0,616,5,79,0,79,0,0,79,79,0,0,0,1,1,330,292,330,292,1,1535,1535
1539,0,4.0.0,0,565,2,56,0,56,0,0,56,56,0,0,0,1,1,239,292,239,292,1,1535,1535
1539,0,5.0.0,0,608,4,69,0,69,0,0,69,69,0,0,0,1,1,336,292,336,292,1,1535,1535
1539,1,0.0.1,0,554,1,27,1,28,0,1,28,28,0,0,0,1,2,186,291,186,292,2,1535,1534
1539,1,1.1.1,1,539,0,47,1,48,1,0,48,48,-1,1,1,2,1,237,298,238,298,2,1535,1534
1539,1,2.0.1,0,569,4,60,1,61,0,1,61,61,0,0,0,1,2,206,291,206,292,2,1535,1534
1539,1,3.0.1,0,560,3,79,1,80,0,1,80,80,0,0,0,1,2,330,291,330,292,2,1535,1534
1539,1,4.0.1,0,539,0,56,1,57,0,1,57,57,0,0,0,1,2,239,291,239,292,2,1535,1534
1539,1,5.0.1,0,558,2,69,1,70,0,1,70,70,0,0,0,1,2,336,291,336,292,2,1535,1534
1539,2,0.0.1,0,554,1,27,1,28,0,1,28,48,0,0,1,1,2,186,291,186,292,3,1535,1487
1539,2,1.2.48,1,539,0,25,48,73,48,0,73,73,-48,48,49,3,1,190,183,238,183,3,1535,1487
1539,2,2.0.1,0,569,4,60,1,61,0,1,61,61,0,0,1,1,2,206,291,206,292,3,1535,1487
1539,2,3.0.1,0,560,3,79,1,80,0,1,80,80,0,0,1,1,2,330,291,330,292,3,1535,1487
1539,2,4.0.1,0,539,0,56,1,57,0,1,57,57,0,0,1,1,2,239,291,239,292,3,1535,1487
1539,2,5.0.1,0,558,2,69,1,70,0,1,70,70,0,0,1,1,2,336,291,336,292,3,1535,1487
1539,3,0.0.1,0,554,1,27,1,28,0,1,28,73,0,0,49,1,2,186,291,186,292,4,1535,1462
1539,3,1.3.73,0,539,0,77,73,150,73,0,150,150,-73,73,122,4,1,165,435,238,435,4,1535,1462
1539,3,2.0.1,0,569,4,60,1,61,0,1,61,73,0,0,49,1,2,206,291,206,292,4,1535,1462
1539,3,3.0.1,0,560,3,79,1,80,0,1,80,80,0,0,49,1,2,330,291,330,292,4,1535,1462
1539,3,4.0.1,0,539,0,56,1,57,0,1,57,73,0,0,49,1,2,239,291,239,292,4,1535,1462
1539,3,5.0.1,1,558,2,69,1,70,0,1,70,73,0,0,49,1,2,336,291,336,292,4,1535,1462
1539,4,0.0.70,0,573,1,27,70,97,0,70,97,97,0,0,49,1,3,186,222,186,292,5,1535,1393
1539,4,1.3.73,0,558,0,77,73,150,73,0,150,150,-73,73,122,4,1,165,435,238,435,5,1535,1393
1539,4,2.0.70,0,575,2,60,70,130,0,70,130,130,0,0,49,1,3,206,222,206,292,5,1535,1393
1539,4,3.0.70,0,573,1,79,70,149,0,70,149,149,0,0,49,1,3,330,222,330,292,5,1535,1393
1539,4,4.0.70,0,558,0,56,70,126,0,70,126,126,0,0,49,1,3,239,222,239,292,5,1535,1393
1539,4,5.1.70,1,558,0,47,70,117,70,0,117,117,-22,23,71,2,2,267,251,336,298,5,1535,1393
1539,5,0.0.70,0,573,1,27,70,97,0,70,97,117,0,0,71,1,3,186,222,186,292,6,1535,1346
1539,5,1.3.73,0,558,0,77,73,150,73,0,150,150,-73,73,144,4,1,165,435,238,435,6,1535,1346
1539,5,2.0.70,0,575,2,60,70,130,0,70,130,130,0,0,71,1,3,206,222,206,292,6,1535,1346
1539,5,3.0.70,0,573,1,79,70,149,0,70,149,149,0,0,71,1,3,330,222,330,292,6,1535,1346
1539,5,4.0.70,0,558,0,56,70,126,0,70,126,126,0,0,71,1,3,239,222,239,292,6,1535,1346
1539,5,5.2.117,1,573,1,69,117,186,117,0,186,186,-44,92,115,3,2,220,158,336,183,6,1535,1346
1539,6,0.0.70,0,573,0,27,70,97,0,70,97,186,0,0,115,1,3,186,222,186,292,7,1535,1277
1539,6,1.3.73,0,573,0,77,73,150,73,0,150,186,-73,73,188,4,1,165,435,238,435,7,1535,1277
1539,6,2.0.70,0,575,1,60,70,130,0,70,130,186,0,0,115,1,3,206,222,206,292,7,1535,1277
1539,6,3.0.70,1,573,0,79,70,149,0,70,149,186,0,0,115,1,3,330,222,330,292,7,1535,1277
1539,6,4.0.70,0,575,1,56,70,126,0,70,126,186,0,0,115,1,3,239,222,239,292,7,1535,1277
1539,6,5.3.186,0,573,0,96,186,282,186,0,282,282,-186,186,301,4,1,151,435,336,435,7,1535,1277
1539,7,0.0.149,1,573,0,27,149,176,0,149,176,186,0,0,115,1,4,186,143,186,292,8,1535,1198
1539,7,1.3.73,0,573,0,77,73,150,73,0,150,186,-73,73,188,4,1,165,435,238,435,8,1535,1198
1539,7,2.0.149,0,573,0,60,149,209,0,149,209,209,0,0,115,1,4,206,143,206,292,8,1535,1198
1539,7,3.1.149,0,573,0,55,149,204,149,0,204,204,-32,55,147,2,3,251,204,330,298,8,1535,1198
1539,7,4.0.149,0,573,0,56,149,205,0,149,205,205,0,0,115,1,4,239,143,239,292,8,1535,1198
1539,7,5.3.186,0,573,0,96,186,282,186,0,282,282,-186,186,301,4,1,151,435,336,435,8,1535,1198
1539,8,0.1.176,0,591,1,85,176,261,176,0,261,261,-59,82,174,2,3,159,204,186,298,9,1535,1171
1539,8,1.3.73,0,573,0,77,73,150,73,0,150,186,-73,73,188,4,1,165,435,238,435,9,1535,1171
1539,8,2.0.176,0,573,0,60,176,236,0,176,236,236,0,0,115,1,5,206,116,206,292,9,1535,1171
1539,8,3.1.149,0,573,0,55,149,204,149,0,204,204,-32,55,147,2,3,251,204,330,298,9,1535,1171
1539,8,4.0.176,1,573,0,56,176,232,0,176,232,232,0,0,115,1,5,239,116,239,292,9,1535,1171
1539,8,5.3.186,0,573,0,96,186,282,186,0,282,282,-186,186,301,4,1,151,435,336,435,9,1535,1171
1539,9,0.1.176,0,591,1,85,176,261,176,0,261,261,-59,82,174,2,3,159,204,186,298,10,1535,1115
1539,9,1.3.73,0,573,0,77,73,150,73,0,150,232,-73,73,188,4,1,165,435,238,435,10,1535,1115
1539,9,2.0.232,1,573,0,60,232,292,0,232,292,292,0,0,115,1,6,206,60,206,292,10,1535,1115
1539,9,3.1.149,0,573,0,55,149,204,149,0,204,232,-32,55,147,2,3,251,204,330,298,10,1535,1115
1539,9,4.1.232,0,573,0,11,232,243,232,0,243,243,-115,138,230,2,3,183,204,239,298,10,1535,1115
1539,9,5.3.186,0,573,0,96,186,282,186,0,282,282,-186,186,301,4,1,151,435,336,435,10,1535,1115
1539,10,0.1.176,0,591,1,85,176,261,176,0,261,292,-59,82,174,2,3,159,204,186,298,11,1535,1055
1539,10,1.3.73,0,573,0,77,73,150,73,0,150,292,-73,73,188,4,1,165,435,238,435,11,1535,1055
1539,10,2.1.292,0,573,0,53,292,345,292,0,345,345,-175,198,290,2,3,146,204,206,298,11,1535,1055
1539,10,3.1.149,1,573,0,55,149,204,149,0,204,292,-32,55,147,2,3,251,204,330,298,11,1535,1055
1539,10,4.1.232,0,573,0,11,232,243,232,0,243,292,-115,138,230,2,3,183,204,239,298,11,1535,1055
1539,10,5.3.186,0,573,0,96,186,282,186,0,282,292,-186,186,301,4,1,151,435,336,435,11,1535,1055
1539,11,0.1.204,0,573,0,85,204,289,176,28,289,292,0,55,147,2,4,159,149,186,298,12,1535,1000
1539,11,1.3.73,0,573,0,77,73,150,73,0,150,292,-73,73,220,4,1,165,435,238,435,12,1535,1000
1539,11,2.1.292,0,573,0,53,292,345,292,0,345,345,-88,143,235,2,4,146,149,206,298,12,1535,1000
1539,11,3.2.204,1,573,0,38,204,242,204,0,242,292,-18,110,165,3,3,196,89,330,183,12,1535,1000
1539,11,4.1.232,0,573,0,11,232,243,232,0,243,292,-28,83,175,2,4,183,149,239,298,12,1535,1000
1539,11,5.3.186,0,573,0,96,186,282,186,0,282,292,-186,186,333,4,1,151,435,336,435,12,1535,1000
1539,12,0.1.204,0,573,0,85,204,289,176,28,289,292,0,55,165,2,4,159,149,186,298,13,1535,962
1539,12,1.3.73,0,573,0,77,73,150,73,0,150,292,-73,73,238,4,1,165,435,238,435,13,1535,962
1539,12,2.1.292,0,573,0,53,292,345,292,0,345,345,-88,143,253,2,4,146,149,206,298,13,1535,962
1539,12,3.3.242,0,629,1,97,242,339,242,0,339,339,-242,242,407,4,1,158,435,330,435,13,1535,962
1539,12,4.1.232,1,573,0,11,232,243,232,0,243,292,-28,83,193,2,4,183,149,239,298,13,1535,962
1539,12,5.3.186,0,573,0,96,186,282,186,0,282,292,-186,186,351,4,1,151,435,336,435,13,1535,962
1539,13,0.1.243,0,573,0,85,243,328,176,67,328,328,0,83,193,2,5,159,138,186,298,14,1535,951
1539,13,1.3.73,0,573,0,77,73,150,73,0,150,292,-73,73,266,4,1,165,435,238,435,14,1535,951
1539,13,2.1.292,0,593,1,53,292,345,292,0,345,345,-49,132,242,2,5,146,138,206,298,14,1535,951
1539,13,3.3.242,0,629,2,97,242,339,242,0,339,339,-242,242,435,4,1,158,435,330,435,14,1535,951
1539,13,4.2.243,1,573,0,32,243,275,243,0,275,292,-1,111,194,3,4,172,51,239,183,14,1535,951
1539,13,5.3.186,0,573,0,96,186,282,186,0,282,292,-186,186,379,4,1,151,435,336,435,14,1535,951
1539,14,0.1.243,1,573,0,85,243,328,176,67,328,328,0,83,194,2,5,159,138,186,298,15,1535,919
1539,14,1.3.73,0,573,0,77,73,150,73,0,150,292,-73,73,267,4,1,165,435,238,435,15,1535,919
1539,14,2.1.292,0,593,1,53,292,345,292,0,345,345,-49,132,243,2,5,146,138,206,298,15,1535,919
1539,14,3.3.242,0,629,2,97,242,339,242,0,339,339,-242,242,436,4,1,158,435,330,435,15,1535,919
1539,14,4.3.275,0,662,3,97,275,372,275,0,372,372,-275,275,469,4,1,140,435,239,435,15,1535,919
1539,14,5.3.186,0,573,0,96,186,282,186,0,282,292,-186,186,380,4,1,151,435,336,435,15,1535,919
1539,15,0.2.328,1,573,0,14,328,342,328,0,342,342,-53,164,247,3,5,74,19,186,183,16,1535,834
1539,15,1.3.73,0,573,0,77,73,150,73,0,150,328,-73,73,267,4,1,165,435,238,435,16,1535,834
1539,15,2.1.328,0,573,0,53,328,381,292,36,381,381,0,83,194,2,6,146,53,206,298,16,1535,834
1539,15,3.3.242,0,629,1,97,242,339,242,0,339,339,-242,242,436,4,1,158,435,330,435,16,1535,834
1539,15,4.3.275,0,662,2,97,275,372,275,0,372,372,-275,275,469,4,1,140,435,239,435,16,1535,834
1539,15,5.3.186,0,573,0,96,186,282,186,0,282,328,-186,186,380,4,1,151,435,336,435,16,1535,834
1539,16,0.3.342,0,632,2,9,342,351,342,0,351,351,-342,342,589,4,1,60,435,186,435,17,1535,820
1539,16,1.3.73,0,573,0,77,73,150,73,0,150,342,-73,73,320,4,1,165,435,238,435,17,1535,820
1539,16,2.1.328,1,573,0,53,328,381,292,36,381,381,0,83,247,2,6,146,53,206,298,17,1535,820
1539,16,3.3.242,0,629,1,97,242,339,242,0,339,342,-242,242,489,4,1,158,435,330,435,17,1535,820
1539,16,4.3.275,0,662,3,97,275,372,275,0,372,372,-275,275,522,4,1,140,435,239,435,17,1535,820
1539,16,5.3.186,0,573,0,96,186,282,186,0,282,342,-186,186,433,4,1,151,435,336,435,17,1535,820
1539,17,0.3.342,0,632,2,9,342,351,342,0,351,381,-342,342,589,4,1,60,435,186,435,18,1535,767
1539,17,1.3.73,0,573,0,77,73,150,73,0,150,381,-73,73,320,4,1,165,435,238,435,18,1535,767
1539,17,2.2.381,1,573,0,5,381,386,381,0,386,386,-39,203,286,3,6,93,5,206,183,18,1535,767
1539,17,3.3.242,0,629,1,97,242,339,242,0,339,381,-242,242,489,4,1,158,435,330,435,18,1535,767
1539,17,4.3.275,0,662,3,97,275,372,275,0,372,381,-275,275,522,4,1,140,435,239,435,18,1535,767
1539,17,5.3.186,0,573,0,96,186,282,186,0,282,381,-186,186,433,4,1,151,435,336,435,18,1535,767
1539,18,0.3.342,0,632,3,9,342,351,342,0,351,386,-342,342,628,4,1,60,435,186,435,19,1535,762
1539,18,1.3.73,1,573,0,77,73,150,73,0,150,386,-73,73,359,4,1,165,435,238,435,19,1535,762
1539,18,2.3.386,0,594,1,59,386,445,386,0,445,445,-386,386,672,4,1,88,435,206,435,19,1535,762
1539,18,3.3.242,0,629,2,97,242,339,242,0,339,386,-242,242,528,4,1,158,435,330,435,19,1535,762
1539,18,4.3.275,0,662,4,97,275,372,275,0,372,386,-275,275,561,4,1,140,435,239,435,19,1535,762
1539,18,5.3.186,0,573,0,96,186,282,186,0,282,386,-186,186,472,4,1,151,435,336,435,19,1535,762
1539,19,0.3.342,0,632,3,9,342,351,342,0,351,386,-192,265,551,4,2,60,358,186,435,20,1535,685
1539,19,1.4.150,1,573,0,88,150,238,150,0,238,386,-150,150,509,5,1,88,327,238,327,20,1535,685
1539,19,2.3.386,0,594,1,59,386,445,386,0,445,445,-236,309,595,4,2,88,358,206,435,20,1535,685
1539,19,3.3.242,0,629,2,97,242,339,242,0,339,386,-92,165,451,4,2,158,358,330,435,20,1535,685
1539,19,4.3.275,0,662,4,97,275,372,275,0,372,386,-125,198,484,4,2,140,358,239,435,20,1535,685
1539,19,5.3.186,0,573,0,96,186,282,186,0,282,386,-36,109,395,4,2,151,358,336,435,20,1535,685
1539,20,0.3.342,0,632,3,9,342,351,342,0,351,386,-192,265,701,4,2,60,358,186,435,21,1535,597
1539,20,2.3.386,0,594,1,59,386,445,386,0,445,445,-236,309,745,4,2,88,358,206,435,21,1535,597
1539,20,3.3.242,0,629,2,97,242,339,242,0,339,386,-92,165,601,4,2,158,358,330,435,21,1535,597
1539,20,4.3.275,0,662,4,97,275,372,275,0,372,386,-125,198,634,4,2,140,358,239,435,21,1535,597
1539,20,5.3.186,1,573,0,96,186,282,186,0,282,386,-36,109,545,4,2,151,358,336,435,21,1535,597
1539,21,0.3.342,0,633,3,9,342,351,342,0,351,386,-60,169,605,4,3,60,262,186,435,22,1535,501
1539,21,2.3.386,0,594,2,59,386,445,386,0,445,445,-104,213,649,4,3,88,262,206,435,22,1535,501
1539,21,3.3.282,0,573,0,97,282,379,242,40,379,386,0,109,545,4,3,158,262,330,435,22,1535,501
1539,21,4.3.282,0,575,1,97,282,379,275,7,379,386,0,109,545,4,3,140,262,239,435,22,1535,501
1539,21,5.4.282,1,573,0,55,282,337,282,0,337,386,-44,194,589,5,2,55,239,336,327,22,1535,501
1539,22,0.3.342,0,633,3,9,342,351,342,0,351,386,-60,169,649,4,3,60,262,186,435,23,1535,446
1539,22,2.3.386,0,594,2,59,386,445,386,0,445,445,-104,213,693,4,3,88,262,206,435,23,1535,446
1539,22,3.3.282,1,573,0,97,282,379,242,40,379,386,0,109,589,4,3,158,262,330,435,23,1535,446
1539,22,4.3.282,0,575,1,97,282,379,275,7,379,386,0,109,589,4,3,140,262,239,435,23,1535,446
1539,23,0.3.379,0,573,0,9,379,388,342,37,388,388,0,109,589,4,4,60,165,186,435,24,1535,349
1539,23,2.3.386,0,594,1,59,386,445,386,0,445,445,-7,116,596,4,4,88,165,206,435,24,1535,349
1539,23,3.4.379,1,573,0,61,379,440,379,0,440,440,-42,236,631,5,3,61,184,330,327,24,1535,349
1539,23,4.3.379,0,599,2,97,379,476,275,104,476,476,0,109,589,4,4,140,165,239,435,24,1535,349
1539,24,0.3.379,1,573,0,9,379,388,342,37,388,440,0,109,631,4,4,60,165,186,435,25,1535,288
1539,24,2.3.386,0,594,1,59,386,445,386,0,445,445,-7,116,638,4,4,88,165,206,435,25,1535,288
1539,24,4.3.379,0,599,2,97,379,476,275,104,476,476,0,109,631,4,4,140,165,239,435,25,1535,288
1539,25,0.4.440,1,573,0,51,440,491,388,52,491,491,0,236,631,5,4,51,123,186,327,26,1535,279
1539,25,2.3.388,0,587,1,59,388,447,386,2,447,447,0,109,631,4,5,88,156,206,435,26,1535,279
1539,25,4.3.388,0,573,0,97,388,485,275,113,485,485,0,109,631,4,5,140,156,239,435,26,1535,279
1539,26,2.3.388,0,587,1,59,388,447,386,2,447,491,0,109,631,4,5,88,156,206,435,27,1535,228
1539,26,4.3.388,1,573,0,97,388,485,275,113,485,491,0,109,631,4,5,140,156,239,435,27,1535,228
1539,27,2.3.485,0,573,0,59,485,544,386,99,544,544,0,109,631,4,6,88,59,206,435,28,1535,131
1539,27,4.4.491,1,573,0,43,491,534,485,6,534,534,0,236,631,5,5,43,72,239,327,28,1535,131
1539,28,2.3.485,1,573,0,59,485,544,386,99,544,544,0,109,631,4,6,88,59,206,435,29,1535,88
1539,29,2.4.544,1,573,0,29,544,573,544,0,573,573,-10,246,641,5,6,29,29,206,327,30,1535,29
1540,0,0.0.0,0,484,4,40,0,40,0,0,40,40,0,0,0,1,1,132,307,132,307,1,1306,1306
1540,0,1.0.0,0,483,3,76,0,76,0,0,76,76,0,0,0,1,1,238,307,238,307,1,1306,1306
1540,0,2.0.0,1,449,0,6,0,6,0,0,6,6,0,0,0,1,1,231,307,231,307,1,1306,1306
1540,0,3.0.0,0,472,2,33,0,33,0,0,33,33,0,0,0,1,1,190,307,190,307,1,1306,1306
1540,0,4.0.0,0,490,5,78,0,78,0,0,78,78,0,0,0,1,1,276,307,276,307,1,1306,1306
1540,0,5.0.0,0,466,1,74,0,74,0,0,74,74,0,0,0,1,1,239,307,239,307,1,1306,1306
1540,1,0.0.6,0,474,4,40,6,46,0,6,46,46,0,0,0,1,2,132,301,132,307,2,1306,1300
1540,1,1.0.6,0,472,3,76,6,82,0,6,82,82,0,0,0,1,2,238,301,238,307,2,1306,1300
1540,1,2.1.6,1,449,0,46,6,52,6,0,52,52,-6,6,6,2,1,225,301,231,301,2,1306,1300
1540,1,3.0.6,0,449,0,33,6,39,0,6,39,39,0,0,0,1,2,190,301,190,307,2,1306,1300
1540,1,4.0.6,0,452,1,78,6,84,0,6,84,84,0,0,0,1,2,276,301,276,307,2,1306,1300
1540,1,5.0.6,0,457,2,74,6,80,0,6,80,80,0,0,0,1,2,239,301,239,307,2,1306,1300
1540,2,0.0.6,0,474,4,40,6,46,0,6,46,52,0,0,6,1,2,132,301,132,307,3,1306,1254
1540,2,1.0.6,0,472,3,76,6,82,0,6,82,82,0,0,6,1,2,238,301,238,307,3,1306,1254
1540,2,2.2.52,1,449,0,57,52,109,52,0,109,109,-52,52,58,3,1,179,151,231,151,3,1306,1254
1540,2,3.0.6,0,449,0,33,6,39,0,6,39,52,0,0,6,1,2,190,301,190,307,3,1306,1254
1540,2,4.0.6,0,452,1,78,6,84,0,6,84,84,0,0,6,1,2,276,301,276,307,3,1306,1254
1540,2,5.0.6,0,457,2,74,6,80,0,6,80,80,0,0,6,1,2,239,301,239,307,3,1306,1254
1540,3,0.0.6,0,474,4,40,6,46,0,6,46,109,0,0,58,1,2,132,301,132,307,4,1306,1197
1540,3,1.0.6,0,472,3,76,6,82,0,6,82,109,0,0,58,1,2,238,301,238,307,4,1306,1197
1540,3,2.3.109,1,449,0,28,109,137,109,0,137,137,-109,109,167,4,1,122,290,231,290,4,1306,1197
1540,3,3.0.6,0,449,0,33,6,39,0,6,39,109,0,0,58,1,2,190,301,190,307,4,1306,1197
1540,3,4.0.6,0,452,1,78,6,84,0,6,84,109,0,0,58,1,2,276,301,276,307,4,1306,1197
1540,3,5.0.6,0,457,2,74,6,80,0,6,80,109,0,0,58,1,2,239,301,239,307,4,1306,1197
1540,4,0.0.6,0,474,4,40,6,46,0,6,46,137,0,0,167,1,2,132,301,132,307,5,1306,1169
1540,4,1.0.6,0,472,3,76,6,82,0,6,82,137,0,0,167,1,2,238,301,238,307,5,1306,1169
1540,4,2.4.137,1,449,0,94,137,231,137,0,231,231,-137,137,304,5,1,94,257,231,257,5,1306,1169
1540,4,3.0.6,0,449,0,33,6,39,0,6,39,137,0,0,167,1,2,190,301,190,307,5,1306,1169
1540,4,4.0.6,0,452,1,78,6,84,0,6,84,137,0,0,167,1,2,276,301,276,307,5,1306,1169
1540,4,5.0.6,0,457,2,74,6,80,0,6,80,137,0,0,167,1,2,239,301,239,307,5,1306,1169
1540,5,0.0.6,0,474,4,40,6,46,0,6,46,231,0,0,304,1,2,132,301,132,307,6,1306,1075
1540,5,1.0.6,0,472,3,76,6,82,0,6,82,231,0,0,304,1,2,238,301,238,307,6,1306,1075
1540,5,3.0.6,1,449,0,33,6,39,0,6,39,231,0,0,304,1,2,190,301,190,307,6,1306,1075
1540,5,4.0.6,0,452,1,78,6,84,0,6,84,231,0,0,304,1,2,276,301,276,307,6,1306,1075
1540,5,5.0.6,0,457,2,74,6,80,0,6,80,231,0,0,304,1,2,239,301,239,307,6,1306,1075
1540,6,0.0.39,0,485,2,40,39,79,0,39,79,231,0,0,304,1,3,132,268,132,307,7,1306,1042
1540,6,1.0.39,0,472,1,76,39,115,0,39,115,231,0,0,304,1,3,238,268,238,307,7,1306,1042
1540,6,3.1.52,1,449,0,93,52,145,39,13,145,231,0,6,304,2,2,157,255,190,301,7,1306,1042
1540,6,4.0.39,0,472,1,78,39,117,0,39,117,231,0,0,304,1,3,276,268,276,307,7,1306,1042
1540,6,5.0.39,0,449,0,74,39,113,0,39,113,231,0,0,304,1,3,239,268,239,307,7,1306,1042
1540,7,0.0.39,0,485,2,40,39,79,0,39,79,231,0,0,304,1,3,132,268,132,307,8,1306,949
1540,7,1.0.39,0,472,1,76,39,115,0,39,115,231,0,0,304,1,3,238,268,238,307,8,1306,949
1540,7,3.2.145,1,449,0,5,145,150,145,0,150,231,-36,88,340,3,2,64,94,190,151,8,1306,949
1540,7,4.0.39,0,472,1,78,39,117,0,39,117,231,0,0,304,1,3,276,268,276,307,8,1306,949
1540,7,5.0.39,0,449,0,74,39,113,0,39,113,231,0,0,304,1,3,239,268,239,307,8,1306,949
1540,8,0.0.39,0,485,2,40,39,79,0,39,79,231,0,0,340,1,3,132,268,132,307,9,1306,944
1540,8,1.0.39,0,472,1,76,39,115,0,39,115,231,0,0,340,1,3,238,268,238,307,9,1306,944
1540,8,3.3.150,1,449,0,56,150,206,150,0,206,231,-13,122,353,4,2,59,262,190,290,9,1306,944
1540,8,4.0.39,0,472,1,78,39,117,0,39,117,231,0,0,340,1,3,276,268,276,307,9,1306,944
1540,8,5.0.39,0,449,0,74,39,113,0,39,113,231,0,0,340,1,3,239,268,239,307,9,1306,944
1540,9,0.0.39,0,485,2,40,39,79,0,39,79,231,0,0,353,1,3,132,268,132,307,10,1306,888
1540,9,1.0.39,0,472,1,76,39,115,0,39,115,231,0,0,353,1,3,238,268,238,307,10,1306,888
1540,9,3.4.231,1,449,0,3,231,234,206,25,234,234,0,137,353,5,2,3,163,190,257,10,1306,888
1540,9,4.0.39,0,472,1,78,39,117,0,39,117,231,0,0,353,1,3,276,268,276,307,10,1306,888
1540,9,5.0.39,0,449,0,74,39,113,0,39,113,231,0,0,353,1,3,239,268,239,307,10,1306,888
1540,10,0.0.39,0,485,2,40,39,79,0,39,79,234,0,0,353,1,3,132,268,132,307,11,1306,885
1540,10,1.0.39,0,472,1,76,39,115,0,39,115,234,0,0,353,1,3,238,268,238,307,11,1306,885
1540,10,4.0.39,1,472,1,78,39,117,0,39,117,234,0,0,353,1,3,276,268,276,307,11,1306,885
1540,10,5.0.39,0,449,0,74,39,113,0,39,113,234,0,0,353,1,3,239,268,239,307,11,1306,885
1540,11,0.0.117,0,496,2,40,117,157,0,117,157,234,0,0,353,1,4,132,190,132,307,12,1306,807
1540,11,1.0.117,0,496,2,76,117,193,0,117,193,234,0,0,353,1,4,238,190,238,307,12,1306,807
1540,11,4.1.145,1,486,1,62,145,207,117,28,207,234,0,6,353,2,3,198,162,276,301,12,1306,807
1540,11,5.0.117,0,472,0,74,117,191,0,117,191,234,0,0,353,1,4,239,190,239,307,12,1306,807
1540,12,0.0.117,0,496,2,40,117,157,0,117,157,234,0,0,353,1,4,132,190,132,307,13,1306,745
1540,12,1.0.117,0,496,2,76,117,193,0,117,193,234,0,0,353,1,4,238,190,238,307,13,1306,745
1540,12,4.2.207,1,489,1,33,207,240,207,0,240,240,-57,145,410,3,3,136,89,276,151,13,1306,745
1540,12,5.0.117,0,486,0,74,117,191,0,117,191,234,0,0,353,1,4,239,190,239,307,13,1306,745
1540,13,0.0.117,0,496,1,40,117,157,0,117,157,240,0,0,410,1,4,132,190,132,307,14,1306,712
1540,13,1.0.117,0,496,1,76,117,193,0,117,193,240,0,0,410,1,4,238,190,238,307,14,1306,712
1540,13,4.3.240,1,496,1,90,240,330,240,0,330,330,-34,156,444,4,3,103,206,276,290,14,1306,712
1540,13,5.0.117,0,489,0,74,117,191,0,117,191,240,0,0,410,1,4,239,190,239,307,14,1306,712
1540,14,0.0.117,0,496,0,40,117,157,0,117,157,330,0,0,444,1,4,132,190,132,307,15,1306,622
1540,14,1.0.117,0,496,0,76,117,193,0,117,193,330,0,0,444,1,4,238,190,238,307,15,1306,622
1540,14,4.4.330,1,496,0,13,330,343,330,0,343,343,-96,233,540,5,3,13,160,276,257,15,1306,622
1540,14,5.0.117,0,496,0,74,117,191,0,117,191,330,0,0,444,1,4,239,190,239,307,15,1306,622
1540,15,0.0.117,0,496,0,40,117,157,0,117,157,343,0,0,540,1,4,132,190,132,307,16,1306,609
1540,15,1.0.117,0,496,0,76,117,193,0,117,193,343,0,0,540,1,4,238,190,238,307,16,1306,609
1540,15,5.0.117,1,496,0,74,117,191,0,117,191,343,0,0,540,1,4,239,190,239,307,16,1306,609
1540,16,0.0.191,0,515,1,40,191,231,0,191,231,343,0,0,540,1,5,132,116,132,307,17,1306,535
1540,16,1.0.191,0,496,0,76,191,267,0,191,267,343,0,0,540,1,5,238,116,238,307,17,1306,535
1540,16,5.1.207,1,496,0,30,207,237,191,16,237,343,0,6,540,2,4,165,100,239,301,17,1306,535
1540,17,0.0.191,0,515,1,40,191,231,0,191,231,343,0,0,540,1,5,132,116,132,307,18,1306,505
1540,17,1.0.191,0,496,0,76,191,267,0,191,267,343,0,0,540,1,5,238,116,238,307,18,1306,505
1540,17,5.2.240,1,496,0,8,240,248,237,3,248,343,0,145,540,3,4,135,56,239,151,18,1306,505
1540,18,0.0.191,0,515,1,40,191,231,0,191,231,343,0,0,540,1,5,132,116,132,307,19,1306,497
1540,18,1.0.191,0,496,0,76,191,267,0,191,267,343,0,0,540,1,5,238,116,238,307,19,1306,497
1540,18,5.3.330,1,558,2,81,330,411,248,82,411,411,0,156,540,4,4,127,116,239,290,19,1306,497
1540,19,0.0.191,0,558,0,40,191,231,0,191,231,411,0,0,540,1,5,132,116,132,307,20,1306,416
1540,19,1.0.191,0,558,0,76,191,267,0,191,267,411,0,0,540,1,5,238,116,238,307,20,1306,416
1540,19,5.4.411,1,558,0,46,411,457,411,0,457,457,-68,301,608,5,4,46,147,239,257,20,1306,416
1540,20,0.0.191,0,558,0,40,191,231,0,191,231,457,0,0,608,1,5,132,116,132,307,21,1306,370
1540,20,1.0.191,1,558,0,76,191,267,0,191,267,457,0,0,608,1,5,238,116,238,307,21,1306,370
1540,21,0.0.267,1,558,0,40,267,307,0,267,307,457,0,0,608,1,6,132,40,132,307,22,1306,294
1540,21,1.1.267,0,558,0,16,267,283,267,0,283,457,-30,36,638,2,5,162,70,238,301,22,1306,294
1540,22,0.1.307,0,558,0,54,307,361,307,0,361,457,-70,76,678,2,5,92,70,132,301,23,1306,254
1540,22,1.1.267,1,558,0,16,267,283,267,0,283,457,-30,36,638,2,5,162,70,238,301,23,1306,254
1540,23,0.1.307,0,558,0,54,307,361,307,0,361,457,-24,60,662,2,6,92,54,132,301,24,1306,238
1540,23,1.2.283,1,558,0,30,283,313,283,0,313,457,-35,180,673,3,5,146,48,238,151,24,1306,238
1540,24,0.1.307,0,558,0,54,307,361,307,0,361,457,-24,60,697,2,6,92,54,132,301,25,1306,208
1540,24,1.3.411,1,558,0,19,411,430,313,98,430,457,0,156,673,4,5,116,35,238,290,25,1306,208
1540,25,0.1.307,0,558,0,54,307,361,307,0,361,457,-24,60,697,2,6,92,54,132,301,26,1306,189
1540,25,1.4.457,1,558,0,97,457,554,430,27,554,554,0,301,673,5,5,97,101,238,257,26,1306,189
1540,26,0.1.307,1,558,0,54,307,361,307,0,361,554,-24,60,697,2,6,92,54,132,301,27,1306,92
1540,27,0.2.361,1,558,0,18,361,379,361,0,379,554,-48,228,745,3,6,38,18,132,151,28,1306,38
1540,28,0.3.430,1,558,0,16,430,446,379,51,446,554,0,156,745,4,6,20,16,132,290,29,1306,20
1540,29,0.4.554,1,558,0,4,554,558,446,108,558,558,0,301,745,5,6,4,4,132,257,30,1306,4
1541,0,0.0.0,0,491,2,53,0,53,0,0,53,53,0,0,0,1,1,175,321,175,321,1,1375,1375
1541,0,1.0.0,0,490,1,52,0,52,0,0,52,52,0,0,0,1,1,239,321,239,321,1,1375,1375
1541,0,2.0.0,0,490,1,52,0,52,0,0,52,52,0,0,0,1,1,258,321,258,321,1,1375,1375
1541,0,3.0.0,0,505,3,85,0,85,0,0,85,85,0,0,0,1,1,249,321,249,321,1,1375,1375
1541,0,4.0.0,1,482,0,1,0,1,0,0,1,1,0,0,0,1,1,215,321,215,321,1,1375,1375
1541,0,5.0.0,0,508,4,78,0,78,0,0,78,78,0,0,0,1,1,239,321,239,321,1,1375,1375
1541,1,0.0.1,0,485,1,53,1,54,0,1,54,54,0,0,0,1,2,175,320,175,321,2,1375,1374
1541,1,1.0.1,0,485,1,52,1,53,0,1,53,53,0,0,0,1,2,239,320,239,321,2,1375,1374
1541,1,2.0.1,0,482,0,52,1,53,0,1,53,53,0,0,0,1,2,258,320,258,321,2,1375,1374
1541,1,3.0.1,0,495,2,85,1,86,0,1,86,86,0,0,0,1,2,249,320,249,321,2,1375,1374
1541,1,4.1.1,1,482,0,15,1,16,1,0,16,16,-1,1,1,2,1,214,205,215,205,2,1375,1374
1541,1,5.0.1,0,485,1,78,1,79,0,1,79,79,0,0,0,1,2,239,320,239,321,2,1375,1374
1541,2,0.0.1,0,485,1,53,1,54,0,1,54,54,0,0,1,1,2,175,320,175,321,3,1375,1359
1541,2,1.0.1,0,485,1,52,1,53,0,1,53,53,0,0,1,1,2,239,320,239,321,3,1375,1359
1541,2,2.0.1,0,482,0,52,1,53,0,1,53,53,0,0,1,1,2,258,320,258,321,3,1375,1359
1541,2,3.0.1,0,495,2,85,1,86,0,1,86,86,0,0,1,1,2,249,320,249,321,3,1375,1359
1541,2,4.2.16,1,482,0,33,16,49,16,0,49,49,-16,16,17,3,1,199,217,215,217,3,1375,1359
1541,2,5.0.1,0,485,1,78,1,79,0,1,79,79,0,0,1,1,2,239,320,239,321,3,1375,1359
1541,3,0.0.1,0,485,1,53,1,54,0,1,54,54,0,0,17,1,2,175,320,175,321,4,1375,1326
1541,3,1.0.1,0,485,1,52,1,53,0,1,53,53,0,0,17,1,2,239,320,239,321,4,1375,1326
1541,3,2.0.1,0,482,0,52,1,53,0,1,53,53,0,0,17,1,2,258,320,258,321,4,1375,1326
1541,3,3.0.1,0,495,2,85,1,86,0,1,86,86,0,0,17,1,2,249,320,249,321,4,1375,1326
1541,3,4.3.49,1,482,0,83,49,132,49,0,132,132,-49,49,66,4,1,166,344,215,344,4,1375,1326
1541,3,5.0.1,0,485,1,78,1,79,0,1,79,79,0,0,17,1,2,239,320,239,321,4,1375,1326
1541,4,0.0.1,0,485,1,53,1,54,0,1,54,132,0,0,66,1,2,175,320,175,321,5,1375,1243
1541,4,1.0.1,0,485,1,52,1,53,0,1,53,132,0,0,66,1,2,239,320,239,321,5,1375,1243
1541,4,2.0.1,0,482,0,52,1,53,0,1,53,132,0,0,66,1,2,258,320,258,321,5,1375,1243
1541,4,3.0.1,0,495,2,85,1,86,0,1,86,132,0,0,66,1,2,249,320,249,321,5,1375,1243
1541,4,4.4.132,1,482,0,83,132,215,132,0,215,215,-132,132,198,5,1,83,288,215,288,5,1375,1243
1541,4,5.0.1,0,485,1,78,1,79,0,1,79,132,0,0,66,1,2,239,320,239,321,5,1375,1243
1541,5,0.0.1,0,485,1,53,1,54,0,1,54,215,0,0,198,1,2,175,320,175,321,6,1375,1160
1541,5,1.0.1,0,485,1,52,1,53,0,1,53,215,0,0,198,1,2,239,320,239,321,6,1375,1160
1541,5,2.0.1,1,482,0,52,1,53,0,1,53,215,0,0,198,1,2,258,320,258,321,6,1375,1160
1541,5,3.0.1,0,495,2,85,1,86,0,1,86,215,0,0,198,1,2,249,320,249,321,6,1375,1160
1541,5,5.0.1,0,485,1,78,1,79,0,1,79,215,0,0,198,1,2,239,320,239,321,6,1375,1160
1541,6,0.0.53,0,485,1,53,53,106,0,53,106,215,0,0,198,1,3,175,268,175,321,7,1375,1108
1541,6,1.0.53,0,482,0,52,53,105,0,53,105,215,0,0,198,1,3,239,268,239,321,7,1375,1108
1541,6,2.1.53,1,482,0,40,53,93,53,0,93,215,-37,38,235,2,2,206,190,258,205,7,1375,1108
1541,6,3.0.53,0,495,2,85,53,138,0,53,138,215,0,0,198,1,3,249,268,249,321,7,1375,1108
1541,6,5.0.53,0,485,1,78,53,131,0,53,131,215,0,0,198,1,3,239,268,239,321,7,1375,1108
1541,7,0.0.53,0,485,1,53,53,106,0,53,106,215,0,0,235,1,3,175,268,175,321,8,1375,1068
1541,7,1.0.53,0,482,0,52,53,105,0,53,105,215,0,0,235,1,3,239,268,239,321,8,1375,1068
1541,7,2.2.93,1,482,0,10,93,103,93,0,103,215,-44,60,279,3,2,166,184,258,217,8,1375,1068
1541,7,3.0.53,0,495,2,85,53,138,0,53,138,215,0,0,235,1,3,249,268,249,321,8,1375,1068
1541,7,5.0.53,0,485,1,78,53,131,0,53,131,215,0,0,235,1,3,239,268,239,321,8,1375,1068
1541,8,0.0.53,0,485,1,53,53,106,0,53,106,215,0,0,279,1,3,175,268,175,321,9,1375,1058
1541,8,1.0.53,0,482,0,52,53,105,0,53,105,215,0,0,279,1,3,239,268,239,321,9,1375,1058
1541,8,2.3.132,1,482,0,96,132,228,103,29,228,228,0,49,279,4,2,156,261,258,344,9,1375,1058
1541,8,3.0.53,0,495,2,85,53,138,0,53,138,215,0,0,279,1,3,249,268,249,321,9,1375,1058
1541,8,5.0.53,0,485,1,78,53,131,0,53,131,215,0,0,279,1,3,239,268,239,321,9,1375,1058
1541,9,0.0.53,0,485,1,53,53,106,0,53,106,228,0,0,279,1,3,175,268,175,321,10,1375,962
1541,9,1.0.53,0,482,0,52,53,105,0,53,105,228,0,0,279,1,3,239,268,239,321,10,1375,962
1541,9,2.4.228,1,482,0,60,228,288,228,0,288,288,-13,145,292,5,2,60,205,258,288,10,1375,962
1541,9,3.0.53,0,495,2,85,53,138,0,53,138,228,0,0,279,1,3,249,268,249,321,10,1375,962
1541,9,5.0.53,0,485,1,78,53,131,0,53,131,228,0,0,279,1,3,239,268,239,321,10,1375,962
1541,10,0.0.53,0,485,1,53,53,106,0,53,106,288,0,0,292,1,3,175,268,175,321,11,1375,902
1541,10,1.0.53,1,482,0,52,53,105,0,53,105,288,0,0,292,1,3,239,268,239,321,11,1375,902
1541,10,3.0.53,0,495,2,85,53,138,0,53,138,288,0,0,292,1,3,249,268,249,321,11,1375,902
1541,10,5.0.53,0,485,1,78,53,131,0,53,131,288,0,0,292,1,3,239,268,239,321,11,1375,902
1541,11,0.0.105,0,485,1,53,105,158,0,105,158,288,0,0,292,1,4,175,216,175,321,12,1375,850
1541,11,1.1.105,1,482,0,83,105,188,105,0,188,288,-12,50,304,2,3,187,150,239,205,12,1375,850
1541,11,3.0.105,0,482,0,85,105,190,0,105,190,288,0,0,292,1,4,249,216,249,321,12,1375,850
1541,11,5.0.105,0,485,1,78,105,183,0,105,183,288,0,0,292,1,4,239,216,239,321,12,1375,850
1541,12,0.0.105,0,485,1,53,105,158,0,105,158,288,0,0,304,1,4,175,216,175,321,13,1375,767
1541,12,1.2.188,1,482,0,36,188,224,188,0,224,288,-85,145,389,3,3,104,174,239,217,13,1375,767
1541,12,3.0.105,0,482,0,85,105,190,0,105,190,288,0,0,304,1,4,249,216,249,321,13,1375,767
1541,12,5.0.105,0,485,1,78,105,183,0,105,183,288,0,0,304,1,4,239,216,239,321,13,1375,767
1541,13,0.0.105,0,485,1,53,105,158,0,105,158,288,0,0,389,1,4,175,216,175,321,14,1375,731
1541,13,1.3.228,1,482,0,61,228,289,224,4,289,289,0,49,389,4,3,68,165,239,344,14,1375,731
1541,13,3.0.105,0,482,0,85,105,190,0,105,190,288,0,0,389,1,4,249,216,249,321,14,1375,731
1541,13,5.0.105,0,485,1,78,105,183,0,105,183,288,0,0,389,1,4,239,216,239,321,14,1375,731
1541,14,0.0.105,0,485,1,53,105,158,0,105,158,289,0,0,389,1,4,175,216,175,321,15,1375,670
1541,14,1.4.289,1,482,0,7,289,296,289,0,296,296,-1,146,390,5,3,7,145,239,288,15,1375,670
1541,14,3.0.105,0,482,0,85,105,190,0,105,190,289,0,0,389,1,4,249,216,249,321,15,1375,670
1541,14,5.0.105,0,485,1,78,105,183,0,105,183,289,0,0,389,1,4,239,216,239,321,15,1375,670
1541,15,0.0.105,0,485,1,53,105,158,0,105,158,296,0,0,390,1,4,175,216,175,321,16,1375,663
1541,15,3.0.105,0,482,0,85,105,190,0,105,190,296,0,0,390,1,4,249,216,249,321,16,1375,663
1541,15,5.0.105,1,485,1,78,105,183,0,105,183,296,0,0,390,1,4,239,216,239,321,16,1375,663
1541,16,0.0.183,0,485,0,53,183,236,0,183,236,296,0,0,390,1,5,175,138,175,321,17,1375,585
1541,16,3.0.183,0,492,1,85,183,268,0,183,268,296,0,0,390,1,5,249,138,249,321,17,1375,585
1541,16,5.1.188,1,485,0,13,188,201,183,5,201,296,0,50,390,2,4,161,67,239,205,17,1375,585
1541,17,0.0.183,0,485,0,53,183,236,0,183,236,296,0,0,390,1,5,175,138,175,321,18,1375,572
1541,17,3.0.183,0,492,1,85,183,268,0,183,268,296,0,0,390,1,5,249,138,249,321,18,1375,572
1541,17,5.2.224,1,485,0,46,224,270,201,23,270,296,0,145,390,3,4,148,138,239,217,18,1375,572
1541,18,0.0.183,0,485,0,53,183,236,0,183,236,296,0,0,390,1,5,175,138,175,321,19,1375,526
1541,18,3.0.183,0,492,1,85,183,268,0,183,268,296,0,0,390,1,5,249,138,249,321,19,1375,526
1541,18,5.3.289,1,492,1,65,289,354,270,19,354,354,0,49,390,4,4,102,104,239,344,19,1375,526
1541,19,0.0.183,0,492,0,53,183,236,0,183,236,354,0,0,390,1,5,175,138,175,321,20,1375,461
1541,19,3.0.183,0,492,0,85,183,268,0,183,268,354,0,0,390,1,5,249,138,249,321,20,1375,461
1541,19,5.4.354,1,492,0,37,354,391,354,0,391,391,-58,204,448,5,4,37,138,239,288,20,1375,461
1541,20,0.0.183,1,492,0,53,183,236,0,183,236,391,0,0,448,1,5,175,138,175,321,21,1375,424
1541,20,3.0.183,0,492,0,85,183,268,0,183,268,391,0,0,448,1,5,249,138,249,321,21,1375,424
1541,21,0.1.236,1,492,0,22,236,258,236,0,258,391,-35,85,483,2,5,122,54,175,205,22,1375,371
1541,21,3.0.236,0,492,0,85,236,321,0,236,321,391,0,0,448,1,6,249,85,249,321,22,1375,371
1541,22,0.2.270,1,492,0,21,270,291,258,12,291,391,0,145,483,3,5,100,92,175,217,23,1375,349
1541,22,3.0.236,0,492,0,85,236,321,0,236,321,391,0,0,483,1,6,249,85,249,321,23,1375,349
1541,23,0.3.354,1,492,0,23,354,377,291,63,377,391,0,49,483,4,5,79,39,175,344,24,1375,328
1541,23,3.0.236,0,492,0,85,236,321,0,236,321,391,0,0,483,1,6,249,85,249,321,24,1375,328
1541,24,0.4.391,1,492,0,56,391,447,377,14,447,447,0,204,483,5,5,56,101,175,288,25,1375,305
1541,24,3.0.236,0,492,0,85,236,321,0,236,321,391,0,0,483,1,6,249,85,249,321,25,1375,305
1541,25,3.0.236,1,492,0,85,236,321,0,236,321,447,0,0,483,1,6,249,85,249,321,26,1375,249
1541,26,3.1.321,1,492,0,32,321,353,321,0,353,447,-63,148,546,2,6,164,32,249,205,27,1375,164
1541,27,3.2.353,1,492,0,71,353,424,353,0,424,447,-62,207,608,3,6,132,71,249,217,28,1375,132
1541,28,3.3.424,1,492,0,16,424,440,424,0,440,447,-47,96,655,4,6,61,16,249,344,29,1375,61
1541,29,3.4.447,1,492,0,45,447,492,440,7,492,492,0,204,655,5,6,45,45,249,288,30,1375,45
1542,0,0.0.0,0,582,5,66,0,66,0,0,66,66,0,0,0,1,1,218,335,218,335,1,1539,1539
1542,0,1.0.0,0,536,2,27,0,27,0,0,27,27,0,0,0,1,1,138,335,138,335,1,1539,1539
1542,0,2.0.0,0,561,3,97,0,97,0,0,97,97,0,0,0,1,1,283,335,283,335,1,1539,1539
1542,0,3.0.0,1,532,1,39,0,39,0,0,39,39,0,0,0,1,1,308,335,308,335,1,1539,1539
1542,0,4.0.0,0,516,0,23,0,23,0,0,23,23,0,0,0,1,1,252,335,252,335,1,1539,1539
1542,0,5.0.0,0,570,4,83,0,83,0,0,83,83,0,0,0,1,1,340,335,340,335,1,1539,1539
1542,1,0.0.39,0,568,3,66,39,105,0,39,105,105,0,0,0,1,2,218,296,218,335,2,1539,1500
1542,1,1.0.39,0,532,0,27,39,66,0,39,66,66,0,0,0,1,2,138,296,138,335,2,1539,1500
1542,1,2.0.39,0,537,1,97,39,136,0,39,136,136,0,0,0,1,2,283,296,283,335,2,1539,1500
1542,1,3.1.39,0,532,0,70,39,109,39,0,109,109,-39,39,39,2,1,269,404,308,404,2,1539,1500
1542,1,4.0.39,1,532,0,23,39,62,0,39,62,62,0,0,0,1,2,252,296,252,335,2,1539,1500
1542,1,5.0.39,0,542,2,83,39,122,0,39,122,122,0,0,0,1,2,340,296,340,335,2,1539,1500
1542,2,0.0.62,0,568,3,66,62,128,0,62,128,128,0,0,0,1,3,218,273,218,335,3,1539,1477
1542,2,1.0.62,0,532,0,27,62,89,0,62,89,89,0,0,0,1,3,138,273,138,335,3,1539,1477
1542,2,2.0.62,0,536,1,97,62,159,0,62,159,159,0,0,0,1,3,283,273,283,335,3,1539,1477
1542,2,3.1.39,0,532,0,70,39,109,39,0,109,109,-39,39,39,2,1,269,404,308,404,3,1539,1477
1542,2,4.1.62,0,537,2,66,62,128,62,0,128,128,-62,62,62,2,1,229,404,252,404,3,1539,1477
1542,2,5.0.62,1,532,0,83,62,145,0,62,145,145,0,0,0,1,3,340,273,340,335,3,1539,1477
1542,3,0.0.145,0,541,1,66,145,211,0,145,211,211,0,0,0,1,4,218,190,218,335,4,1539,1394
1542,3,1.0.145,1,532,0,27,145,172,0,145,172,172,0,0,0,1,4,138,190,138,335,4,1539,1394
1542,3,2.0.145,0,532,0,97,145,242,0,145,242,242,0,0,0,1,4,283,190,283,335,4,1539,1394
1542,3,3.1.39,0,532,0,70,39,109,39,0,109,145,-39,39,39,2,1,269,404,308,404,4,1539,1394
1542,3,4.1.62,0,555,2,66,62,128,62,0,128,145,-62,62,62,2,1,229,404,252,404,4,1539,1394
1542,3,5.1.145,0,565,3,95,145,240,145,0,240,240,-145,145,145,2,1,257,404,340,404,4,1539,1394
1542,4,0.0.172,1,546,1,66,172,238,0,172,238,238,0,0,0,1,5,218,163,218,335,5,1539,1367
1542,4,1.1.172,0,589,4,51,172,223,172,0,223,223,-172,172,172,2,1,111,404,138,404,5,1539,1367
1542,4,2.0.172,0,532,0,97,172,269,0,172,269,269,0,0,0,1,5,283,163,283,335,5,1539,1367
1542,4,3.1.39,0,532,0,70,39,109,39,0,109,172,-39,39,39,2,1,269,404,308,404,5,1539,1367
1542,4,4.1.62,0,555,2,66,62,128,62,0,128,172,-62,62,62,2,1,229,404,252,404,5,1539,1367
1542,4,5.1.145,0,565,3,95,145,240,145,0,240,240,-145,145,145,2,1,257,404,340,404,5,1539,1367
1542,5,0.1.238,0,625,3,89,238,327,238,0,327,327,-238,238,238,2,1,152,404,218,404,6,1539,1301
1542,5,1.1.172,0,631,4,51,172,223,172,0,223,238,-172,172,172,2,1,111,404,138,404,6,1539,1301
1542,5,2.0.238,1,546,0,97,238,335,0,238,335,335,0,0,0,1,6,283,97,283,335,6,1539,1301
1542,5,3.1.39,0,546,0,70,39,109,39,0,109,238,-39,39,39,2,1,269,404,308,404,6,1539,1301
1542,5,4.1.62,0,555,1,66,62,128,62,0,128,238,-62,62,62,2,1,229,404,252,404,6,1539,1301
1542,5,5.1.145,0,565,2,95,145,240,145,0,240,240,-145,145,145,2,1,257,404,340,404,6,1539,1301
1542,6,0.1.238,0,625,3,89,238,327,238,0,327,335,-238,238,238,2,1,152,404,218,404,7,1539,1204
1542,6,1.1.172,0,631,4,51,172,223,172,0,223,335,-172,172,172,2,1,111,404,138,404,7,1539,1204
1542,6,2.1.335,0,546,0,33,335,368,335,0,368,368,-335,335,335,2,1,186,404,283,404,7,1539,1204
1542,6,3.1.39,1,546,0,70,39,109,39,0,109,335,-39,39,39,2,1,269,404,308,404,7,1539,1204
1542,6,4.1.62,0,555,1,66,62,128,62,0,128,335,-62,62,62,2,1,229,404,252,404,7,1539,1204
1542,6,5.1.145,0,565,2,95,145,240,145,0,240,335,-145,145,145,2,1,257,404,340,404,7,1539,1204
1542,7,0.1.238,0,625,2,89,238,327,238,0,327,335,-129,168,168,2,2,152,334,218,404,8,1539,1134
1542,7,1.1.172,0,631,3,51,172,223,172,0,223,335,-63,102,102,2,2,111,334,138,404,8,1539,1134
1542,7,2.1.335,0,546,0,33,335,368,335,0,368,368,-226,265,265,2,2,186,334,283,404,8,1539,1134
1542,7,3.2.109,1,546,0,39,109,148,109,0,148,335,-109,109,148,3,1,199,286,308,286,8,1539,1134
1542,7,4.1.109,0,546,0,66,109,175,62,47,175,335,0,39,39,2,2,229,334,252,404,8,1539,1134
1542,7,5.1.145,0,565,1,95,145,240,145,0,240,335,-36,75,75,2,2,257,334,340,404,8,1539,1134
1542,8,0.1.238,0,625,2,89,238,327,238,0,327,335,-129,168,277,2,2,152,334,218,404,9,1539,1095
1542,8,1.1.172,0,631,3,51,172,223,172,0,223,335,-63,102,211,2,2,111,334,138,404,9,1539,1095
1542,8,2.1.335,0,546,0,33,335,368,335,0,368,368,-226,265,374,2,2,186,334,283,404,9,1539,1095
1542,8,3.3.148,1,546,0,74,148,222,148,0,222,335,-148,148,296,4,1,160,297,308,297,9,1539,1095
1542,8,4.1.109,0,546,0,66,109,175,62,47,175,335,0,39,148,2,2,229,334,252,404,9,1539,1095
1542,8,5.1.145,0,565,1,95,145,240,145,0,240,335,-36,75,184,2,2,257,334,340,404,9,1539,1095
1542,9,0.1.238,0,625,2,89,238,327,238,0,327,335,-129,168,425,2,2,152,334,218,404,10,1539,1021
1542,9,1.1.172,0,631,3,51,172,223,172,0,223,335,-63,102,359,2,2,111,334,138,404,10,1539,1021
1542,9,2.1.335,0,546,0,33,335,368,335,0,368,368,-226,265,522,2,2,186,334,283,404,10,1539,1021
1542,9,3.4.222,1,546,0,86,222,308,222,0,308,335,-222,222,518,5,1,86,217,308,217,10,1539,1021
1542,9,4.1.109,0,546,0,66,109,175,62,47,175,335,0,39,296,2,2,229,334,252,404,10,1539,1021
1542,9,5.1.145,0,565,1,95,145,240,145,0,240,335,-36,75,332,2,2,257,334,340,404,10,1539,1021
1542,10,0.1.238,0,625,2,89,238,327,238,0,327,335,-129,168,647,2,2,152,334,218,404,11,1539,935
1542,10,1.1.172,0,631,3,51,172,223,172,0,223,335,-63,102,581,2,2,111,334,138,404,11,1539,935
1542,10,2.1.335,0,546,0,33,335,368,335,0,368,368,-226,265,744,2,2,186,334,283,404,11,1539,935
1542,10,4.1.109,1,546,0,66,109,175,62,47,175,335,0,39,518,2,2,229,334,252,404,11,1539,935
1542,10,5.1.145,0,565,1,95,145,240,145,0,240,335,-36,75,554,2,2,257,334,340,404,11,1539,935
1542,11,0.1.238,0,625,2,89,238,327,238,0,327,335,-63,102,581,2,3,152,268,218,404,12,1539,869
1542,11,1.1.175,0,571,1,51,175,226,172,3,226,335,0,39,518,2,3,111,268,138,404,12,1539,869
1542,11,2.1.335,0,546,0,33,335,368,335,0,368,368,-160,199,678,2,3,186,268,283,404,12,1539,869
1542,11,4.2.175,1,546,0,34,175,209,175,0,209,335,-27,136,545,3,2,163,247,252,286,12,1539,869
1542,11,5.1.175,0,546,0,95,175,270,145,30,270,335,0,39,518,2,3,257,268,340,404,12,1539,869
1542,12,0.1.238,0,625,2,89,238,327,238,0,327,335,-63,102,608,2,3,152,268,218,404,13,1539,835
1542,12,1.1.175,0,571,1,51,175,226,172,3,226,335,0,39,545,2,3,111,268,138,404,13,1539,835
1542,12,2.1.335,0,546,0,33,335,368,335,0,368,368,-160,199,705,2,3,186,268,283,404,13,1539,835
1542,12,4.3.222,1,546,0,76,222,298,209,13,298,335,0,148,545,4,2,129,223,252,297,13,1539,835
1542,12,5.1.175,0,546,0,95,175,270,145,30,270,335,0,39,545,2,3,257,268,340,404,13,1539,835
1542,13,0.1.238,0,625,2,89,238,327,238,0,327,335,-63,102,608,2,3,152,268,218,404,14,1539,759
1542,13,1.1.175,0,571,1,51,175,226,172,3,226,335,0,39,545,2,3,111,268,138,404,14,1539,759
1542,13,2.1.335,0,546,0,33,335,368,335,0,368,368,-160,199,705,2,3,186,268,283,404,14,1539,759
1542,13,4.4.308,1,546,0,53,308,361,298,10,361,361,0,222,545,5,2,53,131,252,217,14,1539,759
1542,13,5.1.175,0,546,0,95,175,270,145,30,270,335,0,39,545,2,3,257,268,340,404,14,1539,759
1542,14,0.1.238,0,625,2,89,238,327,238,0,327,361,-63,102,608,2,3,152,268,218,404,15,1539,706
1542,14,1.1.175,0,571,1,51,175,226,172,3,226,361,0,39,545,2,3,111,268,138,404,15,1539,706
1542,14,2.1.335,0,546,0,33,335,368,335,0,368,368,-160,199,705,2,3,186,268,283,404,15,1539,706
1542,14,5.1.175,1,546,0,95,175,270,145,30,270,361,0,39,545,2,3,257,268,340,404,15,1539,706
1542,15,0.1.270,0,561,1,89,270,359,238,32,359,361,0,39,545,2,4,152,173,218,404,16,1539,611
1542,15,1.1.270,0,546,0,51,270,321,172,98,321,361,0,39,545,2,4,111,173,138,404,16,1539,611
1542,15,2.1.335,0,546,0,33,335,368,335,0,368,368,-65,104,610,2,4,186,173,283,404,16,1539,611
1542,15,5.2.270,1,546,0,84,270,354,270,0,354,361,-61,197,606,3,3,162,213,340,286,16,1539,611
1542,16,0.1.270,0,561,1,89,270,359,238,32,359,361,0,39,606,2,4,152,173,218,404,17,1539,527
1542,16,1.1.270,0,546,0,51,270,321,172,98,321,361,0,39,606,2,4,111,173,138,404,17,1539,527
1542,16,2.1.335,0,546,0,33,335,368,335,0,368,368,-65,104,671,2,4,186,173,283,404,17,1539,527
1542,16,5.3.354,1,546,0,50,354,404,354,0,404,404,-56,204,662,4,3,78,147,340,297,17,1539,527
1542,17,0.1.270,0,561,1,89,270,359,238,32,359,404,0,39,662,2,4,152,173,218,404,18,1539,477
1542,17,1.1.270,0,546,0,51,270,321,172,98,321,404,0,39,662,2,4,111,173,138,404,18,1539,477
1542,17,2.1.335,0,546,0,33,335,368,335,0,368,404,-65,104,727,2,4,186,173,283,404,18,1539,477
1542,17,5.4.404,1,546,0,28,404,432,404,0,432,432,-43,265,705,5,3,28,78,340,217,18,1539,477
1542,18,0.1.270,0,561,1,89,270,359,238,32,359,432,0,39,705,2,4,152,173,218,404,19,1539,449
1542,18,1.1.270,1,546,0,51,270,321,172,98,321,432,0,39,705,2,4,111,173,138,404,19,1539,449
1542,18,2.1.335,0,546,0,33,335,368,335,0,368,432,-65,104,770,2,4,186,173,283,404,19,1539,449
1542,19,0.1.321,0,596,2,89,321,410,238,83,410,432,0,39,705,2,5,152,122,218,404,20,1539,398
1542,19,1.2.354,1,561,1,41,354,395,321,33,395,432,0,197,705,3,4,60,129,138,286,20,1539,398
1542,19,2.1.335,0,546,0,33,335,368,335,0,368,432,-14,53,719,2,5,186,122,283,404,20,1539,398
1542,20,0.1.321,0,596,1,89,321,410,238,83,410,432,0,39,705,2,5,152,122,218,404,21,1539,357
1542,20,1.3.404,1,561,0,3,404,407,395,9,407,432,0,204,705,4,4,19,97,138,297,21,1539,357
1542,20,2.1.335,0,561,0,33,335,368,335,0,368,432,-14,53,719,2,5,186,122,283,404,21,1539,357
1542,21,0.1.321,0,596,1,89,321,410,238,83,410,432,0,39,705,2,5,152,122,218,404,22,1539,354
1542,21,1.4.432,1,561,0,16,432,448,407,25,448,448,0,265,705,5,4,16,50,138,217,22,1539,354
1542,21,2.1.335,0,561,0,33,335,368,335,0,368,432,-14,53,719,2,5,186,122,283,404,22,1539,354
1542,22,0.1.321,0,596,1,89,321,410,238,83,410,448,0,39,705,2,5,152,122,218,404,23,1539,338
1542,22,2.1.335,1,561,0,33,335,368,335,0,368,448,-14,53,719,2,5,186,122,283,404,23,1539,338
1542,23,0.1.368,0,561,0,89,368,457,238,130,457,457,0,53,719,2,6,152,89,218,404,24,1539,305
1542,23,2.2.395,1,561,0,63,395,458,368,27,458,458,0,197,719,3,5,153,88,283,286,24,1539,305
1542,24,0.1.368,0,561,0,89,368,457,238,130,457,458,0,53,719,2,6,152,89,218,404,25,1539,242
1542,24,2.3.458,1,561,0,65,458,523,458,0,523,523,-51,255,770,4,5,90,94,283,297,25,1539,242
1542,25,0.1.368,0,561,0,89,368,457,238,130,457,523,0,53,770,2,6,152,89,218,404,26,1539,177
1542,25,2.4.523,1,561,0,25,523,548,523,0,548,548,-75,340,845,5,5,25,34,283,217,26,1539,177
1542,26,0.1.368,1,561,0,89,368,457,238,130,457,548,0,53,845,2,6,152,89,218,404,27,1539,152
1542,27,0.2.458,1,561,0,25,458,483,457,1,483,548,0,197,845,3,6,63,25,218,286,28,1539,63
1542,28,0.3.523,1,561,0,29,523,552,483,40,552,552,0,255,845,4,6,38,29,218,297,29,1539,38
1542,29,0.4.552,1,561,0,9,552,561,552,0,561,561,-4,344,849,5,6,9,9,218,217,30,1539,9
1543,0,0.0.0,0,452,0,79,0,79,0,0,79,79,0,0,0,1,1,261,350,261,350,1,1211,1211
1543,0,1.0.0,1,452,0,3,0,3,0,0,3,3,0,0,0,1,1,137,350,137,350,1,1211,1211
1543,0,2.0.0,0,452,0,44,0,44,0,0,44,44,0,0,0,1,1,211,350,211,350,1,1211,1211
1543,0,3.0.0,0,506,2,92,0,92,0,0,92,92,0,0,0,1,1,168,350,168,350,1,1211,1211
1543,0,4.0.0,0,452,0,44,0,44,0,0,44,44,0,0,0,1,1,190,350,190,350,1,1211,1211
1543,0,5.0.0,0,484,1,88,0,88,0,0,88,88,0,0,0,1,1,244,350,244,350,1,1211,1211
1543,1,0.0.3,0,452,0,79,3,82,0,3,82,82,0,0,0,1,2,261,347,261,350,2,1211,1208
1543,1,1.1.3,1,452,0,19,3,22,3,0,22,22,-3,3,3,2,1,134,209,137,209,2,1211,1208
1543,1,2.0.3,0,452,0,44,3,47,0,3,47,47,0,0,0,1,2,211,347,211,350,2,1211,1208
1543,1,3.0.3,0,506,2,92,3,95,0,3,95,95,0,0,0,1,2,168,347,168,350,2,1211,1208
1543,1,4.0.3,0,452,0,44,3,47,0,3,47,47,0,0,0,1,2,190,347,190,350,2,1211,1208
1543,1,5.0.3,0,465,1,88,3,91,0,3,91,91,0,0,0,1,2,244,347,244,350,2,1211,1208
1543,2,0.0.3,0,452,0,79,3,82,0,3,82,82,0,0,3,1,2,261,347,261,350,3,1211,1189
1543,2,1.2.22,1,452,0,46,22,68,22,0,68,68,-22,22,25,3,1,115,154,137,154,3,1211,1189
1543,2,2.0.3,0,452,0,44,3,47,0,3,47,47,0,0,3,1,2,211,347,211,350,3,1211,1189
1543,2,3.0.3,0,506,2,92,3,95,0,3,95,95,0,0,3,1,2,168,347,168,350,3,1211,1189
1543,2,4.0.3,0,452,0,44,3,47,0,3,47,47,0,0,3,1,2,190,347,190,350,3,1211,1189
1543,2,5.0.3,0,465,1,88,3,91,0,3,91,91,0,0,3,1,2,244,347,244,350,3,1211,1189
1543,3,0.0.3,0,452,0,79,3,82,0,3,82,82,0,0,25,1,2,261,347,261,350,4,1211,1143
1543,3,1.3.68,1,452,0,44,68,112,68,0,112,112,-68,68,93,4,1,69,251,137,251,4,1211,1143
1543,3,2.0.3,0,452,0,44,3,47,0,3,47,68,0,0,25,1,2,211,347,211,350,4,1211,1143
1543,3,3.0.3,0,506,2,92,3,95,0,3,95,95,0,0,25,1,2,168,347,168,350,4,1211,1143
1543,3,4.0.3,0,452,0,44,3,47,0,3,47,68,0,0,25,1,2,190,347,190,350,4,1211,1143
1543,3,5.0.3,0,465,1,88,3,91,0,3,91,91,0,0,25,1,2,244,347,244,350,4,1211,1143
1543,4,0.0.3,0,452,0,79,3,82,0,3,82,112,0,0,93,1,2,261,347,261,350,5,1211,1099
1543,4,1.4.112,1,452,0,25,112,137,112,0,137,137,-112,112,205,5,1,25,247,137,247,5,1211,1099
1543,4,2.0.3,0,452,0,44,3,47,0,3,47,112,0,0,93,1,2,211,347,211,350,5,1211,1099
1543,4,3.0.3,0,506,2,92,3,95,0,3,95,112,0,0,93,1,2,168,347,168,350,5,1211,1099
1543,4,4.0.3,0,452,0,44,3,47,0,3,47,112,0,0,93,1,2,190,347,190,350,5,1211,1099
1543,4,5.0.3,0,465,1,88,3,91,0,3,91,112,0,0,93,1,2,244,347,244,350,5,1211,1099
1543,5,0.0.3,0,452,0,79,3,82,0,3,82,137,0,0,205,1,2,261,347,261,350,6,1211,1074
1543,5,2.0.3,1,452,0,44,3,47,0,3,47,137,0,0,205,1,2,211,347,211,350,6,1211,1074
1543,5,3.0.3,0,506,2,92,3,95,0,3,95,137,0,0,205,1,2,168,347,168,350,6,1211,1074
1543,5,4.0.3,0,452,0,44,3,47,0,3,47,137,0,0,205,1,2,190,347,190,350,6,1211,1074
1543,5,5.0.3,0,465,1,88,3,91,0,3,91,137,0,0,205,1,2,244,347,244,350,6,1211,1074
1543,6,0.0.47,0,452,0,79,47,126,0,47,126,137,0,0,205,1,3,261,303,261,350,7,1211,1030
1543,6,2.1.47,1,452,0,27,47,74,47,0,74,137,-25,28,230,2,2,167,190,211,209,7,1211,1030
1543,6,3.0.47,0,506,2,92,47,139,0,47,139,139,0,0,205,1,3,168,303,168,350,7,1211,1030
1543,6,4.0.47,0,452,0,44,47,91,0,47,91,137,0,0,205,1,3,190,303,190,350,7,1211,1030
1543,6,5.0.47,0,465,1,88,47,135,0,47,135,137,0,0,205,1,3,244,303,244,350,7,1211,1030
1543,7,0.0.47,0,452,0,79,47,126,0,47,126,137,0,0,230,1,3,261,303,261,350,8,1211,1003
1543,7,2.2.74,1,452,0,16,74,90,74,0,90,137,-6,28,236,3,2,140,108,211,154,8,1211,1003
1543,7,3.0.47,0,506,2,92,47,139,0,47,139,139,0,0,230,1,3,168,303,168,350,8,1211,1003
1543,7,4.0.47,0,452,0,44,47,91,0,47,91,137,0,0,230,1,3,190,303,190,350,8,1211,1003
1543,7,5.0.47,0,465,1,88,47,135,0,47,135,137,0,0,230,1,3,244,303,244,350,8,1211,1003
1543,8,0.0.47,0,452,0,79,47,126,0,47,126,137,0,0,236,1,3,261,303,261,350,9,1211,987
1543,8,2.3.112,1,452,0,34,112,146,90,22,146,146,0,68,236,4,2,124,207,211,251,9,1211,987
1543,8,3.0.47,0,506,2,92,47,139,0,47,139,139,0,0,236,1,3,168,303,168,350,9,1211,987
1543,8,4.0.47,0,452,0,44,47,91,0,47,91,137,0,0,236,1,3,190,303,190,350,9,1211,987
1543,8,5.0.47,0,465,1,88,47,135,0,47,135,137,0,0,236,1,3,244,303,244,350,9,1211,987
1543,9,0.0.47,0,452,0,79,47,126,0,47,126,146,0,0,236,1,3,261,303,261,350,10,1211,953
1543,9,2.4.146,1,452,0,90,146,236,146,0,236,236,-9,121,245,5,2,90,222,211,247,10,1211,953
1543,9,3.0.47,0,506,2,92,47,139,0,47,139,146,0,0,236,1,3,168,303,168,350,10,1211,953
1543,9,4.0.47,0,452,0,44,47,91,0,47,91,146,0,0,236,1,3,190,303,190,350,10,1211,953
1543,9,5.0.47,0,465,1,88,47,135,0,47,135,146,0,0,236,1,3,244,303,244,350,10,1211,953
1543,10,0.0.47,0,452,0,79,47,126,0,47,126,236,0,0,245,1,3,261,303,261,350,11,1211,863
1543,10,3.0.47,0,506,2,92,47,139,0,47,139,236,0,0,245,1,3,168,303,168,350,11,1211,863
1543,10,4.0.47,1,452,0,44,47,91,0,47,91,236,0,0,245,1,3,190,303,190,350,11,1211,863
1543,10,5.0.47,0,465,1,88,47,135,0,47,135,236,0,0,245,1,3,244,303,244,350,11,1211,863
1543,11,0.0.91,0,452,0,79,91,170,0,91,170,236,0,0,245,1,4,261,259,261,350,12,1211,819
1543,11,3.0.91,0,506,2,92,91,183,0,91,183,236,0,0,245,1,4,168,259,168,350,12,1211,819
1543,11,4.1.91,1,452,0,18,91,109,91,0,109,236,-17,45,262,2,3,146,163,190,209,12,1211,819
1543,11,5.0.91,0,468,1,88,91,179,0,91,179,236,0,0,245,1,4,244,259,244,350,12,1211,819
1543,12,0.0.91,0,452,0,79,91,170,0,91,170,236,0,0,262,1,4,261,259,261,350,13,1211,801
1543,12,3.0.91,0,506,2,92,91,183,0,91,183,236,0,0,262,1,4,168,259,168,350,13,1211,801
1543,12,4.2.109,1,452,0,35,109,144,109,0,144,236,-19,47,281,3,3,128,92,190,154,13,1211,801
1543,12,5.0.91,0,468,1,88,91,179,0,91,179,236,0,0,262,1,4,244,259,244,350,13,1211,801
1543,13,0.0.91,0,452,0,79,91,170,0,91,170,236,0,0,281,1,4,261,259,261,350,14,1211,766
1543,13,3.0.91,0,506,2,92,91,183,0,91,183,236,0,0,281,1,4,168,259,168,350,14,1211,766
1543,13,4.3.146,1,452,0,69,146,215,144,2,215,236,0,68,281,4,3,93,173,190,251,14,1211,766
1543,13,5.0.91,0,468,1,88,91,179,0,91,179,236,0,0,281,1,4,244,259,244,350,14,1211,766
1543,14,0.0.91,0,452,0,79,91,170,0,91,170,236,0,0,281,1,4,261,259,261,350,15,1211,697
1543,14,3.0.91,0,506,2,92,91,183,0,91,183,236,0,0,281,1,4,168,259,168,350,15,1211,697
1543,14,4.4.236,1,452,0,24,236,260,215,21,260,260,0,121,281,5,3,24,132,190,247,15,1211,697
1543,14,5.0.91,0,468,1,88,91,179,0,91,179,236,0,0,281,1,4,244,259,244,350,15,1211,697
1543,15,0.0.91,1,452,0,79,91,170,0,91,170,260,0,0,281,1,4,261,259,261,350,16,1211,673
1543,15,3.0.91,0,506,2,92,91,183,0,91,183,260,0,0,281,1,4,168,259,168,350,16,1211,673
1543,15,5.0.91,0,468,1,88,91,179,0,91,179,260,0,0,281,1,4,244,259,244,350,16,1211,673
1543,16,0.1.170,1,452,0,57,170,227,170,0,227,260,-61,106,342,2,4,182,145,261,209,17,1211,594
1543,16,3.0.170,0,506,1,92,170,262,0,170,262,262,0,0,281,1,5,168,180,168,350,17,1211,594
1543,16,5.0.170,0,452,0,88,170,258,0,170,258,260,0,0,281,1,5,244,180,244,350,17,1211,594
1543,17,0.2.227,1,452,0,28,227,255,227,0,255,260,-83,130,425,3,4,125,57,261,154,18,1211,537
1543,17,3.0.170,0,506,1,92,170,262,0,170,262,262,0,0,342,1,5,168,180,168,350,18,1211,537
1543,17,5.0.170,0,452,0,88,170,258,0,170,258,260,0,0,342,1,5,244,180,244,350,18,1211,537
1543,18,0.3.255,1,452,0,36,255,291,255,0,291,291,-40,108,465,4,4,97,104,261,251,19,1211,509
1543,18,3.0.170,0,506,1,92,170,262,0,170,262,262,0,0,425,1,5,168,180,168,350,19,1211,509
1543,18,5.0.170,0,452,0,88,170,258,0,170,258,260,0,0,425,1,5,244,180,244,350,19,1211,509
1543,19,0.4.291,1,452,0,61,291,352,291,0,352,352,-31,152,496,5,4,61,108,261,247,20,1211,473
1543,19,3.0.170,0,506,1,92,170,262,0,170,262,291,0,0,465,1,5,168,180,168,350,20,1211,473
1543,19,5.0.170,0,452,0,88,170,258,0,170,258,291,0,0,465,1,5,244,180,244,350,20,1211,473
1543,20,3.0.170,0,506,1,92,170,262,0,170,262,352,0,0,496,1,5,168,180,168,350,21,1211,412
1543,20,5.0.170,1,452,0,88,170,258,0,170,258,352,0,0,496,1,5,244,180,244,350,21,1211,412
1543,21,3.0.258,1,452,0,92,258,350,0,258,350,352,0,0,496,1,6,168,92,168,350,22,1211,324
1543,21,5.1.258,0,452,0,79,258,337,258,0,337,352,-31,137,527,2,5,156,88,244,209,22,1211,324
1543,22,3.1.350,0,452,0,9,350,359,350,0,359,359,-123,229,619,2,5,76,88,168,209,23,1211,232
1543,22,5.1.258,1,452,0,79,258,337,258,0,337,352,-31,137,527,2,5,156,88,244,209,23,1211,232
1543,23,3.1.350,0,452,0,9,350,359,350,0,359,359,-13,150,540,2,6,76,9,168,209,24,1211,153
1543,23,5.2.337,1,453,1,23,337,360,337,0,360,360,-82,212,609,3,5,77,29,244,154,24,1211,153
1543,24,3.1.350,0,453,0,9,350,359,350,0,359,360,-13,150,622,2,6,76,9,168,209,25,1211,130
1543,24,5.3.360,1,456,1,35,360,395,360,0,395,395,-69,177,678,4,5,54,68,244,251,25,1211,130
1543,25,3.1.350,0,456,0,9,350,359,350,0,359,395,-13,150,691,2,6,76,9,168,209,26,1211,95
1543,25,5.4.395,1,456,0,19,395,414,395,0,414,414,-43,195,721,5,5,19,47,244,247,26,1211,95
1543,26,3.1.350,1,456,0,9,350,359,350,0,359,414,-13,150,734,2,6,76,9,168,209,27,1211,76
1543,27,3.2.360,1,456,0,6,360,366,359,1,366,414,0,212,734,3,6,67,6,168,154,28,1211,67
1543,28,3.3.395,1,456,0,33,395,428,366,29,428,428,0,177,734,4,6,61,33,168,251,29,1211,61
1543,29,3.4.428,1,456,0,28,428,456,428,0,456,456,-14,209,748,5,6,28,28,168,247,30,1211,28
1544,0,0.0.0,0,616,3,92,0,92,0,0,92,92,0,0,0,1,1,208,463,208,463,1,1680,1680
1544,0,1.0.0,0,599,2,78,0,78,0,0,78,78,0,0,0,1,1,336,463,336,463,1,1680,1680
1544,0,2.0.0,0,584,1,89,0,89,0,0,89,89,0,0,0,1,1,237,463,237,463,1,1680,1680
1544,0,3.0.0,1,579,0,46,0,46,0,0,46,46,0,0,0,1,1,327,463,327,463,1,1680,1680
1544,0,4.0.0,0,579,0,66,0,66,0,0,66,66,0,0,0,1,1,327,463,327,463,1,1680,1680
1544,0,5.0.0,0,627,4,92,0,92,0,0,92,92,0,0,0,1,1,245,463,245,463,1,1680,1680
1544,1,0.0.46,0,616,3,92,46,138,0,46,138,138,0,0,0,1,2,208,417,208,463,2,1680,1634
1544,1,1.0.46,0,584,1,78,46,124,0,46,124,124,0,0,0,1,2,336,417,336,463,2,1680,1634
1544,1,2.0.46,0,584,1,89,46,135,0,46,135,135,0,0,0,1,2,237,417,237,463,2,1680,1634
1544,1,3.1.46,1,579,0,47,46,93,46,0,93,93,-46,46,46,2,1,281,312,327,312,2,1680,1634
1544,1,4.0.46,0,579,0,66,46,112,0,46,112,112,0,0,0,1,2,327,417,327,463,2,1680,1634
1544,1,5.0.46,0,611,2,92,46,138,0,46,138,138,0,0,0,1,2,245,417,245,463,2,1680,1634
1544,2,0.0.46,0,616,3,92,46,138,0,46,138,138,0,0,46,1,2,208,417,208,463,3,1680,1587
1544,2,1.0.46,0,584,1,78,46,124,0,46,124,124,0,0,46,1,2,336,417,336,463,3,1680,1587
1544,2,2.0.46,0,584,1,89,46,135,0,46,135,135,0,0,46,1,2,237,417,237,463,3,1680,1587
1544,2,3.2.93,1,579,0,73,93,166,93,0,166,166,-93,93,139,3,1,234,322,327,322,3,1680,1587
1544,2,4.0.46,0,579,0,66,46,112,0,46,112,112,0,0,46,1,2,327,417,327,463,3,1680,1587
1544,2,5.0.46,0,611,2,92,46,138,0,46,138,138,0,0,46,1,2,245,417,245,463,3,1680,1587
1544,3,0.0.46,0,616,3,92,46,138,0,46,138,166,0,0,139,1,2,208,417,208,463,4,1680,1514
1544,3,1.0.46,0,584,1,78,46,124,0,46,124,166,0,0,139,1,2,336,417,336,463,4,1680,1514
1544,3,2.0.46,0,584,1,89,46,135,0,46,135,166,0,0,139,1,2,237,417,237,463,4,1680,1514
1544,3,3.3.166,1,579,0,92,166,258,166,0,258,258,-166,166,305,4,1,161,306,327,306,4,1680,1514
1544,3,4.0.46,0,579,0,66,46,112,0,46,112,166,0,0,139,1,2,327,417,327,463,4,1680,1514
1544,3,5.0.46,0,611,2,92,46,138,0,46,138,166,0,0,139,1,2,245,417,245,463,4,1680,1514
1544,4,0.0.46,0,616,3,92,46,138,0,46,138,258,0,0,305,1,2,208,417,208,463,5,1680,1422
1544,4,1.0.46,0,584,1,78,46,124,0,46,124,258,0,0,305,1,2,336,417,336,463,5,1680,1422
1544,4,2.0.46,0,584,1,89,46,135,0,46,135,258,0,0,305,1,2,237,417,237,463,5,1680,1422
1544,4,3.4.258,1,579,0,69,258,327,258,0,327,327,-258,258,563,5,1,69,277,327,277,5,1680,1422
1544,4,4.0.46,0,579,0,66,46,112,0,46,112,258,0,0,305,1,2,327,417,327,463,5,1680,1422
1544,4,5.0.46,0,611,2,92,46,138,0,46,138,258,0,0,305,1,2,245,417,245,463,5,1680,1422
1544,5,0.0.46,0,616,3,92,46,138,0,46,138,327,0,0,563,1,2,208,417,208,463,6,1680,1353
1544,5,1.0.46,0,584,1,78,46,124,0,46,124,327,0,0,563,1,2,336,417,336,463,6,1680,1353
1544,5,2.0.46,0,584,1,89,46,135,0,46,135,327,0,0,563,1,2,237,417,237,463,6,1680,1353
1544,5,4.0.46,1,579,0,66,46,112,0,46,112,327,0,0,563,1,2,327,417,327,463,6,1680,1353
1544,5,5.0.46,0,611,2,92,46,138,0,46,138,327,0,0,563,1,2,245,417,245,463,6,1680,1353
1544,6,0.0.112,0,616,3,92,112,204,0,112,204,327,0,0,563,1,3,208,351,208,463,7,1680,1287
1544,6,1.0.112,0,579,0,78,112,190,0,112,190,327,0,0,563,1,3,336,351,336,463,7,1680,1287
1544,6,2.0.112,0,584,1,89,112,201,0,112,201,327,0,0,563,1,3,237,351,237,463,7,1680,1287
1544,6,4.1.112,1,579,0,70,112,182,112,0,182,327,-19,65,582,2,2,261,265,327,312,7,1680,1287
1544,6,5.0.112,0,611,2,92,112,204,0,112,204,327,0,0,563,1,3,245,351,245,463,7,1680,1287
1544,7,0.0.112,0,616,3,92,112,204,0,112,204,327,0,0,582,1,3,208,351,208,463,8,1680,1217
1544,7,1.0.112,0,579,0,78,112,190,0,112,190,327,0,0,582,1,3,336,351,336,463,8,1680,1217
1544,7,2.0.112,0,584,1,89,112,201,0,112,201,327,0,0,582,1,3,237,351,237,463,8,1680,1217
1544,7,4.2.182,1,579,0,36,182,218,182,0,218,327,-16,109,598,3,2,191,249,327,322,8,1680,1217
1544,7,5.0.112,0,611,2,92,112,204,0,112,204,327,0,0,582,1,3,245,351,245,463,8,1680,1217
1544,8,0.0.112,0,616,3,92,112,204,0,112,204,327,0,0,598,1,3,208,351,208,463,9,1680,1181
1544,8,1.0.112,0,579,0,78,112,190,0,112,190,327,0,0,598,1,3,336,351,336,463,9,1680,1181
1544,8,2.0.112,0,584,1,89,112,201,0,112,201,327,0,0,598,1,3,237,351,237,463,9,1680,1181
1544,8,4.3.258,1,579,0,62,258,320,218,40,320,327,0,166,598,4,2,155,214,327,306,9,1680,1181
1544,8,5.0.112,0,611,2,92,112,204,0,112,204,327,0,0,598,1,3,245,351,245,463,9,1680,1181
1544,9,0.0.112,0,616,3,92,112,204,0,112,204,327,0,0,598,1,3,208,351,208,463,10,1680,1119
1544,9,1.0.112,0,579,0,78,112,190,0,112,190,327,0,0,598,1,3,336,351,336,463,10,1680,1119
1544,9,2.0.112,0,584,1,89,112,201,0,112,201,327,0,0,598,1,3,237,351,237,463,10,1680,1119
1544,9,4.4.327,1,579,0,93,327,420,320,7,420,420,0,258,598,5,2,93,208,327,277,10,1680,1119
1544,9,5.0.112,0,611,2,92,112,204,0,112,204,327,0,0,598,1,3,245,351,245,463,10,1680,1119
1544,10,0.0.112,0,616,3,92,112,204,0,112,204,420,0,0,598,1,3,208,351,208,463,11,1680,1026
1544,10,1.0.112,1,579,0,78,112,190,0,112,190,420,0,0,598,1,3,336,351,336,463,11,1680,1026
1544,10,2.0.112,0,584,1,89,112,201,0,112,201,420,0,0,598,1,3,237,351,237,463,11,1680,1026
1544,10,5.0.112,0,611,2,92,112,204,0,112,204,420,0,0,598,1,3,245,351,245,463,11,1680,1026
1544,11,0.0.190,0,616,2,92,190,282,0,190,282,420,0,0,598,1,4,208,273,208,463,12,1680,948
1544,11,1.1.190,1,579,0,87,190,277,190,0,277,420,-8,73,606,2,3,258,195,336,312,12,1680,948
1544,11,2.0.190,0,584,1,89,190,279,0,190,279,420,0,0,598,1,4,237,273,237,463,12,1680,948
1544,11,5.0.190,0,579,0,92,190,282,0,190,282,420,0,0,598,1,4,245,273,245,463,12,1680,948
1544,12,0.0.190,0,616,2,92,190,282,0,190,282,420,0,0,606,1,4,208,273,208,463,13,1680,861
1544,12,1.2.277,1,579,0,51,277,328,277,0,328,420,-59,168,665,3,3,171,213,336,322,13,1680,861
1544,12,2.0.190,0,584,1,89,190,279,0,190,279,420,0,0,606,1,4,237,273,237,463,13,1680,861
1544,12,5.0.190,0,579,0,92,190,282,0,190,282,420,0,0,606,1,4,245,273,245,463,13,1680,861
1544,13,0.0.190,0,616,2,92,190,282,0,190,282,420,0,0,665,1,4,208,273,208,463,14,1680,810
1544,13,1.3.328,1,579,0,86,328,414,328,0,414,420,-8,174,673,4,3,120,152,336,306,14,1680,810
1544,13,2.0.190,0,584,1,89,190,279,0,190,279,420,0,0,665,1,4,237,273,237,463,14,1680,810
1544,13,5.0.190,0,579,0,92,190,282,0,190,282,420,0,0,665,1,4,245,273,245,463,14,1680,810
1544,14,0.0.190,0,616,2,92,190,282,0,190,282,420,0,0,673,1,4,208,273,208,463,15,1680,724
1544,14,1.4.420,1,579,0,34,420,454,414,6,454,454,0,258,673,5,3,34,115,336,277,15,1680,724
1544,14,2.0.190,0,584,1,89,190,279,0,190,279,420,0,0,673,1,4,237,273,237,463,15,1680,724
1544,14,5.0.190,0,579,0,92,190,282,0,190,282,420,0,0,673,1,4,245,273,245,463,15,1680,724
1544,15,0.0.190,0,616,2,92,190,282,0,190,282,454,0,0,673,1,4,208,273,208,463,16,1680,690
1544,15,2.0.190,0,584,1,89,190,279,0,190,279,454,0,0,673,1,4,237,273,237,463,16,1680,690
1544,15,5.0.190,1,579,0,92,190,282,0,190,282,454,0,0,673,1,4,245,273,245,463,16,1680,690
1544,16,0.0.282,0,611,1,92,282,374,0,282,374,454,0,0,673,1,5,208,181,208,463,17,1680,598
1544,16,2.0.282,0,579,0,89,282,371,0,282,371,454,0,0,673,1,5,237,181,237,463,17,1680,598
1544,16,5.1.282,1,579,0,62,282,344,282,0,344,454,-5,78,678,2,4,153,108,245,312,17,1680,598
1544,17,0.0.282,0,611,1,92,282,374,0,282,374,454,0,0,678,1,5,208,181,208,463,18,1680,536
1544,17,2.0.282,0,579,0,89,282,371,0,282,371,454,0,0,678,1,5,237,181,237,463,18,1680,536
1544,17,5.2.344,1,579,0,61,344,405,344,0,405,454,-16,184,694,3,4,91,162,245,322,18,1680,536
1544,18,0.0.282,0,611,1,92,282,374,0,282,374,454,0,0,694,1,5,208,181,208,463,19,1680,475
1544,18,2.0.282,0,579,0,89,282,371,0,282,371,454,0,0,694,1,5,237,181,237,463,19,1680,475
1544,18,5.3.414,1,579,0,20,414,434,405,9,434,454,0,174,694,4,4,30,66,245,306,19,1680,475
1544,19,0.0.282,0,611,1,92,282,374,0,282,374,454,0,0,694,1,5,208,181,208,463,20,1680,455
1544,19,2.0.282,0,579,0,89,282,371,0,282,371,454,0,0,694,1,5,237,181,237,463,20,1680,455
1544,19,5.4.454,1,579,0,10,454,464,434,20,464,464,0,258,694,5,4,10,81,245,277,20,1680,455
1544,20,0.0.282,0,611,1,92,282,374,0,282,374,464,0,0,694,1,5,208,181,208,463,21,1680,445
1544,20,2.0.282,1,579,0,89,282,371,0,282,371,464,0,0,694,1,5,237,181,237,463,21,1680,445
1544,21,0.0.371,0,579,0,92,371,463,0,371,463,464,0,0,694,1,6,208,92,208,463,22,1680,356
1544,21,2.1.371,1,579,0,20,371,391,371,0,391,464,-27,105,721,2,5,148,46,237,312,22,1680,356
1544,22,0.0.371,1,579,0,92,371,463,0,371,463,464,0,0,721,1,6,208,92,208,463,23,1680,336
1544,22,2.2.405,0,579,0,69,405,474,391,14,474,474,0,184,721,3,5,128,101,237,322,23,1680,336
1544,23,0.1.463,0,579,0,26,463,489,463,0,489,489,-72,177,793,2,6,116,26,208,312,24,1680,244
1544,23,2.2.405,1,579,0,69,405,474,391,14,474,474,0,184,721,3,5,128,101,237,322,24,1680,244
1544,24,0.1.463,0,579,0,26,463,489,463,0,489,489,-72,177,793,2,6,116,26,208,312,25,1680,175
1544,24,2.3.474,1,579,0,3,474,477,474,0,477,477,-40,214,761,4,5,59,46,237,306,25,1680,175
1544,25,0.1.463,0,579,0,26,463,489,463,0,489,489,-72,177,833,2,6,116,26,208,312,26,1680,172
1544,25,2.4.477,1,579,0,56,477,533,477,0,533,533,-13,271,774,5,5,56,71,237,277,26,1680,172
1544,26,0.1.463,1,579,0,26,463,489,463,0,489,533,-72,177,846,2,6,116,26,208,312,27,1680,116
1544,27,0.2.489,1,579,0,32,489,521,489,0,521,533,-15,199,861,3,6,90,32,208,322,28,1680,90
1544,28,0.3.521,1,579,0,43,521,564,521,0,564,564,-44,258,905,4,6,58,43,208,306,29,1680,58
1544,29,0.4.564,1,579,0,15,564,579,564,0,579,579,-31,302,936,5,6,15,15,208,277,30,1680,15
1545,0,0.0.0,1,527,0,6,0,6,0,0,6,6,0,0,0,1,1,250,378,250,378,1,1445,1445
1545,0,1.0.0,0,527,0,54,0,54,0,0,54,54,0,0,0,1,1,237,378,237,378,1,1445,1445
1545,0,2.0.0,0,527,0,35,0,35,0,0,35,35,0,0,0,1,1,163,378,163,378,1,1445,1445
1545,0,3.0.0,0,531,1,98,0,98,0,0,98,98,0,0,0,1,1,285,378,285,378,1,1445,1445
1545,0,4.0.0,0,527,0,88,0,88,0,0,88,88,0,0,0,1,1,264,378,264,378,1,1445,1445
1545,0,5.0.0,0,565,2,97,0,97,0,0,97,97,0,0,0,1,1,246,378,246,378,1,1445,1445
1545,1,0.1.6,1,527,0,93,6,99,6,0,99,99,-6,6,6,2,1,244,314,250,314,2,1445,1439
1545,1,1.0.6,0,527,0,54,6,60,0,6,60,60,0,0,0,1,2,237,372,237,378,2,1445,1439
1545,1,2.0.6,0,527,0,35,6,41,0,6,41,41,0,0,0,1,2,163,372,163,378,2,1445,1439
1545,1,3.0.6,0,527,0,98,6,104,0,6,104,104,0,0,0,1,2,285,372,285,378,2,1445,1439
1545,1,4.0.6,0,527,0,88,6,94,0,6,94,94,0,0,0,1,2,264,372,264,378,2,1445,1439
1545,1,5.0.6,0,561,1,97,6,103,0,6,103,103,0,0,0,1,2,246,372,246,378,2,1445,1439
1545,2,0.2.99,1,527,0,35,99,134,99,0,134,134,-99,99,105,3,1,151,289,250,289,3,1445,1346
1545,2,1.0.6,0,527,0,54,6,60,0,6,60,99,0,0,6,1,2,237,372,237,378,3,1445,1346
1545,2,2.0.6,0,527,0,35,6,41,0,6,41,99,0,0,6,1,2,163,372,163,378,3,1445,1346
1545,2,3.0.6,0,527,0,98,6,104,0,6,104,104,0,0,6,1,2,285,372,285,378,3,1445,1346
1545,2,4.0.6,0,527,0,88,6,94,0,6,94,99,0,0,6,1,2,264,372,264,378,3,1445,1346
1545,2,5.0.6,0,561,1,97,6,103,0,6,103,103,0,0,6,1,2,246,372,246,378,3,1445,1346
1545,3,0.3.134,1,527,0,49,134,183,134,0,183,183,-134,134,239,4,1,116,258,250,258,4,1445,1311
1545,3,1.0.6,0,527,0,54,6,60,0,6,60,134,0,0,105,1,2,237,372,237,378,4,1445,1311
1545,3,2.0.6,0,527,0,35,6,41,0,6,41,134,0,0,105,1,2,163,372,163,378,4,1445,1311
1545,3,3.0.6,0,527,0,98,6,104,0,6,104,134,0,0,105,1,2,285,372,285,378,4,1445,1311
1545,3,4.0.6,0,527,0,88,6,94,0,6,94,134,0,0,105,1,2,264,372,264,378,4,1445,1311
1545,3,5.0.6,0,561,1,97,6,103,0,6,103,134,0,0,105,1,2,246,372,246,378,4,1445,1311
1545,4,0.4.183,1,527,0,67,183,250,183,0,250,250,-183,183,422,5,1,67,206,250,206,5,1445,1262
1545,4,1.0.6,0,527,0,54,6,60,0,6,60,183,0,0,239,1,2,237,372,237,378,5,1445,1262
1545,4,2.0.6,0,527,0,35,6,41,0,6,41,183,0,0,239,1,2,163,372,163,378,5,1445,1262
1545,4,3.0.6,0,527,0,98,6,104,0,6,104,183,0,0,239,1,2,285,372,285,378,5,1445,1262
1545,4,4.0.6,0,527,0,88,6,94,0,6,94,183,0,0,239,1,2,264,372,264,378,5,1445,1262
1545,4,5.0.6,0,561,1,97,6,103,0,6,103,183,0,0,239,1,2,246,372,246,378,5,1445,1262
1545,5,1.0.6,1,527,0,54,6,60,0,6,60,250,0,0,422,1,2,237,372,237,378,6,1445,1195
1545,5,2.0.6,0,527,0,35,6,41,0,6,41,250,0,0,422,1,2,163,372,163,378,6,1445,1195
1545,5,3.0.6,0,527,0,98,6,104,0,6,104,250,0,0,422,1,2,285,372,285,378,6,1445,1195
1545,5,4.0.6,0,527,0,88,6,94,0,6,94,250,0,0,422,1,2,264,372,264,378,6,1445,1195
1545,5,5.0.6,0,561,1,97,6,103,0,6,103,250,0,0,422,1,2,246,372,246,378,6,1445,1195
1545,6,1.1.99,1,527,0,55,99,154,60,39,154,250,0,6,422,2,2,183,221,237,314,7,1445,1141
1545,6,2.0.60,0,527,0,35,60,95,0,60,95,250,0,0,422,1,3,163,318,163,378,7,1445,1141
1545,6,3.0.60,0,527,0,98,60,158,0,60,158,250,0,0,422,1,3,285,318,285,378,7,1445,1141
1545,6,4.0.60,0,527,0,88,60,148,0,60,148,250,0,0,422,1,3,264,318,264,378,7,1445,1141
1545,6,5.0.60,0,565,1,97,60,157,0,60,157,250,0,0,422,1,3,246,318,246,378,7,1445,1141
1545,7,1.2.154,1,527,0,57,154,211,154,0,211,250,-20,119,442,3,2,128,254,237,289,8,1445,1086
1545,7,2.0.60,0,527,0,35,60,95,0,60,95,250,0,0,422,1,3,163,318,163,378,8,1445,1086
1545,7,3.0.60,0,527,0,98,60,158,0,60,158,250,0,0,422,1,3,285,318,285,378,8,1445,1086
1545,7,4.0.60,0,527,0,88,60,148,0,60,148,250,0,0,422,1,3,264,318,264,378,8,1445,1086
1545,7,5.0.60,0,565,1,97,60,157,0,60,157,250,0,0,422,1,3,246,318,246,378,8,1445,1086
1545,8,1.3.211,1,527,0,28,211,239,211,0,239,250,-28,162,470,4,2,71,209,237,258,9,1445,1029
1545,8,2.0.60,0,527,0,35,60,95,0,60,95,250,0,0,442,1,3,163,318,163,378,9,1445,1029
1545,8,3.0.60,0,527,0,98,60,158,0,60,158,250,0,0,442,1,3,285,318,285,378,9,1445,1029
1545,8,4.0.60,0,527,0,88,60,148,0,60,148,250,0,0,442,1,3,264,318,264,378,9,1445,1029
1545,8,5.0.60,0,565,1,97,60,157,0,60,157,250,0,0,442,1,3,246,318,246,378,9,1445,1029
1545,9,1.4.250,1,527,0,43,250,293,239,11,293,293,0,183,470,5,2,43,139,237,206,10,1445,1001
1545,9,2.0.60,0,527,0,35,60,95,0,60,95,250,0,0,470,1,3,163,318,163,378,10,1445,1001
1545,9,3.0.60,0,527,0,98,60,158,0,60,158,250,0,0,470,1,3,285,318,285,378,10,1445,1001
1545,9,4.0.60,0,527,0,88,60,148,0,60,148,250,0,0,470,1,3,264,318,264,378,10,1445,1001
1545,9,5.0.60,0,565,1,97,60,157,0,60,157,250,0,0,470,1,3,246,318,246,378,10,1445,1001
1545,10,2.0.60,1,527,0,35,60,95,0,60,95,293,0,0,470,1,3,163,318,163,378,11,1445,958
1545,10,3.0.60,0,527,0,98,60,158,0,60,158,293,0,0,470,1,3,285,318,285,378,11,1445,958
1545,10,4.0.60,0,527,0,88,60,148,0,60,148,293,0,0,470,1,3,264,318,264,378,11,1445,958
1545,10,5.0.60,0,565,1,97,60,157,0,60,157,293,0,0,470,1,3,246,318,246,378,11,1445,958
1545,11,2.1.154,1,527,0,14,154,168,95,59,168,293,0,6,470,2,3,128,166,163,314,12,1445,923
1545,11,3.0.95,0,527,0,98,95,193,0,95,193,293,0,0,470,1,4,285,283,285,378,12,1445,923
1545,11,4.0.95,0,527,0,88,95,183,0,95,183,293,0,0,470,1,4,264,283,264,378,12,1445,923
1545,11,5.0.95,0,565,1,97,95,192,0,95,192,293,0,0,470,1,4,246,283,246,378,12,1445,923
1545,12,2.2.211,1,527,0,22,211,233,168,43,233,293,0,119,470,3,3,114,197,163,289,13,1445,909
1545,12,3.0.95,0,527,0,98,95,193,0,95,193,293,0,0,470,1,4,285,283,285,378,13,1445,909
1545,12,4.0.95,0,527,0,88,95,183,0,95,183,293,0,0,470,1,4,264,283,264,378,13,1445,909
1545,12,5.0.95,0,565,1,97,95,192,0,95,192,293,0,0,470,1,4,246,283,246,378,13,1445,909
1545,13,2.3.239,1,527,0,71,239,310,233,6,310,310,0,162,470,4,3,92,181,163,258,14,1445,887
1545,13,3.0.95,0,527,0,98,95,193,0,95,193,293,0,0,470,1,4,285,283,285,378,14,1445,887
1545,13,4.0.95,0,527,0,88,95,183,0,95,183,293,0,0,470,1,4,264,283,264,378,14,1445,887
1545,13,5.0.95,0,565,1,97,95,192,0,95,192,293,0,0,470,1,4,246,283,246,378,14,1445,887
1545,14,2.4.310,1,527,0,21,310,331,310,0,331,331,-17,200,487,5,3,21,96,163,206,15,1445,816
1545,14,3.0.95,0,527,0,98,95,193,0,95,193,310,0,0,470,1,4,285,283,285,378,15,1445,816
1545,14,4.0.95,0,527,0,88,95,183,0,95,183,310,0,0,470,1,4,264,283,264,378,15,1445,816
1545,14,5.0.95,0,565,1,97,95,192,0,95,192,310,0,0,470,1,4,246,283,246,378,15,1445,816
1545,15,3.0.95,0,527,0,98,95,193,0,95,193,331,0,0,487,1,4,285,283,285,378,16,1445,795
1545,15,4.0.95,1,527,0,88,95,183,0,95,183,331,0,0,487,1,4,264,283,264,378,16,1445,795
1545,15,5.0.95,0,565,1,97,95,192,0,95,192,331,0,0,487,1,4,246,283,246,378,16,1445,795
1545,16,3.0.183,0,527,0,98,183,281,0,183,281,331,0,0,487,1,5,285,195,285,378,17,1445,707
1545,16,4.1.183,1,527,0,22,183,205,183,0,205,331,-15,21,502,2,4,176,152,264,314,17,1445,707
1545,16,5.0.183,0,565,1,97,183,280,0,183,280,331,0,0,487,1,5,246,195,246,378,17,1445,707
1545,17,3.0.183,0,527,0,98,183,281,0,183,281,331,0,0,502,1,5,285,195,285,378,18,1445,685
1545,17,4.2.233,1,527,0,36,233,269,205,28,269,331,0,119,502,3,4,154,175,264,289,18,1445,685
1545,17,5.0.183,0,565,1,97,183,280,0,183,280,331,0,0,502,1,5,246,195,246,378,18,1445,685
1545,18,3.0.183,0,527,0,98,183,281,0,183,281,331,0,0,502,1,5,285,195,285,378,19,1445,649
1545,18,4.3.310,1,527,0,55,310,365,269,41,365,365,0,162,502,4,4,118,110,264,258,19,1445,649
1545,18,5.0.183,0,565,1,97,183,280,0,183,280,331,0,0,502,1,5,246,195,246,378,19,1445,649
1545,19,3.0.183,0,527,0,98,183,281,0,183,281,365,0,0,502,1,5,285,195,285,378,20,1445,594
1545,19,4.4.365,1,527,0,63,365,428,365,0,428,428,-34,234,536,5,4,63,75,264,206,20,1445,594
1545,19,5.0.183,0,565,1,97,183,280,0,183,280,365,0,0,502,1,5,246,195,246,378,20,1445,594
1545,20,3.0.183,1,527,0,98,183,281,0,183,281,428,0,0,536,1,5,285,195,285,378,21,1445,531
1545,20,5.0.183,0,565,1,97,183,280,0,183,280,428,0,0,536,1,5,246,195,246,378,21,1445,531
1545,21,3.1.281,0,527,0,85,281,366,281,0,366,428,-76,97,612,2,5,187,130,285,314,22,1445,433
1545,21,5.0.281,1,527,0,97,281,378,0,281,378,428,0,0,536,1,6,246,97,246,378,22,1445,433
1545,22,3.1.281,1,527,0,85,281,366,281,0,366,428,-76,97,612,2,5,187,130,285,314,23,1445,336
1545,22,5.1.378,0,527,0,45,378,423,378,0,423,428,-173,194,709,2,5,149,130,246,314,23,1445,336
1545,23,3.2.366,1,527,0,40,366,406,366,0,406,428,-97,216,709,3,5,102,139,285,289,24,1445,251
1545,23,5.1.378,0,527,0,45,378,423,378,0,423,428,-12,109,624,2,6,149,45,246,314,24,1445,251
1545,24,3.3.406,1,527,0,51,406,457,406,0,457,457,-41,203,750,4,5,62,55,285,258,25,1445,211
1545,24,5.1.378,0,527,0,45,378,423,378,0,423,428,-12,109,721,2,6,149,45,246,314,25,1445,211
1545,25,3.4.457,1,527,0,11,457,468,457,0,468,468,-29,263,779,5,5,11,12,285,206,26,1445,160
1545,25,5.1.378,0,527,0,45,378,423,378,0,423,457,-12,109,762,2,6,149,45,246,314,26,1445,160
1545,26,5.1.378,1,527,0,45,378,423,378,0,423,468,-12,109,791,2,6,149,45,246,314,27,1445,149
1545,27,5.2.423,1,527,0,99,423,522,423,0,522,522,-17,233,808,3,6,104,99,246,289,28,1445,104
1545,28,5.3.522,1,527,0,4,522,526,522,0,526,526,-65,268,873,4,6,5,4,246,258,29,1445,5
1545,29,5.4.526,1,527,0,1,526,527,526,0,527,527,-58,321,931,5,6,1,1,246,206,30,1445,1
1546,0,0.0.0,0,488,2,19,0,19,0,0,19,19,0,0,0,1,1,194,195,194,195,1,1320,1320
1546,0,1.0.0,0,499,3,30,0,30,0,0,30,30,0,0,0,1,1,237,195,237,195,1,1320,1320
1546,0,2.0.0,0,518,5,81,0,81,0,0,81,81,0,0,0,1,1,289,195,289,195,1,1320,1320
1546,0,3.0.0,0,512,4,52,0,52,0,0,52,52,0,0,0,1,1,147,195,147,195,1,1320,1320
1546,0,4.0.0,0,479,1,10,0,10,0,0,10,10,0,0,0,1,1,204,195,204,195,1,1320,1320
1546,0,5.0.0,1,469,0,3,0,3,0,0,3,3,0,0,0,1,1,249,195,249,195,1,1320,1320
1546,1,0.0.3,0,488,2,19,3,22,0,3,22,22,0,0,0,1,2,194,192,194,195,2,1320,1317
1546,1,1.0.3,0,495,3,30,3,33,0,3,33,33,0,0,0,1,2,237,192,237,195,2,1320,1317
1546,1,2.0.3,0,495,3,81,3,84,0,3,84,84,0,0,0,1,2,289,192,289,195,2,1320,1317
1546,1,3.0.3,0,469,0,52,3,55,0,3,55,55,0,0,0,1,2,147,192,147,195,2,1320,1317
1546,1,4.0.3,0,479,1,10,3,13,0,3,13,13,0,0,0,1,2,204,192,204,195,2,1320,1317
1546,1,5.1.3,1,469,0,29,3,32,3,0,32,32,-3,3,3,2,1,246,218,249,218,2,1320,1317
1546,2,0.0.3,0,488,2,19,3,22,0,3,22,32,0,0,3,1,2,194,192,194,195,3,1320,1288
1546,2,1.0.3,0,495,3,30,3,33,0,3,33,33,0,0,3,1,2,237,192,237,195,3,1320,1288
1546,2,2.0.3,0,495,3,81,3,84,0,3,84,84,0,0,3,1,2,289,192,289,195,3,1320,1288
1546,2,3.0.3,0,469,0,52,3,55,0,3,55,55,0,0,3,1,2,147,192,147,195,3,1320,1288
1546,2,4.0.3,0,479,1,10,3,13,0,3,13,32,0,0,3,1,2,204,192,204,195,3,1320,1288
1546,2,5.2.32,1,469,0,38,32,70,32,0,70,70,-32,32,35,3,1,217,258,249,258,3,1320,1288
1546,3,0.0.3,0,488,2,19,3,22,0,3,22,70,0,0,35,1,2,194,192,194,195,4,1320,1250
1546,3,1.0.3,0,495,3,30,3,33,0,3,33,70,0,0,35,1,2,237,192,237,195,4,1320,1250
1546,3,2.0.3,0,495,3,81,3,84,0,3,84,84,0,0,35,1,2,289,192,289,195,4,1320,1250
1546,3,3.0.3,0,469,0,52,3,55,0,3,55,70,0,0,35,1,2,147,192,147,195,4,1320,1250
1546,3,4.0.3,0,479,1,10,3,13,0,3,13,70,0,0,35,1,2,204,192,204,195,4,1320,1250
1546,3,5.3.70,1,495,3,88,70,158,70,0,158,158,-70,70,105,4,1,179,312,249,312,4,1320,1250
1546,4,0.0.3,0,495,0,19,3,22,0,3,22,158,0,0,105,1,2,194,192,194,195,5,1320,1162
1546,4,1.0.3,0,495,0,30,3,33,0,3,33,158,0,0,105,1,2,237,192,237,195,5,1320,1162
1546,4,2.0.3,0,495,0,81,3,84,0,3,84,158,0,0,105,1,2,289,192,289,195,5,1320,1162
1546,4,3.0.3,0,495,0,52,3,55,0,3,55,158,0,0,105,1,2,147,192,147,195,5,1320,1162
1546,4,4.0.3,1,495,0,10,3,13,0,3,13,158,0,0,105,1,2,204,192,204,195,5,1320,1162
1546,4,5.4.158,0,495,0,91,158,249,158,0,249,249,-158,158,263,5,1,91,337,249,337,5,1320,1162
1546,5,0.0.13,0,495,0,19,13,32,0,13,32,158,0,0,105,1,3,194,182,194,195,6,1320,1152
1546,5,1.0.13,1,495,0,30,13,43,0,13,43,158,0,0,105,1,3,237,182,237,195,6,1320,1152
1546,5,2.0.13,0,495,0,81,13,94,0,13,94,158,0,0,105,1,3,289,182,289,195,6,1320,1152
1546,5,3.0.13,0,495,0,52,13,65,0,13,65,158,0,0,105,1,3,147,182,147,195,6,1320,1152
1546,5,4.1.32,0,495,0,74,32,106,13,19,106,158,0,3,105,2,2,194,189,204,218,6,1320,1152
1546,5,5.4.158,0,495,0,91,158,249,158,0,249,249,-158,158,263,5,1,91,337,249,337,6,1320,1152
1546,6,0.0.43,0,495,0,19,43,62,0,43,62,158,0,0,105,1,4,194,152,194,195,7,1320,1122
1546,6,1.1.43,1,495,0,23,43,66,43,0,66,158,-11,14,116,2,2,207,189,237,218,7,1320,1122
1546,6,2.0.43,0,495,0,81,43,124,0,43,124,158,0,0,105,1,4,289,152,289,195,7,1320,1122
1546,6,3.0.43,0,495,0,52,43,95,0,43,95,158,0,0,105,1,4,147,152,147,195,7,1320,1122
1546,6,4.1.32,0,495,0,74,32,106,13,19,106,158,0,3,105,2,2,194,189,204,218,7,1320,1122
1546,6,5.4.158,0,495,0,91,158,249,158,0,249,249,-158,158,263,5,1,91,337,249,337,7,1320,1122
1546,7,0.0.43,0,495,0,19,43,62,0,43,62,158,0,0,116,1,4,194,152,194,195,8,1320,1099
1546,7,1.2.70,1,495,0,62,70,132,66,4,132,158,0,32,116,3,2,184,220,237,258,8,1320,1099
1546,7,2.0.43,0,495,0,81,43,124,0,43,124,158,0,0,116,1,4,289,152,289,195,8,1320,1099
1546,7,3.0.43,0,495,0,52,43,95,0,43,95,158,0,0,116,1,4,147,152,147,195,8,1320,1099
1546,7,4.1.66,0,495,0,74,66,140,13,53,140,158,0,14,116,2,3,194,166,204,218,8,1320,1099
1546,7,5.4.158,0,495,0,91,158,249,158,0,249,249,-158,158,274,5,1,91,337,249,337,8,1320,1099
1546,8,0.0.43,1,495,0,19,43,62,0,43,62,158,0,0,116,1,4,194,152,194,195,9,1320,1037
1546,8,1.3.158,0,495,0,69,158,227,132,26,227,227,0,70,116,4,2,122,224,237,312,9,1320,1037
1546,8,2.0.43,0,495,0,81,43,124,0,43,124,158,0,0,116,1,4,289,152,289,195,9,1320,1037
1546,8,3.0.43,0,495,0,52,43,95,0,43,95,158,0,0,116,1,4,147,152,147,195,9,1320,1037
1546,8,4.1.66,0,495,0,74,66,140,13,53,140,158,0,14,116,2,3,194,166,204,218,9,1320,1037
1546,8,5.4.158,0,495,0,91,158,249,158,0,249,249,-158,158,274,5,1,91,337,249,337,9,1320,1037
1546,9,0.1.66,0,495,0,61,66,127,62,4,127,158,0,14,116,2,3,175,166,194,218,10,1320,1018
1546,9,1.3.158,0,495,0,69,158,227,132,26,227,227,0,70,116,4,2,122,224,237,312,10,1320,1018
1546,9,2.0.62,1,495,0,81,62,143,0,62,143,158,0,0,116,1,5,289,133,289,195,10,1320,1018
1546,9,3.0.62,0,495,0,52,62,114,0,62,114,158,0,0,116,1,5,147,133,147,195,10,1320,1018
1546,9,4.1.66,0,495,0,74,66,140,13,53,140,158,0,14,116,2,3,194,166,204,218,10,1320,1018
1546,9,5.4.158,0,495,0,91,158,249,158,0,249,249,-158,158,274,5,1,91,337,249,337,10,1320,1018
1546,10,0.1.66,0,495,0,61,66,127,62,4,127,158,0,14,116,2,3,175,166,194,218,11,1320,937
1546,10,1.3.158,0,495,0,69,158,227,132,26,227,227,0,70,116,4,2,122,224,237,312,11,1320,937
1546,10,2.1.143,0,495,0,7,143,150,143,0,150,158,-77,91,193,2,3,208,166,289,218,11,1320,937
1546,10,3.0.143,1,495,0,52,143,195,0,143,195,195,0,0,116,1,6,147,52,147,195,11,1320,937
1546,10,4.1.66,0,495,0,74,66,140,13,53,140,158,0,14,116,2,3,194,166,204,218,11,1320,937
1546,10,5.4.158,0,495,0,91,158,249,158,0,249,249,-158,158,274,5,1,91,337,249,337,11,1320,937
1546,11,0.1.66,0,495,0,61,66,127,62,4,127,195,0,14,116,2,3,175,166,194,218,12,1320,885
1546,11,1.3.158,0,495,0,69,158,227,132,26,227,227,0,70,116,4,2,122,224,237,312,12,1320,885
1546,11,2.1.143,1,495,0,7,143,150,143,0,150,195,-77,91,193,2,3,208,166,289,218,12,1320,885
1546,11,3.1.195,0,495,0,24,195,219,195,0,219,219,-129,143,245,2,3,95,166,147,218,12,1320,885
1546,11,4.1.66,0,495,0,74,66,140,13,53,140,195,0,14,116,2,3,194,166,204,218,12,1320,885
1546,11,5.4.158,0,495,0,91,158,249,158,0,249,249,-158,158,274,5,1,91,337,249,337,12,1320,885
1546,12,0.1.66,0,495,0,61,66,127,62,4,150,195,61,30,132,2,4,175,159,194,218,13,1320,878
1546,12,1.3.158,0,495,0,69,158,227,132,26,227,227,0,70,193,4,2,122,224,237,312,13,1320,878
1546,12,2.2.150,1,495,0,75,150,225,150,0,225,225,-18,50,211,3,3,201,158,289,258,13,1320,878
1546,12,3.1.195,0,495,0,24,195,219,195,0,219,219,-45,136,238,2,4,95,159,147,218,13,1320,878
1546,12,4.1.66,0,495,0,74,66,140,13,53,150,195,74,17,119,2,4,194,159,204,218,13,1320,878
1546,12,5.4.158,0,495,0,91,158,249,158,0,249,249,-158,158,351,5,1,91,337,249,337,13,1320,878
1546,13,0.1.66,0,495,0,61,66,127,62,4,150,225,61,30,150,2,4,175,159,194,218,14,1320,803
1546,13,1.3.158,1,495,0,69,158,227,132,26,227,227,0,70,211,4,2,122,224,237,312,14,1320,803
1546,13,2.3.225,0,511,1,40,225,265,225,0,265,265,-67,137,278,4,2,126,224,289,312,14,1320,803
1546,13,3.1.195,0,495,0,24,195,219,195,0,219,225,-45,136,256,2,4,95,159,147,218,14,1320,803
1546,13,4.1.66,0,495,0,74,66,140,13,53,150,225,74,17,137,2,4,194,159,204,218,14,1320,803
1546,13,5.4.158,0,495,0,91,158,249,158,0,249,249,-158,158,369,5,1,91,337,249,337,14,1320,803
1546,14,0.1.66,0,495,0,61,66,127,62,4,150,227,61,30,150,2,4,175,159,194,218,15,1320,734
1546,14,1.4.227,0,564,1,53,227,280,227,0,280,280,-227,227,438,5,1,53,337,237,337,15,1320,734
1546,14,2.3.227,1,495,0,40,227,267,225,2,267,267,0,70,211,4,3,126,155,289,312,15,1320,734
1546,14,3.1.195,0,495,0,24,195,219,195,0,219,227,-45,136,256,2,4,95,159,147,218,15,1320,734
1546,14,4.1.66,0,495,0,74,66,140,13,53,150,227,74,17,137,2,4,194,159,204,218,15,1320,734
1546,14,5.4.158,0,495,0,91,158,249,158,0,249,249,-158,158,369,5,1,91,337,249,337,15,1320,734
1546,15,0.1.66,0,495,0,61,66,127,62,4,150,267,61,30,150,2,4,175,159,194,218,16,1320,694
1546,15,1.4.227,0,564,2,53,227,280,227,0,280,280,-227,227,438,5,1,53,337,237,337,16,1320,694
1546,15,2.4.267,0,513,1,86,267,353,267,0,353,353,-267,267,478,5,1,86,337,289,337,16,1320,694
1546,15,3.1.195,0,495,0,24,195,219,195,0,219,267,-45,136,256,2,4,95,159,147,218,16,1320,694
1546,15,4.1.66,1,495,0,74,66,140,13,53,150,267,74,17,137,2,4,194,159,204,218,16,1320,694
1546,15,5.4.158,0,495,0,91,158,249,158,0,249,267,-158,158,369,5,1,91,337,249,337,16,1320,694
1546,16,0.1.150,0,495,0,61,150,211,62,88,211,267,0,17,137,2,5,175,85,194,218,17,1320,620
1546,16,1.4.227,0,564,2,53,227,280,227,0,280,280,-227,227,364,5,1,53,337,237,337,17,1320,620
1546,16,2.4.267,0,513,1,86,267,353,267,0,353,353,-267,267,404,5,1,86,337,289,337,17,1320,620
1546,16,3.1.195,0,495,0,24,195,219,195,0,219,267,-45,62,182,2,5,95,85,147,218,17,1320,620
1546,16,4.2.225,1,495,0,37,225,262,140,85,262,267,0,50,137,3,4,120,83,204,258,17,1320,620
1546,16,5.4.158,0,495,0,91,158,249,158,0,249,267,-158,158,295,5,1,91,337,249,337,17,1320,620
1546,17,0.1.150,1,495,0,61,150,211,62,88,211,267,0,17,137,2,5,175,85,194,218,18,1320,583
1546,17,1.4.227,0,564,2,53,227,280,227,0,280,280,-227,227,364,5,1,53,337,237,337,18,1320,583
1546,17,2.4.267,0,513,1,86,267,353,267,0,353,353,-267,267,404,5,1,86,337,289,337,18,1320,583
1546,17,3.1.195,0,495,0,24,195,219,195,0,219,267,-45,62,182,2,5,95,85,147,218,18,1320,583
1546,17,4.3.267,0,495,0,49,267,316,262,5,316,316,0,70,137,4,4,83,115,204,312,18,1320,583
1546,17,5.4.158,0,495,0,91,158,249,158,0,249,267,-158,158,295,5,1,91,337,249,337,18,1320,583
1546,18,0.2.262,1,495,0,38,262,300,211,51,300,300,0,50,137,3,5,114,46,194,258,19,1320,522
1546,18,1.4.227,0,564,2,53,227,280,227,0,280,280,-227,227,364,5,1,53,337,237,337,19,1320,522
1546,18,2.4.267,0,513,1,86,267,353,267,0,353,353,-267,267,404,5,1,86,337,289,337,19,1320,522
1546,18,3.1.211,0,495,0,24,211,235,195,16,235,267,0,17,137,2,6,95,24,147,218,19,1320,522
1546,18,4.3.267,0,495,0,49,267,316,262,5,316,316,0,70,137,4,4,83,115,204,312,19,1320,522
1546,18,5.4.158,0,495,0,91,158,249,158,0,249,267,-158,158,295,5,1,91,337,249,337,19,1320,522
1546,19,0.3.300,0,495,0,56,300,356,300,0,356,356,-33,103,170,4,4,76,115,194,312,20,1320,484
1546,19,1.4.227,0,564,2,53,227,280,227,0,280,300,-227,227,364,5,1,53,337,237,337,20,1320,484
1546,19,2.4.267,0,513,1,86,267,353,267,0,353,353,-267,267,404,5,1,86,337,289,337,20,1320,484
1546,19,3.1.211,1,495,0,24,211,235,195,16,235,300,0,17,137,2,6,95,24,147,218,20,1320,484
1546,19,4.3.267,0,495,0,49,267,316,262,5,316,316,0,70,137,4,4,83,115,204,312,20,1320,484
1546,19,5.4.158,0,495,0,91,158,249,158,0,249,300,-158,158,295,5,1,91,337,249,337,20,1320,484
1546,20,0.3.300,0,495,0,56,300,356,300,0,356,356,-33,103,170,4,4,76,115,194,312,21,1320,460
1546,20,1.4.227,0,564,2,53,227,280,227,0,280,300,-227,227,364,5,1,53,337,237,337,21,1320,460
1546,20,2.4.267,0,513,1,86,267,353,267,0,353,353,-267,267,404,5,1,86,337,289,337,21,1320,460
1546,20,3.2.300,1,495,0,8,300,308,235,65,308,308,0,50,137,3,6,71,8,147,258,21,1320,460
1546,20,4.3.267,0,495,0,49,267,316,262,5,316,316,0,70,137,4,4,83,115,204,312,21,1320,460
1546,20,5.4.158,0,495,0,91,158,249,158,0,249,300,-158,158,295,5,1,91,337,249,337,21,1320,460
1546,21,0.3.300,0,495,0,56,300,356,300,0,356,356,-33,103,170,4,4,76,115,194,312,22,1320,452
1546,21,1.4.227,0,564,2,53,227,280,227,0,280,308,-227,227,364,5,1,53,337,237,337,22,1320,452
1546,21,2.4.267,0,513,1,86,267,353,267,0,353,353,-267,267,404,5,1,86,337,289,337,22,1320,452
1546,21,3.3.308,0,495,0,10,308,318,308,0,318,318,-41,111,178,4,4,63,115,147,312,22,1320,452
1546,21,4.3.267,1,495,0,49,267,316,262,5,316,316,0,70,137,4,4,83,115,204,312,22,1320,452
1546,21,5.4.158,0,495,0,91,158,249,158,0,249,308,-158,158,295,5,1,91,337,249,337,22,1320,452
1546,22,0.3.316,0,495,0,56,316,372,300,16,372,372,0,70,137,4,5,76,66,194,312,23,1320,403
1546,22,1.4.227,0,564,3,53,227,280,227,0,280,316,-227,227,364,5,1,53,337,237,337,23,1320,403
1546,22,2.4.267,0,513,2,86,267,353,267,0,353,353,-267,267,404,5,1,86,337,289,337,23,1320,403
1546,22,3.3.316,1,495,0,10,316,326,308,8,326,326,0,70,137,4,5,63,66,147,312,23,1320,403
1546,22,4.4.316,0,509,1,34,316,350,316,0,350,350,-316,316,453,5,1,34,337,204,337,23,1320,403
1546,22,5.4.158,0,495,0,91,158,249,158,0,249,316,-158,158,295,5,1,91,337,249,337,23,1320,403
1546,23,0.3.326,1,495,0,56,326,382,300,26,382,382,0,70,137,4,6,76,56,194,312,24,1320,393
1546,23,1.4.227,0,564,4,53,227,280,227,0,280,326,-227,227,364,5,1,53,337,237,337,24,1320,393
1546,23,2.4.267,0,513,2,86,267,353,267,0,353,353,-267,267,404,5,1,86,337,289,337,24,1320,393
1546,23,3.4.326,0,519,3,53,326,379,326,0,379,379,-326,326,463,5,1,53,337,147,337,24,1320,393
1546,23,4.4.316,0,509,1,34,316,350,316,0,350,350,-316,316,453,5,1,34,337,204,337,24,1320,393
1546,23,5.4.158,0,495,0,91,158,249,158,0,249,326,-158,158,295,5,1,91,337,249,337,24,1320,393
1546,24,0.4.382,0,522,4,20,382,402,382,0,402,402,-382,382,519,5,1,20,337,194,337,25,1320,337
1546,24,1.4.227,0,564,5,53,227,280,227,0,280,382,-227,227,364,5,1,53,337,237,337,25,1320,337
1546,24,2.4.267,0,513,2,86,267,353,267,0,353,382,-267,267,404,5,1,86,337,289,337,25,1320,337
1546,24,3.4.326,0,519,3,53,326,379,326,0,379,382,-326,326,463,5,1,53,337,147,337,25,1320,337
1546,24,4.4.316,0,509,1,34,316,350,316,0,350,382,-316,316,453,5,1,34,337,204,337,25,1320,337
1546,24,5.4.158,1,495,0,91,158,249,158,0,249,382,-158,158,295,5,1,91,337,249,337,25,1320,337
1546,25,0.4.382,0,522,4,20,382,402,382,0,402,402,-133,291,428,5,2,20,246,194,337,26,1320,246
1546,25,1.4.249,1,495,0,53,249,302,227,22,302,382,0,158,295,5,2,53,246,237,337,26,1320,246
1546,25,2.4.267,0,513,2,86,267,353,267,0,353,382,-18,176,313,5,2,86,246,289,337,26,1320,246
1546,25,3.4.326,0,519,3,53,326,379,326,0,379,382,-77,235,372,5,2,53,246,147,337,26,1320,246
1546,25,4.4.316,0,509,1,34,316,350,316,0,350,382,-67,225,362,5,2,34,246,204,337,26,1320,246
1546,26,0.4.382,0,522,3,20,382,402,382,0,402,402,-80,238,375,5,3,20,193,194,337,27,1320,193
1546,26,2.4.302,1,495,0,86,302,388,267,35,388,388,0,158,295,5,3,86,193,289,337,27,1320,193
1546,26,3.4.326,0,519,2,53,326,379,326,0,379,382,-24,182,319,5,3,53,193,147,337,27,1320,193
1546,26,4.4.316,0,509,1,34,316,350,316,0,350,382,-14,172,309,5,3,34,193,204,337,27,1320,193
1546,27,0.4.388,0,495,0,20,388,408,382,6,408,408,0,158,295,5,4,20,107,194,337,28,1320,107
1546,27,3.4.388,0,495,0,53,388,441,326,62,441,441,0,158,295,5,4,53,107,147,337,28,1320,107
1546,27,4.4.388,1,495,0,34,388,422,316,72,422,422,0,158,295,5,4,34,107,204,337,28,1320,107
1546,28,0.4.422,1,495,0,20,422,442,382,40,442,442,0,158,295,5,5,20,73,194,337,29,1320,73
1546,28,3.4.422,0,495,0,53,422,475,326,96,475,475,0,158,295,5,5,53,73,147,337,29,1320,73
1546,29,3.4.442,1,495,0,53,442,495,326,116,495,495,0,158,295,5,6,53,53,147,337,30,1320,53
1547,0,0.0.0,0,517,0,32,0,32,0,0,32,32,0,0,0,1,1,237,109,237,109,1,1288,1288
1547,0,1.0.0,0,522,2,5,0,5,0,0,5,5,0,0,0,1,1,236,109,236,109,1,1288,1288
1547,0,2.0.0,0,520,1,27,0,27,0,0,27,27,0,0,0,1,1,117,109,117,109,1,1288,1288
1547,0,3.0.0,1,523,3,6,0,6,0,0,6,6,0,0,0,1,1,305,109,305,109,1,1288,1288
1547,0,4.0.0,0,548,4,32,0,32,0,0,32,32,0,0,0,1,1,142,109,142,109,1,1288,1288
1547,0,5.0.0,0,520,1,7,0,7,0,0,7,7,0,0,0,1,1,251,109,251,109,1,1288,1288
1547,1,0.0.6,0,523,0,32,6,38,0,6,38,38,0,0,0,1,2,237,103,237,109,2,1288,1282
1547,1,1.0.6,0,527,2,5,6,11,0,6,11,11,0,0,0,1,2,236,103,236,109,2,1288,1282
1547,1,2.0.6,0,526,1,27,6,33,0,6,33,33,0,0,0,1,2,117,103,117,109,2,1288,1282
1547,1,3.1.6,0,526,1,62,6,68,6,0,68,68,-6,6,6,2,1,299,220,305,220,2,1288,1282
1547,1,4.0.6,0,554,3,32,6,38,0,6,38,38,0,0,0,1,2,142,103,142,109,2,1288,1282
1547,1,5.0.6,1,526,1,7,6,13,0,6,13,13,0,0,0,1,2,251,103,251,109,2,1288,1282
1547,2,0.0.13,0,526,0,32,13,45,0,13,45,45,0,0,0,1,3,237,96,237,109,3,1288,1275
1547,2,1.0.13,1,526,0,5,13,18,0,13,18,18,0,0,0,1,3,236,96,236,109,3,1288,1275
1547,2,2.0.13,0,526,0,27,13,40,0,13,40,40,0,0,0,1,3,117,96,117,109,3,1288,1275
1547,2,3.1.6,0,529,1,62,6,68,6,0,68,68,-6,6,6,2,1,299,220,305,220,3,1288,1275
1547,2,4.0.13,0,526,0,32,13,45,0,13,45,45,0,0,0,1,3,142,96,142,109,3,1288,1275
1547,2,5.1.13,0,526,0,12,13,25,13,0,25,25,-13,13,13,2,1,244,220,251,220,3,1288,1275
1547,3,0.0.18,1,526,0,32,18,50,0,18,50,50,0,0,0,1,4,237,91,237,109,4,1288,1270
1547,3,1.1.18,0,569,2,90,18,108,18,0,108,108,-18,18,18,2,1,231,220,236,220,4,1288,1270
1547,3,2.0.18,0,526,0,27,18,45,0,18,45,45,0,0,0,1,4,117,91,117,109,4,1288,1270
1547,3,3.1.6,0,534,1,62,6,68,6,0,68,68,-6,6,6,2,1,299,220,305,220,4,1288,1270
1547,3,4.0.18,0,526,0,32,18,50,0,18,50,50,0,0,0,1,4,142,91,142,109,4,1288,1270
1547,3,5.1.13,0,526,0,12,13,25,13,0,25,25,-13,13,13,2,1,244,220,251,220,4,1288,1270
1547,4,0.1.50,0,526,0,29,50,79,50,0,79,79,-50,50,50,2,1,205,220,237,220,5,1288,1238
1547,4,1.1.18,0,569,2,90,18,108,18,0,108,108,-18,18,18,2,1,231,220,236,220,5,1288,1238
1547,4,2.0.50,0,526,0,27,50,77,0,50,77,77,0,0,0,1,5,117,59,117,109,5,1288,1238
1547,4,3.1.6,0,535,1,62,6,68,6,0,68,68,-6,6,6,2,1,299,220,305,220,5,1288,1238
1547,4,4.0.50,1,535,1,32,50,82,0,50,82,82,0,0,0,1,5,142,59,142,109,5,1288,1238
1547,4,5.1.13,0,526,0,12,13,25,13,0,25,50,-13,13,13,2,1,244,220,251,220,5,1288,1238
1547,5,0.1.50,0,535,0,29,50,79,50,0,79,82,-50,50,50,2,1,205,220,237,220,6,1288,1206
1547,5,1.1.18,0,569,2,90,18,108,18,0,108,108,-18,18,18,2,1,231,220,236,220,6,1288,1206
1547,5,2.0.82,1,535,0,27,82,109,0,82,109,109,0,0,0,1,6,117,27,117,109,6,1288,1206
1547,5,3.1.6,0,553,1,62,6,68,6,0,68,82,-6,6,6,2,1,299,220,305,220,6,1288,1206
1547,5,4.1.82,0,535,0,26,82,108,82,0,108,108,-82,82,82,2,1,110,220,142,220,6,1288,1206
1547,5,5.1.13,0,535,0,12,13,25,13,0,25,82,-13,13,13,2,1,244,220,251,220,6,1288,1206
1547,6,0.1.50,0,535,0,29,50,79,50,0,79,109,-50,50,50,2,1,205,220,237,220,7,1288,1179
1547,6,1.1.18,0,569,2,90,18,108,18,0,108,109,-18,18,18,2,1,231,220,236,220,7,1288,1179
1547,6,2.1.109,0,535,0,1,109,110,109,0,110,110,-109,109,109,2,1,90,220,117,220,7,1288,1179
1547,6,3.1.6,0,553,1,62,6,68,6,0,68,109,-6,6,6,2,1,299,220,305,220,7,1288,1179
1547,6,4.1.82,0,535,0,26,82,108,82,0,108,109,-82,82,82,2,1,110,220,142,220,7,1288,1179
1547,6,5.1.13,1,535,0,12,13,25,13,0,25,109,-13,13,13,2,1,244,220,251,220,7,1288,1179
1547,7,0.1.50,0,535,0,29,50,79,50,0,79,109,-25,38,38,2,2,205,208,237,220,8,1288,1167
1547,7,1.1.25,0,541,1,90,25,115,18,7,115,115,0,13,13,2,2,231,208,236,220,8,1288,1167
1547,7,2.1.109,0,535,0,1,109,110,109,0,110,110,-84,97,97,2,2,90,208,117,220,8,1288,1167
1547,7,3.1.25,1,535,0,62,25,87,6,19,87,109,0,13,13,2,2,299,208,305,220,8,1288,1167
1547,7,4.1.82,0,535,0,26,82,108,82,0,108,109,-57,70,70,2,2,110,208,142,220,8,1288,1167
1547,7,5.2.25,0,535,0,76,25,101,25,0,101,109,-25,25,38,3,1,232,325,251,325,8,1288,1167
1547,8,0.1.87,1,541,2,29,87,116,50,37,116,116,0,13,13,2,3,205,146,237,220,9,1288,1105
1547,8,1.1.87,0,541,2,90,87,177,18,69,177,177,0,13,13,2,3,231,146,236,220,9,1288,1105
1547,8,2.1.109,0,535,0,1,109,110,109,0,110,110,-22,35,35,2,3,90,146,117,220,9,1288,1105
1547,8,3.2.87,0,582,3,74,87,161,87,0,161,161,-87,87,100,3,1,237,325,305,325,9,1288,1105
1547,8,4.1.87,0,539,1,26,87,113,82,5,113,113,0,13,13,2,3,110,146,142,220,9,1288,1105
1547,8,5.2.25,0,535,0,76,25,101,25,0,101,109,-25,25,38,3,1,232,325,251,325,9,1288,1105
1547,9,0.2.116,0,541,0,42,116,158,116,0,158,158,-116,116,129,3,1,176,325,237,325,10,1288,1076
1547,9,1.1.116,0,541,0,90,116,206,18,98,206,206,0,13,13,2,4,231,117,236,220,10,1288,1076
1547,9,2.1.116,1,541,0,1,116,117,109,7,117,117,0,13,13,2,4,90,117,117,220,10,1288,1076
1547,9,3.2.87,0,582,1,74,87,161,87,0,161,161,-87,87,100,3,1,237,325,305,325,10,1288,1076
1547,9,4.1.116,0,541,0,26,116,142,82,34,142,142,0,13,13,2,4,110,117,142,220,10,1288,1076
1547,9,5.2.25,0,541,0,76,25,101,25,0,101,116,-25,25,38,3,1,232,325,251,325,10,1288,1076
1547,10,0.2.116,0,541,0,42,116,158,116,0,158,158,-116,116,129,3,1,176,325,237,325,11,1288,1075
1547,10,1.1.117,0,541,0,90,117,207,18,99,207,207,0,13,13,2,5,231,116,236,220,11,1288,1075
1547,10,2.2.117,0,541,0,28,117,145,117,0,145,145,-117,117,130,3,1,89,325,117,325,11,1288,1075
1547,10,3.2.87,0,582,1,74,87,161,87,0,161,161,-87,87,100,3,1,237,325,305,325,11,1288,1075
1547,10,4.1.117,1,541,0,26,117,143,82,35,143,143,0,13,13,2,5,110,116,142,220,11,1288,1075
1547,10,5.2.25,0,541,0,76,25,101,25,0,101,117,-25,25,38,3,1,232,325,251,325,11,1288,1075
1547,11,0.2.116,0,541,0,42,116,158,116,0,158,158,-116,116,129,3,1,176,325,237,325,12,1288,1049
1547,11,1.1.143,1,541,0,90,143,233,18,125,233,233,0,13,13,2,6,231,90,236,220,12,1288,1049
1547,11,2.2.117,0,541,0,28,117,145,117,0,145,145,-117,117,130,3,1,89,325,117,325,12,1288,1049
1547,11,3.2.87,0,582,2,74,87,161,87,0,161,161,-87,87,100,3,1,237,325,305,325,12,1288,1049
1547,11,4.2.143,0,550,1,38,143,181,143,0,181,181,-143,143,156,3,1,84,325,142,325,12,1288,1049
1547,11,5.2.25,0,541,0,76,25,101,25,0,101,143,-25,25,38,3,1,232,325,251,325,12,1288,1049
1547,12,0.2.116,0,541,0,42,116,158,116,0,158,233,-116,116,129,3,1,176,325,237,325,13,1288,959
1547,12,1.2.233,0,541,0,67,233,300,233,0,300,300,-233,233,246,3,1,141,325,236,325,13,1288,959
1547,12,2.2.117,0,541,0,28,117,145,117,0,145,233,-117,117,130,3,1,89,325,117,325,13,1288,959
1547,12,3.2.87,0,582,2,74,87,161,87,0,161,233,-87,87,100,3,1,237,325,305,325,13,1288,959
1547,12,4.2.143,0,550,1,38,143,181,143,0,181,233,-143,143,156,3,1,84,325,142,325,13,1288,959
1547,12,5.2.25,1,541,0,76,25,101,25,0,101,233,-25,25,38,3,1,232,325,251,325,13,1288,959
1547,13,0.2.116,0,541,0,42,116,158,116,0,158,233,-15,40,53,3,2,176,249,237,325,14,1288,883
1547,13,1.2.233,0,541,0,67,233,300,233,0,300,300,-132,157,170,3,2,141,249,236,325,14,1288,883
1547,13,2.2.117,0,541,0,28,117,145,117,0,145,233,-16,41,54,3,2,89,249,117,325,14,1288,883
1547,13,3.2.101,0,541,0,74,101,175,87,14,175,233,0,25,38,3,2,237,249,305,325,14,1288,883
1547,13,4.2.143,0,550,1,38,143,181,143,0,181,233,-42,67,80,3,2,84,249,142,325,14,1288,883
1547,13,5.3.101,1,541,0,73,101,174,101,0,174,233,-101,101,139,4,1,156,267,251,267,14,1288,883
1547,14,0.2.116,0,541,0,42,116,158,116,0,158,233,-15,40,154,3,2,176,249,237,325,15,1288,810
1547,14,1.2.233,0,541,0,67,233,300,233,0,300,300,-132,157,271,3,2,141,249,236,325,15,1288,810
1547,14,2.2.117,0,541,0,28,117,145,117,0,145,233,-16,41,155,3,2,89,249,117,325,15,1288,810
1547,14,3.2.101,1,541,0,74,101,175,87,14,175,233,0,25,139,3,2,237,249,305,325,15,1288,810
1547,14,4.2.143,0,550,1,38,143,181,143,0,181,233,-42,67,181,3,2,84,249,142,325,15,1288,810
1547,14,5.4.174,0,541,0,83,174,257,174,0,257,257,-174,174,313,5,1,83,367,251,367,15,1288,810
1547,15,0.2.175,0,541,0,42,175,217,116,59,217,233,0,25,139,3,3,176,175,237,325,16,1288,736
1547,15,1.2.233,0,541,0,67,233,300,233,0,300,300,-58,83,197,3,3,141,175,236,325,16,1288,736
1547,15,2.2.175,0,541,0,28,175,203,117,58,203,233,0,25,139,3,3,89,175,117,325,16,1288,736
1547,15,3.3.175,1,541,0,69,175,244,175,0,244,244,-1,102,140,4,2,163,194,305,267,16,1288,736
1547,15,4.2.175,0,541,0,38,175,213,143,32,213,233,0,25,139,3,3,84,175,142,325,16,1288,736
1547,15,5.4.174,0,541,0,83,174,257,174,0,257,257,-174,174,313,5,1,83,367,251,367,16,1288,736
1547,16,0.2.175,1,541,0,42,175,217,116,59,217,244,0,25,140,3,3,176,175,237,325,17,1288,667
1547,16,1.2.233,0,541,0,67,233,300,233,0,300,300,-58,83,198,3,3,141,175,236,325,17,1288,667
1547,16,2.2.175,0,541,0,28,175,203,117,58,203,244,0,25,140,3,3,89,175,117,325,17,1288,667
1547,16,3.4.244,0,611,1,94,244,338,244,0,338,338,-244,244,384,5,1,94,367,305,367,17,1288,667
1547,16,4.2.175,0,541,0,38,175,213,143,32,213,244,0,25,140,3,3,84,175,142,325,17,1288,667
1547,16,5.4.174,0,541,0,83,174,257,174,0,257,257,-174,174,314,5,1,83,367,251,367,17,1288,667
1547,17,0.3.244,1,541,0,62,244,306,217,27,306,306,0,102,140,4,3,134,125,237,267,18,1288,625
1547,17,1.2.233,0,541,0,67,233,300,233,0,300,300,-16,41,156,3,4,141,133,236,325,18,1288,625
1547,17,2.2.217,0,541,0,28,217,245,117,100,245,245,0,25,140,3,4,89,133,117,325,18,1288,625
1547,17,3.4.244,0,611,1,94,244,338,244,0,338,338,-244,244,384,5,1,94,367,305,367,18,1288,625
1547,17,4.2.217,0,541,0,38,217,255,143,74,255,255,0,25,140,3,4,84,133,142,325,18,1288,625
1547,17,5.4.174,0,541,0,83,174,257,174,0,257,257,-174,174,314,5,1,83,367,251,367,18,1288,625
1547,18,0.4.306,0,590,1,72,306,378,306,0,378,378,-306,306,446,5,1,72,367,237,367,19,1288,563
1547,18,1.2.233,0,541,0,67,233,300,233,0,300,306,-16,41,156,3,4,141,133,236,325,19,1288,563
1547,18,2.2.217,1,541,0,28,217,245,117,100,245,306,0,25,140,3,4,89,133,117,325,19,1288,563
1547,18,3.4.244,0,611,2,94,244,338,244,0,338,338,-244,244,384,5,1,94,367,305,367,19,1288,563
1547,18,4.2.217,0,541,0,38,217,255,143,74,255,306,0,25,140,3,4,84,133,142,325,19,1288,563
1547,18,5.4.174,0,541,0,83,174,257,174,0,257,306,-174,174,314,5,1,83,367,251,367,19,1288,563
1547,19,0.4.306,0,590,1,72,306,378,306,0,378,378,-306,306,446,5,1,72,367,237,367,20,1288,535
1547,19,1.2.245,0,541,0,67,245,312,233,12,312,312,0,25,140,3,5,141,105,236,325,20,1288,535
1547,19,2.3.306,1,541,0,9,306,315,245,61,315,315,0,102,140,4,4,61,63,117,267,20,1288,535
1547,19,3.4.244,0,611,2,94,244,338,244,0,338,338,-244,244,384,5,1,94,367,305,367,20,1288,535
1547,19,4.2.245,0,541,0,38,245,283,143,102,283,306,0,25,140,3,5,84,105,142,325,20,1288,535
1547,19,5.4.174,0,541,0,83,174,257,174,0,257,306,-174,174,314,5,1,83,367,251,367,20,1288,535
1547,20,0.4.306,0,590,1,72,306,378,306,0,378,378,-306,306,446,5,1,72,367,237,367,21,1288,526
1547,20,1.2.245,0,541,0,67,245,312,233,12,312,315,0,25,140,3,5,141,105,236,325,21,1288,526
1547,20,2.4.315,0,599,2,52,315,367,315,0,367,367,-315,315,455,5,1,52,367,117,367,21,1288,526
1547,20,3.4.244,0,611,3,94,244,338,244,0,338,338,-244,244,384,5,1,94,367,305,367,21,1288,526
1547,20,4.2.245,1,541,0,38,245,283,143,102,283,315,0,25,140,3,5,84,105,142,325,21,1288,526
1547,20,5.4.174,0,541,0,83,174,257,174,0,257,315,-174,174,314,5,1,83,367,251,367,21,1288,526
1547,21,0.4.306,0,590,1,72,306,378,306,0,378,378,-306,306,446,5,1,72,367,237,367,22,1288,488
1547,21,1.2.283,0,541,0,67,283,350,233,50,350,350,0,25,140,3,6,141,67,236,325,22,1288,488
1547,21,2.4.315,0,599,2,52,315,367,315,0,367,367,-315,315,455,5,1,52,367,117,367,22,1288,488
1547,21,3.4.244,0,611,3,94,244,338,244,0,338,338,-244,244,384,5,1,94,367,305,367,22,1288,488
1547,21,4.3.315,1,541,0,42,315,357,283,32,357,357,0,102,140,4,5,46,54,142,267,22,1288,488
1547,21,5.4.174,0,541,0,83,174,257,174,0,257,315,-174,174,314,5,1,83,367,251,367,22,1288,488
1547,22,0.4.306,0,590,2,72,306,378,306,0,378,378,-306,306,446,5,1,72,367,237,367,23,1288,446
1547,22,1.2.283,1,541,0,67,283,350,233,50,350,357,0,25,140,3,6,141,67,236,325,23,1288,446
1547,22,2.4.315,0,599,3,52,315,367,315,0,367,367,-315,315,455,5,1,52,367,117,367,23,1288,446
1547,22,3.4.244,0,611,4,94,244,338,244,0,338,357,-244,244,384,5,1,94,367,305,367,23,1288,446
1547,22,4.4.357,0,547,1,4,357,361,357,0,361,361,-357,357,497,5,1,4,367,142,367,23,1288,446
1547,22,5.4.174,0,541,0,83,174,257,174,0,257,357,-174,174,314,5,1,83,367,251,367,23,1288,446
1547,23,0.4.306,0,590,2,72,306,378,306,0,378,378,-306,306,446,5,1,72,367,237,367,24,1288,379
1547,23,1.3.357,1,541,0,12,357,369,350,7,369,369,0,102,140,4,6,74,12,236,267,24,1288,379
1547,23,2.4.315,0,599,3,52,315,367,315,0,367,367,-315,315,455,5,1,52,367,117,367,24,1288,379
1547,23,3.4.244,0,611,4,94,244,338,244,0,338,357,-244,244,384,5,1,94,367,305,367,24,1288,379
1547,23,4.4.357,0,547,1,4,357,361,357,0,361,361,-357,357,497,5,1,4,367,142,367,24,1288,379
1547,23,5.4.174,0,541,0,83,174,257,174,0,257,357,-174,174,314,5,1,83,367,251,367,24,1288,379
1547,24,0.4.306,0,590,3,72,306,378,306,0,378,378,-306,306,446,5,1,72,367,237,367,25,1288,367
1547,24,1.4.369,0,555,2,62,369,431,369,0,431,431,-369,369,509,5,1,62,367,236,367,25,1288,367
1547,24,2.4.315,0,599,4,52,315,367,315,0,367,369,-315,315,455,5,1,52,367,117,367,25,1288,367
1547,24,3.4.244,0,611,5,94,244,338,244,0,338,369,-244,244,384,5,1,94,367,305,367,25,1288,367
1547,24,4.4.357,0,547,1,4,357,361,357,0,361,369,-357,357,497,5,1,4,367,142,367,25,1288,367
1547,24,5.4.174,1,541,0,83,174,257,174,0,257,369,-174,174,314,5,1,83,367,251,367,25,1288,367
1547,25,0.4.306,0,590,3,72,306,378,306,0,378,378,-49,223,363,5,2,72,284,237,367,26,1288,284
1547,25,1.4.369,0,555,2,62,369,431,369,0,431,431,-112,286,426,5,2,62,284,236,367,26,1288,284
1547,25,2.4.315,0,599,4,52,315,367,315,0,367,369,-58,232,372,5,2,52,284,117,367,26,1288,284
1547,25,3.4.257,1,541,0,94,257,351,244,13,351,369,0,174,314,5,2,94,284,305,367,26,1288,284
1547,25,4.4.357,0,547,1,4,357,361,357,0,361,369,-100,274,414,5,2,4,284,142,367,26,1288,284
1547,26,0.4.351,0,541,0,72,351,423,306,45,423,423,0,174,314,5,3,72,190,237,367,27,1288,190
1547,26,1.4.369,0,555,2,62,369,431,369,0,431,431,-18,192,332,5,3,62,190,236,367,27,1288,190
1547,26,2.4.351,0,541,0,52,351,403,315,36,403,403,0,174,314,5,3,52,190,117,367,27,1288,190
1547,26,4.4.357,1,547,1,4,357,361,357,0,361,369,-6,180,320,5,3,4,190,142,367,27,1288,190
1547,27,0.4.361,1,547,0,72,361,433,306,55,433,433,0,180,320,5,4,72,186,237,367,28,1288,186
1547,27,1.4.369,0,555,1,62,369,431,369,0,431,431,-8,188,328,5,4,62,186,236,367,28,1288,186
1547,27,2.4.361,0,547,0,52,361,413,315,46,413,413,0,180,320,5,4,52,186,117,367,28,1288,186
1547,28,1.4.433,0,547,0,62,433,495,369,64,495,495,0,180,320,5,5,62,114,236,367,29,1288,114
1547,28,2.4.433,1,547,0,52,433,485,315,118,485,485,0,180,320,5,5,52,114,117,367,29,1288,114
1547,29,1.4.485,1,547,0,62,485,547,369,116,547,547,0,180,320,5,6,62,62,236,367,30,1288,62
1548,0,0.0.0,0,624,1,45,0,45,0,0,45,45,0,0,0,1,1,280,323,280,323,1,1657,1657
1548,0,1.0.0,0,640,5,80,0,80,0,0,80,80,0,0,0,1,1,336,323,336,323,1,1657,1657
1548,0,2.0.0,0,633,4,73,0,73,0,0,73,73,0,0,0,1,1,342,323,342,323,1,1657,1657
1548,0,3.0.0,0,630,3,59,0,59,0,0,59,59,0,0,0,1,1,166,323,166,323,1,1657,1657
1548,0,4.0.0,0,627,2,54,0,54,0,0,54,54,0,0,0,1,1,280,323,280,323,1,1657,1657
1548,0,5.0.0,1,579,0,12,0,12,0,0,12,12,0,0,0,1,1,253,323,253,323,1,1657,1657
1548,1,0.0.12,1,609,4,45,12,57,0,12,57,57,0,0,0,1,2,280,311,280,323,2,1657,1645
1548,1,1.0.12,0,579,0,80,12,92,0,12,92,92,0,0,0,1,2,336,311,336,323,2,1657,1645
1548,1,2.0.12,0,591,1,73,12,85,0,12,85,85,0,0,0,1,2,342,311,342,323,2,1657,1645
1548,1,3.0.12,0,603,3,59,12,71,0,12,71,71,0,0,0,1,2,166,311,166,323,2,1657,1645
1548,1,4.0.12,0,598,2,54,12,66,0,12,66,66,0,0,0,1,2,280,311,280,323,2,1657,1645
1548,1,5.1.12,0,579,0,94,12,106,12,0,106,106,-12,12,12,2,1,241,421,253,421,2,1657,1645
1548,2,0.1.57,0,650,2,96,57,153,57,0,153,153,-57,57,57,2,1,235,421,280,421,3,1657,1600
1548,2,1.0.57,0,609,0,80,57,137,0,57,137,137,0,0,0,1,3,336,266,336,323,3,1657,1600
1548,2,2.0.57,1,617,1,73,57,130,0,57,130,130,0,0,0,1,3,342,266,342,323,3,1657,1600
1548,2,3.0.57,0,609,0,59,57,116,0,57,116,116,0,0,0,1,3,166,266,166,323,3,1657,1600
1548,2,4.0.57,0,609,0,54,57,111,0,57,111,111,0,0,0,1,3,280,266,280,323,3,1657,1600
1548,2,5.1.12,0,609,0,94,12,106,12,0,106,106,-12,12,12,2,1,241,421,253,421,3,1657,1600
1548,3,0.1.57,0,654,1,96,57,153,57,0,153,153,-57,57,57,2,1,235,421,280,421,4,1657,1527
1548,3,1.0.130,0,617,0,80,130,210,0,130,210,210,0,0,0,1,4,336,193,336,323,4,1657,1527
1548,3,2.1.130,0,617,0,93,130,223,130,0,223,223,-130,130,130,2,1,269,421,342,421,4,1657,1527
1548,3,3.0.130,0,617,0,59,130,189,0,130,189,189,0,0,0,1,4,166,193,166,323,4,1657,1527
1548,3,4.0.130,1,617,0,54,130,184,0,130,184,184,0,0,0,1,4,280,193,280,323,4,1657,1527
1548,3,5.1.12,0,617,0,94,12,106,12,0,106,130,-12,12,12,2,1,241,421,253,421,4,1657,1527
1548,4,0.1.57,0,654,2,96,57,153,57,0,153,184,-57,57,57,2,1,235,421,280,421,5,1657,1473
1548,4,1.0.184,1,619,1,80,184,264,0,184,264,264,0,0,0,1,5,336,139,336,323,5,1657,1473
1548,4,2.1.130,0,617,0,93,130,223,130,0,223,223,-130,130,130,2,1,269,421,342,421,5,1657,1473
1548,4,3.0.184,0,617,0,59,184,243,0,184,243,243,0,0,0,1,5,166,139,166,323,5,1657,1473
1548,4,4.1.184,0,663,3,78,184,262,184,0,262,262,-184,184,184,2,1,226,421,280,421,5,1657,1473
1548,4,5.1.12,0,617,0,94,12,106,12,0,106,184,-12,12,12,2,1,241,421,253,421,5,1657,1473
1548,5,0.1.57,0,655,1,96,57,153,57,0,153,264,-57,57,57,2,1,235,421,280,421,6,1657,1393
1548,5,1.1.264,0,655,1,59,264,323,264,0,323,323,-264,264,264,2,1,256,421,336,421,6,1657,1393
1548,5,2.1.130,0,619,0,93,130,223,130,0,223,264,-130,130,130,2,1,269,421,342,421,6,1657,1393
1548,5,3.0.264,1,619,0,59,264,323,0,264,323,323,0,0,0,1,6,166,59,166,323,6,1657,1393
1548,5,4.1.184,0,685,2,78,184,262,184,0,262,264,-184,184,184,2,1,226,421,280,421,6,1657,1393
1548,5,5.1.12,0,619,0,94,12,106,12,0,106,264,-12,12,12,2,1,241,421,253,421,6,1657,1393
1548,6,0.1.57,0,655,1,96,57,153,57,0,153,323,-57,57,57,2,1,235,421,280,421,7,1657,1334
1548,6,1.1.264,0,655,1,59,264,323,264,0,323,323,-264,264,264,2,1,256,421,336,421,7,1657,1334
1548,6,2.1.130,0,619,0,93,130,223,130,0,223,323,-130,130,130,2,1,269,421,342,421,7,1657,1334
1548,6,3.1.323,0,619,0,1,323,324,323,0,324,324,-323,323,323,2,1,107,421,166,421,7,1657,1334
1548,6,4.1.184,0,685,2,78,184,262,184,0,262,323,-184,184,184,2,1,226,421,280,421,7,1657,1334
1548,6,5.1.12,1,619,0,94,12,106,12,0,106,323,-12,12,12,2,1,241,421,253,421,7,1657,1334
1548,7,0.1.106,0,630,1,96,106,202,57,49,202,323,0,12,12,2,2,235,327,280,421,8,1657,1240
1548,7,1.1.264,0,655,2,59,264,323,264,0,323,323,-158,170,170,2,2,256,327,336,421,8,1657,1240
1548,7,2.1.130,0,619,0,93,130,223,130,0,223,323,-24,36,36,2,2,269,327,342,421,8,1657,1240
1548,7,3.1.323,0,619,0,1,323,324,323,0,324,324,-217,229,229,2,2,107,327,166,421,8,1657,1240
1548,7,4.1.184,0,689,3,78,184,262,184,0,262,323,-78,90,90,2,2,226,327,280,421,8,1657,1240
1548,7,5.2.106,1,619,0,15,106,121,106,0,121,323,-106,106,118,3,1,147,295,253,295,8,1657,1240
1548,8,0.1.106,0,630,1,96,106,202,57,49,202,323,0,12,118,2,2,235,327,280,421,9,1657,1225
1548,8,1.1.264,0,655,2,59,264,323,264,0,323,323,-158,170,276,2,2,256,327,336,421,9,1657,1225
1548,8,2.1.130,0,619,0,93,130,223,130,0,223,323,-24,36,142,2,2,269,327,342,421,9,1657,1225
1548,8,3.1.323,0,619,0,1,323,324,323,0,324,324,-217,229,335,2,2,107,327,166,421,9,1657,1225
1548,8,4.1.184,0,689,3,78,184,262,184,0,262,323,-78,90,196,2,2,226,327,280,421,9,1657,1225
1548,8,5.3.121,1,619,0,58,121,179,121,0,179,323,-121,121,239,4,1,132,320,253,320,9,1657,1225
1548,9,0.1.106,0,630,1,96,106,202,57,49,202,323,0,12,239,2,2,235,327,280,421,10,1657,1167
1548,9,1.1.264,0,655,2,59,264,323,264,0,323,323,-158,170,397,2,2,256,327,336,421,10,1657,1167
1548,9,2.1.130,0,619,0,93,130,223,130,0,223,323,-24,36,263,2,2,269,327,342,421,10,1657,1167
1548,9,3.1.323,0,619,0,1,323,324,323,0,324,324,-217,229,456,2,2,107,327,166,421,10,1657,1167
1548,9,4.1.184,0,689,3,78,184,262,184,0,262,323,-78,90,317,2,2,226,327,280,421,10,1657,1167
1548,9,5.4.179,1,619,0,74,179,253,179,0,253,323,-179,179,418,5,1,74,298,253,298,10,1657,1167
1548,10,0.1.106,1,630,1,96,106,202,57,49,202,323,0,12,418,2,2,235,327,280,421,11,1657,1093
1548,10,1.1.264,0,655,2,59,264,323,264,0,323,323,-158,170,576,2,2,256,327,336,421,11,1657,1093
1548,10,2.1.130,0,619,0,93,130,223,130,0,223,323,-24,36,442,2,2,269,327,342,421,11,1657,1093
1548,10,3.1.323,0,619,0,1,323,324,323,0,324,324,-217,229,635,2,2,107,327,166,421,11,1657,1093
1548,10,4.1.184,0,689,3,78,184,262,184,0,262,323,-78,90,496,2,2,226,327,280,421,11,1657,1093
1548,11,0.2.202,1,630,0,45,202,247,202,0,247,323,-81,187,499,3,2,139,280,280,295,12,1657,997
1548,11,1.1.264,0,671,3,59,264,323,264,0,323,323,-62,74,480,2,3,256,231,336,421,12,1657,997
1548,11,2.1.202,0,662,2,93,202,295,130,72,295,323,0,12,418,2,3,269,231,342,421,12,1657,997
1548,11,3.1.323,0,652,1,1,323,324,323,0,324,324,-121,133,539,2,3,107,231,166,421,12,1657,997
1548,11,4.1.202,0,630,0,78,202,280,184,18,280,323,0,12,418,2,3,226,231,280,421,12,1657,997
1548,12,0.3.247,1,630,0,69,247,316,247,0,316,323,-68,189,567,4,2,94,262,280,320,13,1657,952
1548,12,1.1.264,0,671,3,59,264,323,264,0,323,323,-62,74,561,2,3,256,231,336,421,13,1657,952
1548,12,2.1.202,0,662,2,93,202,295,130,72,295,323,0,12,499,2,3,269,231,342,421,13,1657,952
1548,12,3.1.323,0,652,1,1,323,324,323,0,324,324,-121,133,620,2,3,107,231,166,421,13,1657,952
1548,12,4.1.202,0,630,0,78,202,280,184,18,280,323,0,12,499,2,3,226,231,280,421,13,1657,952
1548,13,0.4.316,1,630,0,25,316,341,316,0,341,341,-63,242,630,5,2,25,224,280,298,14,1657,883
1548,13,1.1.264,0,671,3,59,264,323,264,0,323,323,-62,74,629,2,3,256,231,336,421,14,1657,883
1548,13,2.1.202,0,662,2,93,202,295,130,72,295,323,0,12,567,2,3,269,231,342,421,14,1657,883
1548,13,3.1.323,0,652,1,1,323,324,323,0,324,324,-121,133,688,2,3,107,231,166,421,14,1657,883
1548,13,4.1.202,0,630,0,78,202,280,184,18,280,323,0,12,567,2,3,226,231,280,421,14,1657,883
1548,14,1.1.264,0,671,3,59,264,323,264,0,323,341,-62,74,692,2,3,256,231,336,421,15,1657,858
1548,14,2.1.202,1,662,2,93,202,295,130,72,295,341,0,12,630,2,3,269,231,342,421,15,1657,858
1548,14,3.1.323,0,652,1,1,323,324,323,0,324,341,-121,133,751,2,3,107,231,166,421,15,1657,858
1548,14,4.1.202,0,630,0,78,202,280,184,18,280,341,0,12,630,2,3,226,231,280,421,15,1657,858
1548,15,1.1.295,1,669,1,59,295,354,264,31,354,354,0,12,630,2,4,256,138,336,421,16,1657,765
1548,15,2.2.295,0,662,0,81,295,376,295,0,376,376,-48,235,678,3,3,176,235,342,295,16,1657,765
1548,15,3.1.323,0,662,0,1,323,324,323,0,324,341,-28,40,658,2,4,107,138,166,421,16,1657,765
1548,15,4.1.295,0,662,0,78,295,373,184,111,373,373,0,12,630,2,4,226,138,280,421,16,1657,765
1548,16,1.2.354,0,684,1,73,354,427,354,0,427,427,-107,294,737,3,3,197,235,336,295,17,1657,706
1548,16,2.2.295,0,669,0,81,295,376,295,0,376,376,-48,235,678,3,3,176,235,342,295,17,1657,706
1548,16,3.1.354,0,669,0,1,354,355,323,31,355,355,0,12,630,2,5,107,79,166,421,17,1657,706
1548,16,4.1.354,1,687,2,78,354,432,184,170,432,432,0,12,630,2,5,226,79,280,421,17,1657,706
1548,17,1.2.354,0,689,1,73,354,427,354,0,427,432,-107,294,737,3,3,197,235,336,295,18,1657,628
1548,17,2.2.295,0,687,0,81,295,376,295,0,376,432,-48,235,678,3,3,176,235,342,295,18,1657,628
1548,17,3.1.432,1,687,0,1,432,433,323,109,433,433,0,12,630,2,6,107,1,166,421,18,1657,628
1548,17,4.2.432,0,689,1,39,432,471,432,0,471,471,-185,372,815,3,3,148,235,280,295,18,1657,628
1548,18,1.2.354,0,689,1,73,354,427,354,0,427,433,-107,294,737,3,3,197,235,336,295,19,1657,627
1548,18,2.2.295,1,687,0,81,295,376,295,0,376,433,-48,235,678,3,3,176,235,342,295,19,1657,627
1548,18,3.2.433,0,690,2,42,433,475,433,0,475,475,-186,373,816,3,3,106,235,166,295,19,1657,627
1548,18,4.2.432,0,689,1,39,432,471,432,0,471,471,-185,372,815,3,3,148,235,280,295,19,1657,627
1548,19,1.2.376,0,687,0,73,376,449,354,22,449,449,0,235,678,3,4,197,154,336,295,20,1657,546
1548,19,2.3.376,1,687,0,77,376,453,376,0,453,453,-60,249,738,4,3,95,193,342,320,20,1657,546
1548,19,3.2.433,0,711,2,42,433,475,433,0,475,475,-57,292,735,3,4,106,154,166,295,20,1657,546
1548,19,4.2.432,0,704,1,39,432,471,432,0,471,471,-56,291,734,3,4,148,154,280,295,20,1657,546
1548,20,1.2.376,0,687,0,73,376,449,354,22,449,453,0,235,738,3,4,197,154,336,295,21,1657,469
1548,20,2.4.453,1,687,0,18,453,471,453,0,471,471,-112,354,850,5,3,18,199,342,298,21,1657,469
1548,20,3.2.433,0,711,2,42,433,475,433,0,475,475,-57,292,795,3,4,106,154,166,295,21,1657,469
1548,20,4.2.432,0,704,1,39,432,471,432,0,471,471,-56,291,794,3,4,148,154,280,295,21,1657,469
1548,21,1.2.376,1,687,0,73,376,449,354,22,449,471,0,235,850,3,4,197,154,336,295,22,1657,451
1548,21,3.2.433,0,711,2,42,433,475,433,0,475,475,-57,292,907,3,4,106,154,166,295,22,1657,451
1548,21,4.2.432,0,704,1,39,432,471,432,0,471,471,-56,291,906,3,4,148,154,280,295,22,1657,451
1548,22,1.3.453,1,687,0,53,453,506,449,4,506,506,0,249,850,4,4,124,116,336,320,23,1657,378
1548,22,3.2.449,0,687,0,42,449,491,433,16,491,491,0,235,850,3,5,106,81,166,295,23,1657,378
1548,22,4.2.449,0,687,0,39,449,488,432,17,488,488,0,235,850,3,5,148,81,280,295,23,1657,378
1548,23,1.4.506,0,687,0,71,506,577,506,0,577,577,-35,389,885,5,4,71,181,336,298,24,1657,325
1548,23,3.2.449,0,687,0,42,449,491,433,16,491,506,0,235,850,3,5,106,81,166,295,24,1657,325
1548,23,4.2.449,1,687,0,39,449,488,432,17,488,506,0,235,850,3,5,148,81,280,295,24,1657,325
1548,24,1.4.506,0,687,0,71,506,577,506,0,577,577,-35,389,885,5,4,71,181,336,298,25,1657,286
1548,24,3.2.488,0,687,0,42,488,530,433,55,530,530,0,235,850,3,6,106,42,166,295,25,1657,286
1548,24,4.3.506,1,687,0,35,506,541,488,18,541,541,0,249,850,4,5,109,63,280,320,25,1657,286
1548,25,1.4.506,0,687,0,71,506,577,506,0,577,577,-35,389,885,5,4,71,181,336,298,26,1657,251
1548,25,3.2.488,1,687,0,42,488,530,433,55,530,541,0,235,850,3,6,106,42,166,295,26,1657,251
1548,25,4.4.541,0,722,1,74,541,615,541,0,615,615,-70,424,920,5,4,74,181,280,298,26,1657,251
1548,26,1.4.506,0,687,0,71,506,577,506,0,577,577,-35,389,885,5,4,71,181,336,298,27,1657,209
1548,26,3.3.541,1,687,0,28,541,569,530,11,569,569,0,249,850,4,6,64,28,166,320,27,1657,209
1548,26,4.4.541,0,722,1,74,541,615,541,0,615,615,-70,424,920,5,4,74,181,280,298,27,1657,209
1548,27,1.4.506,1,687,0,71,506,577,506,0,577,577,-35,389,885,5,4,71,181,336,298,28,1657,181
1548,27,3.4.569,0,750,2,36,569,605,569,0,605,605,-98,452,948,5,4,36,181,166,298,28,1657,181
1548,27,4.4.541,0,722,1,74,541,615,541,0,615,615,-70,424,920,5,4,74,181,280,298,28,1657,181
1548,28,3.4.577,0,687,0,36,577,613,569,8,613,613,0,389,885,5,5,36,110,166,298,29,1657,110
1548,28,4.4.577,1,687,0,74,577,651,541,36,651,651,0,389,885,5,5,74,110,280,298,29,1657,110
1548,29,3.4.651,1,687,0,36,651,687,569,82,687,687,0,389,885,5,6,36,36,166,298,30,1657,36
1549,0,0.0.0,0,647,4,58,0,58,0,0,58,58,0,0,0,1,1,325,237,325,237,1,1621,1621
1549,0,1.0.0,0,642,3,56,0,56,0,0,56,56,0,0,0,1,1,335,237,335,237,1,1621,1621
1549,0,2.0.0,1,615,2,19,0,19,0,0,19,19,0,0,0,1,1,268,237,268,237,1,1621,1621
1549,0,3.0.0,0,599,0,12,0,12,0,0,12,12,0,0,0,1,1,223,237,223,237,1,1621,1621
1549,0,4.0.0,0,648,5,75,0,75,0,0,75,75,0,0,0,1,1,216,237,216,237,1,1621,1621
1549,0,5.0.0,0,613,1,17,0,17,0,0,17,17,0,0,0,1,1,254,237,254,237,1,1621,1621
1549,1,0.0.19,0,615,0,58,19,77,0,19,77,77,0,0,0,1,2,325,218,325,237,2,1621,1602
1549,1,1.0.19,0,615,0,56,19,75,0,19,75,75,0,0,0,1,2,335,218,335,237,2,1621,1602
1549,1,2.1.19,0,615,0,87,19,106,19,0,106,106,-19,19,19,2,1,249,325,268,325,2,1621,1602
1549,1,3.0.19,0,615,0,12,19,31,0,19,31,31,0,0,0,1,2,223,218,223,237,2,1621,1602
1549,1,4.0.19,0,615,0,75,19,94,0,19,94,94,0,0,0,1,2,216,218,216,237,2,1621,1602
1549,1,5.0.19,1,615,0,17,19,36,0,19,36,36,0,0,0,1,2,254,218,254,237,2,1621,1602
1549,2,0.0.36,0,615,0,58,36,94,0,36,94,94,0,0,0,1,3,325,201,325,237,3,1621,1585
1549,2,1.0.36,0,618,1,56,36,92,0,36,92,92,0,0,0,1,3,335,201,335,237,3,1621,1585
1549,2,2.1.19,0,615,0,87,19,106,19,0,106,106,-19,19,19,2,1,249,325,268,325,3,1621,1585
1549,2,3.0.36,1,615,0,12,36,48,0,36,48,48,0,0,0,1,3,223,201,223,237,3,1621,1585
1549,2,4.0.36,0,615,0,75,36,111,0,36,111,111,0,0,0,1,3,216,201,216,237,3,1621,1585
1549,2,5.1.36,0,638,2,77,36,113,36,0,113,113,-36,36,36,2,1,237,325,254,325,3,1621,1585
1549,3,0.0.48,0,615,0,58,48,106,0,48,106,106,0,0,0,1,4,325,189,325,237,4,1621,1573
1549,3,1.0.48,1,618,1,56,48,104,0,48,104,104,0,0,0,1,4,335,189,335,237,4,1621,1573
1549,3,2.1.19,0,615,0,87,19,106,19,0,106,106,-19,19,19,2,1,249,325,268,325,4,1621,1573
1549,3,3.1.48,0,632,2,39,48,87,48,0,87,87,-48,48,48,2,1,211,325,223,325,4,1621,1573
1549,3,4.0.48,0,615,0,75,48,123,0,48,123,123,0,0,0,1,4,216,189,216,237,4,1621,1573
1549,3,5.1.36,0,638,3,77,36,113,36,0,113,113,-36,36,36,2,1,237,325,254,325,4,1621,1573
1549,4,0.0.104,1,624,1,58,104,162,0,104,162,162,0,0,0,1,5,325,133,325,237,5,1621,1517
1549,4,1.1.104,0,646,4,27,104,131,104,0,131,131,-104,104,104,2,1,279,325,335,325,5,1621,1517
1549,4,2.1.19,0,618,0,87,19,106,19,0,106,106,-19,19,19,2,1,249,325,268,325,5,1621,1517
1549,4,3.1.48,0,640,2,39,48,87,48,0,87,104,-48,48,48,2,1,211,325,223,325,5,1621,1517
1549,4,4.0.104,0,618,0,75,104,179,0,104,179,179,0,0,0,1,5,216,133,216,237,5,1621,1517
1549,4,5.1.36,0,644,3,77,36,113,36,0,113,113,-36,36,36,2,1,237,325,254,325,5,1621,1517
1549,5,0.1.162,0,632,1,65,162,227,162,0,227,227,-162,162,162,2,1,267,325,325,325,6,1621,1459
1549,5,1.1.104,0,650,4,27,104,131,104,0,131,162,-104,104,104,2,1,279,325,335,325,6,1621,1459
1549,5,2.1.19,0,624,0,87,19,106,19,0,106,162,-19,19,19,2,1,249,325,268,325,6,1621,1459
1549,5,3.1.48,0,640,2,39,48,87,48,0,87,162,-48,48,48,2,1,211,325,223,325,6,1621,1459
1549,5,4.0.162,1,624,0,75,162,237,0,162,237,237,0,0,0,1,6,216,75,216,237,6,1621,1459
1549,5,5.1.36,0,644,3,77,36,113,36,0,113,162,-36,36,36,2,1,237,325,254,325,6,1621,1459
1549,6,0.1.162,0,632,1,65,162,227,162,0,227,237,-162,162,162,2,1,267,325,325,325,7,1621,1384
1549,6,1.1.104,1,650,4,27,104,131,104,0,131,237,-104,104,104,2,1,279,325,335,325,7,1621,1384
1549,6,2.1.19,0,624,0,87,19,106,19,0,106,237,-19,19,19,2,1,249,325,268,325,7,1621,1384
1549,6,3.1.48,0,640,2,39,48,87,48,0,87,237,-48,48,48,2,1,211,325,223,325,7,1621,1384
1549,6,4.1.237,0,632,1,30,237,267,237,0,267,267,-237,237,237,2,1,141,325,216,325,7,1621,1384
1549,6,5.1.36,0,644,3,77,36,113,36,0,113,237,-36,36,36,2,1,237,325,254,325,7,1621,1384
1549,7,0.1.162,0,651,1,65,162,227,162,0,227,237,-31,135,135,2,2,267,298,325,325,8,1621,1357
1549,7,1.2.131,1,650,0,78,131,209,131,0,209,237,-131,131,235,3,1,252,262,335,262,8,1621,1357
1549,7,2.1.131,0,650,0,87,131,218,19,112,218,237,0,104,104,2,2,249,298,268,325,8,1621,1357
1549,7,3.1.48,0,650,0,39,48,87,48,0,131,237,39,65,65,2,2,211,298,223,325,8,1621,1357
1549,7,4.1.237,0,650,0,30,237,267,237,0,267,267,-106,210,210,2,2,141,298,216,325,8,1621,1357
1549,7,5.1.131,0,651,1,77,131,208,36,95,208,237,0,104,104,2,2,237,298,254,325,8,1621,1357
1549,8,0.1.162,0,651,1,65,162,227,162,0,227,237,-31,135,266,2,2,267,298,325,325,9,1621,1279
1549,8,1.3.209,0,651,1,94,209,303,209,0,303,303,-209,209,444,4,1,174,372,335,372,9,1621,1279
1549,8,2.1.131,0,650,0,87,131,218,19,112,218,237,0,104,235,2,2,249,298,268,325,9,1621,1279
1549,8,3.1.48,1,650,0,39,48,87,48,0,131,237,39,65,196,2,2,211,298,223,325,9,1621,1279
1549,8,4.1.237,0,650,0,30,237,267,237,0,267,267,-106,210,341,2,2,141,298,216,325,9,1621,1279
1549,8,5.1.131,0,651,1,77,131,208,36,95,208,237,0,104,235,2,2,237,298,254,325,9,1621,1279
1549,9,0.1.162,0,651,1,65,162,227,162,0,227,237,-31,96,227,2,3,267,259,325,325,10,1621,1240
1549,9,1.3.209,0,651,1,94,209,303,209,0,303,303,-209,209,405,4,1,174,372,335,372,10,1621,1240
1549,9,2.1.131,0,650,0,87,131,218,19,112,218,237,0,65,196,2,3,249,259,268,325,10,1621,1240
1549,9,3.2.87,1,650,0,9,87,96,87,0,209,237,9,122,187,3,2,172,184,223,262,10,1621,1240
1549,9,4.1.237,0,650,0,30,237,267,237,0,267,267,-106,171,302,2,3,141,259,216,325,10,1621,1240
1549,9,5.1.131,0,651,1,77,131,208,36,95,208,237,0,65,196,2,3,237,259,254,325,10,1621,1240
1549,10,0.1.162,0,651,1,65,162,227,162,0,227,237,-31,96,218,2,3,267,259,325,325,11,1621,1231
1549,10,1.3.209,0,651,1,94,209,303,209,0,303,303,-209,209,396,4,1,174,372,335,372,11,1621,1231
1549,10,2.1.131,0,650,0,87,131,218,19,112,218,237,0,65,187,2,3,249,259,268,325,11,1621,1231
1549,10,3.3.96,1,650,0,86,96,182,96,0,182,237,-96,96,283,4,1,163,372,223,372,11,1621,1231
1549,10,4.1.237,0,650,0,30,237,267,237,0,267,267,-106,171,293,2,3,141,259,216,325,11,1621,1231
1549,10,5.1.131,0,651,1,77,131,208,36,95,208,237,0,65,187,2,3,237,259,254,325,11,1621,1231
1549,11,0.1.162,0,651,1,65,162,227,162,0,227,237,-31,96,314,2,3,267,259,325,325,12,1621,1145
1549,11,1.3.209,1,651,1,94,209,303,209,0,303,303,-27,123,310,4,2,174,286,335,372,12,1621,1145
1549,11,2.1.131,0,650,0,87,131,218,19,112,218,237,0,65,283,2,3,249,259,268,325,12,1621,1145
1549,11,3.4.182,0,650,0,77,182,259,182,0,259,259,-182,182,465,5,1,77,425,223,425,12,1621,1145
1549,11,4.1.237,0,650,0,30,237,267,237,0,267,267,-106,171,389,2,3,141,259,216,325,12,1621,1145
1549,11,5.1.131,0,651,1,77,131,208,36,95,208,237,0,65,283,2,3,237,259,254,325,12,1621,1145
1549,12,0.1.162,0,651,0,65,162,227,162,0,227,303,-31,96,341,2,3,267,259,325,325,13,1621,1051
1549,12,1.4.303,0,651,0,80,303,383,303,0,383,383,-303,303,613,5,1,80,425,335,425,13,1621,1051
1549,12,2.1.131,1,651,0,87,131,218,19,112,218,303,0,65,310,2,3,249,259,268,325,13,1621,1051
1549,12,3.4.182,0,651,0,77,182,259,182,0,259,303,-182,182,492,5,1,77,425,223,425,13,1621,1051
1549,12,4.1.237,0,651,0,30,237,267,237,0,267,303,-106,171,416,2,3,141,259,216,325,13,1621,1051
1549,12,5.1.131,0,651,0,77,131,208,36,95,208,303,0,65,310,2,3,237,259,254,325,13,1621,1051
1549,13,0.1.218,0,651,0,65,218,283,162,56,283,303,0,65,310,2,4,267,172,325,325,14,1621,964
1549,13,1.4.303,0,651,0,80,303,383,303,0,383,383,-303,303,613,5,1,80,425,335,425,14,1621,964
1549,13,2.2.218,1,651,0,34,218,252,218,0,252,303,-9,131,319,3,3,162,175,268,262,14,1621,964
1549,13,3.4.182,0,651,0,77,182,259,182,0,259,303,-182,182,492,5,1,77,425,223,425,14,1621,964
1549,13,4.1.237,0,651,0,30,237,267,237,0,267,303,-19,84,329,2,4,141,172,216,325,14,1621,964
1549,13,5.1.218,0,651,0,77,218,295,36,182,295,303,0,65,310,2,4,237,172,254,325,14,1621,964
1549,14,0.1.218,0,651,0,65,218,283,162,56,283,303,0,65,319,2,4,267,172,325,325,15,1621,930
1549,14,1.4.303,0,651,0,80,303,383,303,0,383,383,-303,303,622,5,1,80,425,335,425,15,1621,930
1549,14,2.3.303,1,651,0,46,303,349,252,51,349,349,0,123,319,4,3,128,192,268,372,15,1621,930
1549,14,3.4.182,0,651,0,77,182,259,182,0,259,303,-182,182,501,5,1,77,425,223,425,15,1621,930
1549,14,4.1.237,0,651,0,30,237,267,237,0,267,303,-19,84,338,2,4,141,172,216,325,15,1621,930
1549,14,5.1.218,0,651,0,77,218,295,36,182,295,303,0,65,319,2,4,237,172,254,325,15,1621,930
1549,15,0.1.218,0,651,0,65,218,283,162,56,283,349,0,65,319,2,4,267,172,325,325,16,1621,884
1549,15,1.4.303,0,651,0,80,303,383,303,0,383,383,-303,303,622,5,1,80,425,335,425,16,1621,884
1549,15,2.4.349,0,697,1,82,349,431,349,0,431,431,-349,349,668,5,1,82,425,268,425,16,1621,884
1549,15,3.4.182,0,651,0,77,182,259,182,0,259,349,-182,182,501,5,1,77,425,223,425,16,1621,884
1549,15,4.1.237,0,651,0,30,237,267,237,0,267,349,-19,84,338,2,4,141,172,216,325,16,1621,884
1549,15,5.1.218,1,651,0,77,218,295,36,182,295,349,0,65,319,2,4,237,172,254,325,16,1621,884
1549,16,0.1.295,1,651,0,65,295,360,162,133,360,360,0,65,319,2,5,267,95,325,325,17,1621,807
1549,16,1.4.303,0,651,0,80,303,383,303,0,383,383,-303,303,622,5,1,80,425,335,425,17,1621,807
1549,16,2.4.349,0,697,1,82,349,431,349,0,431,431,-349,349,668,5,1,82,425,268,425,17,1621,807
1549,16,3.4.182,0,651,0,77,182,259,182,0,259,349,-182,182,501,5,1,77,425,223,425,17,1621,807
1549,16,4.1.295,0,651,0,30,295,325,237,58,325,349,0,65,319,2,5,141,95,216,325,17,1621,807
1549,16,5.2.295,0,651,0,53,295,348,295,0,348,349,-43,174,362,3,4,160,141,254,262,17,1621,807
1549,17,0.2.360,0,651,0,49,360,409,360,0,409,409,-108,239,427,3,4,202,141,325,262,18,1621,742
1549,17,1.4.303,0,651,0,80,303,383,303,0,383,383,-303,303,622,5,1,80,425,335,425,18,1621,742
1549,17,2.4.349,0,697,1,82,349,431,349,0,431,431,-349,349,668,5,1,82,425,268,425,18,1621,742
1549,17,3.4.182,0,651,0,77,182,259,182,0,259,360,-182,182,501,5,1,77,425,223,425,18,1621,742
1549,17,4.1.360,1,651,0,30,360,390,237,123,390,390,0,65,319,2,6,141,30,216,325,18,1621,742
1549,17,5.2.295,0,651,0,53,295,348,295,0,348,360,-43,174,362,3,4,160,141,254,262,18,1621,742
1549,18,0.2.360,0,651,0,49,360,409,360,0,409,409,-108,239,427,3,4,202,141,325,262,19,1621,712
1549,18,1.4.303,0,651,0,80,303,383,303,0,383,390,-303,303,622,5,1,80,425,335,425,19,1621,712
1549,18,2.4.349,0,697,1,82,349,431,349,0,431,431,-349,349,668,5,1,82,425,268,425,19,1621,712
1549,18,3.4.182,0,651,0,77,182,259,182,0,259,390,-182,182,501,5,1,77,425,223,425,19,1621,712
1549,18,4.2.390,0,651,0,39,390,429,390,0,429,429,-138,269,457,3,4,111,141,216,262,19,1621,712
1549,18,5.2.295,1,651,0,53,295,348,295,0,348,390,-43,174,362,3,4,160,141,254,262,19,1621,712
1549,19,0.2.360,0,651,0,49,360,409,360,0,409,409,-12,186,374,3,5,202,88,325,262,20,1621,659
1549,19,1.4.303,0,651,0,80,303,383,303,0,383,390,-303,303,665,5,1,80,425,335,425,20,1621,659
1549,19,2.4.349,0,697,1,82,349,431,349,0,431,431,-349,349,711,5,1,82,425,268,425,20,1621,659
1549,19,3.4.182,0,651,0,77,182,259,182,0,259,390,-182,182,544,5,1,77,425,223,425,20,1621,659
1549,19,4.2.390,0,651,0,39,390,429,390,0,429,429,-42,216,404,3,5,111,88,216,262,20,1621,659
1549,19,5.3.349,1,651,0,42,349,391,348,1,391,391,0,123,362,4,4,107,146,254,372,20,1621,659
1549,20,0.2.360,1,651,0,49,360,409,360,0,409,409,-12,186,374,3,5,202,88,325,262,21,1621,617
1549,20,1.4.303,0,651,0,80,303,383,303,0,383,391,-303,303,665,5,1,80,425,335,425,21,1621,617
1549,20,2.4.349,0,697,2,82,349,431,349,0,431,431,-349,349,711,5,1,82,425,268,425,21,1621,617
1549,20,3.4.182,0,651,0,77,182,259,182,0,259,391,-182,182,544,5,1,77,425,223,425,21,1621,617
1549,20,4.2.390,0,651,0,39,390,429,390,0,429,429,-42,216,404,3,5,111,88,216,262,21,1621,617
1549,20,5.4.391,0,659,1,65,391,456,391,0,456,456,-391,391,753,5,1,65,425,254,425,21,1621,617
1549,21,0.3.409,0,651,0,76,409,485,409,0,485,485,-18,141,392,4,5,153,104,325,372,22,1621,568
1549,21,1.4.303,0,651,0,80,303,383,303,0,383,409,-303,303,677,5,1,80,425,335,425,22,1621,568
1549,21,2.4.349,0,697,2,82,349,431,349,0,431,431,-349,349,723,5,1,82,425,268,425,22,1621,568
1549,21,3.4.182,0,651,0,77,182,259,182,0,259,409,-182,182,556,5,1,77,425,223,425,22,1621,568
1549,21,4.2.409,1,651,0,39,409,448,390,19,448,448,0,186,374,3,6,111,39,216,262,22,1621,568
1549,21,5.4.391,0,659,1,65,391,456,391,0,456,456,-391,391,765,5,1,65,425,254,425,22,1621,568
1549,22,0.3.409,1,651,0,76,409,485,409,0,485,485,-18,141,392,4,5,153,104,325,372,23,1621,529
1549,22,1.4.303,0,651,0,80,303,383,303,0,383,448,-303,303,677,5,1,80,425,335,425,23,1621,529
1549,22,2.4.349,0,697,2,82,349,431,349,0,431,448,-349,349,723,5,1,82,425,268,425,23,1621,529
1549,22,3.4.182,0,651,0,77,182,259,182,0,259,448,-182,182,556,5,1,77,425,223,425,23,1621,529
1549,22,4.3.448,0,651,0,28,448,476,448,0,476,476,-57,180,431,4,5,72,104,216,372,23,1621,529
1549,22,5.4.391,0,659,1,65,391,456,391,0,456,456,-391,391,765,5,1,65,425,254,425,23,1621,529
1549,23,0.4.485,0,671,2,77,485,562,485,0,562,562,-485,485,877,5,1,77,425,325,425,24,1621,453
1549,23,1.4.303,0,651,0,80,303,383,303,0,383,485,-303,303,695,5,1,80,425,335,425,24,1621,453
1549,23,2.4.349,0,697,3,82,349,431,349,0,431,485,-349,349,741,5,1,82,425,268,425,24,1621,453
1549,23,3.4.182,0,651,0,77,182,259,182,0,259,485,-182,182,574,5,1,77,425,223,425,24,1621,453
1549,23,4.3.485,1,651,0,28,485,513,448,37,513,513,0,141,392,4,6,72,28,216,372,24,1621,453
1549,23,5.4.391,0,659,1,65,391,456,391,0,456,485,-391,391,783,5,1,65,425,254,425,24,1621,453
1549,24,0.4.485,0,671,2,77,485,562,485,0,562,562,-485,485,877,5,1,77,425,325,425,25,1621,425
1549,24,1.4.303,0,651,0,80,303,383,303,0,383,513,-303,303,695,5,1,80,425,335,425,25,1621,425
1549,24,2.4.349,0,697,3,82,349,431,349,0,431,513,-349,349,741,5,1,82,425,268,425,25,1621,425
1549,24,3.4.182,1,651,0,77,182,259,182,0,259,513,-182,182,574,5,1,77,425,223,425,25,1621,425
1549,24,4.4.513,0,699,4,44,513,557,513,0,557,557,-513,513,905,5,1,44,425,216,425,25,1621,425
1549,24,5.4.391,0,659,1,65,391,456,391,0,456,513,-391,391,783,5,1,65,425,254,425,25,1621,425
1549,25,0.4.485,0,671,2,77,485,562,485,0,562,562,-226,408,800,5,2,77,348,325,425,26,1621,348
1549,25,1.4.303,1,651,0,80,303,383,303,0,383,513,-44,226,618,5,2,80,348,335,425,26,1621,348
1549,25,2.4.349,0,697,3,82,349,431,349,0,431,513,-90,272,664,5,2,82,348,268,425,26,1621,348
1549,25,4.4.513,0,699,4,44,513,557,513,0,557,557,-254,436,828,5,2,44,348,216,425,26,1621,348
1549,25,5.4.391,0,659,1,65,391,456,391,0,456,513,-132,314,706,5,2,65,348,254,425,26,1621,348
1549,26,0.4.485,0,671,2,77,485,562,485,0,562,562,-102,328,720,5,3,77,268,325,425,27,1621,268
1549,26,2.4.383,1,651,0,82,383,465,349,34,465,513,0,226,618,5,3,82,268,268,425,27,1621,268
1549,26,4.4.513,0,699,3,44,513,557,513,0,557,557,-130,356,748,5,3,44,268,216,425,27,1621,268
1549,26,5.4.391,0,659,1,65,391,456,391,0,456,513,-8,234,626,5,3,65,268,254,425,27,1621,268
1549,27,0.4.485,0,671,1,77,485,562,485,0,562,562,-20,246,638,5,4,77,186,325,425,28,1621,186
1549,27,4.4.513,0,699,2,44,513,557,513,0,557,557,-48,274,666,5,4,44,186,216,425,28,1621,186
1549,27,5.4.465,1,651,0,65,465,530,391,74,530,530,0,226,618,5,4,65,186,254,425,28,1621,186
1549,28,0.4.530,1,651,0,77,530,607,485,45,607,607,0,226,618,5,5,77,121,325,425,29,1621,121
1549,28,4.4.530,0,651,0,44,530,574,513,17,574,574,0,226,618,5,5,44,121,216,425,29,1621,121
1549,29,4.4.607,1,651,0,44,607,651,513,94,651,651,0,226,618,5,6,44,44,216,425,30,1621,44
1550,0,0.0.0,0,580,2,71,0,71,0,0,71,71,0,0,0,1,1,269,350,269,350,1,1687,1687
1550,0,1.0.0,1,578,1,32,0,32,0,0,32,32,0,0,0,1,1,335,350,335,350,1,1687,1687
1550,0,2.0.0,0,610,4,64,0,64,0,0,64,64,0,0,0,1,1,294,350,294,350,1,1687,1687
1550,0,3.0.0,0,605,3,65,0,65,0,0,65,65,0,0,0,1,1,280,350,280,350,1,1687,1687
1550,0,4.0.0,0,643,5,97,0,97,0,0,97,97,0,0,0,1,1,253,350,253,350,1,1687,1687
1550,0,5.0.0,0,546,0,21,0,21,0,0,21,21,0,0,0,1,1,256,350,256,350,1,1687,1687
1550,1,0.0.32,0,590,1,71,32,103,0,32,103,103,0,0,0,1,2,269,318,269,350,2,1687,1655
1550,1,1.1.32,0,590,1,94,32,126,32,0,126,126,-32,32,32,2,1,303,426,335,426,2,1687,1655
1550,1,2.0.32,0,590,1,64,32,96,0,32,96,96,0,0,0,1,2,294,318,294,350,2,1687,1655
1550,1,3.0.32,0,590,1,65,32,97,0,32,97,97,0,0,0,1,2,280,318,280,350,2,1687,1655
1550,1,4.0.32,0,602,2,97,32,129,0,32,129,129,0,0,0,1,2,253,318,253,350,2,1687,1655
1550,1,5.0.32,1,578,0,21,32,53,0,32,53,53,0,0,0,1,2,256,318,256,350,2,1687,1655
1550,2,0.0.53,0,578,0,71,53,124,0,53,124,124,0,0,0,1,3,269,297,269,350,3,1687,1634
1550,2,1.1.32,0,590,2,94,32,126,32,0,126,126,-32,32,32,2,1,303,426,335,426,3,1687,1634
1550,2,2.0.53,1,581,1,64,53,117,0,53,117,117,0,0,0,1,3,294,297,294,350,3,1687,1634
1550,2,3.0.53,0,581,1,65,53,118,0,53,118,118,0,0,0,1,3,280,297,280,350,3,1687,1634
1550,2,4.0.53,0,594,3,97,53,150,0,53,150,150,0,0,0,1,3,253,297,253,350,3,1687,1634
1550,2,5.1.53,0,578,0,61,53,114,53,0,114,114,-53,53,53,2,1,235,426,256,426,3,1687,1634
1550,3,0.0.117,0,581,0,71,117,188,0,117,188,188,0,0,0,1,4,269,233,269,350,4,1687,1570
1550,3,1.1.32,0,590,3,94,32,126,32,0,126,126,-32,32,32,2,1,303,426,335,426,4,1687,1570
1550,3,2.1.117,0,585,1,81,117,198,117,0,198,198,-117,117,117,2,1,230,426,294,426,4,1687,1570
1550,3,3.0.117,1,589,2,65,117,182,0,117,182,182,0,0,0,1,4,280,233,280,350,4,1687,1570
1550,3,4.0.117,0,589,2,97,117,214,0,117,214,214,0,0,0,1,4,253,233,253,350,4,1687,1570
1550,3,5.1.53,0,581,0,61,53,114,53,0,114,117,-53,53,53,2,1,235,426,256,426,4,1687,1570
1550,4,0.0.182,1,589,0,71,182,253,0,182,253,253,0,0,0,1,5,269,168,269,350,5,1687,1505
1550,4,1.1.32,0,590,1,94,32,126,32,0,126,182,-32,32,32,2,1,303,426,335,426,5,1687,1505
1550,4,2.1.117,0,589,0,81,117,198,117,0,198,198,-117,117,117,2,1,230,426,294,426,5,1687,1505
1550,4,3.1.182,0,639,3,76,182,258,182,0,258,258,-182,182,182,2,1,215,426,280,426,5,1687,1505
1550,4,4.0.182,0,600,2,97,182,279,0,182,279,279,0,0,0,1,5,253,168,253,350,5,1687,1505
1550,4,5.1.53,0,589,0,61,53,114,53,0,114,182,-53,53,53,2,1,235,426,256,426,5,1687,1505
1550,5,0.1.253,0,593,2,33,253,286,253,0,286,286,-253,253,253,2,1,198,426,269,426,6,1687,1434
1550,5,1.1.32,0,590,1,94,32,126,32,0,126,253,-32,32,32,2,1,303,426,335,426,6,1687,1434
1550,5,2.1.117,0,589,0,81,117,198,117,0,198,253,-117,117,117,2,1,230,426,294,426,6,1687,1434
1550,5,3.1.182,0,639,3,76,182,258,182,0,258,258,-182,182,182,2,1,215,426,280,426,6,1687,1434
1550,5,4.0.253,1,589,0,97,253,350,0,253,350,350,0,0,0,1,6,253,97,253,350,6,1687,1434
1550,5,5.1.53,0,589,0,61,53,114,53,0,114,253,-53,53,53,2,1,235,426,256,426,6,1687,1434
1550,6,0.1.253,0,593,2,33,253,286,253,0,286,350,-253,253,253,2,1,198,426,269,426,7,1687,1337
1550,6,1.1.32,1,590,1,94,32,126,32,0,126,350,-32,32,32,2,1,303,426,335,426,7,1687,1337
1550,6,2.1.117,0,589,0,81,117,198,117,0,198,350,-117,117,117,2,1,230,426,294,426,7,1687,1337
1550,6,3.1.182,0,639,3,76,182,258,182,0,258,350,-182,182,182,2,1,215,426,280,426,7,1687,1337
1550,6,4.1.350,0,643,4,81,350,431,350,0,431,431,-350,350,350,2,1,156,426,253,426,7,1687,1337
1550,6,5.1.53,0,589,0,61,53,114,53,0,114,350,-53,53,53,2,1,235,426,256,426,7,1687,1337
1550,7,0.1.253,0,593,1,33,253,286,253,0,286,350,-127,159,159,2,2,198,332,269,426,8,1687,1243
1550,7,1.2.126,0,590,0,83,126,209,126,0,209,350,-126,126,158,3,1,209,427,335,427,8,1687,1243
1550,7,2.1.126,0,593,1,81,126,207,117,9,207,350,0,32,32,2,2,230,332,294,426,8,1687,1243
1550,7,3.1.182,0,639,2,76,182,258,182,0,258,350,-56,88,88,2,2,215,332,280,426,8,1687,1243
1550,7,4.1.350,0,643,3,81,350,431,350,0,431,431,-224,256,256,2,2,156,332,253,426,8,1687,1243
1550,7,5.1.126,1,590,0,61,126,187,53,73,187,350,0,32,32,2,2,235,332,256,426,8,1687,1243
1550,8,0.1.253,0,606,2,33,253,286,253,0,286,350,-66,98,98,2,3,198,271,269,426,9,1687,1182
1550,8,1.2.126,0,590,0,83,126,209,126,0,209,350,-126,126,158,3,1,209,427,335,427,9,1687,1182
1550,8,2.1.187,1,594,1,81,187,268,117,70,268,350,0,32,32,2,3,230,271,294,426,9,1687,1182
1550,8,3.1.187,0,590,0,76,187,263,182,5,263,350,0,32,32,2,3,215,271,280,426,9,1687,1182
1550,8,4.1.350,0,643,3,81,350,431,350,0,431,431,-163,195,195,2,3,156,271,253,426,9,1687,1182
1550,8,5.2.187,0,651,4,91,187,278,187,0,278,350,-187,187,219,3,1,174,427,256,427,9,1687,1182
1550,9,0.1.268,1,594,0,33,268,301,253,15,301,350,0,32,32,2,4,198,190,269,426,10,1687,1101
1550,9,1.2.126,0,594,0,83,126,209,126,0,209,350,-126,126,158,3,1,209,427,335,427,10,1687,1101
1550,9,2.2.268,0,652,4,86,268,354,268,0,354,354,-268,268,300,3,1,149,427,294,427,10,1687,1101
1550,9,3.1.268,0,600,1,76,268,344,182,86,344,350,0,32,32,2,4,215,190,280,426,10,1687,1101
1550,9,4.1.350,0,643,2,81,350,431,350,0,431,431,-82,114,114,2,4,156,190,253,426,10,1687,1101
1550,9,5.2.187,0,651,3,91,187,278,187,0,278,350,-187,187,219,3,1,174,427,256,427,10,1687,1101
1550,10,0.2.301,0,594,0,52,301,353,301,0,353,353,-301,301,333,3,1,165,427,269,427,11,1687,1068
1550,10,1.2.126,0,594,0,83,126,209,126,0,209,350,-126,126,158,3,1,209,427,335,427,11,1687,1068
1550,10,2.2.268,0,652,3,86,268,354,268,0,354,354,-268,268,300,3,1,149,427,294,427,11,1687,1068
1550,10,3.1.301,1,594,0,76,301,377,182,119,377,377,0,32,32,2,5,215,157,280,426,11,1687,1068
1550,10,4.1.350,0,646,1,81,350,431,350,0,431,431,-49,81,81,2,5,156,157,253,426,11,1687,1068
1550,10,5.2.187,0,651,2,91,187,278,187,0,278,350,-187,187,219,3,1,174,427,256,427,11,1687,1068
1550,11,0.2.301,0,594,0,52,301,353,301,0,353,377,-301,301,333,3,1,165,427,269,427,12,1687,992
1550,11,1.2.126,0,594,0,83,126,209,126,0,209,377,-126,126,158,3,1,209,427,335,427,12,1687,992
1550,11,2.2.268,0,652,3,86,268,354,268,0,354,377,-268,268,300,3,1,149,427,294,427,12,1687,992
1550,11,3.2.377,0,615,1,75,377,452,377,0,452,452,-377,377,409,3,1,139,427,280,427,12,1687,992
1550,11,4.1.377,1,594,0,81,377,458,350,27,458,458,0,32,32,2,6,156,81,253,426,12,1687,992
1550,11,5.2.187,0,651,2,91,187,278,187,0,278,377,-187,187,219,3,1,174,427,256,427,12,1687,992
1550,12,0.2.301,0,594,0,52,301,353,301,0,353,458,-301,301,333,3,1,165,427,269,427,13,1687,911
1550,12,1.2.126,1,594,0,83,126,209,126,0,209,458,-126,126,158,3,1,209,427,335,427,13,1687,911
1550,12,2.2.268,0,652,4,86,268,354,268,0,354,458,-268,268,300,3,1,149,427,294,427,13,1687,911
1550,12,3.2.377,0,615,1,75,377,452,377,0,452,458,-377,377,409,3,1,139,427,280,427,13,1687,911
1550,12,4.2.458,0,637,2,40,458,498,458,0,498,498,-458,458,490,3,1,75,427,253,427,13,1687,911
1550,12,5.2.187,0,651,3,91,187,278,187,0,278,458,-187,187,219,3,1,174,427,256,427,13,1687,911
1550,13,0.2.301,0,594,0,52,301,353,301,0,353,458,-92,218,250,3,2,165,344,269,427,14,1687,828
1550,13,1.3.209,1,594,0,37,209,246,209,0,246,458,-209,209,367,4,1,126,227,335,227,14,1687,828
1550,13,2.2.268,0,652,3,86,268,354,268,0,354,458,-59,185,217,3,2,149,344,294,427,14,1687,828
1550,13,3.2.377,0,615,1,75,377,452,377,0,452,458,-168,294,326,3,2,139,344,280,427,14,1687,828
1550,13,4.2.458,0,637,2,40,458,498,458,0,498,498,-249,375,407,3,2,75,344,253,427,14,1687,828
1550,13,5.2.209,0,594,0,91,209,300,187,22,300,458,0,126,158,3,2,174,344,256,427,14,1687,828
1550,14,0.2.301,0,594,0,52,301,353,301,0,353,458,-92,218,459,3,2,165,344,269,427,15,1687,791
1550,14,1.4.246,1,594,0,89,246,335,246,0,335,458,-246,246,613,5,1,89,257,335,257,15,1687,791
1550,14,2.2.268,0,652,3,86,268,354,268,0,354,458,-59,185,426,3,2,149,344,294,427,15,1687,791
1550,14,3.2.377,0,615,1,75,377,452,377,0,452,458,-168,294,535,3,2,139,344,280,427,15,1687,791
1550,14,4.2.458,0,637,2,40,458,498,458,0,498,498,-249,375,616,3,2,75,344,253,427,15,1687,791
1550,14,5.2.209,0,594,0,91,209,300,187,22,300,458,0,126,367,3,2,174,344,256,427,15,1687,791
1550,15,0.2.301,0,594,0,52,301,353,301,0,353,458,-92,218,705,3,2,165,344,269,427,16,1687,702
1550,15,2.2.268,0,652,3,86,268,354,268,0,354,458,-59,185,672,3,2,149,344,294,427,16,1687,702
1550,15,3.2.377,0,615,1,75,377,452,377,0,452,458,-168,294,781,3,2,139,344,280,427,16,1687,702
1550,15,4.2.458,0,637,2,40,458,498,458,0,498,498,-249,375,862,3,2,75,344,253,427,16,1687,702
1550,15,5.2.209,1,594,0,91,209,300,187,22,300,458,0,126,613,3,2,174,344,256,427,16,1687,702
1550,16,0.2.301,0,594,0,52,301,353,301,0,353,458,-1,127,614,3,3,165,253,269,427,17,1687,611
1550,16,2.2.300,0,600,1,86,300,386,268,32,386,458,0,126,613,3,3,149,253,294,427,17,1687,611
1550,16,3.2.377,0,615,2,75,377,452,377,0,452,458,-77,203,690,3,3,139,253,280,427,17,1687,611
1550,16,4.2.458,0,637,3,40,458,498,458,0,498,498,-158,284,771,3,3,75,253,253,427,17,1687,611
1550,16,5.3.300,1,594,0,27,300,327,300,0,327,458,-54,263,667,4,2,83,190,256,227,17,1687,611
1550,17,0.2.301,0,594,0,52,301,353,301,0,353,458,-1,127,668,3,3,165,253,269,427,18,1687,584
1550,17,2.2.300,0,600,1,86,300,386,268,32,386,458,0,126,667,3,3,149,253,294,427,18,1687,584
1550,17,3.2.377,0,615,2,75,377,452,377,0,452,458,-77,203,744,3,3,139,253,280,427,18,1687,584
1550,17,4.2.458,0,637,3,40,458,498,458,0,498,498,-158,284,825,3,3,75,253,253,427,18,1687,584
1550,17,5.4.335,1,594,0,56,335,391,327,8,391,458,0,246,667,5,2,56,168,256,257,18,1687,584
1550,18,0.2.301,1,594,0,52,301,353,301,0,353,458,-1,127,668,3,3,165,253,269,427,19,1687,528
1550,18,2.2.300,0,600,1,86,300,386,268,32,386,458,0,126,667,3,3,149,253,294,427,19,1687,528
1550,18,3.2.377,0,615,2,75,377,452,377,0,452,458,-77,203,744,3,3,139,253,280,427,19,1687,528
1550,18,4.2.458,0,637,3,40,458,498,458,0,498,498,-158,284,825,3,3,75,253,253,427,19,1687,528
1550,19,0.3.353,1,594,0,82,353,435,353,0,435,458,-26,289,694,4,3,113,163,269,227,20,1687,476
1550,19,2.2.353,0,594,0,86,353,439,268,85,439,458,0,127,668,3,4,149,201,294,427,20,1687,476
1550,19,3.2.377,0,615,1,75,377,452,377,0,452,458,-24,151,692,3,4,139,201,280,427,20,1687,476
1550,19,4.2.458,0,637,2,40,458,498,458,0,498,498,-105,232,773,3,4,75,201,253,427,20,1687,476
1550,20,0.4.435,1,594,0,31,435,466,435,0,466,466,-44,290,738,5,3,31,112,269,257,21,1687,394
1550,20,2.2.353,0,594,0,86,353,439,268,85,439,458,0,127,694,3,4,149,201,294,427,21,1687,394
1550,20,3.2.377,0,615,1,75,377,452,377,0,452,458,-24,151,718,3,4,139,201,280,427,21,1687,394
1550,20,4.2.458,0,637,2,40,458,498,458,0,498,498,-105,232,799,3,4,75,201,253,427,21,1687,394
1550,21,2.2.353,1,594,0,86,353,439,268,85,439,466,0,127,738,3,4,149,201,294,427,22,1687,363
1550,21,3.2.377,0,615,1,75,377,452,377,0,452,466,-24,151,762,3,4,139,201,280,427,22,1687,363
1550,21,4.2.458,0,637,2,40,458,498,458,0,498,498,-105,232,843,3,4,75,201,253,427,22,1687,363
1550,22,2.3.439,1,594,0,15,439,454,439,0,454,466,-4,293,742,4,4,63,81,294,227,23,1687,277
1550,22,3.2.439,0,594,0,75,439,514,377,62,514,514,0,127,738,3,5,139,115,280,427,23,1687,277
1550,22,4.2.458,0,637,1,40,458,498,458,0,498,498,-19,146,757,3,5,75,115,253,427,23,1687,277
1550,23,2.4.466,1,594,0,48,466,514,454,12,514,514,0,290,742,5,4,48,81,294,257,24,1687,262
1550,23,3.2.439,0,594,0,75,439,514,377,62,514,514,0,127,742,3,5,139,115,280,427,24,1687,262
1550,23,4.2.458,0,637,1,40,458,498,458,0,498,498,-19,146,761,3,5,75,115,253,427,24,1687,262
1550,24,3.2.439,1,594,0,75,439,514,377,62,514,514,0,127,742,3,5,139,115,280,427,25,1687,214
1550,24,4.2.458,0,637,1,40,458,498,458,0,498,514,-19,146,761,3,5,75,115,253,427,25,1687,214
1550,25,3.3.514,1,594,0,45,514,559,514,0,559,559,-60,353,802,4,5,64,66,280,227,26,1687,139
1550,25,4.2.514,0,594,0,40,514,554,458,56,554,554,0,127,742,3,6,75,40,253,427,26,1687,139
1550,26,3.4.559,1,594,0,19,559,578,559,0,578,578,-45,335,847,5,5,19,33,280,257,27,1687,94
1550,26,4.2.514,0,594,0,40,514,554,458,56,554,559,0,127,802,3,6,75,40,253,427,27,1687,94
1550,27,4.2.514,1,594,0,40,514,554,458,56,554,578,0,127,847,3,6,75,40,253,427,28,1687,75
1550,28,4.3.559,1,594,0,21,559,580,554,5,580,580,0,353,847,4,6,35,21,253,227,29,1687,35
1550,29,4.4.580,1,594,0,14,580,594,580,0,594,594,-2,337,849,5,6,14,14,253,257,30,1687,14
1551,0,0.0.0,0,572,5,84,0,84,0,0,84,84,0,0,0,1,1,313,168,313,168,1,1364,1364
1551,0,1.0.0,1,499,1,8,0,8,0,0,8,8,0,0,0,1,1,335,168,335,168,1,1364,1364
1551,0,2.0.0,0,509,3,11,0,11,0,0,11,11,0,0,0,1,1,222,168,222,168,1,1364,1364
1551,0,3.0.0,0,498,0,19,0,19,0,0,19,19,0,0,0,1,1,142,168,142,168,1,1364,1364
1551,0,4.0.0,0,508,2,20,0,20,0,0,20,20,0,0,0,1,1,193,168,193,168,1,1364,1364
1551,0,5.0.0,0,514,4,26,0,26,0,0,26,26,0,0,0,1,1,159,168,159,168,1,1364,1364
1551,1,0.0.8,0,580,5,84,8,92,0,8,92,92,0,0,0,1,2,313,160,313,168,2,1364,1356
1551,1,1.1.8,0,539,4,62,8,70,8,0,70,70,-8,8,8,2,1,327,230,335,230,2,1364,1356
1551,1,2.0.8,1,510,1,11,8,19,0,8,19,19,0,0,0,1,2,222,160,222,168,2,1364,1356
1551,1,3.0.8,0,499,0,19,8,27,0,8,27,27,0,0,0,1,2,142,160,142,168,2,1364,1356
1551,1,4.0.8,0,516,2,20,8,28,0,8,28,28,0,0,0,1,2,193,160,193,168,2,1364,1356
1551,1,5.0.8,0,522,3,26,8,34,0,8,34,34,0,0,0,1,2,159,160,159,168,2,1364,1356
1551,2,0.0.19,0,591,5,84,19,103,0,19,103,103,0,0,0,1,3,313,149,313,168,3,1364,1345
1551,2,1.1.8,0,539,3,62,8,70,8,0,70,70,-8,8,8,2,1,327,230,335,230,3,1364,1345
1551,2,2.1.19,0,562,4,74,19,93,19,0,93,93,-19,19,19,2,1,211,230,222,230,3,1364,1345
1551,2,3.0.19,0,510,0,19,19,38,0,19,38,38,0,0,0,1,3,142,149,142,168,3,1364,1345
1551,2,4.0.19,1,527,1,20,19,39,0,19,39,39,0,0,0,1,3,193,149,193,168,3,1364,1345
1551,2,5.0.19,0,533,2,26,19,45,0,19,45,45,0,0,0,1,3,159,149,159,168,3,1364,1345
1551,3,0.0.39,0,553,2,84,39,123,0,39,123,123,0,0,0,1,4,313,129,313,168,4,1364,1325
1551,3,1.1.8,0,539,1,62,8,70,8,0,70,70,-8,8,8,2,1,327,230,335,230,4,1364,1325
1551,3,2.1.19,0,562,3,74,19,93,19,0,93,93,-19,19,19,2,1,211,230,222,230,4,1364,1325
1551,3,3.0.39,1,527,0,19,39,58,0,39,58,58,0,0,0,1,4,142,129,142,168,4,1364,1325
1551,3,4.1.39,0,527,0,34,39,73,39,0,73,73,-39,39,39,2,1,173,230,193,230,4,1364,1325
1551,3,5.0.39,0,527,0,26,39,65,0,39,65,65,0,0,0,1,4,159,129,159,168,4,1364,1325
1551,4,0.0.58,0,539,1,84,58,142,0,58,142,142,0,0,0,1,5,313,110,313,168,5,1364,1306
1551,4,1.1.8,0,539,1,62,8,70,8,0,70,70,-8,8,8,2,1,327,230,335,230,5,1364,1306
1551,4,2.1.19,0,562,2,74,19,93,19,0,93,93,-19,19,19,2,1,211,230,222,230,5,1364,1306
1551,4,3.1.58,0,527,0,15,58,73,58,0,73,73,-58,58,58,2,1,123,230,142,230,5,1364,1306
1551,4,4.1.39,0,527,0,34,39,73,39,0,73,73,-39,39,39,2,1,173,230,193,230,5,1364,1306
1551,4,5.0.58,1,527,0,26,58,84,0,58,84,84,0,0,0,1,5,159,110,159,168,5,1364,1306
1551,5,0.0.84,1,527,0,84,84,168,0,84,168,168,0,0,0,1,6,313,84,313,168,6,1364,1280
1551,5,1.1.8,0,539,1,62,8,70,8,0,70,84,-8,8,8,2,1,327,230,335,230,6,1364,1280
1551,5,2.1.19,0,562,3,74,19,93,19,0,93,93,-19,19,19,2,1,211,230,222,230,6,1364,1280
1551,5,3.1.58,0,527,0,15,58,73,58,0,73,84,-58,58,58,2,1,123,230,142,230,6,1364,1280
1551,5,4.1.39,0,527,0,34,39,73,39,0,73,84,-39,39,39,2,1,173,230,193,230,6,1364,1280
1551,5,5.1.84,0,541,2,44,84,128,84,0,128,128,-84,84,84,2,1,133,230,159,230,6,1364,1280
1551,6,0.1.168,0,527,0,1,168,169,168,0,169,169,-168,168,168,2,1,229,230,313,230,7,1364,1196
1551,6,1.1.8,1,539,1,62,8,70,8,0,70,168,-8,8,8,2,1,327,230,335,230,7,1364,1196
1551,6,2.1.19,0,562,3,74,19,93,19,0,93,168,-19,19,19,2,1,211,230,222,230,7,1364,1196
1551,6,3.1.58,0,527,0,15,58,73,58,0,73,168,-58,58,58,2,1,123,230,142,230,7,1364,1196
1551,6,4.1.39,0,527,0,34,39,73,39,0,73,168,-39,39,39,2,1,173,230,193,230,7,1364,1196
1551,6,5.1.84,0,541,2,44,84,128,84,0,128,168,-84,84,84,2,1,133,230,159,230,7,1364,1196
1551,7,0.1.168,0,539,0,1,168,169,168,0,169,169,-98,106,106,2,2,229,168,313,230,8,1364,1134
1551,7,1.2.70,0,587,3,89,70,159,70,0,159,168,-70,70,78,3,1,265,299,335,299,8,1364,1134
1551,7,2.1.70,0,593,4,74,70,144,19,51,144,168,0,8,8,2,2,211,168,222,230,8,1364,1134
1551,7,3.1.70,0,539,0,15,70,85,58,12,85,168,0,8,8,2,2,123,168,142,230,8,1364,1134
1551,7,4.1.70,1,558,1,34,70,104,39,31,104,168,0,8,8,2,2,173,168,193,230,8,1364,1134
1551,7,5.1.84,0,582,2,44,84,128,84,0,128,168,-14,22,22,2,2,133,168,159,230,8,1364,1134
1551,8,0.1.168,1,558,0,1,168,169,168,0,169,169,-64,72,72,2,3,229,134,313,230,9,1364,1100
1551,8,1.2.70,0,587,3,89,70,159,70,0,159,168,-70,70,78,3,1,265,299,335,299,9,1364,1100
1551,8,2.1.104,0,585,2,74,104,178,19,85,178,178,0,8,8,2,3,211,134,222,230,9,1364,1100
1551,8,3.1.104,0,558,0,15,104,119,58,46,119,168,0,8,8,2,3,123,134,142,230,9,1364,1100
1551,8,4.2.104,0,558,0,41,104,145,104,0,145,168,-104,104,112,3,1,139,299,193,299,9,1364,1100
1551,8,5.1.104,0,561,1,44,104,148,84,20,148,168,0,8,8,2,3,133,134,159,230,9,1364,1100
1551,9,0.2.169,0,587,2,56,169,225,169,0,225,225,-169,169,241,3,1,228,299,313,299,10,1364,1099
1551,9,1.2.70,0,587,2,89,70,159,70,0,159,169,-70,70,142,3,1,265,299,335,299,10,1364,1099
1551,9,2.1.169,0,558,0,74,169,243,19,150,243,243,0,72,72,2,4,211,133,222,230,10,1364,1099
1551,9,3.1.104,1,558,0,15,104,119,58,46,169,169,15,57,57,2,4,123,133,142,230,10,1364,1099
1551,9,4.2.104,0,558,0,41,104,145,104,0,145,169,-104,104,176,3,1,139,299,193,299,10,1364,1099
1551,9,5.1.104,0,561,1,44,104,148,84,20,169,169,44,28,28,2,4,133,133,159,230,10,1364,1099
1551,10,0.2.169,0,587,2,56,169,225,169,0,225,225,-169,169,226,3,1,228,299,313,299,11,1364,1084
1551,10,1.2.70,0,591,3,89,70,159,70,0,159,169,-70,70,127,3,1,265,299,335,299,11,1364,1084
1551,10,2.1.169,1,558,0,74,169,243,19,150,243,243,0,57,57,2,5,211,118,222,230,11,1364,1084
1551,10,3.2.119,0,573,1,43,119,162,119,0,162,169,-119,119,176,3,1,108,299,142,299,11,1364,1084
1551,10,4.2.104,0,558,0,41,104,145,104,0,145,169,-104,104,161,3,1,139,299,193,299,11,1364,1084
1551,10,5.1.119,0,558,0,44,119,163,84,35,169,169,44,13,13,2,5,133,118,159,230,11,1364,1084
1551,11,0.2.169,0,587,2,56,169,225,169,0,225,243,-169,169,226,3,1,228,299,313,299,12,1364,1010
1551,11,1.2.70,0,591,3,89,70,159,70,0,159,243,-70,70,127,3,1,265,299,335,299,12,1364,1010
1551,11,2.2.243,0,591,3,40,243,283,243,0,283,283,-243,243,300,3,1,137,299,222,299,12,1364,1010
1551,11,3.2.119,0,573,1,43,119,162,119,0,162,243,-119,119,176,3,1,108,299,142,299,12,1364,1010
1551,11,4.2.104,0,558,0,41,104,145,104,0,145,243,-104,104,161,3,1,139,299,193,299,12,1364,1010
1551,11,5.1.119,1,558,0,44,119,163,84,35,243,243,44,13,13,2,6,133,44,159,230,12,1364,1010
1551,12,0.2.169,0,587,3,56,169,225,169,0,225,243,-169,169,182,3,1,228,299,313,299,13,1364,966
1551,12,1.2.70,1,591,4,89,70,159,70,0,159,243,-70,70,83,3,1,265,299,335,299,13,1364,966
1551,12,2.2.243,0,591,4,40,243,283,243,0,283,283,-243,243,256,3,1,137,299,222,299,13,1364,966
1551,12,3.2.119,0,573,1,43,119,162,119,0,162,243,-119,119,132,3,1,108,299,142,299,13,1364,966
1551,12,4.2.104,0,558,0,41,104,145,104,0,145,243,-104,104,117,3,1,139,299,193,299,13,1364,966
1551,12,5.2.163,0,574,2,30,163,193,163,0,193,243,-163,163,176,3,1,89,299,159,299,13,1364,966
1551,13,0.2.169,0,623,3,56,169,225,169,0,225,243,-10,80,93,3,2,228,210,313,299,14,1364,877
1551,13,1.3.159,1,623,3,78,159,237,159,0,237,243,-159,159,242,4,1,176,281,335,281,14,1364,877
1551,13,2.2.243,0,591,0,40,243,283,243,0,283,283,-84,154,167,3,2,137,210,222,299,14,1364,877
1551,13,3.2.159,0,593,1,43,159,202,119,40,202,243,0,70,83,3,2,108,210,142,299,14,1364,877
1551,13,4.2.159,0,600,2,41,159,200,104,55,200,243,0,70,83,3,2,139,210,193,299,14,1364,877
1551,13,5.2.163,0,591,0,30,163,193,163,0,193,243,-4,74,87,3,2,89,210,159,299,14,1364,877
1551,14,0.2.169,0,623,0,56,169,225,169,0,225,243,-10,80,252,3,2,228,210,313,299,15,1364,799
1551,14,1.4.237,0,623,0,98,237,335,237,0,335,335,-237,237,479,5,1,98,386,335,386,15,1364,799
1551,14,2.2.243,0,623,0,40,243,283,243,0,283,283,-84,154,326,3,2,137,210,222,299,15,1364,799
1551,14,3.2.159,0,623,0,43,159,202,119,40,202,243,0,70,242,3,2,108,210,142,299,15,1364,799
1551,14,4.2.159,1,623,0,41,159,200,104,55,200,243,0,70,242,3,2,139,210,193,299,15,1364,799
1551,14,5.2.163,0,623,0,30,163,193,163,0,193,243,-4,74,246,3,2,89,210,159,299,15,1364,799
1551,15,0.2.200,0,623,0,56,200,256,169,31,256,256,0,70,242,3,3,228,169,313,299,16,1364,758
1551,15,1.4.237,0,623,0,98,237,335,237,0,335,335,-237,237,479,5,1,98,386,335,386,16,1364,758
1551,15,2.2.243,0,623,0,40,243,283,243,0,283,283,-43,113,285,3,3,137,169,222,299,16,1364,758
1551,15,3.2.200,0,623,0,43,200,243,119,81,243,243,0,70,242,3,3,108,169,142,299,16,1364,758
1551,15,4.3.237,1,623,0,14,237,251,200,37,251,251,0,159,242,4,2,98,203,193,281,16,1364,758
1551,15,5.2.200,0,623,0,30,200,230,163,37,230,243,0,70,242,3,3,89,169,159,299,16,1364,758
1551,16,0.2.200,1,623,0,56,200,256,169,31,256,256,0,70,242,3,3,228,169,313,299,17,1364,744
1551,16,1.4.237,0,623,0,98,237,335,237,0,335,335,-237,237,479,5,1,98,386,335,386,17,1364,744
1551,16,2.2.243,0,623,0,40,243,283,243,0,283,283,-43,113,285,3,3,137,169,222,299,17,1364,744
1551,16,3.2.200,0,623,0,43,200,243,119,81,243,251,0,70,242,3,3,108,169,142,299,17,1364,744
1551,16,4.4.251,0,637,1,84,251,335,251,0,335,335,-251,251,493,5,1,84,386,193,386,17,1364,744
1551,16,5.2.200,0,623,0,30,200,230,163,37,230,251,0,70,242,3,3,89,169,159,299,17,1364,744
1551,17,0.3.256,0,623,0,89,256,345,256,0,345,345,-5,164,247,4,3,172,189,313,281,18,1364,688
1551,17,1.4.237,0,623,0,98,237,335,237,0,335,335,-237,237,479,5,1,98,386,335,386,18,1364,688
1551,17,2.2.256,0,623,0,40,256,296,243,13,296,296,0,70,242,3,4,137,113,222,299,18,1364,688
1551,17,3.2.256,1,623,0,43,256,299,119,137,299,299,0,70,242,3,4,108,113,142,299,18,1364,688
1551,17,4.4.251,0,637,1,84,251,335,251,0,335,335,-251,251,493,5,1,84,386,193,386,18,1364,688
1551,17,5.2.256,0,623,0,30,256,286,163,93,286,286,0,70,242,3,4,89,113,159,299,18,1364,688
1551,18,0.3.256,0,623,0,89,256,345,256,0,345,345,-5,164,247,4,3,172,189,313,281,19,1364,645
1551,18,1.4.237,0,623,0,98,237,335,237,0,335,335,-237,237,479,5,1,98,386,335,386,19,1364,645
1551,18,2.2.299,0,623,0,40,299,339,243,56,339,339,0,70,242,3,5,137,70,222,299,19,1364,645
1551,18,3.3.299,0,623,0,5,299,304,299,0,304,304,-48,207,290,4,3,65,189,142,281,19,1364,645
1551,18,4.4.251,0,637,1,84,251,335,251,0,335,335,-251,251,493,5,1,84,386,193,386,19,1364,645
1551,18,5.2.299,1,623,0,30,299,329,163,136,329,329,0,70,242,3,5,89,70,159,299,19,1364,645
1551,19,0.3.256,0,623,0,89,256,345,256,0,345,345,-5,164,247,4,3,172,189,313,281,20,1364,615
1551,19,1.4.237,0,623,0,98,237,335,237,0,335,335,-237,237,479,5,1,98,386,335,386,20,1364,615
1551,19,2.2.329,1,623,0,40,329,369,243,86,369,369,0,70,242,3,6,137,40,222,299,20,1364,615
1551,19,3.3.299,0,623,0,5,299,304,299,0,304,329,-48,207,290,4,3,65,189,142,281,20,1364,615
1551,19,4.4.251,0,637,1,84,251,335,251,0,335,335,-251,251,493,5,1,84,386,193,386,20,1364,615
1551,19,5.3.329,0,623,0,12,329,341,329,0,341,341,-78,237,320,4,3,59,189,159,281,20,1364,615
1551,20,0.3.256,1,623,0,89,256,345,256,0,345,369,-5,164,247,4,3,172,189,313,281,21,1364,575
1551,20,1.4.237,0,623,0,98,237,335,237,0,335,369,-237,237,479,5,1,98,386,335,386,21,1364,575
1551,20,2.3.369,0,623,0,83,369,452,369,0,452,452,-118,277,360,4,3,97,189,222,281,21,1364,575
1551,20,3.3.299,0,623,0,5,299,304,299,0,304,369,-48,207,290,4,3,65,189,142,281,21,1364,575
1551,20,4.4.251,0,637,1,84,251,335,251,0,335,369,-251,251,493,5,1,84,386,193,386,21,1364,575
1551,20,5.3.329,0,623,0,12,329,341,329,0,341,369,-78,237,320,4,3,59,189,159,281,21,1364,575
1551,21,0.4.345,0,633,1,83,345,428,345,0,428,428,-345,345,592,5,1,83,386,313,386,22,1364,486
1551,21,1.4.237,0,623,0,98,237,335,237,0,335,369,-237,237,484,5,1,98,386,335,386,22,1364,486
1551,21,2.3.369,0,623,0,83,369,452,369,0,452,452,-24,188,271,4,4,97,100,222,281,22,1364,486
1551,21,3.3.345,1,623,0,5,345,350,299,46,350,369,0,164,247,4,4,65,100,142,281,22,1364,486
1551,21,4.4.251,0,637,2,84,251,335,251,0,335,369,-251,251,498,5,1,84,386,193,386,22,1364,486
1551,21,5.3.345,0,623,0,12,345,357,329,16,357,369,0,164,247,4,4,59,100,159,281,22,1364,486
1551,22,0.4.345,0,633,1,83,345,428,345,0,428,428,-345,345,592,5,1,83,386,313,386,23,1364,481
1551,22,1.4.237,0,623,0,98,237,335,237,0,335,369,-237,237,484,5,1,98,386,335,386,23,1364,481
1551,22,2.3.369,0,623,0,83,369,452,369,0,452,452,-19,183,266,4,5,97,95,222,281,23,1364,481
1551,22,3.4.350,0,638,3,60,350,410,350,0,410,410,-350,350,597,5,1,60,386,142,386,23,1364,481
1551,22,4.4.251,0,637,2,84,251,335,251,0,335,369,-251,251,498,5,1,84,386,193,386,23,1364,481
1551,22,5.3.350,1,623,0,12,350,362,329,21,362,369,0,164,247,4,5,59,95,159,281,23,1364,481
1551,23,0.4.345,0,633,1,83,345,428,345,0,428,428,-345,345,592,5,1,83,386,313,386,24,1364,469
1551,23,1.4.237,0,623,0,98,237,335,237,0,335,369,-237,237,484,5,1,98,386,335,386,24,1364,469
1551,23,2.3.369,1,623,0,83,369,452,369,0,452,452,-7,171,254,4,6,97,83,222,281,24,1364,469
1551,23,3.4.350,0,638,3,60,350,410,350,0,410,410,-350,350,597,5,1,60,386,142,386,24,1364,469
1551,23,4.4.251,0,637,2,84,251,335,251,0,335,369,-251,251,498,5,1,84,386,193,386,24,1364,469
1551,23,5.4.362,0,650,4,47,362,409,362,0,409,409,-362,362,609,5,1,47,386,159,386,24,1364,469
1551,24,0.4.345,0,633,1,83,345,428,345,0,428,452,-345,345,599,5,1,83,386,313,386,25,1364,386
1551,24,1.4.237,1,623,0,98,237,335,237,0,335,452,-237,237,491,5,1,98,386,335,386,25,1364,386
1551,24,2.4.452,0,656,5,14,452,466,452,0,466,466,-452,452,706,5,1,14,386,222,386,25,1364,386
1551,24,3.4.350,0,638,3,60,350,410,350,0,410,452,-350,350,604,5,1,60,386,142,386,25,1364,386
1551,24,4.4.251,0,637,2,84,251,335,251,0,335,452,-251,251,505,5,1,84,386,193,386,25,1364,386
1551,24,5.4.362,0,650,4,47,362,409,362,0,409,452,-362,362,616,5,1,47,386,159,386,25,1364,386
1551,25,0.4.345,0,633,1,83,345,428,345,0,428,452,-10,247,501,5,2,83,288,313,386,26,1364,288
1551,25,2.4.452,0,656,4,14,452,466,452,0,466,466,-117,354,608,5,2,14,288,222,386,26,1364,288
1551,25,3.4.350,0,638,2,60,350,410,350,0,410,452,-15,252,506,5,2,60,288,142,386,26,1364,288
1551,25,4.4.335,1,623,0,84,335,419,251,84,419,452,0,237,491,5,2,84,288,193,386,26,1364,288
1551,25,5.4.362,0,650,3,47,362,409,362,0,409,452,-27,264,518,5,2,47,288,159,386,26,1364,288
1551,26,0.4.419,1,623,0,83,419,502,345,74,502,502,0,237,491,5,3,83,204,313,386,27,1364,204
1551,26,2.4.452,0,656,1,14,452,466,452,0,466,466,-33,270,524,5,3,14,204,222,386,27,1364,204
1551,26,3.4.419,0,623,0,60,419,479,350,69,479,479,0,237,491,5,3,60,204,142,386,27,1364,204
1551,26,5.4.419,0,623,0,47,419,466,362,57,466,466,0,237,491,5,3,47,204,159,386,27,1364,204
1551,27,2.4.502,1,623,0,14,502,516,452,50,516,516,0,237,491,5,4,14,121,222,386,28,1364,121
1551,27,3.4.502,0,623,0,60,502,562,350,152,562,562,0,237,491,5,4,60,121,142,386,28,1364,121
1551,27,5.4.502,0,623,0,47,502,549,362,140,549,549,0,237,491,5,4,47,121,159,386,28,1364,121
1551,28,3.4.516,0,623,0,60,516,576,350,166,576,576,0,237,491,5,5,60,107,142,386,29,1364,107
1551,28,5.4.516,1,623,0,47,516,563,362,154,563,563,0,237,491,5,5,47,107,159,386,29,1364,107
1551,29,3.4.563,1,623,0,60,563,623,350,213,623,623,0,237,491,5,6,60,60,142,386,30,1364,60
1552,0,0.0.0,0,580,4,97,0,97,0,0,97,97,0,0,0,1,1,355,380,355,380,1,1628,1628
1552,0,1.0.0,0,605,5,83,0,83,0,0,83,83,0,0,0,1,1,236,380,236,380,1,1628,1628
1552,0,2.0.0,1,543,1,56,0,56,0,0,56,56,0,0,0,1,1,347,380,347,380,1,1628,1628
1552,0,3.0.0,0,576,3,72,0,72,0,0,72,72,0,0,0,1,1,201,380,201,380,1,1628,1628
1552,0,4.0.0,0,555,2,41,0,41,0,0,41,41,0,0,0,1,1,229,380,229,380,1,1628,1628
1552,0,5.0.0,0,523,0,31,0,31,0,0,31,31,0,0,0,1,1,260,380,260,380,1,1628,1628
1552,1,0.0.56,0,574,4,97,56,153,0,56,153,153,0,0,0,1,2,355,324,355,380,2,1628,1572
1552,1,1.0.56,0,605,5,83,56,139,0,56,139,139,0,0,0,1,2,236,324,236,380,2,1628,1572
1552,1,2.1.56,1,566,1,68,56,124,56,0,124,124,-56,56,56,2,1,291,332,347,332,2,1628,1572
1552,1,3.0.56,0,573,3,72,56,128,0,56,128,128,0,0,0,1,2,201,324,201,380,2,1628,1572
1552,1,4.0.56,0,568,2,41,56,97,0,56,97,97,0,0,0,1,2,229,324,229,380,2,1628,1572
1552,1,5.0.56,0,543,0,31,56,87,0,56,87,87,0,0,0,1,2,260,324,260,380,2,1628,1572
1552,2,0.0.56,0,574,3,97,56,153,0,56,153,153,0,0,56,1,2,355,324,355,380,3,1628,1504
1552,2,1.0.56,0,605,4,83,56,139,0,56,139,139,0,0,56,1,2,236,324,236,380,3,1628,1504
1552,2,2.2.124,0,568,1,92,124,216,124,0,216,216,-124,124,180,3,1,223,365,347,365,3,1628,1504
1552,2,3.0.56,0,573,2,72,56,128,0,56,128,128,0,0,56,1,2,201,324,201,380,3,1628,1504
1552,2,4.0.56,0,568,1,41,56,97,0,56,97,124,0,0,56,1,2,229,324,229,380,3,1628,1504
1552,2,5.0.56,1,566,0,31,56,87,0,56,87,124,0,0,56,1,2,260,324,260,380,3,1628,1504
1552,3,0.0.87,0,566,0,97,87,184,0,87,184,184,0,0,56,1,3,355,293,355,380,4,1628,1473
1552,3,1.0.87,0,605,3,83,87,170,0,87,170,170,0,0,56,1,3,236,293,236,380,4,1628,1473
1552,3,2.2.124,0,568,1,92,124,216,124,0,216,216,-124,124,180,3,1,223,365,347,365,4,1628,1473
1552,3,3.0.87,0,573,2,72,87,159,0,87,159,159,0,0,56,1,3,201,293,201,380,4,1628,1473
1552,3,4.0.87,0,566,0,41,87,128,0,87,128,128,0,0,56,1,3,229,293,229,380,4,1628,1473
1552,3,5.1.124,1,566,0,27,124,151,87,37,151,151,0,56,56,2,2,229,264,260,332,4,1628,1473
1552,4,0.0.87,0,566,0,97,87,184,0,87,184,184,0,0,56,1,3,355,293,355,380,5,1628,1446
1552,4,1.0.87,0,605,3,83,87,170,0,87,170,170,0,0,56,1,3,236,293,236,380,5,1628,1446
1552,4,2.2.124,0,568,1,92,124,216,124,0,216,216,-124,124,180,3,1,223,365,347,365,5,1628,1446
1552,4,3.0.87,0,573,2,72,87,159,0,87,159,159,0,0,56,1,3,201,293,201,380,5,1628,1446
1552,4,4.0.87,1,566,0,41,87,128,0,87,128,151,0,0,56,1,3,229,293,229,380,5,1628,1446
1552,4,5.2.151,0,566,0,68,151,219,151,0,219,219,-151,151,207,3,1,202,365,260,365,5,1628,1446
1552,5,0.0.128,1,566,0,97,128,225,0,128,225,225,0,0,56,1,4,355,252,355,380,6,1628,1405
1552,5,1.0.128,0,616,3,83,128,211,0,128,211,211,0,0,56,1,4,236,252,236,380,6,1628,1405
1552,5,2.2.124,0,568,1,92,124,216,124,0,216,216,-124,124,180,3,1,223,365,347,365,6,1628,1405
1552,5,3.0.128,0,576,2,72,128,200,0,128,200,200,0,0,56,1,4,201,252,201,380,6,1628,1405
1552,5,4.1.151,0,566,0,85,151,236,128,23,236,236,0,56,56,2,3,188,237,229,332,6,1628,1405
1552,5,5.2.151,0,566,0,68,151,219,151,0,219,219,-151,151,207,3,1,202,365,260,365,6,1628,1405
1552,6,0.1.225,0,576,2,68,225,293,225,0,293,293,-74,130,130,2,3,258,237,355,332,7,1628,1308
1552,6,1.0.225,1,566,0,83,225,308,0,225,308,308,0,0,56,1,5,236,155,236,380,7,1628,1308
1552,6,2.2.124,0,568,1,92,124,216,124,0,216,225,-124,124,180,3,1,223,365,347,365,7,1628,1308
1552,6,3.0.225,0,566,0,72,225,297,0,225,297,297,0,0,56,1,5,201,155,201,380,7,1628,1308
1552,6,4.1.151,0,566,0,85,151,236,128,23,236,236,0,56,56,2,3,188,237,229,332,7,1628,1308
1552,6,5.2.151,0,566,0,68,151,219,151,0,219,225,-151,151,207,3,1,202,365,260,365,7,1628,1308
1552,7,0.1.225,0,576,2,68,225,293,225,0,293,308,-74,130,130,2,3,258,237,355,332,8,1628,1225
1552,7,1.1.308,0,566,0,31,308,339,308,0,339,339,-157,213,213,2,3,153,237,236,332,8,1628,1225
1552,7,2.2.124,0,568,1,92,124,216,124,0,216,308,-124,124,180,3,1,223,365,347,365,8,1628,1225
1552,7,3.0.308,1,566,0,72,308,380,0,308,380,380,0,0,56,1,6,201,72,201,380,8,1628,1225
1552,7,4.1.151,0,566,0,85,151,236,128,23,236,308,0,56,56,2,3,188,237,229,332,8,1628,1225
1552,7,5.2.151,0,566,0,68,151,219,151,0,219,308,-151,151,207,3,1,202,365,260,365,8,1628,1225
1552,8,0.1.225,0,576,2,68,225,293,225,0,293,380,-74,130,130,2,3,258,237,355,332,9,1628,1153
1552,8,1.1.308,0,566,0,31,308,339,308,0,339,380,-157,213,213,2,3,153,237,236,332,9,1628,1153
1552,8,2.2.124,0,568,1,92,124,216,124,0,216,380,-124,124,180,3,1,223,365,347,365,9,1628,1153
1552,8,3.1.380,0,566,0,53,380,433,380,0,433,433,-229,285,285,2,3,129,237,201,332,9,1628,1153
1552,8,4.1.151,1,566,0,85,151,236,128,23,236,380,0,56,56,2,3,188,237,229,332,9,1628,1153
1552,8,5.2.151,0,566,0,68,151,219,151,0,219,380,-151,151,207,3,1,202,365,260,365,9,1628,1153
1552,9,0.1.236,1,566,0,68,236,304,225,11,304,380,0,56,56,2,4,258,152,355,332,10,1628,1068
1552,9,1.1.308,0,566,0,31,308,339,308,0,339,380,-72,128,128,2,4,153,152,236,332,10,1628,1068
1552,9,2.2.124,0,568,1,92,124,216,124,0,216,380,-124,124,180,3,1,223,365,347,365,10,1628,1068
1552,9,3.1.380,0,566,0,53,380,433,380,0,433,433,-144,200,200,2,4,129,152,201,332,10,1628,1068
1552,9,4.2.236,0,601,2,42,236,278,236,0,278,380,-236,236,292,3,1,103,365,229,365,10,1628,1068
1552,9,5.2.151,0,566,0,68,151,219,151,0,219,380,-151,151,207,3,1,202,365,260,365,10,1628,1068
1552,10,0.2.304,0,576,2,59,304,363,304,0,363,380,-304,304,360,3,1,190,365,355,365,11,1628,1000
1552,10,1.1.308,1,566,0,31,308,339,308,0,339,380,-4,60,60,2,5,153,84,236,332,11,1628,1000
1552,10,2.2.124,0,568,1,92,124,216,124,0,216,380,-124,124,180,3,1,223,365,347,365,11,1628,1000
1552,10,3.1.380,0,566,0,53,380,433,380,0,433,433,-76,132,132,2,5,129,84,201,332,11,1628,1000
1552,10,4.2.236,0,601,3,42,236,278,236,0,278,380,-236,236,292,3,1,103,365,229,365,11,1628,1000
1552,10,5.2.151,0,566,0,68,151,219,151,0,219,380,-151,151,207,3,1,202,365,260,365,11,1628,1000
1552,11,0.2.304,0,576,2,59,304,363,304,0,363,380,-304,304,364,3,1,190,365,355,365,12,1628,969
1552,11,1.2.339,0,645,4,94,339,433,339,0,433,433,-339,339,399,3,1,122,365,236,365,12,1628,969
1552,11,2.2.124,0,568,1,92,124,216,124,0,216,380,-124,124,184,3,1,223,365,347,365,12,1628,969
1552,11,3.1.380,1,566,0,53,380,433,380,0,433,433,-41,101,101,2,6,129,53,201,332,12,1628,969
1552,11,4.2.236,0,601,3,42,236,278,236,0,278,380,-236,236,296,3,1,103,365,229,365,12,1628,969
1552,11,5.2.151,0,566,0,68,151,219,151,0,219,380,-151,151,211,3,1,202,365,260,365,12,1628,969
1552,12,0.2.304,0,576,2,59,304,363,304,0,363,433,-304,304,405,3,1,190,365,355,365,13,1628,916
1552,12,1.2.339,0,645,4,94,339,433,339,0,433,433,-339,339,440,3,1,122,365,236,365,13,1628,916
1552,12,2.2.124,1,568,1,92,124,216,124,0,216,433,-124,124,225,3,1,223,365,347,365,13,1628,916
1552,12,3.2.433,0,566,0,10,433,443,433,0,443,443,-433,433,534,3,1,76,365,201,365,13,1628,916
1552,12,4.2.236,0,601,3,42,236,278,236,0,278,433,-236,236,337,3,1,103,365,229,365,13,1628,916
1552,12,5.2.151,0,566,0,68,151,219,151,0,219,433,-151,151,252,3,1,202,365,260,365,13,1628,916
1552,13,0.2.304,0,576,2,59,304,363,304,0,363,433,-88,212,313,3,2,190,273,355,365,14,1628,824
1552,13,1.2.339,0,645,4,94,339,433,339,0,433,433,-123,247,348,3,2,122,273,236,365,14,1628,824
1552,13,2.3.216,1,568,0,52,216,268,216,0,268,433,-216,216,441,4,1,131,333,347,333,14,1628,824
1552,13,3.2.433,0,573,1,10,433,443,433,0,443,443,-217,341,442,3,2,76,273,201,365,14,1628,824
1552,13,4.2.236,0,623,3,42,236,278,236,0,278,433,-20,144,245,3,2,103,273,229,365,14,1628,824
1552,13,5.2.216,0,568,0,68,216,284,151,65,284,433,0,124,225,3,2,202,273,260,365,14,1628,824
1552,14,0.2.304,0,576,2,59,304,363,304,0,363,433,-88,212,529,3,2,190,273,355,365,15,1628,772
1552,14,1.2.339,0,645,4,94,339,433,339,0,433,433,-123,247,564,3,2,122,273,236,365,15,1628,772
1552,14,2.4.268,1,568,0,79,268,347,268,0,347,433,-268,268,709,5,1,79,218,347,218,15,1628,772
1552,14,3.2.433,0,573,1,10,433,443,433,0,443,443,-217,341,658,3,2,76,273,201,365,15,1628,772
1552,14,4.2.236,0,623,3,42,236,278,236,0,278,433,-20,144,461,3,2,103,273,229,365,15,1628,772
1552,14,5.2.216,0,568,0,68,216,284,151,65,284,433,0,124,441,3,2,202,273,260,365,15,1628,772
1552,15,0.2.304,0,576,2,59,304,363,304,0,363,433,-88,212,797,3,2,190,273,355,365,16,1628,693
1552,15,1.2.339,0,645,4,94,339,433,339,0,433,433,-123,247,832,3,2,122,273,236,365,16,1628,693
1552,15,3.2.433,0,573,1,10,433,443,433,0,443,443,-217,341,926,3,2,76,273,201,365,16,1628,693
1552,15,4.2.236,0,623,3,42,236,278,236,0,278,433,-20,144,729,3,2,103,273,229,365,16,1628,693
1552,15,5.2.216,1,568,0,68,216,284,151,65,284,433,0,124,709,3,2,202,273,260,365,16,1628,693
1552,16,0.2.304,0,576,2,59,304,363,304,0,363,433,-20,144,729,3,3,190,205,355,365,17,1628,625
1552,16,1.2.339,0,645,3,94,339,433,339,0,433,433,-55,179,764,3,3,122,205,236,365,17,1628,625
1552,16,3.2.433,0,573,1,10,433,443,433,0,443,443,-149,273,858,3,3,76,205,201,365,17,1628,625
1552,16,4.2.284,1,568,0,42,284,326,236,48,326,433,0,124,709,3,3,103,205,229,365,17,1628,625
1552,16,5.3.284,0,568,0,96,284,380,284,0,380,433,-16,232,725,4,2,134,281,260,333,17,1628,625
1552,17,0.2.326,1,568,0,59,326,385,304,22,385,433,0,124,709,3,4,190,163,355,365,18,1628,583
1552,17,1.2.339,0,645,3,94,339,433,339,0,433,433,-13,137,722,3,4,122,163,236,365,18,1628,583
1552,17,3.2.433,0,573,1,10,433,443,433,0,443,443,-107,231,816,3,4,76,163,201,365,18,1628,583
1552,17,4.3.326,0,610,2,7,326,333,326,0,333,433,-58,274,767,4,2,61,281,229,333,18,1628,583
1552,17,5.3.284,0,568,0,96,284,380,284,0,380,433,-16,232,725,4,2,134,281,260,333,18,1628,583
1552,18,0.3.385,0,581,2,95,385,480,385,0,480,480,-117,333,826,4,2,131,281,355,333,19,1628,524
1552,18,1.2.385,0,568,0,94,385,479,339,46,479,479,0,124,709,3,5,122,104,236,365,19,1628,524
1552,18,3.2.433,1,573,1,10,433,443,433,0,443,443,-48,172,757,3,5,76,104,201,365,19,1628,524
1552,18,4.3.326,0,610,3,7,326,333,326,0,333,433,-58,274,767,4,2,61,281,229,333,19,1628,524
1552,18,5.3.284,0,568,0,96,284,380,284,0,380,433,-16,232,725,4,2,134,281,260,333,19,1628,524
1552,19,0.3.385,0,581,1,95,385,480,385,0,480,480,-117,333,874,4,2,131,281,355,333,20,1628,514
1552,19,1.2.443,1,573,0,94,443,537,339,104,537,537,0,172,757,3,6,122,94,236,365,20,1628,514
1552,19,3.3.443,0,645,3,63,443,506,443,0,506,506,-175,391,932,4,2,66,281,201,333,20,1628,514
1552,19,4.3.326,0,615,2,7,326,333,326,0,333,443,-58,274,815,4,2,61,281,229,333,20,1628,514
1552,19,5.3.284,0,573,0,96,284,380,284,0,380,443,-16,232,773,4,2,134,281,260,333,20,1628,514
1552,20,0.3.385,0,581,1,95,385,480,385,0,480,537,-117,333,874,4,2,131,281,355,333,21,1628,420
1552,20,1.3.537,0,623,3,20,537,557,537,0,557,557,-269,485,1026,4,2,28,281,236,333,21,1628,420
1552,20,3.3.443,0,645,4,63,443,506,443,0,506,537,-175,391,932,4,2,66,281,201,333,21,1628,420
1552,20,4.3.326,1,615,2,7,326,333,326,0,333,537,-58,274,815,4,2,61,281,229,333,21,1628,420
1552,20,5.3.284,0,573,0,96,284,380,284,0,380,537,-16,232,773,4,2,134,281,260,333,21,1628,420
1552,21,0.3.385,0,662,3,95,385,480,385,0,480,537,-52,326,867,4,3,131,274,355,333,22,1628,413
1552,21,1.3.537,0,623,1,20,537,557,537,0,557,557,-204,478,1019,4,3,28,274,236,333,22,1628,413
1552,21,3.3.443,0,645,2,63,443,506,443,0,506,537,-110,384,925,4,3,66,274,201,333,22,1628,413
1552,21,4.4.347,1,615,0,54,347,401,333,14,401,537,0,268,815,5,2,54,139,229,218,22,1628,413
1552,21,5.3.333,0,615,0,96,333,429,284,49,429,537,0,274,815,4,3,134,274,260,333,22,1628,413
1552,22,0.3.385,0,662,3,95,385,480,385,0,480,537,-52,326,867,4,3,131,274,355,333,23,1628,359
1552,22,1.3.537,0,623,1,20,537,557,537,0,557,557,-204,478,1019,4,3,28,274,236,333,23,1628,359
1552,22,3.3.443,0,645,2,63,443,506,443,0,506,537,-110,384,925,4,3,66,274,201,333,23,1628,359
1552,22,5.3.333,1,615,0,96,333,429,284,49,429,537,0,274,815,4,3,134,274,260,333,23,1628,359
1552,23,0.3.429,0,615,0,95,429,524,385,44,524,537,0,274,815,4,4,131,178,355,333,24,1628,263
1552,23,1.3.537,0,623,1,20,537,557,537,0,557,557,-108,382,923,4,4,28,178,236,333,24,1628,263
1552,23,3.3.443,0,645,2,63,443,506,443,0,506,537,-14,288,829,4,4,66,178,201,333,24,1628,263
1552,23,5.4.429,1,615,0,38,429,467,429,0,467,537,-28,296,843,5,3,38,85,260,218,24,1628,263
1552,24,0.3.429,1,615,0,95,429,524,385,44,524,537,0,274,843,4,4,131,178,355,333,25,1628,225
1552,24,1.3.537,0,623,1,20,537,557,537,0,557,557,-108,382,951,4,4,28,178,236,333,25,1628,225
1552,24,3.3.443,0,645,2,63,443,506,443,0,506,537,-14,288,857,4,4,66,178,201,333,25,1628,225
1552,25,0.4.524,1,615,0,36,524,560,524,0,560,560,-57,353,900,5,4,36,47,355,218,26,1628,130
1552,25,1.3.537,0,623,1,20,537,557,537,0,557,557,-13,287,856,4,5,28,83,236,333,26,1628,130
1552,25,3.3.524,0,615,0,63,524,587,443,81,587,587,0,274,843,4,5,66,83,201,333,26,1628,130
1552,26,1.3.537,1,623,1,20,537,557,537,0,557,560,-13,287,913,4,5,28,83,236,333,27,1628,94
1552,26,3.3.524,0,615,0,63,524,587,443,81,587,587,0,274,900,4,5,66,83,201,333,27,1628,94
1552,27,1.4.560,1,623,0,8,560,568,557,3,568,568,0,353,913,5,5,8,11,236,218,28,1628,74
1552,27,3.3.557,0,623,0,63,557,620,443,114,620,620,0,287,913,4,6,66,63,201,333,28,1628,74
1552,28,3.3.557,1,623,0,63,557,620,443,114,620,620,0,287,913,4,6,66,63,201,333,29,1628,66
1552,29,3.4.620,1,623,0,3,620,623,620,0,623,623,-52,405,965,5,6,3,3,201,218,30,1628,3
1553,0,0.0.0,0,506,1,11,0,11,0,0,11,11,0,0,0,1,1,200,195,200,195,1,1398,1398
1553,0,1.0.0,0,546,4,58,0,58,0,0,58,58,0,0,0,1,1,334,195,334,195,1,1398,1398
1553,0,2.0.0,0,495,0,3,0,3,0,0,3,3,0,0,0,1,1,175,195,175,195,1,1398,1398
1553,0,3.0.0,1,520,2,25,0,25,0,0,25,25,0,0,0,1,1,259,195,259,195,1,1398,1398
1553,0,4.0.0,0,539,3,63,0,63,0,0,63,63,0,0,0,1,1,268,195,268,195,1,1398,1398
1553,0,5.0.0,0,520,2,35,0,35,0,0,35,35,0,0,0,1,1,162,195,162,195,1,1398,1398
1553,1,0.0.25,1,531,1,11,25,36,0,25,36,36,0,0,0,1,2,200,170,200,195,2,1398,1373
1553,1,1.0.25,0,537,2,58,25,83,0,25,83,83,0,0,0,1,2,334,170,334,195,2,1398,1373
1553,1,2.0.25,0,520,0,3,25,28,0,25,28,28,0,0,0,1,2,175,170,175,195,2,1398,1373
1553,1,3.1.25,0,531,1,91,25,116,25,0,116,116,-25,25,25,2,1,234,334,259,334,2,1398,1373
1553,1,4.0.25,0,531,1,63,25,88,0,25,88,88,0,0,0,1,2,268,170,268,195,2,1398,1373
1553,1,5.0.25,0,531,1,35,25,60,0,25,60,60,0,0,0,1,2,162,170,162,195,2,1398,1373
1553,2,0.1.36,0,531,0,36,36,72,36,0,72,72,-36,36,36,2,1,189,334,200,334,3,1398,1362
1553,2,1.0.36,0,537,1,58,36,94,0,36,94,94,0,0,0,1,3,334,159,334,195,3,1398,1362
1553,2,2.0.36,1,531,0,3,36,39,0,36,39,39,0,0,0,1,3,175,159,175,195,3,1398,1362
1553,2,3.1.25,0,531,0,91,25,116,25,0,116,116,-25,25,25,2,1,234,334,259,334,3,1398,1362
1553,2,4.0.36,0,531,0,63,36,99,0,36,99,99,0,0,0,1,3,268,159,268,195,3,1398,1362
1553,2,5.0.36,0,531,0,35,36,71,0,36,71,71,0,0,0,1,3,162,159,162,195,3,1398,1362
1553,3,0.1.36,0,531,0,36,36,72,36,0,72,72,-36,36,36,2,1,189,334,200,334,4,1398,1359
1553,3,1.0.39,1,537,1,58,39,97,0,39,97,97,0,0,0,1,4,334,156,334,195,4,1398,1359
1553,3,2.1.39,0,531,0,61,39,100,39,0,100,100,-39,39,39,2,1,172,334,175,334,4,1398,1359
1553,3,3.1.25,0,531,0,91,25,116,25,0,116,116,-25,25,25,2,1,234,334,259,334,4,1398,1359
1553,3,4.0.39,0,531,0,63,39,102,0,39,102,102,0,0,0,1,4,268,156,268,195,4,1398,1359
1553,3,5.0.39,0,531,0,35,39,74,0,39,74,74,0,0,0,1,4,162,156,162,195,4,1398,1359
1553,4,0.1.36,0,548,1,36,36,72,36,0,72,97,-36,36,36,2,1,189,334,200,334,5,1398,1301
1553,4,1.1.97,0,568,2,98,97,195,97,0,195,195,-97,97,97,2,1,276,334,334,334,5,1398,1301
1553,4,2.1.39,0,548,1,61,39,100,39,0,100,100,-39,39,39,2,1,172,334,175,334,5,1398,1301
1553,4,3.1.25,0,537,0,91,25,116,25,0,116,116,-25,25,25,2,1,234,334,259,334,5,1398,1301
1553,4,4.0.97,1,537,0,63,97,160,0,97,160,160,0,0,0,1,5,268,98,268,195,5,1398,1301
1553,4,5.0.97,0,537,0,35,97,132,0,97,132,132,0,0,0,1,5,162,98,162,195,5,1398,1301
1553,5,0.1.36,0,548,2,36,36,72,36,0,72,160,-36,36,36,2,1,189,334,200,334,6,1398,1238
1553,5,1.1.97,0,568,3,98,97,195,97,0,195,195,-97,97,97,2,1,276,334,334,334,6,1398,1238
1553,5,2.1.39,0,548,2,61,39,100,39,0,100,160,-39,39,39,2,1,172,334,175,334,6,1398,1238
1553,5,3.1.25,0,537,0,91,25,116,25,0,116,160,-25,25,25,2,1,234,334,259,334,6,1398,1238
1553,5,4.1.160,0,545,1,38,160,198,160,0,198,198,-160,160,160,2,1,205,334,268,334,6,1398,1238
1553,5,5.0.160,1,537,0,35,160,195,0,160,195,195,0,0,0,1,6,162,35,162,195,6,1398,1238
1553,6,0.1.36,1,548,2,36,36,72,36,0,72,195,-36,36,36,2,1,189,334,200,334,7,1398,1203
1553,6,1.1.97,0,568,4,98,97,195,97,0,195,195,-97,97,97,2,1,276,334,334,334,7,1398,1203
1553,6,2.1.39,0,548,2,61,39,100,39,0,100,195,-39,39,39,2,1,172,334,175,334,7,1398,1203
1553,6,3.1.25,0,537,0,91,25,116,25,0,116,195,-25,25,25,2,1,234,334,259,334,7,1398,1203
1553,6,4.1.160,0,545,1,38,160,198,160,0,198,198,-160,160,160,2,1,205,334,268,334,7,1398,1203
1553,6,5.1.195,0,555,3,10,195,205,195,0,205,205,-195,195,195,2,1,127,334,162,334,7,1398,1203
1553,7,0.2.72,1,548,0,62,72,134,72,0,134,195,-72,72,108,3,1,153,334,200,334,8,1398,1167
1553,7,1.1.97,0,568,2,98,97,195,97,0,195,195,-25,61,61,2,2,276,298,334,334,8,1398,1167
1553,7,2.1.72,0,548,0,61,72,133,39,33,133,195,0,36,36,2,2,172,298,175,334,8,1398,1167
1553,7,3.1.72,0,548,0,91,72,163,25,47,163,195,0,36,36,2,2,234,298,259,334,8,1398,1167
1553,7,4.1.160,0,548,0,38,160,198,160,0,198,198,-88,124,124,2,2,205,298,268,334,8,1398,1167
1553,7,5.1.195,0,567,1,10,195,205,195,0,205,205,-123,159,159,2,2,127,298,162,334,8,1398,1167
1553,8,0.3.134,1,548,0,3,134,137,134,0,137,195,-134,134,242,4,1,91,288,200,288,9,1398,1105
1553,8,1.1.97,0,568,2,98,97,195,97,0,195,195,-25,61,133,2,2,276,298,334,334,9,1398,1105
1553,8,2.1.72,0,548,0,61,72,133,39,33,133,195,0,36,108,2,2,172,298,175,334,9,1398,1105
1553,8,3.1.72,0,548,0,91,72,163,25,47,163,195,0,36,108,2,2,234,298,259,334,9,1398,1105
1553,8,4.1.160,0,548,0,38,160,198,160,0,198,198,-88,124,196,2,2,205,298,268,334,9,1398,1105
1553,8,5.1.195,0,567,1,10,195,205,195,0,205,205,-123,159,231,2,2,127,298,162,334,9,1398,1105
1553,9,0.4.137,1,548,0,88,137,225,137,0,225,225,-137,137,379,5,1,88,247,200,247,10,1398,1102
1553,9,1.1.97,0,568,2,98,97,195,97,0,195,195,-25,61,267,2,2,276,298,334,334,10,1398,1102
1553,9,2.1.72,0,548,0,61,72,133,39,33,133,195,0,36,242,2,2,172,298,175,334,10,1398,1102
1553,9,3.1.72,0,548,0,91,72,163,25,47,163,195,0,36,242,2,2,234,298,259,334,10,1398,1102
1553,9,4.1.160,0,548,0,38,160,198,160,0,198,198,-88,124,330,2,2,205,298,268,334,10,1398,1102
1553,9,5.1.195,0,567,1,10,195,205,195,0,205,205,-123,159,365,2,2,127,298,162,334,10,1398,1102
1553,10,1.1.97,0,568,2,98,97,195,97,0,195,225,-25,61,404,2,2,276,298,334,334,11,1398,1014
1553,10,2.1.72,0,548,0,61,72,133,39,33,133,225,0,36,379,2,2,172,298,175,334,11,1398,1014
1553,10,3.1.72,1,548,0,91,72,163,25,47,163,225,0,36,379,2,2,234,298,259,334,11,1398,1014
1553,10,4.1.160,0,548,0,38,160,198,160,0,198,225,-88,124,467,2,2,205,298,268,334,11,1398,1014
1553,10,5.1.195,0,567,1,10,195,205,195,0,205,225,-123,159,502,2,2,127,298,162,334,11,1398,1014
1553,11,1.1.163,0,585,2,98,163,261,97,66,261,261,0,36,379,2,3,276,207,334,334,12,1398,923
1553,11,2.1.163,1,548,0,61,163,224,39,124,224,225,0,36,379,2,3,172,207,175,334,12,1398,923
1553,11,3.2.163,0,548,0,77,163,240,163,0,240,240,-29,101,408,3,2,143,272,259,334,12,1398,923
1553,11,4.1.163,0,548,0,38,163,201,160,3,201,225,0,36,379,2,3,205,207,268,334,12,1398,923
1553,11,5.1.195,0,567,1,10,195,205,195,0,205,225,-32,68,411,2,3,127,207,162,334,12,1398,923
1553,12,1.1.224,0,598,3,98,224,322,97,127,322,322,0,36,379,2,4,276,146,334,334,13,1398,862
1553,12,2.2.224,0,575,2,46,224,270,224,0,270,270,-90,162,469,3,2,111,272,175,334,13,1398,862
1553,12,3.2.163,0,548,0,77,163,240,163,0,240,240,-29,101,408,3,2,143,272,259,334,13,1398,862
1553,12,4.1.224,1,559,1,38,224,262,160,64,262,262,0,36,379,2,4,205,146,268,334,13,1398,862
1553,12,5.1.224,0,548,0,10,224,234,195,29,234,234,0,36,379,2,4,127,146,162,334,13,1398,862
1553,13,1.1.262,1,585,2,98,262,360,97,165,360,360,0,36,379,2,5,276,108,334,334,14,1398,824
1553,13,2.2.224,0,577,1,46,224,270,224,0,270,270,-90,162,469,3,2,111,272,175,334,14,1398,824
1553,13,3.2.163,0,559,0,77,163,240,163,0,240,262,-29,101,408,3,2,143,272,259,334,14,1398,824
1553,13,4.2.262,0,585,2,43,262,305,262,0,305,305,-128,200,507,3,2,167,272,268,334,14,1398,824
1553,13,5.1.262,0,559,0,10,262,272,195,67,272,272,0,36,379,2,5,127,108,162,334,14,1398,824
1553,14,1.2.360,0,626,2,99,360,459,360,0,459,459,-226,298,605,3,2,178,272,334,334,15,1398,726
1553,14,2.2.224,0,594,1,46,224,270,224,0,270,360,-90,162,469,3,2,111,272,175,334,15,1398,726
1553,14,3.2.163,0,585,0,77,163,240,163,0,240,360,-29,101,408,3,2,143,272,259,334,15,1398,726
1553,14,4.2.262,0,585,0,43,262,305,262,0,305,360,-128,200,507,3,2,167,272,268,334,15,1398,726
1553,14,5.1.360,1,585,0,10,360,370,195,165,370,370,0,36,379,2,6,127,10,162,334,15,1398,726
1553,15,1.2.360,0,626,2,99,360,459,360,0,459,459,-226,298,605,3,2,178,272,334,334,16,1398,716
1553,15,2.2.224,0,594,1,46,224,270,224,0,270,370,-90,162,469,3,2,111,272,175,334,16,1398,716
1553,15,3.2.163,1,585,0,77,163,240,163,0,240,370,-29,101,408,3,2,143,272,259,334,16,1398,716
1553,15,4.2.262,0,585,0,43,262,305,262,0,305,370,-128,200,507,3,2,167,272,268,334,16,1398,716
1553,15,5.2.370,0,585,0,7,370,377,370,0,377,377,-236,308,615,3,2,117,272,162,334,16,1398,716
1553,16,1.2.360,0,626,2,99,360,459,360,0,459,459,-120,221,528,3,3,178,195,334,334,17,1398,639
1553,16,2.2.240,0,588,1,46,240,286,224,16,286,370,0,101,408,3,3,111,195,175,334,17,1398,639
1553,16,3.3.240,1,585,0,22,240,262,240,0,262,370,-103,237,511,4,2,66,285,259,288,17,1398,639
1553,16,4.2.262,0,585,0,43,262,305,262,0,305,370,-22,123,430,3,3,167,195,268,334,17,1398,639
1553,16,5.2.370,0,585,0,7,370,377,370,0,377,377,-130,231,538,3,3,117,195,162,334,17,1398,639
1553,17,1.2.360,0,626,2,99,360,459,360,0,459,459,-120,221,631,3,3,178,195,334,334,18,1398,617
1553,17,2.2.240,0,588,1,46,240,286,224,16,286,370,0,101,511,3,3,111,195,175,334,18,1398,617
1553,17,3.4.262,1,585,0,44,262,306,262,0,306,370,-37,174,548,5,2,44,159,259,247,18,1398,617
1553,17,4.2.262,0,585,0,43,262,305,262,0,305,370,-22,123,533,3,3,167,195,268,334,18,1398,617
1553,17,5.2.370,0,585,0,7,370,377,370,0,377,377,-130,231,641,3,3,117,195,162,334,18,1398,617
1553,18,1.2.360,0,626,2,99,360,459,360,0,459,459,-120,221,668,3,3,178,195,334,334,19,1398,573
1553,18,2.2.240,0,588,1,46,240,286,224,16,286,370,0,101,548,3,3,111,195,175,334,19,1398,573
1553,18,4.2.262,1,585,0,43,262,305,262,0,305,370,-22,123,570,3,3,167,195,268,334,19,1398,573
1553,18,5.2.370,0,585,0,7,370,377,370,0,377,377,-130,231,678,3,3,117,195,162,334,19,1398,573
1553,19,1.2.360,0,626,1,99,360,459,360,0,459,459,-55,178,625,3,4,178,152,334,334,20,1398,530
1553,19,2.2.305,1,585,0,46,305,351,224,81,351,370,0,123,570,3,4,111,152,175,334,20,1398,530
1553,19,4.3.305,0,585,0,99,305,404,305,0,404,404,-43,280,613,4,3,124,263,268,288,20,1398,530
1553,19,5.2.370,0,585,0,7,370,377,370,0,377,377,-65,188,635,3,4,117,152,162,334,20,1398,530
1553,20,1.2.360,0,626,1,99,360,459,360,0,459,459,-9,132,579,3,5,178,106,334,334,21,1398,484
1553,20,2.3.351,0,631,2,21,351,372,351,0,372,372,-89,326,659,4,3,65,263,175,288,21,1398,484
1553,20,4.3.305,0,585,0,99,305,404,305,0,404,404,-43,280,613,4,3,124,263,268,288,21,1398,484
1553,20,5.2.370,1,585,0,7,370,377,370,0,377,377,-19,142,589,3,5,117,106,162,334,21,1398,484
1553,21,1.2.377,1,585,0,99,377,476,360,17,476,476,0,142,589,3,6,178,99,334,334,22,1398,477
1553,21,2.3.351,0,631,1,21,351,372,351,0,372,377,-89,326,678,4,3,65,263,175,288,22,1398,477
1553,21,4.3.305,0,585,0,99,305,404,305,0,404,404,-43,280,632,4,3,124,263,268,288,22,1398,477
1553,21,5.3.377,0,636,2,81,377,458,377,0,458,458,-115,352,704,4,3,110,263,162,288,22,1398,477
1553,22,1.3.476,0,648,3,62,476,538,476,0,538,538,-214,451,803,4,3,79,263,334,288,23,1398,378
1553,22,2.3.351,1,631,1,21,351,372,351,0,372,476,-89,326,678,4,3,65,263,175,288,23,1398,378
1553,22,4.3.305,0,585,0,99,305,404,305,0,404,476,-43,280,632,4,3,124,263,268,288,23,1398,378
1553,22,5.3.377,0,636,2,81,377,458,377,0,458,476,-115,352,704,4,3,110,263,162,288,23,1398,378
1553,23,1.3.476,0,648,2,62,476,538,476,0,538,538,-104,430,782,4,4,79,242,334,288,24,1398,357
1553,23,2.4.372,1,631,0,44,372,416,372,0,416,476,-66,240,744,5,3,44,115,175,247,24,1398,357
1553,23,4.3.372,0,631,0,99,372,471,305,67,471,476,0,326,678,4,4,124,242,268,288,24,1398,357
1553,23,5.3.377,0,636,1,81,377,458,377,0,458,476,-5,331,683,4,4,110,242,162,288,24,1398,357
1553,24,1.3.476,0,648,2,62,476,538,476,0,538,538,-104,430,848,4,4,79,242,334,288,25,1398,313
1553,24,4.3.372,1,631,0,99,372,471,305,67,471,476,0,326,744,4,4,124,242,268,288,25,1398,313
1553,24,5.3.377,0,636,1,81,377,458,377,0,458,476,-5,331,749,4,4,110,242,162,288,25,1398,313
1553,25,1.3.476,0,648,1,62,476,538,476,0,538,538,-5,331,749,4,5,79,143,334,288,26,1398,214
1553,25,4.4.471,1,631,0,25,471,496,471,0,496,496,-55,295,799,5,4,25,71,268,247,26,1398,214
1553,25,5.3.471,0,631,0,81,471,552,377,94,552,552,0,326,744,4,5,110,143,162,288,26,1398,214
1553,26,1.3.476,1,648,1,62,476,538,476,0,538,538,-5,331,804,4,5,79,143,334,288,27,1398,189
1553,26,5.3.471,0,631,0,81,471,552,377,94,552,552,0,326,799,4,5,110,143,162,288,27,1398,189
1553,27,1.4.538,1,648,0,17,538,555,538,0,555,555,-42,337,846,5,5,17,46,334,247,28,1398,127
1553,27,5.3.538,0,648,0,81,538,619,377,161,619,619,0,331,804,4,6,110,81,162,288,28,1398,127
1553,28,5.3.538,1,648,0,81,538,619,377,161,619,619,0,331,846,4,6,110,81,162,288,29,1398,110
1553,29,5.4.619,1,648,0,29,619,648,619,0,648,648,-64,401,910,5,6,29,29,162,247,30,1398,29
1554,0,0.0.0,0,582,0,24,0,24,0,0,24,24,0,0,0,1,1,146,309,146,309,1,1566,1566
1554,0,1.0.0,0,602,3,34,0,34,0,0,34,34,0,0,0,1,1,135,309,135,309,1,1566,1566
1554,0,2.0.0,1,608,4,48,0,48,0,0,48,48,0,0,0,1,1,300,309,300,309,1,1566,1566
1554,0,3.0.0,0,588,2,78,0,78,0,0,78,78,0,0,0,1,1,318,309,318,309,1,1566,1566
1554,0,4.0.0,0,586,1,85,0,85,0,0,85,85,0,0,0,1,1,404,309,404,309,1,1566,1566
1554,0,5.0.0,0,582,0,40,0,40,0,0,40,40,0,0,0,1,1,263,309,263,309,1,1566,1566
1554,1,0.0.48,0,608,0,24,48,72,0,48,72,72,0,0,0,1,2,146,261,146,309,2,1566,1518
1554,1,1.0.48,0,608,0,34,48,82,0,48,82,82,0,0,0,1,2,135,261,135,309,2,1566,1518
1554,1,2.1.48,0,608,0,55,48,103,48,0,103,103,-48,48,48,2,1,252,338,300,338,2,1566,1518
1554,1,3.0.48,0,608,0,78,48,126,0,48,126,126,0,0,0,1,2,318,261,318,309,2,1566,1518
1554,1,4.0.48,1,618,1,85,48,133,0,48,133,133,0,0,0,1,2,404,261,404,309,2,1566,1518
1554,1,5.0.48,0,630,2,40,48,88,0,48,88,88,0,0,0,1,2,263,261,263,309,2,1566,1518
1554,2,0.0.133,0,618,0,24,133,157,0,133,157,157,0,0,0,1,3,146,176,146,309,3,1566,1433
1554,2,1.0.133,0,630,1,34,133,167,0,133,167,167,0,0,0,1,3,135,176,135,309,3,1566,1433
1554,2,2.1.48,0,618,0,55,48,103,48,0,103,133,-48,48,48,2,1,252,338,300,338,3,1566,1433
1554,2,3.0.133,0,634,2,78,133,211,0,133,211,211,0,0,0,1,3,318,176,318,309,3,1566,1433
1554,2,4.1.133,0,630,1,89,133,222,133,0,222,222,-133,133,133,2,1,319,338,404,338,3,1566,1433
1554,2,5.0.133,1,630,1,40,133,173,0,133,173,173,0,0,0,1,3,263,176,263,309,3,1566,1433
1554,3,0.0.173,0,634,1,24,173,197,0,173,197,197,0,0,0,1,4,146,136,146,309,4,1566,1393
1554,3,1.0.173,0,630,0,34,173,207,0,173,207,207,0,0,0,1,4,135,136,135,309,4,1566,1393
1554,3,2.1.48,0,630,0,55,48,103,48,0,103,173,-48,48,48,2,1,252,338,300,338,4,1566,1393
1554,3,3.0.173,1,634,1,78,173,251,0,173,251,251,0,0,0,1,4,318,136,318,309,4,1566,1393
1554,3,4.1.133,0,630,0,89,133,222,133,0,222,222,-133,133,133,2,1,319,338,404,338,4,1566,1393
1554,3,5.1.173,0,686,2,93,173,266,173,0,266,266,-173,173,173,2,1,223,338,263,338,4,1566,1393
1554,4,0.0.251,1,634,0,24,251,275,0,251,275,275,0,0,0,1,5,146,58,146,309,5,1566,1315
1554,4,1.0.251,0,634,0,34,251,285,0,251,285,285,0,0,0,1,5,135,58,135,309,5,1566,1315
1554,4,2.1.48,0,634,0,55,48,103,48,0,103,251,-48,48,48,2,1,252,338,300,338,5,1566,1315
1554,4,3.1.251,0,634,0,30,251,281,251,0,281,281,-251,251,251,2,1,240,338,318,338,5,1566,1315
1554,4,4.1.133,0,634,0,89,133,222,133,0,222,251,-133,133,133,2,1,319,338,404,338,5,1566,1315
1554,4,5.1.173,0,686,1,93,173,266,173,0,266,266,-173,173,173,2,1,223,338,263,338,5,1566,1315
1554,5,0.1.275,0,634,0,5,275,280,275,0,280,280,-275,275,275,2,1,122,338,146,338,6,1566,1291
1554,5,1.0.275,1,634,0,34,275,309,0,275,309,309,0,0,0,1,6,135,34,135,309,6,1566,1291
1554,5,2.1.48,0,634,0,55,48,103,48,0,103,275,-48,48,48,2,1,252,338,300,338,6,1566,1291
1554,5,3.1.251,0,634,0,30,251,281,251,0,281,281,-251,251,251,2,1,240,338,318,338,6,1566,1291
1554,5,4.1.133,0,634,0,89,133,222,133,0,222,275,-133,133,133,2,1,319,338,404,338,6,1566,1291
1554,5,5.1.173,0,687,1,93,173,266,173,0,266,275,-173,173,173,2,1,223,338,263,338,6,1566,1291
1554,6,0.1.275,0,634,0,5,275,280,275,0,280,309,-275,275,275,2,1,122,338,146,338,7,1566,1257
1554,6,1.1.309,0,634,0,66,309,375,309,0,375,375,-309,309,309,2,1,101,338,135,338,7,1566,1257
1554,6,2.1.48,1,634,0,55,48,103,48,0,103,309,-48,48,48,2,1,252,338,300,338,7,1566,1257
1554,6,3.1.251,0,634,0,30,251,281,251,0,281,309,-251,251,251,2,1,240,338,318,338,7,1566,1257
1554,6,4.1.133,0,634,0,89,133,222,133,0,222,309,-133,133,133,2,1,319,338,404,338,7,1566,1257
1554,6,5.1.173,0,687,1,93,173,266,173,0,266,309,-173,173,173,2,1,223,338,263,338,7,1566,1257
1554,7,0.1.275,0,634,0,5,275,280,275,0,280,309,-172,220,220,2,2,122,283,146,338,8,1566,1202
1554,7,1.1.309,0,634,0,66,309,375,309,0,375,375,-206,254,254,2,2,101,283,135,338,8,1566,1202
1554,7,2.2.103,1,634,0,98,103,201,103,0,201,309,-103,103,151,3,1,197,301,300,301,8,1566,1202
1554,7,3.1.251,0,634,0,30,251,281,251,0,281,309,-148,196,196,2,2,240,283,318,338,8,1566,1202
1554,7,4.1.133,0,634,0,89,133,222,133,0,222,309,-30,78,78,2,2,319,283,404,338,8,1566,1202
1554,7,5.1.173,0,687,1,93,173,266,173,0,266,309,-70,118,118,2,2,223,283,263,338,8,1566,1202
1554,8,0.1.275,0,634,0,5,275,280,275,0,280,309,-172,220,323,2,2,122,283,146,338,9,1566,1104
1554,8,1.1.309,0,634,0,66,309,375,309,0,375,375,-206,254,357,2,2,101,283,135,338,9,1566,1104
1554,8,2.3.201,1,649,1,89,201,290,201,0,290,309,-201,201,352,4,1,99,342,300,342,9,1566,1104
1554,8,3.1.251,0,634,0,30,251,281,251,0,281,309,-148,196,299,2,2,240,283,318,338,9,1566,1104
1554,8,4.1.133,0,634,0,89,133,222,133,0,222,309,-30,78,181,2,2,319,283,404,338,9,1566,1104
1554,8,5.1.173,0,687,2,93,173,266,173,0,266,309,-70,118,221,2,2,223,283,263,338,9,1566,1104
1554,9,0.1.275,0,649,0,5,275,280,275,0,280,309,-172,220,524,2,2,122,283,146,338,10,1566,1015
1554,9,1.1.309,0,649,0,66,309,375,309,0,375,375,-206,254,558,2,2,101,283,135,338,10,1566,1015
1554,9,2.4.290,1,649,0,10,290,300,290,0,300,309,-290,290,642,5,1,10,276,300,276,10,1566,1015
1554,9,3.1.251,0,649,0,30,251,281,251,0,281,309,-148,196,500,2,2,240,283,318,338,10,1566,1015
1554,9,4.1.133,0,649,0,89,133,222,133,0,222,309,-30,78,382,2,2,319,283,404,338,10,1566,1015
1554,9,5.1.173,0,687,1,93,173,266,173,0,266,309,-70,118,422,2,2,223,283,263,338,10,1566,1015
1554,10,0.1.275,0,649,0,5,275,280,275,0,280,309,-172,220,814,2,2,122,283,146,338,11,1566,1005
1554,10,1.1.309,0,649,0,66,309,375,309,0,375,375,-206,254,848,2,2,101,283,135,338,11,1566,1005
1554,10,3.1.251,0,649,0,30,251,281,251,0,281,309,-148,196,790,2,2,240,283,318,338,11,1566,1005
1554,10,4.1.133,1,649,0,89,133,222,133,0,222,309,-30,78,672,2,2,319,283,404,338,11,1566,1005
1554,10,5.1.173,0,687,1,93,173,266,173,0,266,309,-70,118,712,2,2,223,283,263,338,11,1566,1005
1554,11,0.1.275,0,649,0,5,275,280,275,0,280,309,-53,131,725,2,3,122,194,146,338,12,1566,916
1554,11,1.1.309,0,649,0,66,309,375,309,0,375,375,-87,165,759,2,3,101,194,135,338,12,1566,916
1554,11,3.1.251,0,649,0,30,251,281,251,0,281,309,-29,107,701,2,3,240,194,318,338,12,1566,916
1554,11,4.2.222,1,649,0,43,222,265,222,0,265,309,-21,124,693,3,2,230,203,404,301,12,1566,916
1554,11,5.1.222,0,649,0,93,222,315,173,49,315,315,0,78,672,2,3,223,194,263,338,12,1566,916
1554,12,0.1.275,0,649,0,5,275,280,275,0,280,309,-53,131,746,2,3,122,194,146,338,13,1566,873
1554,12,1.1.309,0,649,0,66,309,375,309,0,375,375,-87,165,780,2,3,101,194,135,338,13,1566,873
1554,12,3.1.251,0,649,0,30,251,281,251,0,281,309,-29,107,722,2,3,240,194,318,338,13,1566,873
1554,12,4.3.290,1,649,0,93,290,383,265,25,383,383,0,201,693,4,2,187,253,404,342,13,1566,873
1554,12,5.1.222,0,649,0,93,222,315,173,49,315,315,0,78,693,2,3,223,194,263,338,13,1566,873
1554,13,0.1.275,0,649,0,5,275,280,275,0,280,383,-53,131,746,2,3,122,194,146,338,14,1566,780
1554,13,1.1.309,0,649,0,66,309,375,309,0,375,383,-87,165,780,2,3,101,194,135,338,14,1566,780
1554,13,3.1.251,0,649,0,30,251,281,251,0,281,383,-29,107,722,2,3,240,194,318,338,14,1566,780
1554,13,4.4.383,1,649,0,94,383,477,383,0,477,477,-83,373,776,5,2,94,266,404,276,14,1566,780
1554,13,5.1.222,0,649,0,93,222,315,173,49,315,383,0,78,693,2,3,223,194,263,338,14,1566,780
1554,14,0.1.275,0,649,0,5,275,280,275,0,280,477,-53,131,829,2,3,122,194,146,338,15,1566,686
1554,14,1.1.309,0,649,0,66,309,375,309,0,375,477,-87,165,863,2,3,101,194,135,338,15,1566,686
1554,14,3.1.251,1,649,0,30,251,281,251,0,281,477,-29,107,805,2,3,240,194,318,338,15,1566,686
1554,14,5.1.222,0,649,0,93,222,315,173,49,315,477,0,78,776,2,3,223,194,263,338,15,1566,686
1554,15,0.1.281,0,649,0,5,281,286,275,6,286,477,0,107,805,2,4,122,164,146,338,16,1566,656
1554,15,1.1.309,0,649,0,66,309,375,309,0,375,477,-28,135,833,2,4,101,164,135,338,16,1566,656
1554,15,3.2.281,1,649,0,44,281,325,281,0,325,477,-16,140,821,3,3,210,160,318,301,16,1566,656
1554,15,5.1.281,0,649,0,93,281,374,173,108,374,477,0,107,805,2,4,223,164,263,338,16,1566,656
1554,16,0.1.281,0,649,0,5,281,286,275,6,286,477,0,107,821,2,4,122,164,146,338,17,1566,612
1554,16,1.1.309,0,649,0,66,309,375,309,0,375,477,-28,135,849,2,4,101,164,135,338,17,1566,612
1554,16,3.3.383,1,649,0,81,383,464,325,58,464,477,0,201,821,4,3,166,160,318,342,17,1566,612
1554,16,5.1.281,0,649,0,93,281,374,173,108,374,477,0,107,821,2,4,223,164,263,338,17,1566,612
1554,17,0.1.281,0,649,0,5,281,286,275,6,286,477,0,107,821,2,4,122,164,146,338,18,1566,531
1554,17,1.1.309,0,649,0,66,309,375,309,0,375,477,-28,135,849,2,4,101,164,135,338,18,1566,531
1554,17,3.4.477,1,649,0,85,477,562,464,13,562,562,0,373,821,5,3,85,172,318,276,18,1566,531
1554,17,5.1.281,0,649,0,93,281,374,173,108,374,477,0,107,821,2,4,223,164,263,338,18,1566,531
1554,18,0.1.281,0,649,0,5,281,286,275,6,286,562,0,107,821,2,4,122,164,146,338,19,1566,446
1554,18,1.1.309,0,649,0,66,309,375,309,0,375,562,-28,135,849,2,4,101,164,135,338,19,1566,446
1554,18,5.1.281,1,649,0,93,281,374,173,108,374,562,0,107,821,2,4,223,164,263,338,19,1566,446
1554,19,0.1.374,1,649,0,5,374,379,275,99,379,562,0,107,821,2,5,122,71,146,338,20,1566,353
1554,19,1.1.374,0,649,0,66,374,440,309,65,440,562,0,107,821,2,5,101,71,135,338,20,1566,353
1554,19,5.2.374,0,649,0,45,374,419,374,0,419,562,-49,189,870,3,4,130,116,263,301,20,1566,353
1554,20,0.2.379,0,649,0,66,379,445,379,0,445,562,-54,194,875,3,4,117,116,146,301,21,1566,348
1554,20,1.1.379,0,649,0,66,379,445,309,70,445,562,0,107,821,2,6,101,66,135,338,21,1566,348
1554,20,5.2.374,1,649,0,45,374,419,374,0,419,562,-49,189,870,3,4,130,116,263,301,21,1566,348
1554,21,0.2.419,0,649,0,66,419,485,379,40,485,562,0,189,870,3,5,117,71,146,301,22,1566,303
1554,21,1.1.379,0,649,0,66,379,445,309,70,445,562,0,107,870,2,6,101,66,135,338,22,1566,303
1554,21,5.3.464,1,649,0,65,464,529,419,45,529,562,0,201,870,4,4,85,79,263,342,22,1566,303
1554,22,0.2.419,0,649,0,66,419,485,379,40,485,562,0,189,870,3,5,117,71,146,301,23,1566,238
1554,22,1.1.379,0,649,0,66,379,445,309,70,445,562,0,107,870,2,6,101,66,135,338,23,1566,238
1554,22,5.4.562,1,649,0,20,562,582,529,33,582,582,0,373,870,5,4,20,87,263,276,23,1566,238
1554,23,0.2.419,1,649,0,66,419,485,379,40,485,582,0,189,870,3,5,117,71,146,301,24,1566,218
1554,23,1.1.379,0,649,0,66,379,445,309,70,445,582,0,107,870,2,6,101,66,135,338,24,1566,218
1554,24,0.3.529,1,649,0,10,529,539,485,44,539,582,0,201,870,4,5,51,14,146,342,25,1566,152
1554,24,1.1.379,0,649,0,66,379,445,309,70,445,582,0,107,870,2,6,101,66,135,338,25,1566,152
1554,25,0.4.582,1,649,0,41,582,623,539,43,623,623,0,373,870,5,5,41,67,146,276,26,1566,142
1554,25,1.1.379,0,649,0,66,379,445,309,70,445,582,0,107,870,2,6,101,66,135,338,26,1566,142
1554,26,1.1.379,1,649,0,66,379,445,309,70,445,623,0,107,870,2,6,101,66,135,338,27,1566,101
1554,27,1.2.485,1,649,0,5,485,490,445,40,490,623,0,189,870,3,6,35,5,135,301,28,1566,35
1554,28,1.3.539,1,649,0,4,539,543,490,49,543,623,0,201,870,4,6,30,4,135,342,29,1566,30
1554,29,1.4.623,1,649,0,26,623,649,543,80,649,649,0,373,870,5,6,26,26,135,276,30,1566,26
1555,0,0.0.0,0,506,2,37,0,37,0,0,37,37,0,0,0,1,1,287,225,287,225,1,1439,1439
1555,0,1.0.0,0,488,1,10,0,10,0,0,10,10,0,0,0,1,1,136,225,136,225,1,1439,1439
1555,0,2.0.0,0,563,5,94,0,94,0,0,94,94,0,0,0,1,1,327,225,327,225,1,1439,1439
1555,0,3.0.0,0,519,3,32,0,32,0,0,32,32,0,0,0,1,1,179,225,179,225,1,1439,1439
1555,0,4.0.0,1,487,0,7,0,7,0,0,7,7,0,0,0,1,1,244,225,244,225,1,1439,1439
1555,0,5.0.0,0,532,4,45,0,45,0,0,45,45,0,0,0,1,1,266,225,266,225,1,1439,1439
1555,1,0.0.7,1,487,0,37,7,44,0,7,44,44,0,0,0,1,2,287,218,287,225,2,1439,1432
1555,1,1.0.7,0,487,0,10,7,17,0,7,17,17,0,0,0,1,2,136,218,136,225,2,1439,1432
1555,1,2.0.7,0,528,3,94,7,101,0,7,101,101,0,0,0,1,2,327,218,327,225,2,1439,1432
1555,1,3.0.7,0,492,1,32,7,39,0,7,39,39,0,0,0,1,2,179,218,179,225,2,1439,1432
1555,1,4.1.7,0,487,0,42,7,49,7,0,49,49,-7,7,7,2,1,237,340,244,340,2,1439,1432
1555,1,5.0.7,0,505,2,45,7,52,0,7,52,52,0,0,0,1,2,266,218,266,225,2,1439,1432
1555,2,0.1.44,0,513,4,72,44,116,44,0,116,116,-44,44,44,2,1,250,340,287,340,3,1439,1395
1555,2,1.0.44,0,487,0,10,44,54,0,44,54,54,0,0,0,1,3,136,181,136,225,3,1439,1395
1555,2,2.0.44,0,493,2,94,44,138,0,44,138,138,0,0,0,1,3,327,181,327,225,3,1439,1395
1555,2,3.0.44,0,492,1,32,44,76,0,44,76,76,0,0,0,1,3,179,181,179,225,3,1439,1395
1555,2,4.1.7,0,487,0,42,7,49,7,0,49,49,-7,7,7,2,1,237,340,244,340,3,1439,1395
1555,2,5.0.44,1,494,3,45,44,89,0,44,89,89,0,0,0,1,3,266,181,266,225,3,1439,1395
1555,3,0.1.44,0,514,2,72,44,116,44,0,116,116,-44,44,44,2,1,250,340,287,340,4,1439,1350
1555,3,1.0.89,1,494,0,10,89,99,0,89,99,99,0,0,0,1,4,136,136,136,225,4,1439,1350
1555,3,2.0.89,0,504,1,94,89,183,0,89,183,183,0,0,0,1,4,327,136,327,225,4,1439,1350
1555,3,3.0.89,0,494,0,32,89,121,0,89,121,121,0,0,0,1,4,179,136,179,225,4,1439,1350
1555,3,4.1.7,0,494,0,42,7,49,7,0,49,89,-7,7,7,2,1,237,340,244,340,4,1439,1350
1555,3,5.1.89,0,564,3,76,89,165,89,0,165,165,-89,89,89,2,1,221,340,266,340,4,1439,1350
1555,4,0.1.44,0,514,2,72,44,116,44,0,116,116,-44,44,44,2,1,250,340,287,340,5,1439,1340
1555,4,1.1.99,0,526,3,34,99,133,99,0,133,133,-99,99,99,2,1,126,340,136,340,5,1439,1340
1555,4,2.0.99,0,504,1,94,99,193,0,99,193,193,0,0,0,1,5,327,126,327,225,5,1439,1340
1555,4,3.0.99,1,494,0,32,99,131,0,99,131,131,0,0,0,1,5,179,126,179,225,5,1439,1340
1555,4,4.1.7,0,494,0,42,7,49,7,0,49,99,-7,7,7,2,1,237,340,244,340,5,1439,1340
1555,4,5.1.89,0,564,4,76,89,165,89,0,165,165,-89,89,89,2,1,221,340,266,340,5,1439,1340
1555,5,0.1.44,0,529,2,72,44,116,44,0,116,131,-44,44,44,2,1,250,340,287,340,6,1439,1308
1555,5,1.1.99,0,542,3,34,99,133,99,0,133,133,-99,99,99,2,1,126,340,136,340,6,1439,1308
1555,5,2.0.131,1,494,0,94,131,225,0,131,225,225,0,0,0,1,6,327,94,327,225,6,1439,1308
1555,5,3.1.131,0,502,1,68,131,199,131,0,199,199,-131,131,131,2,1,147,340,179,340,6,1439,1308
1555,5,4.1.7,0,494,0,42,7,49,7,0,49,131,-7,7,7,2,1,237,340,244,340,6,1439,1308
1555,5,5.1.89,0,564,4,76,89,165,89,0,165,165,-89,89,89,2,1,221,340,266,340,6,1439,1308
1555,6,0.1.44,0,529,2,72,44,116,44,0,116,225,-44,44,44,2,1,250,340,287,340,7,1439,1214
1555,6,1.1.99,0,542,3,34,99,133,99,0,133,225,-99,99,99,2,1,126,340,136,340,7,1439,1214
1555,6,2.1.225,0,494,0,48,225,273,225,0,273,273,-225,225,225,2,1,233,340,327,340,7,1439,1214
1555,6,3.1.131,0,502,1,68,131,199,131,0,199,225,-131,131,131,2,1,147,340,179,340,7,1439,1214
1555,6,4.1.7,1,494,0,42,7,49,7,0,49,225,-7,7,7,2,1,237,340,244,340,7,1439,1214
1555,6,5.1.89,0,564,4,76,89,165,89,0,165,225,-89,89,89,2,1,221,340,266,340,7,1439,1214
1555,7,0.1.49,0,494,0,72,49,121,44,5,121,225,0,7,7,2,2,250,298,287,340,8,1439,1172
1555,7,1.1.99,0,542,2,34,99,133,99,0,133,225,-50,57,57,2,2,126,298,136,340,8,1439,1172
1555,7,2.1.225,0,494,0,48,225,273,225,0,273,273,-176,183,183,2,2,233,298,327,340,8,1439,1172
1555,7,3.1.131,0,502,1,68,131,199,131,0,199,225,-82,89,89,2,2,147,298,179,340,8,1439,1172
1555,7,4.2.49,1,494,0,44,49,93,49,0,93,225,-49,49,56,3,1,195,271,244,271,8,1439,1172
1555,7,5.1.89,0,564,3,76,89,165,89,0,165,225,-40,47,47,2,2,221,298,266,340,8,1439,1172
1555,8,0.1.49,0,494,0,72,49,121,44,5,121,225,0,7,56,2,2,250,298,287,340,9,1439,1128
1555,8,1.1.99,0,542,2,34,99,133,99,0,133,225,-50,57,106,2,2,126,298,136,340,9,1439,1128
1555,8,2.1.225,0,494,0,48,225,273,225,0,273,273,-176,183,232,2,2,233,298,327,340,9,1439,1128
1555,8,3.1.131,0,502,1,68,131,199,131,0,199,225,-82,89,138,2,2,147,298,179,340,9,1439,1128
1555,8,4.3.93,1,494,0,86,93,179,93,0,179,225,-93,93,149,4,1,151,295,244,295,9,1439,1128
1555,8,5.1.89,0,564,3,76,89,165,89,0,165,225,-40,47,96,2,2,221,298,266,340,9,1439,1128
1555,9,0.1.49,0,494,0,72,49,121,44,5,121,225,0,7,149,2,2,250,298,287,340,10,1439,1042
1555,9,1.1.99,0,542,2,34,99,133,99,0,133,225,-50,57,199,2,2,126,298,136,340,10,1439,1042
1555,9,2.1.225,0,494,0,48,225,273,225,0,273,273,-176,183,325,2,2,233,298,327,340,10,1439,1042
1555,9,3.1.131,0,502,1,68,131,199,131,0,199,225,-82,89,231,2,2,147,298,179,340,10,1439,1042
1555,9,4.4.179,1,494,0,65,179,244,179,0,244,244,-179,179,328,5,1,65,308,244,308,10,1439,1042
1555,9,5.1.89,0,564,3,76,89,165,89,0,165,225,-40,47,189,2,2,221,298,266,340,10,1439,1042
1555,10,0.1.49,1,494,0,72,49,121,44,5,121,244,0,7,328,2,2,250,298,287,340,11,1439,977
1555,10,1.1.99,0,542,2,34,99,133,99,0,133,244,-50,57,378,2,2,126,298,136,340,11,1439,977
1555,10,2.1.225,0,494,0,48,225,273,225,0,273,273,-176,183,504,2,2,233,298,327,340,11,1439,977
1555,10,3.1.131,0,502,1,68,131,199,131,0,199,244,-82,89,410,2,2,147,298,179,340,11,1439,977
1555,10,5.1.89,0,564,3,76,89,165,89,0,165,244,-40,47,368,2,2,221,298,266,340,11,1439,977
1555,11,0.2.121,1,494,0,69,121,190,121,0,190,244,-28,77,356,3,2,178,227,287,271,12,1439,905
1555,11,1.1.121,0,494,0,34,121,155,99,22,155,244,0,7,328,2,3,126,226,136,340,12,1439,905
1555,11,2.1.225,0,494,0,48,225,273,225,0,273,273,-104,111,432,2,3,233,226,327,340,12,1439,905
1555,11,3.1.131,0,502,1,68,131,199,131,0,199,244,-10,17,338,2,3,147,226,179,340,12,1439,905
1555,11,5.1.121,0,504,2,76,121,197,89,32,197,244,0,7,328,2,3,221,226,266,340,12,1439,905
1555,12,0.3.190,1,494,0,16,190,206,190,0,206,244,-11,104,367,4,2,109,209,287,295,13,1439,836
1555,12,1.1.121,0,494,0,34,121,155,99,22,155,244,0,7,356,2,3,126,226,136,340,13,1439,836
1555,12,2.1.225,0,494,0,48,225,273,225,0,273,273,-104,111,460,2,3,233,226,327,340,13,1439,836
1555,12,3.1.131,0,502,1,68,131,199,131,0,199,244,-10,17,366,2,3,147,226,179,340,13,1439,836
1555,12,5.1.121,0,504,2,76,121,197,89,32,197,244,0,7,356,2,3,221,226,266,340,13,1439,836
1555,13,0.4.244,1,494,0,93,244,337,206,38,337,337,0,179,367,5,2,93,243,287,308,14,1439,820
1555,13,1.1.121,0,494,0,34,121,155,99,22,155,244,0,7,367,2,3,126,226,136,340,14,1439,820
1555,13,2.1.225,0,494,0,48,225,273,225,0,273,273,-104,111,471,2,3,233,226,327,340,14,1439,820
1555,13,3.1.131,0,502,1,68,131,199,131,0,199,244,-10,17,377,2,3,147,226,179,340,14,1439,820
1555,13,5.1.121,0,504,2,76,121,197,89,32,197,244,0,7,367,2,3,221,226,266,340,14,1439,820
1555,14,1.1.121,0,494,0,34,121,155,99,22,155,337,0,7,367,2,3,126,226,136,340,15,1439,727
1555,14,2.1.225,0,494,0,48,225,273,225,0,273,337,-104,111,471,2,3,233,226,327,340,15,1439,727
1555,14,3.1.131,0,502,1,68,131,199,131,0,199,337,-10,17,377,2,3,147,226,179,340,15,1439,727
1555,14,5.1.121,1,504,2,76,121,197,89,32,197,337,0,7,367,2,3,221,226,266,340,15,1439,727
1555,15,1.1.197,0,504,0,34,197,231,99,98,231,337,0,7,367,2,4,126,150,136,340,16,1439,651
1555,15,2.1.225,0,528,2,48,225,273,225,0,273,337,-28,35,395,2,4,233,150,327,340,16,1439,651
1555,15,3.1.197,0,539,3,68,197,265,131,66,265,337,0,7,367,2,4,147,150,179,340,16,1439,651
1555,15,5.2.197,1,515,1,83,197,280,197,0,280,337,-7,84,374,3,3,145,158,266,271,16,1439,651
1555,16,1.1.197,0,515,0,34,197,231,99,98,231,337,0,7,374,2,4,126,150,136,340,17,1439,568
1555,16,2.1.225,0,528,1,48,225,273,225,0,273,337,-28,35,402,2,4,233,150,327,340,17,1439,568
1555,16,3.1.197,0,539,2,68,197,265,131,66,265,337,0,7,374,2,4,147,150,179,340,17,1439,568
1555,16,5.3.280,1,528,1,50,280,330,280,0,330,337,-74,178,448,4,3,62,193,266,295,17,1439,568
1555,17,1.1.197,0,528,0,34,197,231,99,98,231,337,0,7,448,2,4,126,150,136,340,18,1439,518
1555,17,2.1.225,0,528,0,48,225,273,225,0,273,337,-28,35,476,2,4,233,150,327,340,18,1439,518
1555,17,3.1.197,0,539,1,68,197,265,131,66,265,337,0,7,448,2,4,147,150,179,340,18,1439,518
1555,17,5.4.337,1,528,0,12,337,349,330,7,349,349,0,179,448,5,3,12,150,266,308,18,1439,518
1555,18,1.1.197,1,528,0,34,197,231,99,98,231,349,0,7,448,2,4,126,150,136,340,19,1439,506
1555,18,2.1.225,0,528,0,48,225,273,225,0,273,349,-28,35,476,2,4,233,150,327,340,19,1439,506
1555,18,3.1.197,0,539,1,68,197,265,131,66,265,349,0,7,448,2,4,147,150,179,340,19,1439,506
1555,19,1.2.280,1,535,1,11,280,291,231,49,291,349,0,84,448,3,4,92,75,136,271,20,1439,472
1555,19,2.1.231,0,528,0,48,231,279,225,6,279,349,0,7,448,2,5,233,116,327,340,20,1439,472
1555,19,3.1.231,0,548,2,68,231,299,131,100,299,349,0,7,448,2,5,147,116,179,340,20,1439,472
1555,20,1.3.330,0,535,0,45,330,375,291,39,375,375,0,178,448,4,4,81,143,136,295,21,1439,461
1555,20,2.1.231,1,535,0,48,231,279,225,6,279,349,0,7,448,2,5,233,116,327,340,21,1439,461
1555,20,3.1.231,0,548,1,68,231,299,131,100,299,349,0,7,448,2,5,147,116,179,340,21,1439,461
1555,21,1.3.330,0,535,0,45,330,375,291,39,375,375,0,178,448,4,4,81,143,136,295,22,1439,413
1555,21,2.2.291,1,535,0,52,291,343,279,12,343,349,0,84,448,3,5,185,64,327,271,22,1439,413
1555,21,3.1.279,0,535,0,68,279,347,131,148,347,349,0,7,448,2,6,147,68,179,340,22,1439,413
1555,22,1.3.330,0,535,0,45,330,375,291,39,375,375,0,178,448,4,4,81,143,136,295,23,1439,361
1555,22,2.3.343,0,539,1,58,343,401,343,0,401,401,-13,191,461,4,4,133,143,327,295,23,1439,361
1555,22,3.1.279,1,535,0,68,279,347,131,148,347,349,0,7,448,2,6,147,68,179,340,23,1439,361
1555,23,1.3.330,0,535,0,45,330,375,291,39,375,375,0,178,448,4,4,81,143,136,295,24,1439,293
1555,23,2.3.343,0,539,1,58,343,401,343,0,401,401,-13,191,461,4,4,133,143,327,295,24,1439,293
1555,23,3.2.347,1,535,0,12,347,359,347,0,359,359,-4,88,452,3,6,79,12,179,271,24,1439,293
1555,24,1.3.330,0,535,0,45,330,375,291,39,375,375,0,178,452,4,4,81,143,136,295,25,1439,281
1555,24,2.3.343,1,539,1,58,343,401,343,0,401,401,-13,191,465,4,4,133,143,327,295,25,1439,281
1555,24,3.3.359,0,568,2,40,359,399,359,0,399,399,-29,207,481,4,4,67,143,179,295,25,1439,281
1555,25,1.3.401,1,539,0,45,401,446,291,110,446,446,0,191,465,4,5,81,85,136,295,26,1439,223
1555,25,2.4.401,0,539,0,75,401,476,401,0,476,476,-52,231,517,5,4,75,138,327,308,26,1439,223
1555,25,3.3.401,0,539,0,40,401,441,359,42,441,441,0,191,465,4,5,67,85,179,295,26,1439,223
1555,26,1.4.446,0,584,1,36,446,482,446,0,482,482,-97,276,562,5,4,36,138,136,308,27,1439,178
1555,26,2.4.401,0,539,0,75,401,476,401,0,476,476,-52,231,517,5,4,75,138,327,308,27,1439,178
1555,26,3.3.446,1,539,0,40,446,486,359,87,486,486,0,191,465,4,6,67,40,179,295,27,1439,178
1555,27,1.4.446,0,584,2,36,446,482,446,0,482,486,-97,276,562,5,4,36,138,136,308,28,1439,138
1555,27,2.4.401,1,539,0,75,401,476,401,0,476,486,-52,231,517,5,4,75,138,327,308,28,1439,138
1555,27,3.4.486,0,549,1,27,486,513,486,0,513,513,-137,316,602,5,4,27,138,179,308,28,1439,138
1555,28,1.4.476,1,539,0,36,476,512,446,30,512,512,0,231,517,5,5,36,63,136,308,29,1439,63
1555,28,3.4.486,0,549,1,27,486,513,486,0,513,513,-10,241,527,5,5,27,63,179,308,29,1439,63
1555,29,3.4.512,1,539,0,27,512,539,486,26,539,539,0,231,517,5,6,27,27,179,308,30,1439,27
1556,0,0.0.0,0,550,4,50,0,50,0,0,50,50,0,0,0,1,1,233,338,233,338,1,1409,1409
1556,0,1.0.0,0,547,3,85,0,85,0,0,85,85,0,0,0,1,1,236,338,236,338,1,1409,1409
1556,0,2.0.0,0,535,2,40,0,40,0,0,40,40,0,0,0,1,1,155,338,155,338,1,1409,1409
1556,0,3.0.0,0,522,0,85,0,85,0,0,85,85,0,0,0,1,1,336,338,336,338,1,1409,1409
1556,0,4.0.0,1,534,1,29,0,29,0,0,29,29,0,0,0,1,1,281,338,281,338,1,1409,1409
1556,0,5.0.0,0,568,5,49,0,49,0,0,49,49,0,0,0,1,1,168,338,168,338,1,1409,1409
1556,1,0.0.29,0,542,3,50,29,79,0,29,79,79,0,0,0,1,2,233,309,233,338,2,1409,1380
1556,1,1.0.29,0,543,4,85,29,114,0,29,114,114,0,0,0,1,2,236,309,236,338,2,1409,1380
1556,1,2.0.29,0,534,0,40,29,69,0,29,69,69,0,0,0,1,2,155,309,155,338,2,1409,1380
1556,1,3.0.29,0,538,1,85,29,114,0,29,114,114,0,0,0,1,2,336,309,336,338,2,1409,1380
1556,1,4.1.29,1,534,0,93,29,122,29,0,122,122,-29,29,29,2,1,252,244,281,244,2,1409,1380
1556,1,5.0.29,0,541,2,49,29,78,0,29,78,78,0,0,0,1,2,168,309,168,338,2,1409,1380
1556,2,0.0.29,0,542,3,50,29,79,0,29,79,122,0,0,29,1,2,233,309,233,338,3,1409,1287
1556,2,1.0.29,0,543,4,85,29,114,0,29,114,122,0,0,29,1,2,236,309,236,338,3,1409,1287
1556,2,2.0.29,0,534,0,40,29,69,0,29,69,122,0,0,29,1,2,155,309,155,338,3,1409,1287
1556,2,3.0.29,0,538,1,85,29,114,0,29,114,122,0,0,29,1,2,336,309,336,338,3,1409,1287
1556,2,4.2.122,1,534,0,45,122,167,122,0,167,167,-122,122,151,3,1,159,239,281,239,3,1409,1287
1556,2,5.0.29,0,541,2,49,29,78,0,29,78,122,0,0,29,1,2,168,309,168,338,3,1409,1287
1556,3,0.0.29,0,542,3,50,29,79,0,29,79,167,0,0,151,1,2,233,309,233,338,4,1409,1242
1556,3,1.0.29,0,552,4,85,29,114,0,29,114,167,0,0,151,1,2,236,309,236,338,4,1409,1242
1556,3,2.0.29,0,534,0,40,29,69,0,29,69,167,0,0,151,1,2,155,309,155,338,4,1409,1242
1556,3,3.0.29,0,538,1,85,29,114,0,29,114,167,0,0,151,1,2,336,309,336,338,4,1409,1242
1556,3,4.3.167,1,534,0,79,167,246,167,0,246,246,-167,167,318,4,1,114,349,281,349,4,1409,1242
1556,3,5.0.29,0,541,2,49,29,78,0,29,78,167,0,0,151,1,2,168,309,168,338,4,1409,1242
1556,4,0.0.29,0,542,3,50,29,79,0,29,79,246,0,0,318,1,2,233,309,233,338,5,1409,1163
1556,4,1.0.29,0,552,4,85,29,114,0,29,114,246,0,0,318,1,2,236,309,236,338,5,1409,1163
1556,4,2.0.29,0,534,0,40,29,69,0,29,69,246,0,0,318,1,2,155,309,155,338,5,1409,1163
1556,4,3.0.29,0,538,1,85,29,114,0,29,114,246,0,0,318,1,2,336,309,336,338,5,1409,1163
1556,4,4.4.246,1,534,0,35,246,281,246,0,281,281,-246,246,564,5,1,35,239,281,239,5,1409,1163
1556,4,5.0.29,0,541,2,49,29,78,0,29,78,246,0,0,318,1,2,168,309,168,338,5,1409,1163
1556,5,0.0.29,0,542,3,50,29,79,0,29,79,281,0,0,564,1,2,233,309,233,338,6,1409,1128
1556,5,1.0.29,0,552,4,85,29,114,0,29,114,281,0,0,564,1,2,236,309,236,338,6,1409,1128
1556,5,2.0.29,0,534,0,40,29,69,0,29,69,281,0,0,564,1,2,155,309,155,338,6,1409,1128
1556,5,3.0.29,1,538,1,85,29,114,0,29,114,281,0,0,564,1,2,336,309,336,338,6,1409,1128
1556,5,5.0.29,0,541,2,49,29,78,0,29,78,281,0,0,564,1,2,168,309,168,338,6,1409,1128
1556,6,0.0.114,0,539,1,50,114,164,0,114,164,281,0,0,564,1,3,233,224,233,338,7,1409,1043
1556,6,1.0.114,0,548,2,85,114,199,0,114,199,281,0,0,564,1,3,236,224,236,338,7,1409,1043
1556,6,2.0.114,0,538,0,40,114,154,0,114,154,281,0,0,564,1,3,155,224,155,338,7,1409,1043
1556,6,3.1.122,1,538,0,7,122,129,114,8,129,281,0,29,564,2,2,251,151,336,244,7,1409,1043
1556,6,5.0.114,0,538,0,49,114,163,0,114,163,281,0,0,564,1,3,168,224,168,338,7,1409,1043
1556,7,0.0.114,0,539,1,50,114,164,0,114,164,281,0,0,564,1,3,233,224,233,338,8,1409,1036
1556,7,1.0.114,0,548,2,85,114,199,0,114,199,281,0,0,564,1,3,236,224,236,338,8,1409,1036
1556,7,2.0.114,0,538,0,40,114,154,0,114,154,281,0,0,564,1,3,155,224,155,338,8,1409,1036
1556,7,3.2.167,1,538,0,78,167,245,129,38,245,281,0,122,564,3,2,244,194,336,239,8,1409,1036
1556,7,5.0.114,0,538,0,49,114,163,0,114,163,281,0,0,564,1,3,168,224,168,338,8,1409,1036
1556,8,0.0.114,1,539,1,50,114,164,0,114,164,281,0,0,564,1,3,233,224,233,338,9,1409,958
1556,8,1.0.114,0,548,2,85,114,199,0,114,199,281,0,0,564,1,3,236,224,236,338,9,1409,958
1556,8,2.0.114,0,538,0,40,114,154,0,114,154,281,0,0,564,1,3,155,224,155,338,9,1409,958
1556,8,3.3.246,0,548,2,98,246,344,245,1,344,344,0,167,564,4,2,166,270,336,349,9,1409,958
1556,8,5.0.114,0,538,0,49,114,163,0,114,163,281,0,0,564,1,3,168,224,168,338,9,1409,958
1556,9,0.1.164,1,539,0,40,164,204,164,0,204,281,-35,64,599,2,3,183,144,233,244,10,1409,908
1556,9,1.0.164,0,548,1,85,164,249,0,164,249,281,0,0,564,1,4,236,174,236,338,10,1409,908
1556,9,2.0.164,0,539,0,40,164,204,0,164,204,281,0,0,564,1,4,155,174,155,338,10,1409,908
1556,9,3.3.246,0,548,1,98,246,344,245,1,344,344,0,167,564,4,2,166,270,336,349,10,1409,908
1556,9,5.0.164,0,548,1,49,164,213,0,164,213,281,0,0,564,1,4,168,174,168,338,10,1409,908
1556,10,0.2.245,1,548,1,73,245,318,204,41,318,318,0,122,599,3,3,143,116,233,239,11,1409,868
1556,10,1.0.164,0,548,1,85,164,249,0,164,249,281,0,0,599,1,4,236,174,236,338,11,1409,868
1556,10,2.0.164,0,539,0,40,164,204,0,164,204,281,0,0,599,1,4,155,174,155,338,11,1409,868
1556,10,3.3.246,0,548,1,98,246,344,245,1,344,344,0,167,599,4,2,166,270,336,349,11,1409,868
1556,10,5.0.164,0,548,1,49,164,213,0,164,213,281,0,0,599,1,4,168,174,168,338,11,1409,868
1556,11,0.3.318,0,601,1,23,318,341,318,0,341,341,-72,239,671,4,2,70,270,233,349,12,1409,795
1556,11,1.0.164,0,548,0,85,164,249,0,164,249,318,0,0,599,1,4,236,174,236,338,12,1409,795
1556,11,2.0.164,1,548,0,40,164,204,0,164,204,318,0,0,599,1,4,155,174,155,338,12,1409,795
1556,11,3.3.246,0,548,0,98,246,344,245,1,344,344,0,167,599,4,2,166,270,336,349,12,1409,795
1556,11,5.0.164,0,548,0,49,164,213,0,164,213,318,0,0,599,1,4,168,174,168,338,12,1409,795
1556,12,0.3.318,0,601,1,23,318,341,318,0,341,341,-72,239,671,4,2,70,270,233,349,13,1409,755
1556,12,1.0.204,0,548,0,85,204,289,0,204,289,318,0,0,599,1,5,236,134,236,338,13,1409,755
1556,12,2.1.204,1,548,0,42,204,246,204,0,246,318,0,64,599,2,4,115,104,155,244,13,1409,755
1556,12,3.3.246,0,548,0,98,246,344,245,1,344,344,0,167,599,4,2,166,270,336,349,13,1409,755
1556,12,5.0.204,0,548,0,49,204,253,0,204,253,318,0,0,599,1,5,168,134,168,338,13,1409,755
1556,13,0.3.318,0,601,1,23,318,341,318,0,341,341,-72,239,671,4,2,70,270,233,349,14,1409,713
1556,13,1.0.204,0,548,0,85,204,289,0,204,289,318,0,0,599,1,5,236,134,236,338,14,1409,713
1556,13,2.2.318,1,548,0,5,318,323,246,72,323,323,0,122,599,3,4,73,43,155,239,14,1409,713
1556,13,3.3.246,0,548,0,98,246,344,245,1,344,344,0,167,599,4,2,166,270,336,349,14,1409,713
1556,13,5.0.204,0,548,0,49,204,253,0,204,253,318,0,0,599,1,5,168,134,168,338,14,1409,713
1556,14,0.3.318,0,601,1,23,318,341,318,0,341,341,-72,239,671,4,2,70,270,233,349,15,1409,708
1556,14,1.0.204,0,548,0,85,204,289,0,204,289,323,0,0,599,1,5,236,134,236,338,15,1409,708
1556,14,2.3.323,0,606,2,27,323,350,323,0,350,350,-77,244,676,4,2,68,270,155,349,15,1409,708
1556,14,3.3.246,0,548,0,98,246,344,245,1,344,344,0,167,599,4,2,166,270,336,349,15,1409,708
1556,14,5.0.204,1,548,0,49,204,253,0,204,253,323,0,0,599,1,5,168,134,168,338,15,1409,708
1556,15,0.3.318,0,601,1,23,318,341,318,0,341,341,-72,239,671,4,2,70,270,233,349,16,1409,659
1556,15,1.0.253,1,548,0,85,253,338,0,253,338,338,0,0,599,1,6,236,85,236,338,16,1409,659
1556,15,2.3.323,0,606,2,27,323,350,323,0,350,350,-77,244,676,4,2,68,270,155,349,16,1409,659
1556,15,3.3.246,0,548,0,98,246,344,245,1,344,344,0,167,599,4,2,166,270,336,349,16,1409,659
1556,15,5.1.253,0,548,0,59,253,312,253,0,312,323,-7,71,606,2,5,119,62,168,244,16,1409,659
1556,16,0.3.318,0,601,1,23,318,341,318,0,341,341,-72,239,671,4,2,70,270,233,349,17,1409,574
1556,16,1.1.338,1,548,0,3,338,341,338,0,341,341,-92,156,691,2,5,151,62,236,244,17,1409,574
1556,16,2.3.323,0,606,2,27,323,350,323,0,350,350,-77,244,676,4,2,68,270,155,349,17,1409,574
1556,16,3.3.246,0,548,0,98,246,344,245,1,344,344,0,167,599,4,2,166,270,336,349,17,1409,574
1556,16,5.1.253,0,548,0,59,253,312,253,0,312,338,-7,71,606,2,5,119,62,168,244,17,1409,574
1556,17,0.3.318,0,601,1,23,318,341,318,0,341,341,-72,239,763,4,2,70,270,233,349,18,1409,571
1556,17,1.2.341,1,548,0,16,341,357,341,0,357,357,-18,140,709,3,5,148,38,236,239,18,1409,571
1556,17,2.3.323,0,606,2,27,323,350,323,0,350,350,-77,244,768,4,2,68,270,155,349,18,1409,571
1556,17,3.3.246,0,548,0,98,246,344,245,1,344,344,0,167,691,4,2,166,270,336,349,18,1409,571
1556,17,5.1.253,0,548,0,59,253,312,253,0,341,341,59,97,632,2,6,119,59,168,244,18,1409,571
1556,18,0.3.318,0,601,2,23,318,341,318,0,341,357,-72,239,781,4,2,70,270,233,349,19,1409,555
1556,18,1.3.357,0,580,1,87,357,444,357,0,444,444,-111,278,820,4,2,132,270,236,349,19,1409,555
1556,18,2.3.323,0,606,3,27,323,350,323,0,350,357,-77,244,786,4,2,68,270,155,349,19,1409,555
1556,18,3.3.246,0,548,0,98,246,344,245,1,344,357,0,167,709,4,2,166,270,336,349,19,1409,555
1556,18,5.1.253,1,548,0,59,253,312,253,0,341,357,59,97,650,2,6,119,59,168,244,19,1409,555
1556,19,0.3.318,0,601,2,23,318,341,318,0,341,357,-72,239,722,4,2,70,270,233,349,20,1409,496
1556,19,1.3.357,0,580,1,87,357,444,357,0,444,444,-111,278,761,4,2,132,270,236,349,20,1409,496
1556,19,2.3.323,0,606,3,27,323,350,323,0,350,357,-77,244,727,4,2,68,270,155,349,20,1409,496
1556,19,3.3.246,0,548,0,98,246,344,245,1,344,357,0,167,650,4,2,166,270,336,349,20,1409,496
1556,19,5.2.357,1,548,0,22,357,379,312,45,379,379,0,140,650,3,6,60,22,168,239,20,1409,496
1556,20,0.3.318,0,601,3,23,318,341,318,0,341,379,-72,239,722,4,2,70,270,233,349,21,1409,474
1556,20,1.3.357,0,580,2,87,357,444,357,0,444,444,-111,278,761,4,2,132,270,236,349,21,1409,474
1556,20,2.3.323,0,606,4,27,323,350,323,0,350,379,-77,244,727,4,2,68,270,155,349,21,1409,474
1556,20,3.3.246,1,548,0,98,246,344,245,1,344,379,0,167,650,4,2,166,270,336,349,21,1409,474
1556,20,5.3.379,0,569,1,35,379,414,379,0,414,414,-133,300,783,4,2,38,270,168,349,21,1409,474
1556,21,0.3.344,0,548,0,23,344,367,318,26,367,379,0,167,650,4,3,70,172,233,349,22,1409,376
1556,21,1.3.357,0,580,2,87,357,444,357,0,444,444,-13,180,663,4,3,132,172,236,349,22,1409,376
1556,21,2.3.344,0,548,0,27,344,371,323,21,371,379,0,167,650,4,3,68,172,155,349,22,1409,376
1556,21,3.4.344,1,548,0,68,344,412,344,0,412,412,-63,309,713,5,2,68,204,336,239,22,1409,376
1556,21,5.3.379,0,569,1,35,379,414,379,0,414,414,-35,202,685,4,3,38,172,168,349,22,1409,376
1556,22,0.3.344,1,548,0,23,344,367,318,26,367,412,0,167,713,4,3,70,172,233,349,23,1409,308
1556,22,1.3.357,0,580,2,87,357,444,357,0,444,444,-13,180,726,4,3,132,172,236,349,23,1409,308
1556,22,2.3.344,0,548,0,27,344,371,323,21,371,412,0,167,713,4,3,68,172,155,349,23,1409,308
1556,22,5.3.379,0,569,1,35,379,414,379,0,414,414,-35,202,748,4,3,38,172,168,349,23,1409,308
1556,23,0.4.412,1,548,0,47,412,459,367,45,459,459,0,309,713,5,3,47,136,233,239,24,1409,285
1556,23,1.3.367,0,548,0,87,367,454,357,10,454,454,0,167,713,4,4,132,149,236,349,24,1409,285
1556,23,2.3.367,0,548,0,27,367,394,323,44,394,412,0,167,713,4,4,68,149,155,349,24,1409,285
1556,23,5.3.379,0,573,1,35,379,414,379,0,414,414,-12,179,725,4,4,38,149,168,349,24,1409,285
1556,24,1.3.367,0,548,0,87,367,454,357,10,454,459,0,167,713,4,4,132,149,236,349,25,1409,238
1556,24,2.3.367,1,548,0,27,367,394,323,44,394,459,0,167,713,4,4,68,149,155,349,25,1409,238
1556,24,5.3.379,0,573,1,35,379,414,379,0,414,459,-12,179,725,4,4,38,149,168,349,25,1409,238
1556,25,1.3.394,0,548,0,87,394,481,357,37,481,481,0,167,713,4,5,132,122,236,349,26,1409,211
1556,25,2.4.459,1,548,0,41,459,500,394,65,500,500,0,309,713,5,4,41,89,155,239,26,1409,211
1556,25,5.3.394,0,561,1,35,394,429,379,15,429,459,0,167,713,4,5,38,122,168,349,26,1409,211
1556,26,1.3.394,0,548,0,87,394,481,357,37,481,500,0,167,713,4,5,132,122,236,349,27,1409,170
1556,26,5.3.394,1,561,1,35,394,429,379,15,429,500,0,167,713,4,5,38,122,168,349,27,1409,170
1556,27,1.3.429,0,561,0,87,429,516,357,72,516,516,0,167,713,4,6,132,87,236,349,28,1409,135
1556,27,5.4.500,1,561,0,3,500,503,429,71,503,503,0,309,713,5,5,3,48,168,239,28,1409,135
1556,28,1.3.429,1,561,0,87,429,516,357,72,516,516,0,167,713,4,6,132,87,236,349,29,1409,132
1556,29,1.4.516,1,561,0,45,516,561,516,0,561,561,-13,322,726,5,6,45,45,236,239,30,1409,45
1557,0,0.0.0,0,539,0,63,0,63,0,0,63,63,0,0,0,1,1,276,352,276,352,1,1476,1476
1557,0,1.0.0,0,546,2,61,0,61,0,0,61,61,0,0,0,1,1,235,352,235,352,1,1476,1476
1557,0,2.0.0,0,554,3,85,0,85,0,0,85,85,0,0,0,1,1,279,352,279,352,1,1476,1476
1557,0,3.0.0,0,539,0,38,0,38,0,0,38,38,0,0,0,1,1,198,352,198,352,1,1476,1476
1557,0,4.0.0,0,541,1,51,0,51,0,0,51,51,0,0,0,1,1,219,352,219,352,1,1476,1476
1557,0,5.0.0,1,539,0,54,0,54,0,0,54,54,0,0,0,1,1,269,352,269,352,1,1476,1476
1557,1,0.0.54,0,539,0,63,54,117,0,54,117,117,0,0,0,1,2,276,298,276,352,2,1476,1422
1557,1,1.0.54,0,553,2,61,54,115,0,54,115,115,0,0,0,1,2,235,298,235,352,2,1476,1422
1557,1,2.0.54,0,539,0,85,54,139,0,54,139,139,0,0,0,1,2,279,298,279,352,2,1476,1422
1557,1,3.0.54,0,539,0,38,54,92,0,54,92,92,0,0,0,1,2,198,298,198,352,2,1476,1422
1557,1,4.0.54,0,541,1,51,54,105,0,54,105,105,0,0,0,1,2,219,298,219,352,2,1476,1422
1557,1,5.1.54,1,539,0,42,54,96,54,0,96,96,-54,54,54,2,1,215,245,269,245,2,1476,1422
1557,2,0.0.54,0,539,0,63,54,117,0,54,117,117,0,0,54,1,2,276,298,276,352,3,1476,1380
1557,2,1.0.54,0,553,2,61,54,115,0,54,115,115,0,0,54,1,2,235,298,235,352,3,1476,1380
1557,2,2.0.54,0,539,0,85,54,139,0,54,139,139,0,0,54,1,2,279,298,279,352,3,1476,1380
1557,2,3.0.54,0,539,0,38,54,92,0,54,92,96,0,0,54,1,2,198,298,198,352,3,1476,1380
1557,2,4.0.54,0,541,1,51,54,105,0,54,105,105,0,0,54,1,2,219,298,219,352,3,1476,1380
1557,2,5.2.96,1,539,0,60,96,156,96,0,156,156,-96,96,150,3,1,173,307,269,307,3,1476,1380
1557,3,0.0.54,0,539,0,63,54,117,0,54,117,156,0,0,150,1,2,276,298,276,352,4,1476,1320
1557,3,1.0.54,0,553,2,61,54,115,0,54,115,156,0,0,150,1,2,235,298,235,352,4,1476,1320
1557,3,2.0.54,0,539,0,85,54,139,0,54,139,156,0,0,150,1,2,279,298,279,352,4,1476,1320
1557,3,3.0.54,0,539,0,38,54,92,0,54,92,156,0,0,150,1,2,198,298,198,352,4,1476,1320
1557,3,4.0.54,0,541,1,51,54,105,0,54,105,156,0,0,150,1,2,219,298,219,352,4,1476,1320
1557,3,5.3.156,1,539,0,20,156,176,156,0,176,176,-156,156,306,4,1,113,304,269,304,4,1476,1320
1557,4,0.0.54,0,539,0,63,54,117,0,54,117,176,0,0,306,1,2,276,298,276,352,5,1476,1300
1557,4,1.0.54,0,553,2,61,54,115,0,54,115,176,0,0,306,1,2,235,298,235,352,5,1476,1300
1557,4,2.0.54,0,539,0,85,54,139,0,54,139,176,0,0,306,1,2,279,298,279,352,5,1476,1300
1557,4,3.0.54,0,539,0,38,54,92,0,54,92,176,0,0,306,1,2,198,298,198,352,5,1476,1300
1557,4,4.0.54,0,541,1,51,54,105,0,54,105,176,0,0,306,1,2,219,298,219,352,5,1476,1300
1557,4,5.4.176,1,539,0,93,176,269,176,0,269,269,-176,176,482,5,1,93,268,269,268,5,1476,1300
1557,5,0.0.54,1,539,0,63,54,117,0,54,117,269,0,0,482,1,2,276,298,276,352,6,1476,1207
1557,5,1.0.54,0,553,2,61,54,115,0,54,115,269,0,0,482,1,2,235,298,235,352,6,1476,1207
1557,5,2.0.54,0,539,0,85,54,139,0,54,139,269,0,0,482,1,2,279,298,279,352,6,1476,1207
1557,5,3.0.54,0,539,0,38,54,92,0,54,92,269,0,0,482,1,2,198,298,198,352,6,1476,1207
1557,5,4.0.54,0,541,1,51,54,105,0,54,105,269,0,0,482,1,2,219,298,219,352,6,1476,1207
1557,6,0.1.117,1,539,0,8,117,125,117,0,125,269,-21,75,503,2,2,213,203,276,245,7,1476,1144
1557,6,1.0.117,0,569,3,61,117,178,0,117,178,269,0,0,482,1,3,235,235,235,352,7,1476,1144
1557,6,2.0.117,0,554,2,85,117,202,0,117,202,269,0,0,482,1,3,279,235,279,352,7,1476,1144
1557,6,3.0.117,0,539,0,38,117,155,0,117,155,269,0,0,482,1,3,198,235,198,352,7,1476,1144
1557,6,4.0.117,0,543,1,51,117,168,0,117,168,269,0,0,482,1,3,219,235,219,352,7,1476,1144
1557,7,0.2.156,1,539,0,76,156,232,125,31,232,269,0,96,503,3,2,205,247,276,307,8,1476,1136
1557,7,1.0.117,0,569,3,61,117,178,0,117,178,269,0,0,503,1,3,235,235,235,352,8,1476,1136
1557,7,2.0.117,0,554,2,85,117,202,0,117,202,269,0,0,503,1,3,279,235,279,352,8,1476,1136
1557,7,3.0.117,0,539,0,38,117,155,0,117,155,269,0,0,503,1,3,198,235,198,352,8,1476,1136
1557,7,4.0.117,0,543,1,51,117,168,0,117,168,269,0,0,503,1,3,219,235,219,352,8,1476,1136
1557,8,0.3.232,1,539,0,30,232,262,232,0,262,269,-56,212,559,4,2,129,284,276,304,9,1476,1060
1557,8,1.0.117,0,569,3,61,117,178,0,117,178,269,0,0,503,1,3,235,235,235,352,9,1476,1060
1557,8,2.0.117,0,554,2,85,117,202,0,117,202,269,0,0,503,1,3,279,235,279,352,9,1476,1060
1557,8,3.0.117,0,539,0,38,117,155,0,117,155,269,0,0,503,1,3,198,235,198,352,9,1476,1060
1557,8,4.0.117,0,543,1,51,117,168,0,117,168,269,0,0,503,1,3,219,235,219,352,9,1476,1060
1557,9,0.4.269,1,539,0,99,269,368,262,7,368,368,0,176,559,5,2,99,175,276,268,10,1476,1030
1557,9,1.0.117,0,569,3,61,117,178,0,117,178,269,0,0,559,1,3,235,235,235,352,10,1476,1030
1557,9,2.0.117,0,554,2,85,117,202,0,117,202,269,0,0,559,1,3,279,235,279,352,10,1476,1030
1557,9,3.0.117,0,539,0,38,117,155,0,117,155,269,0,0,559,1,3,198,235,198,352,10,1476,1030
1557,9,4.0.117,0,543,1,51,117,168,0,117,168,269,0,0,559,1,3,219,235,219,352,10,1476,1030
1557,10,1.0.117,0,569,3,61,117,178,0,117,178,368,0,0,559,1,3,235,235,235,352,11,1476,931
1557,10,2.0.117,0,554,2,85,117,202,0,117,202,368,0,0,559,1,3,279,235,279,352,11,1476,931
1557,10,3.0.117,1,539,0,38,117,155,0,117,155,368,0,0,559,1,3,198,235,198,352,11,1476,931
1557,10,4.0.117,0,543,1,51,117,168,0,117,168,368,0,0,559,1,3,219,235,219,352,11,1476,931
1557,11,1.0.155,0,550,2,61,155,216,0,155,216,368,0,0,559,1,4,235,197,235,352,12,1476,893
1557,11,2.0.155,0,539,0,85,155,240,0,155,240,368,0,0,559,1,4,279,197,279,352,12,1476,893
1557,11,3.1.155,1,539,0,45,155,200,155,0,200,368,-30,105,589,2,3,160,195,198,245,12,1476,893
1557,11,4.0.155,0,546,1,51,155,206,0,155,206,368,0,0,559,1,4,219,197,219,352,12,1476,893
1557,12,1.0.155,0,550,2,61,155,216,0,155,216,368,0,0,589,1,4,235,197,235,352,13,1476,848
1557,12,2.0.155,0,539,0,85,155,240,0,155,240,368,0,0,589,1,4,279,197,279,352,13,1476,848
1557,12,3.2.232,1,539,0,46,232,278,200,32,278,368,0,96,589,3,3,115,171,198,307,13,1476,848
1557,12,4.0.155,0,546,1,51,155,206,0,155,206,368,0,0,589,1,4,219,197,219,352,13,1476,848
1557,13,1.0.155,0,550,2,61,155,216,0,155,216,368,0,0,589,1,4,235,197,235,352,14,1476,802
1557,13,2.0.155,0,539,0,85,155,240,0,155,240,368,0,0,589,1,4,279,197,279,352,14,1476,802
1557,13,3.3.278,0,539,0,58,278,336,278,0,336,368,-16,228,605,4,3,69,254,198,304,14,1476,802
1557,13,4.0.155,1,546,1,51,155,206,0,155,206,368,0,0,589,1,4,219,197,219,352,14,1476,802
1557,14,1.0.206,1,546,0,61,206,267,0,206,267,368,0,0,589,1,5,235,146,235,352,15,1476,751
1557,14,2.0.206,0,573,1,85,206,291,0,206,291,368,0,0,589,1,5,279,146,279,352,15,1476,751
1557,14,3.3.278,0,546,0,58,278,336,278,0,336,368,-16,228,605,4,3,69,254,198,304,15,1476,751
1557,14,4.1.206,0,546,0,45,206,251,206,0,251,368,-6,111,595,2,4,168,150,219,245,15,1476,751
1557,15,1.1.267,0,546,0,70,267,337,267,0,337,368,-67,172,656,2,4,174,150,235,245,16,1476,690
1557,15,2.0.267,1,546,0,85,267,352,0,267,352,368,0,0,589,1,6,279,85,279,352,16,1476,690
1557,15,3.3.278,0,546,0,58,278,336,278,0,336,368,-16,228,605,4,3,69,254,198,304,16,1476,690
1557,15,4.1.206,0,546,0,45,206,251,206,0,251,368,-6,111,595,2,4,168,150,219,245,16,1476,690
1557,16,1.1.267,0,546,0,70,267,337,267,0,337,368,-67,172,656,2,4,174,150,235,245,17,1476,605
1557,16,2.1.352,0,546,0,35,352,387,352,0,387,387,-152,257,741,2,4,194,150,279,245,17,1476,605
1557,16,3.3.278,0,546,0,58,278,336,278,0,336,368,-16,228,605,4,3,69,254,198,304,17,1476,605
1557,16,4.1.206,1,546,0,45,206,251,206,0,251,368,-6,111,595,2,4,168,150,219,245,17,1476,605
1557,17,1.1.267,0,546,0,70,267,337,267,0,337,368,-16,127,611,2,5,174,105,235,245,18,1476,560
1557,17,2.1.352,0,546,0,35,352,387,352,0,387,387,-101,212,696,2,5,194,105,279,245,18,1476,560
1557,17,3.3.278,0,546,0,58,278,336,278,0,336,368,-16,228,611,4,3,69,254,198,304,18,1476,560
1557,17,4.2.278,1,546,0,46,278,324,251,27,324,368,0,96,595,3,4,123,125,219,307,18,1476,560
1557,18,1.1.267,1,546,0,70,267,337,267,0,337,368,-16,127,611,2,5,174,105,235,245,19,1476,514
1557,18,2.1.352,0,546,0,35,352,387,352,0,387,387,-101,212,696,2,5,194,105,279,245,19,1476,514
1557,18,3.3.278,0,546,0,58,278,336,278,0,336,368,-16,228,611,4,3,69,254,198,304,19,1476,514
1557,18,4.3.324,0,584,1,72,324,396,324,0,396,396,-62,274,657,4,3,77,254,219,304,19,1476,514
1557,19,1.2.337,1,546,0,21,337,358,337,0,358,368,-13,109,624,3,5,104,79,235,307,20,1476,444
1557,19,2.1.352,0,546,0,35,352,387,352,0,387,387,-15,142,626,2,6,194,35,279,245,20,1476,444
1557,19,3.3.278,0,546,0,58,278,336,278,0,336,368,-16,228,627,4,3,69,254,198,304,20,1476,444
1557,19,4.3.324,0,584,1,72,324,396,324,0,396,396,-62,274,673,4,3,77,254,219,304,20,1476,444
1557,20,1.3.358,0,560,1,29,358,387,358,0,387,387,-96,308,720,4,3,83,254,235,304,21,1476,423
1557,20,2.1.352,1,546,0,35,352,387,352,0,387,387,-15,142,639,2,6,194,35,279,245,21,1476,423
1557,20,3.3.278,0,546,0,58,278,336,278,0,336,368,-16,228,640,4,3,69,254,198,304,21,1476,423
1557,20,4.3.324,0,584,2,72,324,396,324,0,396,396,-62,274,686,4,3,77,254,219,304,21,1476,423
1557,21,1.3.358,0,560,1,29,358,387,358,0,387,387,-96,308,735,4,3,83,254,235,304,22,1476,388
1557,21,2.2.387,1,546,0,58,387,445,387,0,445,445,-29,138,668,3,6,159,58,279,307,22,1476,388
1557,21,3.3.278,0,546,0,58,278,336,278,0,336,387,-16,228,655,4,3,69,254,198,304,22,1476,388
1557,21,4.3.324,0,584,2,72,324,396,324,0,396,396,-62,274,701,4,3,77,254,219,304,22,1476,388
1557,22,1.3.358,0,560,1,29,358,387,358,0,387,445,-96,308,764,4,3,83,254,235,304,23,1476,330
1557,22,2.3.445,0,546,0,95,445,540,445,0,540,540,-183,395,851,4,3,101,254,279,304,23,1476,330
1557,22,3.3.278,1,546,0,58,278,336,278,0,336,445,-16,228,684,4,3,69,254,198,304,23,1476,330
1557,22,4.3.324,0,584,2,72,324,396,324,0,396,445,-62,274,730,4,3,77,254,219,304,23,1476,330
1557,23,1.3.358,0,560,1,29,358,387,358,0,387,445,-22,250,706,4,4,83,196,235,304,24,1476,272
1557,23,2.3.445,0,546,0,95,445,540,445,0,540,540,-109,337,793,4,4,101,196,279,304,24,1476,272
1557,23,3.4.368,1,546,0,11,368,379,336,32,379,445,0,176,684,5,3,11,76,198,268,24,1476,272
1557,23,4.3.336,0,546,0,72,336,408,324,12,408,445,0,228,684,4,4,77,196,219,304,24,1476,272
1557,24,1.3.358,1,560,1,29,358,387,358,0,387,445,-22,250,706,4,4,83,196,235,304,25,1476,261
1557,24,2.3.445,0,546,0,95,445,540,445,0,540,540,-109,337,793,4,4,101,196,279,304,25,1476,261
1557,24,4.3.336,0,546,0,72,336,408,324,12,408,445,0,228,684,4,4,77,196,219,304,25,1476,261
1557,25,1.4.387,1,560,0,54,387,441,387,0,441,445,-8,184,714,5,4,54,65,235,268,26,1476,232
1557,25,2.3.445,0,617,1,95,445,540,445,0,540,540,-58,308,764,4,5,101,167,279,304,26,1476,232
1557,25,4.3.387,0,560,0,72,387,459,324,63,459,459,0,250,706,4,5,77,167,219,304,26,1476,232
1557,26,2.3.445,0,617,1,95,445,540,445,0,540,540,-58,308,772,4,5,101,167,279,304,27,1476,178
1557,26,4.3.387,1,560,0,72,387,459,324,63,459,459,0,250,714,4,5,77,167,219,304,27,1476,178
1557,27,2.3.459,0,560,0,95,459,554,445,14,554,554,0,250,714,4,6,101,95,279,304,28,1476,106
1557,27,4.4.459,1,560,0,5,459,464,459,0,464,464,-18,202,732,5,5,5,11,219,268,28,1476,106
1557,28,2.3.459,1,560,0,95,459,554,445,14,554,554,0,250,732,4,6,101,95,279,304,29,1476,101
1557,29,2.4.554,1,560,0,6,554,560,554,0,560,560,-90,292,822,5,6,6,6,279,268,30,1476,6
1558,0,0.0.0,0,644,3,76,0,76,0,0,76,76,0,0,0,1,1,319,366,319,366,1,1642,1642
1558,0,1.0.0,0,588,0,36,0,36,0,0,36,36,0,0,0,1,1,234,366,234,366,1,1642,1642
1558,0,2.0.0,0,588,0,32,0,32,0,0,32,32,0,0,0,1,1,207,366,207,366,1,1642,1642
1558,0,3.0.0,0,630,2,91,0,91,0,0,91,91,0,0,0,1,1,256,366,256,366,1,1642,1642
1558,0,4.0.0,1,614,1,72,0,72,0,0,72,72,0,0,0,1,1,355,366,355,366,1,1642,1642
1558,0,5.0.0,0,588,0,59,0,59,0,0,59,59,0,0,0,1,1,271,366,271,366,1,1642,1642
1558,1,0.0.72,0,677,4,76,72,148,0,72,148,148,0,0,0,1,2,319,294,319,366,2,1642,1570
1558,1,1.0.72,1,640,1,36,72,108,0,72,108,108,0,0,0,1,2,234,294,234,366,2,1642,1570
1558,1,2.0.72,0,614,0,32,72,104,0,72,104,104,0,0,0,1,2,207,294,207,366,2,1642,1570
1558,1,3.0.72,0,677,4,91,72,163,0,72,163,163,0,0,0,1,2,256,294,256,366,2,1642,1570
1558,1,4.1.72,0,670,3,97,72,169,72,0,169,169,-72,72,72,2,1,283,348,355,348,2,1642,1570
1558,1,5.0.72,0,656,2,59,72,131,0,72,131,131,0,0,0,1,2,271,294,271,366,2,1642,1570
1558,2,0.0.108,0,677,3,76,108,184,0,108,184,184,0,0,0,1,3,319,258,319,366,3,1642,1534
1558,2,1.1.108,0,640,0,38,108,146,108,0,146,146,-108,108,108,2,1,198,348,234,348,3,1642,1534
1558,2,2.0.108,1,641,1,32,108,140,0,108,140,140,0,0,0,1,3,207,258,207,366,3,1642,1534
1558,2,3.0.108,0,677,3,91,108,199,0,108,199,199,0,0,0,1,3,256,258,256,366,3,1642,1534
1558,2,4.1.72,0,670,2,97,72,169,72,0,169,169,-72,72,72,2,1,283,348,355,348,3,1642,1534
1558,2,5.0.108,0,640,0,59,108,167,0,108,167,167,0,0,0,1,3,271,258,271,366,3,1642,1534
1558,3,0.0.140,0,646,1,76,140,216,0,140,216,216,0,0,0,1,4,319,226,319,366,4,1642,1502
1558,3,1.1.108,0,641,0,38,108,146,108,0,146,146,-108,108,108,2,1,198,348,234,348,4,1642,1502
1558,3,2.1.140,0,641,0,29,140,169,140,0,169,169,-140,140,140,2,1,175,348,207,348,4,1642,1502
1558,3,3.0.140,0,646,1,91,140,231,0,140,231,231,0,0,0,1,4,256,226,256,366,4,1642,1502
1558,3,4.1.72,0,670,2,97,72,169,72,0,169,169,-72,72,72,2,1,283,348,355,348,4,1642,1502
1558,3,5.0.140,1,641,0,59,140,199,0,140,199,199,0,0,0,1,4,271,226,271,366,4,1642,1502
1558,4,0.0.199,1,641,0,76,199,275,0,199,275,275,0,0,0,1,5,319,167,319,366,5,1642,1443
1558,4,1.1.108,0,641,0,38,108,146,108,0,146,199,-108,108,108,2,1,198,348,234,348,5,1642,1443
1558,4,2.1.140,0,641,0,29,140,169,140,0,169,199,-140,140,140,2,1,175,348,207,348,5,1642,1443
1558,4,3.0.199,0,646,1,91,199,290,0,199,290,290,0,0,0,1,5,256,167,256,366,5,1642,1443
1558,4,4.1.72,0,670,2,97,72,169,72,0,169,199,-72,72,72,2,1,283,348,355,348,5,1642,1443
1558,4,5.1.199,0,641,0,26,199,225,199,0,225,225,-199,199,199,2,1,212,348,271,348,5,1642,1443
1558,5,0.1.275,0,658,1,75,275,350,275,0,350,350,-275,275,275,2,1,243,348,319,348,6,1642,1367
1558,5,1.1.108,0,641,0,38,108,146,108,0,146,275,-108,108,108,2,1,198,348,234,348,6,1642,1367
1558,5,2.1.140,0,641,0,29,140,169,140,0,169,275,-140,140,140,2,1,175,348,207,348,6,1642,1367
1558,5,3.0.275,1,641,0,91,275,366,0,275,366,366,0,0,0,1,6,256,91,256,366,6,1642,1367
1558,5,4.1.72,0,670,2,97,72,169,72,0,169,275,-72,72,72,2,1,283,348,355,348,6,1642,1367
1558,5,5.1.199,0,641,0,26,199,225,199,0,225,275,-199,199,199,2,1,212,348,271,348,6,1642,1367
1558,6,0.1.275,0,658,1,75,275,350,275,0,350,366,-275,275,275,2,1,243,348,319,348,7,1642,1276
1558,6,1.1.108,0,641,0,38,108,146,108,0,146,366,-108,108,108,2,1,198,348,234,348,7,1642,1276
1558,6,2.1.140,0,641,0,29,140,169,140,0,169,366,-140,140,140,2,1,175,348,207,348,7,1642,1276
1558,6,3.1.366,0,661,2,83,366,449,366,0,449,449,-366,366,366,2,1,165,348,256,348,7,1642,1276
1558,6,4.1.72,1,670,3,97,72,169,72,0,169,366,-72,72,72,2,1,283,348,355,348,7,1642,1276
1558,6,5.1.199,0,641,0,26,199,225,199,0,225,366,-199,199,199,2,1,212,348,271,348,7,1642,1276
1558,7,0.1.275,0,670,0,75,275,350,275,0,350,366,-106,178,178,2,2,243,251,319,348,8,1642,1179
1558,7,1.1.169,0,677,1,38,169,207,108,61,207,366,0,72,72,2,2,198,251,234,348,8,1642,1179
1558,7,2.1.169,0,670,0,29,169,198,140,29,198,366,0,72,72,2,2,175,251,207,348,8,1642,1179
1558,7,3.1.366,0,670,0,83,366,449,366,0,449,449,-197,269,269,2,2,165,251,256,348,8,1642,1179
1558,7,4.2.169,1,677,1,46,169,215,169,0,215,366,-169,169,241,3,1,186,275,355,275,8,1642,1179
1558,7,5.1.199,0,670,0,26,199,225,199,0,225,366,-30,102,102,2,2,212,251,271,348,8,1642,1179
1558,8,0.1.275,0,677,0,75,275,350,275,0,350,366,-106,178,347,2,2,243,251,319,348,9,1642,1133
1558,8,1.1.169,0,677,0,38,169,207,108,61,207,366,0,72,241,2,2,198,251,234,348,9,1642,1133
1558,8,2.1.169,0,677,0,29,169,198,140,29,198,366,0,72,241,2,2,175,251,207,348,9,1642,1133
1558,8,3.1.366,0,677,0,83,366,449,366,0,449,449,-197,269,438,2,2,165,251,256,348,9,1642,1133
1558,8,4.3.215,1,677,0,65,215,280,215,0,280,366,-215,215,456,4,1,140,256,355,256,9,1642,1133
1558,8,5.1.199,0,677,0,26,199,225,199,0,225,366,-30,102,271,2,2,212,251,271,348,9,1642,1133
1558,9,0.1.275,0,677,0,75,275,350,275,0,350,366,-106,178,562,2,2,243,251,319,348,10,1642,1068
1558,9,1.1.169,0,677,0,38,169,207,108,61,207,366,0,72,456,2,2,198,251,234,348,10,1642,1068
1558,9,2.1.169,0,677,0,29,169,198,140,29,198,366,0,72,456,2,2,175,251,207,348,10,1642,1068
1558,9,3.1.366,0,677,0,83,366,449,366,0,449,449,-197,269,653,2,2,165,251,256,348,10,1642,1068
1558,9,4.4.280,1,677,0,75,280,355,280,0,355,366,-280,280,736,5,1,75,397,355,397,10,1642,1068
1558,9,5.1.199,0,677,0,26,199,225,199,0,225,366,-30,102,486,2,2,212,251,271,348,10,1642,1068
1558,10,0.1.275,0,677,0,75,275,350,275,0,350,366,-106,178,842,2,2,243,251,319,348,11,1642,993
1558,10,1.1.169,1,677,0,38,169,207,108,61,207,366,0,72,736,2,2,198,251,234,348,11,1642,993
1558,10,2.1.169,0,677,0,29,169,198,140,29,198,366,0,72,736,2,2,175,251,207,348,11,1642,993
1558,10,3.1.366,0,677,0,83,366,449,366,0,449,449,-197,269,933,2,2,165,251,256,348,11,1642,993
1558,10,5.1.199,0,677,0,26,199,225,199,0,225,366,-30,102,766,2,2,212,251,271,348,11,1642,993
1558,11,0.1.275,0,677,0,75,275,350,275,0,350,366,-68,140,804,2,3,243,213,319,348,12,1642,955
1558,11,1.2.215,1,677,0,27,215,242,207,8,242,366,0,169,736,3,2,160,229,234,275,12,1642,955
1558,11,2.1.207,0,677,0,29,207,236,140,67,236,366,0,72,736,2,3,175,213,207,348,12,1642,955
1558,11,3.1.366,0,677,0,83,366,449,366,0,449,449,-159,231,895,2,3,165,213,256,348,12,1642,955
1558,11,5.1.207,0,677,0,26,207,233,199,8,233,366,0,72,736,2,3,212,213,271,348,12,1642,955
1558,12,0.1.275,0,677,0,75,275,350,275,0,350,366,-68,140,804,2,3,243,213,319,348,13,1642,928
1558,12,1.3.280,1,677,0,70,280,350,242,38,350,366,0,215,736,4,2,133,191,234,256,13,1642,928
1558,12,2.1.207,0,677,0,29,207,236,140,67,236,366,0,72,736,2,3,175,213,207,348,13,1642,928
1558,12,3.1.366,0,677,0,83,366,449,366,0,449,449,-159,231,895,2,3,165,213,256,348,13,1642,928
1558,12,5.1.207,0,677,0,26,207,233,199,8,233,366,0,72,736,2,3,212,213,271,348,13,1642,928
1558,13,0.1.275,0,677,0,75,275,350,275,0,350,366,-68,140,804,2,3,243,213,319,348,14,1642,858
1558,13,1.4.355,0,677,0,63,355,418,350,5,418,418,0,280,736,5,2,63,322,234,397,14,1642,858
1558,13,2.1.207,1,677,0,29,207,236,140,67,236,366,0,72,736,2,3,175,213,207,348,14,1642,858
1558,13,3.1.366,0,677,0,83,366,449,366,0,449,449,-159,231,895,2,3,165,213,256,348,14,1642,858
1558,13,5.1.207,0,677,0,26,207,233,199,8,233,366,0,72,736,2,3,212,213,271,348,14,1642,858
1558,14,0.1.275,0,677,0,75,275,350,275,0,350,366,-39,111,775,2,4,243,184,319,348,15,1642,829
1558,14,1.4.355,0,677,0,63,355,418,350,5,418,418,0,280,736,5,2,63,322,234,397,15,1642,829
1558,14,2.2.242,1,677,0,11,242,253,236,6,253,366,0,169,736,3,3,146,202,207,275,15,1642,829
1558,14,3.1.366,0,677,0,83,366,449,366,0,449,449,-130,202,866,2,4,165,184,256,348,15,1642,829
1558,14,5.1.236,0,677,0,26,236,262,199,37,262,366,0,72,736,2,4,212,184,271,348,15,1642,829
1558,15,0.1.275,0,677,0,75,275,350,275,0,350,366,-39,111,775,2,4,243,184,319,348,16,1642,818
1558,15,1.4.355,0,677,0,63,355,418,350,5,418,418,0,280,736,5,2,63,322,234,397,16,1642,818
1558,15,2.3.350,1,677,0,64,350,414,253,97,414,414,0,215,736,4,3,135,121,207,256,16,1642,818
1558,15,3.1.366,0,677,0,83,366,449,366,0,449,449,-130,202,866,2,4,165,184,256,348,16,1642,818
1558,15,5.1.236,0,677,0,26,236,262,199,37,262,366,0,72,736,2,4,212,184,271,348,16,1642,818
1558,16,0.1.275,0,677,0,75,275,350,275,0,350,414,-39,111,775,2,4,243,184,319,348,17,1642,754
1558,16,1.4.355,0,677,0,63,355,418,350,5,418,418,0,280,736,5,2,63,322,234,397,17,1642,754
1558,16,2.4.414,0,736,1,71,414,485,414,0,485,485,-59,339,795,5,2,71,322,207,397,17,1642,754
1558,16,3.1.366,0,677,0,83,366,449,366,0,449,449,-130,202,866,2,4,165,184,256,348,17,1642,754
1558,16,5.1.236,1,677,0,26,236,262,199,37,262,414,0,72,736,2,4,212,184,271,348,17,1642,754
1558,17,0.1.275,0,677,0,75,275,350,275,0,350,414,-13,85,749,2,5,243,158,319,348,18,1642,728
1558,17,1.4.355,0,677,0,63,355,418,350,5,418,418,0,280,736,5,2,63,322,234,397,18,1642,728
1558,17,2.4.414,0,736,1,71,414,485,414,0,485,485,-59,339,795,5,2,71,322,207,397,18,1642,728
1558,17,3.1.366,0,677,0,83,366,449,366,0,449,449,-104,176,840,2,5,165,158,256,348,18,1642,728
1558,17,5.2.262,1,677,0,98,262,360,262,0,360,414,-9,178,745,3,4,186,191,271,275,18,1642,728
1558,18,0.1.275,0,677,0,75,275,350,275,0,350,414,-13,85,758,2,5,243,158,319,348,19,1642,630
1558,18,1.4.355,0,677,0,63,355,418,350,5,418,418,0,280,745,5,2,63,322,234,397,19,1642,630
1558,18,2.4.414,0,736,1,71,414,485,414,0,485,485,-59,339,804,5,2,71,322,207,397,19,1642,630
1558,18,3.1.366,0,677,0,83,366,449,366,0,449,449,-104,176,849,2,5,165,158,256,348,19,1642,630
1558,18,5.3.414,1,677,0,4,414,418,360,54,418,418,0,215,745,4,4,88,57,271,256,19,1642,630
1558,19,0.1.275,1,677,0,75,275,350,275,0,350,418,-13,85,758,2,5,243,158,319,348,20,1642,626
1558,19,1.4.355,0,677,0,63,355,418,350,5,418,418,0,280,745,5,2,63,322,234,397,20,1642,626
1558,19,2.4.414,0,736,1,71,414,485,414,0,485,485,-59,339,804,5,2,71,322,207,397,20,1642,626
1558,19,3.1.366,0,677,0,83,366,449,366,0,449,449,-104,176,849,2,5,165,158,256,348,20,1642,626
1558,19,5.4.418,0,677,0,84,418,502,418,0,502,502,-63,343,808,5,2,84,322,271,397,20,1642,626
1558,20,0.2.360,1,677,0,80,360,440,350,10,440,440,0,178,758,3,5,168,93,319,275,21,1642,551
1558,20,1.4.355,0,677,0,63,355,418,350,5,418,418,0,280,758,5,2,63,322,234,397,21,1642,551
1558,20,2.4.414,0,736,1,71,414,485,414,0,485,485,-59,339,817,5,2,71,322,207,397,21,1642,551
1558,20,3.1.366,0,677,0,83,366,449,366,0,449,449,-16,101,774,2,6,165,83,256,348,21,1642,551
1558,20,5.4.418,0,677,0,84,418,502,418,0,502,502,-63,343,821,5,2,84,322,271,397,21,1642,551
1558,21,0.3.440,1,677,0,36,440,476,440,0,476,476,-22,237,780,4,5,88,53,319,256,22,1642,471
1558,21,1.4.355,0,677,0,63,355,418,350,5,418,440,0,280,758,5,2,63,322,234,397,22,1642,471
1558,21,2.4.414,0,736,1,71,414,485,414,0,485,485,-59,339,817,5,2,71,322,207,397,22,1642,471
1558,21,3.1.366,0,677,0,83,366,449,366,0,449,449,-16,101,774,2,6,165,83,256,348,22,1642,471
1558,21,5.4.418,0,677,0,84,418,502,418,0,502,502,-63,343,821,5,2,84,322,271,397,22,1642,471
1558,22,0.4.476,0,735,1,52,476,528,476,0,528,528,-121,401,901,5,2,52,322,319,397,23,1642,435
1558,22,1.4.355,0,677,0,63,355,418,350,5,418,476,0,280,780,5,2,63,322,234,397,23,1642,435
1558,22,2.4.414,0,736,2,71,414,485,414,0,485,485,-59,339,839,5,2,71,322,207,397,23,1642,435
1558,22,3.1.366,1,677,0,83,366,449,366,0,449,476,-16,101,796,2,6,165,83,256,348,23,1642,435
1558,22,5.4.418,0,677,0,84,418,502,418,0,502,502,-63,343,843,5,2,84,322,271,397,23,1642,435
1558,23,0.4.476,0,735,1,52,476,528,476,0,528,528,-121,401,917,5,2,52,322,319,397,24,1642,352
1558,23,1.4.355,0,677,0,63,355,418,350,5,418,476,0,280,796,5,2,63,322,234,397,24,1642,352
1558,23,2.4.414,0,736,2,71,414,485,414,0,485,485,-59,339,855,5,2,71,322,207,397,24,1642,352
1558,23,3.2.449,1,677,0,13,449,462,449,0,462,476,-9,187,805,3,6,82,13,256,275,24,1642,352
1558,23,5.4.418,0,677,0,84,418,502,418,0,502,502,-63,343,859,5,2,84,322,271,397,24,1642,352
1558,24,0.4.476,0,735,1,52,476,528,476,0,528,528,-121,401,926,5,2,52,322,319,397,25,1642,339
1558,24,1.4.355,0,677,0,63,355,418,350,5,418,476,0,280,805,5,2,63,322,234,397,25,1642,339
1558,24,2.4.414,0,736,2,71,414,485,414,0,485,485,-59,339,864,5,2,71,322,207,397,25,1642,339
1558,24,3.3.476,1,677,0,17,476,493,462,14,493,493,0,237,805,4,6,69,17,256,256,25,1642,339
1558,24,5.4.418,0,677,0,84,418,502,418,0,502,502,-63,343,868,5,2,84,322,271,397,25,1642,339
1558,25,0.4.476,0,735,2,52,476,528,476,0,528,528,-121,401,926,5,2,52,322,319,397,26,1642,322
1558,25,1.4.355,1,677,0,63,355,418,350,5,418,493,0,280,805,5,2,63,322,234,397,26,1642,322
1558,25,2.4.414,0,736,3,71,414,485,414,0,485,493,-59,339,864,5,2,71,322,207,397,26,1642,322
1558,25,3.4.493,0,681,1,52,493,545,493,0,545,545,-138,418,943,5,2,52,322,256,397,26,1642,322
1558,25,5.4.418,0,677,0,84,418,502,418,0,502,502,-63,343,868,5,2,84,322,271,397,26,1642,322
1558,26,0.4.476,0,735,2,52,476,528,476,0,528,528,-58,338,863,5,3,52,259,319,397,27,1642,259
1558,26,2.4.418,0,677,0,71,418,489,414,4,489,493,0,280,805,5,3,71,259,207,397,27,1642,259
1558,26,3.4.493,0,681,1,52,493,545,493,0,545,545,-75,355,880,5,3,52,259,256,397,27,1642,259
1558,26,5.4.418,1,677,0,84,418,502,418,0,502,502,0,280,805,5,3,84,259,271,397,27,1642,259
1558,27,0.4.502,1,677,0,52,502,554,476,26,554,554,0,280,805,5,4,52,175,319,397,28,1642,175
1558,27,2.4.502,0,677,0,71,502,573,414,88,573,573,0,280,805,5,4,71,175,207,397,28,1642,175
1558,27,3.4.502,0,677,0,52,502,554,493,9,554,554,0,280,805,5,4,52,175,256,397,28,1642,175
1558,28,2.4.554,1,677,0,71,554,625,414,140,625,625,0,280,805,5,5,71,123,207,397,29,1642,123
1558,28,3.4.554,0,677,0,52,554,606,493,61,606,606,0,280,805,5,5,52,123,256,397,29,1642,123
1558,29,3.4.625,1,677,0,52,625,677,493,132,677,677,0,280,805,5,6,52,52,256,397,30,1642,52
1559,0,0.0.0,0,577,3,89,0,89,0,0,89,89,0,0,0,1,1,264,380,264,380,1,1510,1510
1559,0,1.0.0,0,539,0,12,0,12,0,0,12,12,0,0,0,1,1,135,380,135,380,1,1510,1510
1559,0,2.0.0,0,555,1,77,0,77,0,0,77,77,0,0,0,1,1,232,380,232,380,1,1510,1510
1559,0,3.0.0,1,539,0,45,0,45,0,0,45,45,0,0,0,1,1,314,380,314,380,1,1510,1510
1559,0,4.0.0,0,564,2,94,0,94,0,0,94,94,0,0,0,1,1,293,380,293,380,1,1510,1510
1559,0,5.0.0,0,539,0,63,0,63,0,0,63,63,0,0,0,1,1,272,380,272,380,1,1510,1510
1559,1,0.0.45,0,543,1,89,45,134,0,45,134,134,0,0,0,1,2,264,335,264,380,2,1510,1465
1559,1,1.0.45,0,539,0,12,45,57,0,45,57,57,0,0,0,1,2,135,335,135,380,2,1510,1465
1559,1,2.0.45,0,555,2,77,45,122,0,45,122,122,0,0,0,1,2,232,335,232,380,2,1510,1465
1559,1,3.1.45,1,539,0,22,45,67,45,0,67,67,-45,45,45,2,1,269,152,314,152,2,1510,1465
1559,1,4.0.45,0,555,2,94,45,139,0,45,139,139,0,0,0,1,2,293,335,293,380,2,1510,1465
1559,1,5.0.45,0,539,0,63,45,108,0,45,108,108,0,0,0,1,2,272,335,272,380,2,1510,1465
1559,2,0.0.45,0,543,1,89,45,134,0,45,134,134,0,0,45,1,2,264,335,264,380,3,1510,1443
1559,2,1.0.45,0,539,0,12,45,57,0,45,57,67,0,0,45,1,2,135,335,135,380,3,1510,1443
1559,2,2.0.45,0,555,2,77,45,122,0,45,122,122,0,0,45,1,2,232,335,232,380,3,1510,1443
1559,2,3.2.67,1,539,0,79,67,146,67,0,146,146,-67,67,112,3,1,247,341,314,341,3,1510,1443
1559,2,4.0.45,0,555,2,94,45,139,0,45,139,139,0,0,45,1,2,293,335,293,380,3,1510,1443
1559,2,5.0.45,0,539,0,63,45,108,0,45,108,108,0,0,45,1,2,272,335,272,380,3,1510,1443
1559,3,0.0.45,0,543,1,89,45,134,0,45,134,146,0,0,112,1,2,264,335,264,380,4,1510,1364
1559,3,1.0.45,0,539,0,12,45,57,0,45,57,146,0,0,112,1,2,135,335,135,380,4,1510,1364
1559,3,2.0.45,0,555,3,77,45,122,0,45,122,146,0,0,112,1,2,232,335,232,380,4,1510,1364
1559,3,3.3.146,1,548,2,75,146,221,146,0,221,221,-146,146,258,4,1,168,310,314,310,4,1510,1364
1559,3,4.0.45,0,555,3,94,45,139,0,45,139,146,0,0,112,1,2,293,335,293,380,4,1510,1364
1559,3,5.0.45,0,539,0,63,45,108,0,45,108,146,0,0,112,1,2,272,335,272,380,4,1510,1364
1559,4,0.0.45,0,548,0,89,45,134,0,45,134,221,0,0,258,1,2,264,335,264,380,5,1510,1289
1559,4,1.0.45,0,548,0,12,45,57,0,45,57,221,0,0,258,1,2,135,335,135,380,5,1510,1289
1559,4,2.0.45,0,555,1,77,45,122,0,45,122,221,0,0,258,1,2,232,335,232,380,5,1510,1289
1559,4,3.4.221,1,548,0,93,221,314,221,0,314,314,-221,221,479,5,1,93,327,314,327,5,1510,1289
1559,4,4.0.45,0,555,1,94,45,139,0,45,139,221,0,0,258,1,2,293,335,293,380,5,1510,1289
1559,4,5.0.45,0,548,0,63,45,108,0,45,108,221,0,0,258,1,2,272,335,272,380,5,1510,1289
1559,5,0.0.45,0,548,0,89,45,134,0,45,134,314,0,0,479,1,2,264,335,264,380,6,1510,1196
1559,5,1.0.45,0,548,0,12,45,57,0,45,57,314,0,0,479,1,2,135,335,135,380,6,1510,1196
1559,5,2.0.45,0,555,1,77,45,122,0,45,122,314,0,0,479,1,2,232,335,232,380,6,1510,1196
1559,5,4.0.45,0,555,1,94,45,139,0,45,139,314,0,0,479,1,2,293,335,293,380,6,1510,1196
1559,5,5.0.45,1,548,0,63,45,108,0,45,108,314,0,0,479,1,2,272,335,272,380,6,1510,1196
1559,6,0.0.108,0,548,0,89,108,197,0,108,197,314,0,0,479,1,3,264,272,264,380,7,1510,1133
1559,6,1.0.108,0,548,0,12,108,120,0,108,120,314,0,0,479,1,3,135,272,135,380,7,1510,1133
1559,6,2.0.108,0,555,1,77,108,185,0,108,185,314,0,0,479,1,3,232,272,232,380,7,1510,1133
1559,6,4.0.108,0,555,1,94,108,202,0,108,202,314,0,0,479,1,3,293,272,293,380,7,1510,1133
1559,6,5.1.108,1,548,0,9,108,117,108,0,117,314,-41,86,520,2,2,209,130,272,152,7,1510,1133
1559,7,0.0.108,0,548,0,89,108,197,0,108,197,314,0,0,520,1,3,264,272,264,380,8,1510,1124
1559,7,1.0.108,0,548,0,12,108,120,0,108,120,314,0,0,520,1,3,135,272,135,380,8,1510,1124
1559,7,2.0.108,0,555,1,77,108,185,0,108,185,314,0,0,520,1,3,232,272,232,380,8,1510,1124
1559,7,4.0.108,0,555,1,94,108,202,0,108,202,314,0,0,520,1,3,293,272,293,380,8,1510,1124
1559,7,5.2.146,1,548,0,37,146,183,117,29,183,314,0,67,520,3,2,200,262,272,341,8,1510,1124
1559,8,0.0.108,0,548,0,89,108,197,0,108,197,314,0,0,520,1,3,264,272,264,380,9,1510,1087
1559,8,1.0.108,0,548,0,12,108,120,0,108,120,314,0,0,520,1,3,135,272,135,380,9,1510,1087
1559,8,2.0.108,0,555,1,77,108,185,0,108,185,314,0,0,520,1,3,232,272,232,380,9,1510,1087
1559,8,4.0.108,0,555,1,94,108,202,0,108,202,314,0,0,520,1,3,293,272,293,380,9,1510,1087
1559,8,5.3.221,1,548,0,88,221,309,183,38,309,314,0,146,520,4,2,163,235,272,310,9,1510,1087
1559,9,0.0.108,0,548,0,89,108,197,0,108,197,314,0,0,520,1,3,264,272,264,380,10,1510,999
1559,9,1.0.108,0,548,0,12,108,120,0,108,120,314,0,0,520,1,3,135,272,135,380,10,1510,999
1559,9,2.0.108,0,555,1,77,108,185,0,108,185,314,0,0,520,1,3,232,272,232,380,10,1510,999
1559,9,4.0.108,0,555,1,94,108,202,0,108,202,314,0,0,520,1,3,293,272,293,380,10,1510,999
1559,9,5.4.314,1,548,0,75,314,389,309,5,389,389,0,221,520,5,2,75,234,272,327,10,1510,999
1559,10,0.0.108,0,548,0,89,108,197,0,108,197,389,0,0,520,1,3,264,272,264,380,11,1510,924
1559,10,1.0.108,1,548,0,12,108,120,0,108,120,389,0,0,520,1,3,135,272,135,380,11,1510,924
1559,10,2.0.108,0,555,1,77,108,185,0,108,185,389,0,0,520,1,3,232,272,232,380,11,1510,924
1559,10,4.0.108,0,555,1,94,108,202,0,108,202,389,0,0,520,1,3,293,272,293,380,11,1510,924
1559,11,0.0.120,0,548,0,89,120,209,0,120,209,389,0,0,520,1,4,264,260,264,380,12,1510,912
1559,11,1.1.120,1,548,0,6,120,126,120,0,126,389,-3,89,523,2,3,123,121,135,152,12,1510,912
1559,11,2.0.120,0,555,1,77,120,197,0,120,197,389,0,0,520,1,4,232,260,232,380,12,1510,912
1559,11,4.0.120,0,555,1,94,120,214,0,120,214,389,0,0,520,1,4,293,260,293,380,12,1510,912
1559,12,0.0.120,0,548,0,89,120,209,0,120,209,389,0,0,523,1,4,264,260,264,380,13,1510,906
1559,12,1.2.183,1,548,0,32,183,215,126,57,215,389,0,67,523,3,3,117,225,135,341,13,1510,906
1559,12,2.0.120,0,555,1,77,120,197,0,120,197,389,0,0,523,1,4,232,260,232,380,13,1510,906
1559,12,4.0.120,0,555,1,94,120,214,0,120,214,389,0,0,523,1,4,293,260,293,380,13,1510,906
1559,13,0.0.120,0,548,0,89,120,209,0,120,209,389,0,0,523,1,4,264,260,264,380,14,1510,874
1559,13,1.3.309,1,548,0,13,309,322,215,94,322,389,0,146,523,4,3,85,147,135,310,14,1510,874
1559,13,2.0.120,0,555,1,77,120,197,0,120,197,389,0,0,523,1,4,232,260,232,380,14,1510,874
1559,13,4.0.120,0,555,1,94,120,214,0,120,214,389,0,0,523,1,4,293,260,293,380,14,1510,874
1559,14,0.0.120,0,548,0,89,120,209,0,120,209,389,0,0,523,1,4,264,260,264,380,15,1510,861
1559,14,1.4.389,1,548,0,72,389,461,322,67,461,461,0,221,523,5,3,72,159,135,327,15,1510,861
1559,14,2.0.120,0,555,1,77,120,197,0,120,197,389,0,0,523,1,4,232,260,232,380,15,1510,861
1559,14,4.0.120,0,555,1,94,120,214,0,120,214,389,0,0,523,1,4,293,260,293,380,15,1510,861
1559,15,0.0.120,0,548,0,89,120,209,0,120,209,461,0,0,523,1,4,264,260,264,380,16,1510,789
1559,15,2.0.120,0,555,1,77,120,197,0,120,197,461,0,0,523,1,4,232,260,232,380,16,1510,789
1559,15,4.0.120,1,555,1,94,120,214,0,120,214,461,0,0,523,1,4,293,260,293,380,16,1510,789
1559,16,0.0.214,0,563,1,89,214,303,0,214,303,461,0,0,523,1,5,264,166,264,380,17,1510,695
1559,16,2.0.214,0,555,0,77,214,291,0,214,291,461,0,0,523,1,5,232,166,232,380,17,1510,695
1559,16,4.1.214,1,555,0,49,214,263,214,0,263,461,-88,177,611,2,4,199,115,293,152,17,1510,695
1559,17,0.0.214,0,563,1,89,214,303,0,214,303,461,0,0,611,1,5,264,166,264,380,18,1510,646
1559,17,2.0.214,0,555,0,77,214,291,0,214,291,461,0,0,611,1,5,232,166,232,380,18,1510,646
1559,17,4.2.263,1,555,0,47,263,310,263,0,310,461,-48,115,659,3,4,150,193,293,341,18,1510,646
1559,18,0.0.214,0,563,1,89,214,303,0,214,303,461,0,0,659,1,5,264,166,264,380,19,1510,599
1559,18,2.0.214,0,555,0,77,214,291,0,214,291,461,0,0,659,1,5,232,166,232,380,19,1510,599
1559,18,4.3.322,1,555,0,58,322,380,310,12,380,461,0,146,659,4,4,103,134,293,310,19,1510,599
1559,19,0.0.214,0,563,1,89,214,303,0,214,303,461,0,0,659,1,5,264,166,264,380,20,1510,541
1559,19,2.0.214,0,555,0,77,214,291,0,214,291,461,0,0,659,1,5,232,166,232,380,20,1510,541
1559,19,4.4.461,1,555,0,45,461,506,380,81,506,506,0,221,659,5,4,45,87,293,327,20,1510,541
1559,20,0.0.214,1,563,1,89,214,303,0,214,303,506,0,0,659,1,5,264,166,264,380,21,1510,496
1559,20,2.0.214,0,555,0,77,214,291,0,214,291,506,0,0,659,1,5,232,166,232,380,21,1510,496
1559,21,0.1.303,0,563,0,44,303,347,303,0,347,506,-40,217,699,2,5,175,66,264,152,22,1510,407
1559,21,2.0.303,1,563,0,77,303,380,0,303,380,506,0,0,659,1,6,232,77,232,380,22,1510,407
1559,22,0.1.303,1,563,0,44,303,347,303,0,347,506,-40,217,699,2,5,175,66,264,152,23,1510,330
1559,22,2.1.380,0,563,0,22,380,402,380,0,402,506,-117,294,776,2,5,155,66,232,152,23,1510,330
1559,23,0.2.347,0,563,0,83,347,430,347,0,430,506,-37,152,736,3,5,131,146,264,341,24,1510,286
1559,23,2.1.380,1,563,0,22,380,402,380,0,402,506,-33,250,732,2,6,155,22,232,152,24,1510,286
1559,24,0.2.347,1,563,0,83,347,430,347,0,430,506,-37,152,769,3,5,131,146,264,341,25,1510,264
1559,24,2.2.402,0,596,1,63,402,465,402,0,465,506,-92,207,824,3,5,133,146,232,341,25,1510,264
1559,25,0.3.430,1,563,0,43,430,473,430,0,473,506,-50,196,819,4,5,48,76,264,310,26,1510,181
1559,25,2.2.430,0,563,0,63,430,493,402,28,493,506,0,152,769,3,6,133,63,232,341,26,1510,181
1559,26,0.4.506,1,563,0,5,506,511,473,33,511,511,0,221,819,5,5,5,42,264,327,27,1510,138
1559,26,2.2.430,0,563,0,63,430,493,402,28,493,506,0,152,819,3,6,133,63,232,341,27,1510,138
1559,27,2.2.430,1,563,0,63,430,493,402,28,493,511,0,152,819,3,6,133,63,232,341,28,1510,133
1559,28,2.3.493,1,563,0,33,493,526,493,0,526,526,-20,216,839,4,6,70,33,232,310,29,1510,70
1559,29,2.4.526,1,563,0,37,526,563,526,0,563,563,-15,236,854,5,6,37,37,232,327,30,1510,37
1560,0,0.0.0,1,511,0,3,0,3,0,0,3,3,0,0,0,1,1,207,297,207,297,1,1384,1384
1560,0,1.0.0,0,525,3,87,0,87,0,0,87,87,0,0,0,1,1,333,297,333,297,1,1384,1384
1560,0,2.0.0,0,532,4,24,0,24,0,0,24,24,0,0,0,1,1,62,297,62,297,1,1384,1384
1560,0,3.0.0,0,578,5,98,0,98,0,0,98,98,0,0,0,1,1,275,297,275,297,1,1384,1384
1560,0,4.0.0,0,512,1,17,0,17,0,0,17,17,0,0,0,1,1,134,297,134,297,1,1384,1384
1560,0,5.0.0,0,523,2,68,0,68,0,0,68,68,0,0,0,1,1,373,297,373,297,1,1384,1384
1560,1,0.1.3,1,511,0,12,3,15,3,0,15,15,-3,3,3,2,1,204,255,207,255,2,1384,1381
1560,1,1.0.3,0,518,2,87,3,90,0,3,90,90,0,0,0,1,2,333,294,333,297,2,1384,1381
1560,1,2.0.3,0,532,3,24,3,27,0,3,27,27,0,0,0,1,2,62,294,62,297,2,1384,1381
1560,1,3.0.3,0,574,4,98,3,101,0,3,101,101,0,0,0,1,2,275,294,275,297,2,1384,1381
1560,1,4.0.3,0,512,1,17,3,20,0,3,20,20,0,0,0,1,2,134,294,134,297,2,1384,1381
1560,1,5.0.3,0,511,0,68,3,71,0,3,71,71,0,0,0,1,2,373,294,373,297,2,1384,1381
1560,2,0.2.15,1,511,0,86,15,101,15,0,101,101,-15,15,18,3,1,192,310,207,310,3,1384,1369
1560,2,1.0.3,0,518,2,87,3,90,0,3,90,90,0,0,3,1,2,333,294,333,297,3,1384,1369
1560,2,2.0.3,0,532,3,24,3,27,0,3,27,27,0,0,3,1,2,62,294,62,297,3,1384,1369
1560,2,3.0.3,0,574,4,98,3,101,0,3,101,101,0,0,3,1,2,275,294,275,297,3,1384,1369
1560,2,4.0.3,0,512,1,17,3,20,0,3,20,20,0,0,3,1,2,134,294,134,297,3,1384,1369
1560,2,5.0.3,0,511,0,68,3,71,0,3,71,71,0,0,3,1,2,373,294,373,297,3,1384,1369
1560,3,0.3.101,1,511,0,49,101,150,101,0,150,150,-101,101,119,4,1,106,264,207,264,4,1384,1283
1560,3,1.0.3,0,518,2,87,3,90,0,3,90,101,0,0,18,1,2,333,294,333,297,4,1384,1283
1560,3,2.0.3,0,532,3,24,3,27,0,3,27,101,0,0,18,1,2,62,294,62,297,4,1384,1283
1560,3,3.0.3,0,574,4,98,3,101,0,3,101,101,0,0,18,1,2,275,294,275,297,4,1384,1283
1560,3,4.0.3,0,512,1,17,3,20,0,3,20,101,0,0,18,1,2,134,294,134,297,4,1384,1283
1560,3,5.0.3,0,511,0,68,3,71,0,3,71,101,0,0,18,1,2,373,294,373,297,4,1384,1283
1560,4,0.4.150,1,511,0,57,150,207,150,0,207,207,-150,150,269,5,1,57,258,207,258,5,1384,1234
1560,4,1.0.3,0,518,2,87,3,90,0,3,90,150,0,0,119,1,2,333,294,333,297,5,1384,1234
1560,4,2.0.3,0,532,3,24,3,27,0,3,27,150,0,0,119,1,2,62,294,62,297,5,1384,1234
1560,4,3.0.3,0,574,4,98,3,101,0,3,101,150,0,0,119,1,2,275,294,275,297,5,1384,1234
1560,4,4.0.3,0,512,1,17,3,20,0,3,20,150,0,0,119,1,2,134,294,134,297,5,1384,1234
1560,4,5.0.3,0,511,0,68,3,71,0,3,71,150,0,0,119,1,2,373,294,373,297,5,1384,1234
1560,5,1.0.3,0,518,2,87,3,90,0,3,90,207,0,0,269,1,2,333,294,333,297,6,1384,1177
1560,5,2.0.3,0,532,3,24,3,27,0,3,27,207,0,0,269,1,2,62,294,62,297,6,1384,1177
1560,5,3.0.3,0,574,4,98,3,101,0,3,101,207,0,0,269,1,2,275,294,275,297,6,1384,1177
1560,5,4.0.3,0,512,1,17,3,20,0,3,20,207,0,0,269,1,2,134,294,134,297,6,1384,1177
1560,5,5.0.3,1,511,0,68,3,71,0,3,71,207,0,0,269,1,2,373,294,373,297,6,1384,1177
1560,6,1.0.71,0,511,0,87,71,158,0,71,158,207,0,0,269,1,3,333,226,333,297,7,1384,1109
1560,6,2.0.71,0,511,0,24,71,95,0,71,95,207,0,0,269,1,3,62,226,62,297,7,1384,1109
1560,6,3.0.71,0,521,1,98,71,169,0,71,169,207,0,0,269,1,3,275,226,275,297,7,1384,1109
1560,6,4.0.71,0,511,0,17,71,88,0,71,88,207,0,0,269,1,3,134,226,134,297,7,1384,1109
1560,6,5.1.71,1,511,0,91,71,162,71,0,162,207,-56,59,325,2,2,305,243,373,255,7,1384,1109
1560,7,1.0.71,0,511,0,87,71,158,0,71,158,207,0,0,325,1,3,333,226,333,297,8,1384,1018
1560,7,2.0.71,0,511,0,24,71,95,0,71,95,207,0,0,325,1,3,62,226,62,297,8,1384,1018
1560,7,3.0.71,0,521,1,98,71,169,0,71,169,207,0,0,325,1,3,275,226,275,297,8,1384,1018
1560,7,4.0.71,0,511,0,17,71,88,0,71,88,207,0,0,325,1,3,134,226,134,297,8,1384,1018
1560,7,5.2.162,1,511,0,75,162,237,162,0,237,237,-61,76,386,3,2,214,224,373,310,8,1384,1018
1560,8,1.0.71,0,511,0,87,71,158,0,71,158,237,0,0,386,1,3,333,226,333,297,9,1384,943
1560,8,2.0.71,0,511,0,24,71,95,0,71,95,237,0,0,386,1,3,62,226,62,297,9,1384,943
1560,8,3.0.71,0,521,1,98,71,169,0,71,169,237,0,0,386,1,3,275,226,275,297,9,1384,943
1560,8,4.0.71,0,511,0,17,71,88,0,71,88,237,0,0,386,1,3,134,226,134,297,9,1384,943
1560,8,5.3.237,1,511,0,73,237,310,237,0,310,310,-87,188,473,4,2,139,215,373,264,9,1384,943
1560,9,1.0.71,0,511,0,87,71,158,0,71,158,310,0,0,473,1,3,333,226,333,297,10,1384,870
1560,9,2.0.71,0,511,0,24,71,95,0,71,95,310,0,0,473,1,3,62,226,62,297,10,1384,870
1560,9,3.0.71,0,521,1,98,71,169,0,71,169,310,0,0,473,1,3,275,226,275,297,10,1384,870
1560,9,4.0.71,0,511,0,17,71,88,0,71,88,310,0,0,473,1,3,134,226,134,297,10,1384,870
1560,9,5.4.310,1,511,0,66,310,376,310,0,376,376,-103,253,576,5,2,66,201,373,258,10,1384,870
1560,10,1.0.71,1,511,0,87,71,158,0,71,158,376,0,0,576,1,3,333,226,333,297,11,1384,804
1560,10,2.0.71,0,511,0,24,71,95,0,71,95,376,0,0,576,1,3,62,226,62,297,11,1384,804
1560,10,3.0.71,0,521,1,98,71,169,0,71,169,376,0,0,576,1,3,275,226,275,297,11,1384,804
1560,10,4.0.71,0,511,0,17,71,88,0,71,88,376,0,0,576,1,3,134,226,134,297,11,1384,804
1560,11,1.1.162,0,511,0,74,162,236,158,4,236,376,0,59,576,2,3,246,152,333,255,12,1384,717
1560,11,2.0.158,0,511,0,24,158,182,0,158,182,376,0,0,576,1,4,62,139,62,297,12,1384,717
1560,11,3.0.158,0,511,0,98,158,256,0,158,256,376,0,0,576,1,4,275,139,275,297,12,1384,717
1560,11,4.0.158,1,511,0,17,158,175,0,158,175,376,0,0,576,1,4,134,139,134,297,12,1384,717
1560,12,1.1.162,0,511,0,74,162,236,158,4,236,376,0,59,576,2,3,246,152,333,255,13,1384,700
1560,12,2.0.175,0,511,0,24,175,199,0,175,199,376,0,0,576,1,5,62,122,62,297,13,1384,700
1560,12,3.0.175,1,511,0,98,175,273,0,175,273,376,0,0,576,1,5,275,122,275,297,13,1384,700
1560,12,4.1.175,0,511,0,2,175,177,175,0,177,376,-13,72,589,2,3,117,152,134,255,13,1384,700
1560,13,1.1.162,0,511,0,74,162,236,158,4,236,376,0,59,576,2,3,246,152,333,255,14,1384,602
1560,13,2.0.273,1,511,0,24,273,297,0,273,297,376,0,0,576,1,6,62,24,62,297,14,1384,602
1560,13,3.1.273,0,511,0,60,273,333,273,0,333,376,-111,170,687,2,3,177,152,275,255,14,1384,602
1560,13,4.1.175,0,511,0,2,175,177,175,0,177,376,-13,72,589,2,3,117,152,134,255,14,1384,602
1560,14,1.1.162,1,511,0,74,162,236,158,4,236,376,0,59,576,2,3,246,152,333,255,15,1384,578
1560,14,2.1.297,0,511,0,16,297,313,297,0,313,376,-135,194,711,2,3,38,152,62,255,15,1384,578
1560,14,3.1.273,0,511,0,60,273,333,273,0,333,376,-111,170,687,2,3,177,152,275,255,15,1384,578
1560,14,4.1.175,0,511,0,2,175,177,175,0,177,376,-13,72,589,2,3,117,152,134,255,15,1384,578
1560,15,1.2.237,1,511,0,37,237,274,236,1,274,376,0,76,576,3,3,172,149,333,310,16,1384,504
1560,15,2.1.297,0,511,0,16,297,313,297,0,313,376,-61,120,637,2,4,38,78,62,255,16,1384,504
1560,15,3.1.273,0,511,0,60,273,333,273,0,333,376,-37,96,613,2,4,177,78,275,255,16,1384,504
1560,15,4.1.236,0,511,0,2,236,238,175,61,238,376,0,59,576,2,4,117,78,134,255,16,1384,504
1560,16,1.3.310,1,511,0,54,310,364,274,36,364,376,0,188,576,4,3,135,142,333,264,17,1384,467
1560,16,2.1.297,0,511,0,16,297,313,297,0,313,376,-61,120,637,2,4,38,78,62,255,17,1384,467
1560,16,3.1.273,0,511,0,60,273,333,273,0,333,376,-37,96,613,2,4,177,78,275,255,17,1384,467
1560,16,4.1.236,0,511,0,2,236,238,175,61,238,376,0,59,576,2,4,117,78,134,255,17,1384,467
1560,17,1.4.376,1,511,0,81,376,457,364,12,457,457,0,253,576,5,3,81,135,333,258,18,1384,413
1560,17,2.1.297,0,511,0,16,297,313,297,0,313,376,-61,120,637,2,4,38,78,62,255,18,1384,413
1560,17,3.1.273,0,511,0,60,273,333,273,0,333,376,-37,96,613,2,4,177,78,275,255,18,1384,413
1560,17,4.1.236,0,511,0,2,236,238,175,61,238,376,0,59,576,2,4,117,78,134,255,18,1384,413
1560,18,2.1.297,0,511,0,16,297,313,297,0,313,457,-61,120,637,2,4,38,78,62,255,19,1384,332
1560,18,3.1.273,0,511,0,60,273,333,273,0,333,457,-37,96,613,2,4,177,78,275,255,19,1384,332
1560,18,4.1.236,1,511,0,2,236,238,175,61,238,457,0,59,576,2,4,117,78,134,255,19,1384,332
1560,19,2.1.297,0,511,0,16,297,313,297,0,313,457,-59,118,635,2,5,38,76,62,255,20,1384,330
1560,19,3.1.273,0,511,0,60,273,333,273,0,333,457,-35,94,611,2,5,177,76,275,255,20,1384,330
1560,19,4.2.274,1,511,0,48,274,322,238,36,322,457,0,76,576,3,4,115,112,134,310,20,1384,330
1560,20,2.1.297,0,511,0,16,297,313,297,0,313,457,-59,118,635,2,5,38,76,62,255,21,1384,282
1560,20,3.1.273,0,511,0,60,273,333,273,0,333,457,-35,94,611,2,5,177,76,275,255,21,1384,282
1560,20,4.3.364,1,511,0,51,364,415,322,42,415,457,0,188,576,4,4,67,88,134,264,21,1384,282
1560,21,2.1.297,0,511,0,16,297,313,297,0,313,457,-59,118,635,2,5,38,76,62,255,22,1384,231
1560,21,3.1.273,0,511,0,60,273,333,273,0,333,457,-35,94,611,2,5,177,76,275,255,22,1384,231
1560,21,4.4.457,1,511,0,16,457,473,415,42,473,473,0,253,576,5,4,16,54,134,258,22,1384,231
1560,22,2.1.297,0,511,0,16,297,313,297,0,313,473,-59,118,635,2,5,38,76,62,255,23,1384,215
1560,22,3.1.273,1,511,0,60,273,333,273,0,333,473,-35,94,611,2,5,177,76,275,255,23,1384,215
1560,23,2.1.333,0,511,0,16,333,349,297,36,349,473,0,94,611,2,6,38,16,62,255,24,1384,155
1560,23,3.2.333,1,511,0,47,333,380,333,0,380,473,-11,87,622,3,5,117,64,275,310,24,1384,155
1560,24,2.1.333,0,511,0,16,333,349,297,36,349,473,0,94,622,2,6,38,16,62,255,25,1384,108
1560,24,3.3.415,1,511,0,35,415,450,380,35,450,473,0,188,622,4,5,70,37,275,264,25,1384,108
1560,25,2.1.333,0,511,0,16,333,349,297,36,349,473,0,94,622,2,6,38,16,62,255,26,1384,73
1560,25,3.4.473,1,511,0,35,473,508,450,23,508,508,0,253,622,5,5,35,38,275,258,26,1384,73
1560,26,2.1.333,1,511,0,16,333,349,297,36,349,508,0,94,622,2,6,38,16,62,255,27,1384,38
1560,27,2.2.380,1,511,0,17,380,397,349,31,397,508,0,87,622,3,6,22,17,62,310,28,1384,22
1560,28,2.3.450,1,511,0,2,450,452,397,53,452,508,0,188,622,4,6,5,2,62,264,29,1384,5
1560,29,2.4.508,1,511,0,3,508,511,452,56,511,511,0,253,622,5,6,3,3,62,258,30,1384,3
1561,0,0.0.0,1,599,1,16,0,16,0,0,16,16,0,0,0,1,1,251,310,251,310,1,1743,1743
1561,0,1.0.0,0,627,3,63,0,63,0,0,63,63,0,0,0,1,1,332,310,332,310,1,1743,1743
1561,0,2.0.0,0,617,2,69,0,69,0,0,69,69,0,0,0,1,1,284,310,284,310,1,1743,1743
1561,0,3.0.0,0,634,4,51,0,51,0,0,51,51,0,0,0,1,1,332,310,332,310,1,1743,1743
1561,0,4.0.0,0,583,0,38,0,38,0,0,38,38,0,0,0,1,1,269,310,269,310,1,1743,1743
1561,0,5.0.0,0,627,3,73,0,73,0,0,73,73,0,0,0,1,1,275,310,275,310,1,1743,1743
1561,1,0.1.16,0,628,1,79,16,95,16,0,95,95,-16,16,16,2,1,235,355,251,355,2,1743,1727
1561,1,1.0.16,0,643,2,63,16,79,0,16,79,79,0,0,0,1,2,332,294,332,310,2,1743,1727
1561,1,2.0.16,0,628,1,69,16,85,0,16,85,85,0,0,0,1,2,284,294,284,310,2,1743,1727
1561,1,3.0.16,1,650,3,51,16,67,0,16,67,67,0,0,0,1,2,332,294,332,310,2,1743,1727
1561,1,4.0.16,0,599,0,38,16,54,0,16,54,54,0,0,0,1,2,269,294,269,310,2,1743,1727
1561,1,5.0.16,0,643,2,73,16,89,0,16,89,89,0,0,0,1,2,275,294,275,310,2,1743,1727
1561,2,0.1.16,0,650,0,79,16,95,16,0,95,95,-16,16,16,2,1,235,355,251,355,3,1743,1676
1561,2,1.0.67,0,657,1,63,67,130,0,67,130,130,0,0,0,1,3,332,243,332,310,3,1743,1676
1561,2,2.0.67,0,657,1,69,67,136,0,67,136,136,0,0,0,1,3,284,243,284,310,3,1743,1676
1561,2,3.1.67,0,657,1,98,67,165,67,0,165,165,-67,67,67,2,1,281,355,332,355,3,1743,1676
1561,2,4.0.67,1,650,0,38,67,105,0,67,105,105,0,0,0,1,3,269,243,269,310,3,1743,1676
1561,2,5.0.67,0,657,1,73,67,140,0,67,140,140,0,0,0,1,3,275,243,275,310,3,1743,1676
1561,3,0.1.16,0,650,0,79,16,95,16,0,95,105,-16,16,16,2,1,235,355,251,355,4,1743,1638
1561,3,1.0.105,1,650,0,63,105,168,0,105,168,168,0,0,0,1,4,332,205,332,310,4,1743,1638
1561,3,2.0.105,0,657,1,69,105,174,0,105,174,174,0,0,0,1,4,284,205,284,310,4,1743,1638
1561,3,3.1.67,0,657,1,98,67,165,67,0,165,165,-67,67,67,2,1,281,355,332,355,4,1743,1638
1561,3,4.1.105,0,650,0,53,105,158,105,0,158,158,-105,105,105,2,1,231,355,269,355,4,1743,1638
1561,3,5.0.105,0,657,1,73,105,178,0,105,178,178,0,0,0,1,4,275,205,275,310,4,1743,1638
1561,4,0.1.16,0,650,0,79,16,95,16,0,95,168,-16,16,16,2,1,235,355,251,355,5,1743,1575
1561,4,1.1.168,0,650,0,42,168,210,168,0,210,210,-168,168,168,2,1,269,355,332,355,5,1743,1575
1561,4,2.0.168,1,650,0,69,168,237,0,168,237,237,0,0,0,1,5,284,142,284,310,5,1743,1575
1561,4,3.1.67,0,657,1,98,67,165,67,0,165,168,-67,67,67,2,1,281,355,332,355,5,1743,1575
1561,4,4.1.105,0,650,0,53,105,158,105,0,158,168,-105,105,105,2,1,231,355,269,355,5,1743,1575
1561,4,5.0.168,0,650,0,73,168,241,0,168,241,241,0,0,0,1,5,275,142,275,310,5,1743,1575
1561,5,0.1.16,0,650,0,79,16,95,16,0,95,237,-16,16,16,2,1,235,355,251,355,6,1743,1506
1561,5,1.1.168,0,650,0,42,168,210,168,0,210,237,-168,168,168,2,1,269,355,332,355,6,1743,1506
1561,5,2.1.237,0,653,1,9,237,246,237,0,246,246,-237,237,237,2,1,215,355,284,355,6,1743,1506
1561,5,3.1.67,0,657,2,98,67,165,67,0,165,237,-67,67,67,2,1,281,355,332,355,6,1743,1506
1561,5,4.1.105,0,650,0,53,105,158,105,0,158,237,-105,105,105,2,1,231,355,269,355,6,1743,1506
1561,5,5.0.237,1,650,0,73,237,310,0,237,310,310,0,0,0,1,6,275,73,275,310,6,1743,1506
1561,6,0.1.16,1,650,0,79,16,95,16,0,95,310,-16,16,16,2,1,235,355,251,355,7,1743,1433
1561,6,1.1.168,0,650,0,42,168,210,168,0,210,310,-168,168,168,2,1,269,355,332,355,7,1743,1433
1561,6,2.1.237,0,653,1,9,237,246,237,0,246,310,-237,237,237,2,1,215,355,284,355,7,1743,1433
1561,6,3.1.67,0,657,2,98,67,165,67,0,165,310,-67,67,67,2,1,281,355,332,355,7,1743,1433
1561,6,4.1.105,0,650,0,53,105,158,105,0,158,310,-105,105,105,2,1,231,355,269,355,7,1743,1433
1561,6,5.1.310,0,650,0,74,310,384,310,0,384,384,-310,310,310,2,1,202,355,275,355,7,1743,1433
1561,7,0.2.95,1,673,2,90,95,185,95,0,185,310,-95,95,111,3,1,156,277,251,277,8,1743,1354
1561,7,1.1.168,0,650,0,42,168,210,168,0,210,310,-73,89,89,2,2,269,276,332,355,8,1743,1354
1561,7,2.1.237,0,653,1,9,237,246,237,0,246,310,-142,158,158,2,2,215,276,284,355,8,1743,1354
1561,7,3.1.95,0,685,3,98,95,193,67,28,193,310,0,16,16,2,2,281,276,332,355,8,1743,1354
1561,7,4.1.105,0,650,0,53,105,158,105,0,158,310,-10,26,26,2,2,231,276,269,355,8,1743,1354
1561,7,5.1.310,0,650,0,74,310,384,310,0,384,384,-215,231,231,2,2,202,276,275,355,8,1743,1354
1561,8,0.3.185,0,673,0,56,185,241,185,0,241,310,-185,185,296,4,1,66,416,251,416,9,1743,1264
1561,8,1.1.168,0,673,0,42,168,210,168,0,210,310,-73,89,184,2,2,269,276,332,355,9,1743,1264
1561,8,2.1.237,0,673,0,9,237,246,237,0,246,310,-142,158,253,2,2,215,276,284,355,9,1743,1264
1561,8,3.1.95,0,685,1,98,95,193,67,28,193,310,0,16,111,2,2,281,276,332,355,9,1743,1264
1561,8,4.1.105,1,673,0,53,105,158,105,0,158,310,-10,26,121,2,2,231,276,269,355,9,1743,1264
1561,8,5.1.310,0,673,0,74,310,384,310,0,384,384,-215,231,326,2,2,202,276,275,355,9,1743,1264
1561,9,0.3.185,0,673,0,56,185,241,185,0,241,310,-185,185,306,4,1,66,416,251,416,10,1743,1211
1561,9,1.1.168,0,673,0,42,168,210,168,0,210,310,-10,36,131,2,3,269,223,332,355,10,1743,1211
1561,9,2.1.237,0,673,0,9,237,246,237,0,246,310,-79,105,200,2,3,215,223,284,355,10,1743,1211
1561,9,3.1.158,0,687,1,98,158,256,67,91,256,310,0,26,121,2,3,281,223,332,355,10,1743,1211
1561,9,4.2.185,1,673,0,49,185,234,158,27,234,310,0,95,121,3,2,178,187,269,277,10,1743,1211
1561,9,5.1.310,0,673,0,74,310,384,310,0,384,384,-152,178,273,2,3,202,223,275,355,10,1743,1211
1561,10,0.3.185,0,673,0,56,185,241,185,0,241,310,-185,185,306,4,1,66,416,251,416,11,1743,1162
1561,10,1.1.168,1,673,0,42,168,210,168,0,210,310,-10,36,131,2,3,269,223,332,355,11,1743,1162
1561,10,2.1.237,0,673,0,9,237,246,237,0,246,310,-79,105,200,2,3,215,223,284,355,11,1743,1162
1561,10,3.1.158,0,687,2,98,158,256,67,91,256,310,0,26,121,2,3,281,223,332,355,11,1743,1162
1561,10,4.3.234,0,676,1,44,234,278,234,0,278,310,-234,234,355,4,1,129,416,269,416,11,1743,1162
1561,10,5.1.310,0,673,0,74,310,384,310,0,384,384,-152,178,273,2,3,202,223,275,355,11,1743,1162
1561,11,0.3.185,0,673,0,56,185,241,185,0,241,310,-185,185,316,4,1,66,416,251,416,12,1743,1120
1561,11,1.2.234,1,673,0,42,234,276,210,24,276,310,0,95,131,3,3,227,138,332,277,12,1743,1120
1561,11,2.1.237,0,673,0,9,237,246,237,0,246,310,-27,63,158,2,4,215,181,284,355,12,1743,1120
1561,11,3.1.210,0,673,0,98,210,308,67,143,308,310,0,36,131,2,4,281,181,332,355,12,1743,1120
1561,11,4.3.234,0,676,1,44,234,278,234,0,278,310,-234,234,365,4,1,129,416,269,416,12,1743,1120
1561,11,5.1.310,0,673,0,74,310,384,310,0,384,384,-100,136,231,2,4,202,181,275,355,12,1743,1120
1561,12,0.3.185,0,673,0,56,185,241,185,0,241,310,-185,185,316,4,1,66,416,251,416,13,1743,1078
1561,12,1.3.276,0,746,2,95,276,371,276,0,371,371,-276,276,407,4,1,185,416,332,416,13,1743,1078
1561,12,2.1.237,0,673,0,9,237,246,237,0,246,310,-27,63,158,2,4,215,181,284,355,13,1743,1078
1561,12,3.1.210,1,673,0,98,210,308,67,143,308,310,0,36,131,2,4,281,181,332,355,13,1743,1078
1561,12,4.3.234,0,676,1,44,234,278,234,0,278,310,-234,234,365,4,1,129,416,269,416,13,1743,1078
1561,12,5.1.310,0,673,0,74,310,384,310,0,384,384,-100,136,231,2,4,202,181,275,355,13,1743,1078
1561,13,0.3.185,0,673,0,56,185,241,185,0,241,310,-185,185,316,4,1,66,416,251,416,14,1743,980
1561,13,1.3.276,0,746,2,95,276,371,276,0,371,371,-276,276,407,4,1,185,416,332,416,14,1743,980
1561,13,2.1.308,0,673,0,9,308,317,237,71,317,317,0,36,131,2,5,215,83,284,355,14,1743,980
1561,13,3.2.308,1,673,0,14,308,322,308,0,322,322,-32,127,163,3,4,183,96,332,277,14,1743,980
1561,13,4.3.234,0,676,1,44,234,278,234,0,278,310,-234,234,365,4,1,129,416,269,416,14,1743,980
1561,13,5.1.310,0,673,0,74,310,384,310,0,384,384,-2,38,133,2,5,202,83,275,355,14,1743,980
1561,14,0.3.185,0,673,0,56,185,241,185,0,241,322,-185,185,348,4,1,66,416,251,416,15,1743,966
1561,14,1.3.276,0,746,3,95,276,371,276,0,371,371,-276,276,439,4,1,185,416,332,416,15,1743,966
1561,14,2.1.308,1,673,0,9,308,317,237,71,317,322,0,36,163,2,5,215,83,284,355,15,1743,966
1561,14,3.3.322,0,724,2,93,322,415,322,0,415,415,-322,322,485,4,1,169,416,332,416,15,1743,966
1561,14,4.3.234,0,676,1,44,234,278,234,0,278,322,-234,234,397,4,1,129,416,269,416,15,1743,966
1561,14,5.1.310,0,673,0,74,310,384,310,0,384,384,-2,38,165,2,5,202,83,275,355,15,1743,966
1561,15,0.3.185,0,673,0,56,185,241,185,0,241,322,-185,185,348,4,1,66,416,251,416,16,1743,957
1561,15,1.3.276,0,746,3,95,276,371,276,0,371,371,-276,276,439,4,1,185,416,332,416,16,1743,957
1561,15,2.2.322,1,673,0,69,322,391,317,5,391,391,0,127,163,3,5,206,82,284,277,16,1743,957
1561,15,3.3.322,0,724,2,93,322,415,322,0,415,415,-322,322,485,4,1,169,416,332,416,16,1743,957
1561,15,4.3.234,0,676,1,44,234,278,234,0,278,322,-234,234,397,4,1,129,416,269,416,16,1743,957
1561,15,5.1.317,0,673,0,74,317,391,310,7,391,391,0,36,163,2,6,202,74,275,355,16,1743,957
1561,16,0.3.185,0,673,0,56,185,241,185,0,241,391,-185,185,348,4,1,66,416,251,416,17,1743,888
1561,16,1.3.276,0,746,4,95,276,371,276,0,371,391,-276,276,439,4,1,185,416,332,416,17,1743,888
1561,16,2.3.391,0,687,2,70,391,461,391,0,461,461,-391,391,554,4,1,137,416,284,416,17,1743,888
1561,16,3.3.322,0,724,3,93,322,415,322,0,415,415,-322,322,485,4,1,169,416,332,416,17,1743,888
1561,16,4.3.234,0,676,1,44,234,278,234,0,278,391,-234,234,397,4,1,129,416,269,416,17,1743,888
1561,16,5.1.317,1,673,0,74,317,391,310,7,391,391,0,36,163,2,6,202,74,275,355,17,1743,888
1561,17,0.3.185,0,673,0,56,185,241,185,0,241,391,-185,185,348,4,1,66,416,251,416,18,1743,814
1561,17,1.3.276,0,746,4,95,276,371,276,0,371,391,-276,276,439,4,1,185,416,332,416,18,1743,814
1561,17,2.3.391,0,687,2,70,391,461,391,0,461,461,-391,391,554,4,1,137,416,284,416,18,1743,814
1561,17,3.3.322,0,724,3,93,322,415,322,0,415,415,-322,322,485,4,1,169,416,332,416,18,1743,814
1561,17,4.3.234,0,676,1,44,234,278,234,0,278,391,-234,234,397,4,1,129,416,269,416,18,1743,814
1561,17,5.2.391,1,673,0,13,391,404,391,0,404,404,0,127,163,3,6,128,13,275,277,18,1743,814
1561,18,0.3.185,1,673,0,56,185,241,185,0,241,404,-185,185,348,4,1,66,416,251,416,19,1743,801
1561,18,1.3.276,0,746,5,95,276,371,276,0,371,404,-276,276,439,4,1,185,416,332,416,19,1743,801
1561,18,2.3.391,0,687,2,70,391,461,391,0,461,461,-391,391,554,4,1,137,416,284,416,19,1743,801
1561,18,3.3.322,0,724,4,93,322,415,322,0,415,415,-322,322,485,4,1,169,416,332,416,19,1743,801
1561,18,4.3.234,0,676,1,44,234,278,234,0,278,404,-234,234,397,4,1,129,416,269,416,19,1743,801
1561,18,5.3.404,0,698,3,58,404,462,404,0,462,462,-404,404,567,4,1,115,416,275,416,19,1743,801
1561,19,0.4.241,1,673,0,10,241,251,241,0,251,404,-241,241,589,5,1,10,385,251,385,20,1743,745
1561,19,1.3.276,0,746,4,95,276,371,276,0,371,404,-35,220,383,4,2,185,360,332,416,20,1743,745
1561,19,2.3.391,0,687,1,70,391,461,391,0,461,461,-150,335,498,4,2,137,360,284,416,20,1743,745
1561,19,3.3.322,0,724,3,93,322,415,322,0,415,415,-81,266,429,4,2,169,360,332,416,20,1743,745
1561,19,4.3.241,0,673,0,44,241,285,234,7,285,404,0,185,348,4,2,129,360,269,416,20,1743,745
1561,19,5.3.404,0,698,2,58,404,462,404,0,462,462,-163,348,511,4,2,115,360,275,416,20,1743,745
1561,20,1.3.276,0,746,4,95,276,371,276,0,371,404,-35,220,624,4,2,185,360,332,416,21,1743,735
1561,20,2.3.391,0,687,1,70,391,461,391,0,461,461,-150,335,739,4,2,137,360,284,416,21,1743,735
1561,20,3.3.322,0,724,3,93,322,415,322,0,415,415,-81,266,670,4,2,169,360,332,416,21,1743,735
1561,20,4.3.241,1,673,0,44,241,285,234,7,285,404,0,185,589,4,2,129,360,269,416,21,1743,735
1561,20,5.3.404,0,698,2,58,404,462,404,0,462,462,-163,348,752,4,2,115,360,275,416,21,1743,735
1561,21,1.3.285,1,673,0,95,285,380,276,9,380,404,0,185,589,4,3,185,316,332,416,22,1743,691
1561,21,2.3.391,0,687,1,70,391,461,391,0,461,461,-106,291,695,4,3,137,316,284,416,22,1743,691
1561,21,3.3.322,0,724,3,93,322,415,322,0,415,415,-37,222,626,4,3,169,316,332,416,22,1743,691
1561,21,4.4.285,0,673,0,85,285,370,285,0,370,404,-34,275,623,5,2,85,375,269,385,22,1743,691
1561,21,5.3.404,0,698,2,58,404,462,404,0,462,462,-119,304,708,4,3,115,316,275,416,22,1743,691
1561,22,1.4.380,0,673,0,90,380,470,380,0,470,470,-129,370,718,5,2,90,375,332,385,23,1743,596
1561,22,2.3.391,0,687,1,70,391,461,391,0,461,461,-11,196,600,4,4,137,221,284,416,23,1743,596
1561,22,3.3.380,1,673,0,93,380,473,322,58,473,473,0,185,589,4,4,169,221,332,416,23,1743,596
1561,22,4.4.285,0,673,0,85,285,370,285,0,370,404,-34,275,623,5,2,85,375,269,385,23,1743,596
1561,22,5.3.404,0,698,2,58,404,462,404,0,462,462,-24,209,613,4,4,115,221,275,416,23,1743,596
1561,23,1.4.380,0,673,0,90,380,470,380,0,470,473,-129,370,718,5,2,90,375,332,385,24,1743,503
1561,23,2.3.473,0,673,0,70,473,543,391,82,543,543,0,185,589,4,5,137,128,284,416,24,1743,503
1561,23,3.4.473,0,673,0,76,473,549,473,0,549,549,-222,463,811,5,2,76,375,332,385,24,1743,503
1561,23,4.4.285,0,673,0,85,285,370,285,0,370,473,-34,275,623,5,2,85,375,269,385,24,1743,503
1561,23,5.3.473,1,673,0,58,473,531,404,69,531,531,0,185,589,4,5,115,128,275,416,24,1743,503
1561,24,1.4.380,0,673,0,90,380,470,380,0,470,531,-129,370,718,5,2,90,375,332,385,25,1743,445
1561,24,2.3.531,1,673,0,70,531,601,391,140,601,601,0,185,589,4,6,137,70,284,416,25,1743,445
1561,24,3.4.473,0,673,0,76,473,549,473,0,549,549,-222,463,811,5,2,76,375,332,385,25,1743,445
1561,24,4.4.285,0,673,0,85,285,370,285,0,370,531,-34,275,623,5,2,85,375,269,385,25,1743,445
1561,24,5.4.531,0,731,1,57,531,588,531,0,588,588,-280,521,869,5,2,57,375,275,385,25,1743,445
1561,25,1.4.380,0,673,0,90,380,470,380,0,470,601,-129,370,718,5,2,90,375,332,385,26,1743,375
1561,25,2.4.601,0,725,1,67,601,668,601,0,668,668,-350,591,939,5,2,67,375,284,385,26,1743,375
1561,25,3.4.473,0,673,0,76,473,549,473,0,549,601,-222,463,811,5,2,76,375,332,385,26,1743,375
1561,25,4.4.285,1,673,0,85,285,370,285,0,370,601,-34,275,623,5,2,85,375,269,385,26,1743,375
1561,25,5.4.531,0,731,2,57,531,588,531,0,588,601,-280,521,869,5,2,57,375,275,385,26,1743,375
1561,26,1.4.380,1,673,0,90,380,470,380,0,470,601,-10,285,633,5,3,90,290,332,385,27,1743,290
1561,26,2.4.601,0,725,1,67,601,668,601,0,668,668,-231,506,854,5,3,67,290,284,385,27,1743,290
1561,26,3.4.473,0,673,0,76,473,549,473,0,549,601,-103,378,726,5,3,76,290,332,385,27,1743,290
1561,26,5.4.531,0,731,2,57,531,588,531,0,588,601,-161,436,784,5,3,57,290,275,385,27,1743,290
1561,27,2.4.601,0,725,1,67,601,668,601,0,668,668,-131,416,764,5,4,67,200,284,385,28,1743,200
1561,27,3.4.473,1,673,0,76,473,549,473,0,549,601,-3,288,636,5,4,76,200,332,385,28,1743,200
1561,27,5.4.531,0,731,2,57,531,588,531,0,588,601,-61,346,694,5,4,57,200,275,385,28,1743,200
1561,28,2.4.601,0,725,1,67,601,668,601,0,668,668,-52,340,688,5,5,67,124,284,385,29,1743,124
1561,28,5.4.549,1,673,0,57,549,606,531,18,606,606,0,288,636,5,5,57,124,275,385,29,1743,124
1561,29,2.4.606,1,673,0,67,606,673,601,5,673,673,0,288,636,5,6,67,67,284,385,30,1743,67
1562,0,0.0.0,1,485,2,29,0,29,0,0,29,29,0,0,0,1,1,295,225,295,225,1,1318,1318
1562,0,1.0.0,0,474,0,39,0,39,0,0,39,39,0,0,0,1,1,234,225,234,225,1,1318,1318
1562,0,2.0.0,0,474,0,15,0,15,0,0,15,15,0,0,0,1,1,113,225,113,225,1,1318,1318
1562,0,3.0.0,0,479,1,5,0,5,0,0,5,5,0,0,0,1,1,193,225,193,225,1,1318,1318
1562,0,4.0.0,0,485,2,60,0,60,0,0,60,60,0,0,0,1,1,207,225,207,225,1,1318,1318
1562,0,5.0.0,0,541,3,77,0,77,0,0,77,77,0,0,0,1,1,276,225,276,225,1,1318,1318
1562,1,0.1.29,1,494,3,47,29,76,29,0,76,76,-29,29,29,2,1,266,161,295,161,2,1318,1289
1562,1,1.0.29,0,493,2,39,29,68,0,29,68,68,0,0,0,1,2,234,196,234,225,2,1318,1289
1562,1,2.0.29,0,485,0,15,29,44,0,29,44,44,0,0,0,1,2,113,196,113,225,2,1318,1289
1562,1,3.0.29,0,490,1,5,29,34,0,29,34,34,0,0,0,1,2,193,196,193,225,2,1318,1289
1562,1,4.0.29,0,510,4,60,29,89,0,29,89,89,0,0,0,1,2,207,196,207,225,2,1318,1289
1562,1,5.0.29,0,548,5,77,29,106,0,29,106,106,0,0,0,1,2,276,196,276,225,2,1318,1289
1562,2,0.2.76,0,548,3,93,76,169,76,0,169,169,-76,76,105,3,1,219,345,295,345,3,1318,1242
1562,2,1.0.29,0,501,1,39,29,68,0,29,68,76,0,0,29,1,2,234,196,234,225,3,1318,1242
1562,2,2.0.29,0,494,0,15,29,44,0,29,44,76,0,0,29,1,2,113,196,113,225,3,1318,1242
1562,2,3.0.29,1,494,0,5,29,34,0,29,34,76,0,0,29,1,2,193,196,193,225,3,1318,1242
1562,2,4.0.29,0,510,2,60,29,89,0,29,89,89,0,0,29,1,2,207,196,207,225,3,1318,1242
1562,2,5.0.29,0,548,3,77,29,106,0,29,106,106,0,0,29,1,2,276,196,276,225,3,1318,1242
1562,3,0.2.76,0,548,4,93,76,169,76,0,169,169,-76,76,105,3,1,219,345,295,345,4,1318,1237
1562,3,1.0.34,0,501,1,39,34,73,0,34,73,76,0,0,29,1,3,234,191,234,225,4,1318,1237
1562,3,2.0.34,0,494,0,15,34,49,0,34,49,76,0,0,29,1,3,113,191,113,225,4,1318,1237
1562,3,3.1.76,1,531,3,37,76,113,34,42,113,113,0,29,29,2,2,188,114,193,161,4,1318,1237
1562,3,4.0.34,0,515,2,60,34,94,0,34,94,94,0,0,29,1,3,207,191,207,225,4,1318,1237
1562,3,5.0.34,0,548,4,77,34,111,0,34,111,111,0,0,29,1,3,276,191,276,225,4,1318,1237
1562,4,0.2.76,0,548,1,93,76,169,76,0,169,169,-76,76,105,3,1,219,345,295,345,5,1318,1200
1562,4,1.0.34,1,531,0,39,34,73,0,34,73,113,0,0,29,1,3,234,191,234,225,5,1318,1200
1562,4,2.0.34,0,531,0,15,34,49,0,34,49,113,0,0,29,1,3,113,191,113,225,5,1318,1200
1562,4,3.2.113,0,581,2,81,113,194,113,0,194,194,-113,113,142,3,1,151,345,193,345,5,1318,1200
1562,4,4.0.34,0,531,0,60,34,94,0,34,94,113,0,0,29,1,3,207,191,207,225,5,1318,1200
1562,4,5.0.34,0,548,1,77,34,111,0,34,111,113,0,0,29,1,3,276,191,276,225,5,1318,1200
1562,5,0.2.76,0,548,2,93,76,169,76,0,169,169,-76,76,105,3,1,219,345,295,345,6,1318,1161
1562,5,1.1.113,1,538,1,10,113,123,73,40,123,123,0,29,29,2,3,195,77,234,161,6,1318,1161
1562,5,2.0.73,0,531,0,15,73,88,0,73,88,113,0,0,29,1,4,113,152,113,225,6,1318,1161
1562,5,3.2.113,0,581,3,81,113,194,113,0,194,194,-113,113,142,3,1,151,345,193,345,6,1318,1161
1562,5,4.0.73,0,538,1,60,73,133,0,73,133,133,0,0,29,1,4,207,152,207,225,6,1318,1161
1562,5,5.0.73,0,538,1,77,73,150,0,73,150,150,0,0,29,1,4,276,152,276,225,6,1318,1161
1562,6,0.2.76,0,548,1,93,76,169,76,0,169,169,-76,76,105,3,1,219,345,295,345,7,1318,1151
1562,6,1.2.123,0,538,0,48,123,171,123,0,171,171,-123,123,152,3,1,185,345,234,345,7,1318,1151
1562,6,2.0.73,1,538,0,15,73,88,0,73,88,123,0,0,29,1,4,113,152,113,225,7,1318,1151
1562,6,3.2.113,0,581,2,81,113,194,113,0,194,194,-113,113,142,3,1,151,345,193,345,7,1318,1151
1562,6,4.0.73,0,538,0,60,73,133,0,73,133,133,0,0,29,1,4,207,152,207,225,7,1318,1151
1562,6,5.0.73,0,538,0,77,73,150,0,73,150,150,0,0,29,1,4,276,152,276,225,7,1318,1151
1562,7,0.2.76,0,548,1,93,76,169,76,0,169,169,-76,76,105,3,1,219,345,295,345,8,1318,1136
1562,7,1.2.123,0,538,0,48,123,171,123,0,171,171,-123,123,152,3,1,185,345,234,345,8,1318,1136
1562,7,2.1.123,1,538,0,3,123,126,88,35,126,126,0,29,29,2,4,98,67,113,161,8,1318,1136
1562,7,3.2.113,0,581,2,81,113,194,113,0,194,194,-113,113,142,3,1,151,345,193,345,8,1318,1136
1562,7,4.0.88,0,538,0,60,88,148,0,88,148,148,0,0,29,1,5,207,137,207,225,8,1318,1136
1562,7,5.0.88,0,538,0,77,88,165,0,88,165,165,0,0,29,1,5,276,137,276,225,8,1318,1136
1562,8,0.2.76,0,548,2,93,76,169,76,0,169,169,-76,76,105,3,1,219,345,295,345,9,1318,1133
1562,8,1.2.123,0,538,0,48,123,171,123,0,171,171,-123,123,152,3,1,185,345,234,345,9,1318,1133
1562,8,2.2.126,0,541,1,23,126,149,126,0,149,149,-126,126,155,3,1,95,345,113,345,9,1318,1133
1562,8,3.2.113,0,581,3,81,113,194,113,0,194,194,-113,113,142,3,1,151,345,193,345,9,1318,1133
1562,8,4.0.88,0,538,0,60,88,148,0,88,148,148,0,0,29,1,5,207,137,207,225,9,1318,1133
1562,8,5.0.88,1,538,0,77,88,165,0,88,165,165,0,0,29,1,5,276,137,276,225,9,1318,1133
1562,9,0.2.76,0,548,2,93,76,169,76,0,169,169,-76,76,105,3,1,219,345,295,345,10,1318,1056
1562,9,1.2.123,0,538,0,48,123,171,123,0,171,171,-123,123,152,3,1,185,345,234,345,10,1318,1056
1562,9,2.2.126,0,541,1,23,126,149,126,0,149,165,-126,126,155,3,1,95,345,113,345,10,1318,1056
1562,9,3.2.113,0,582,3,81,113,194,113,0,194,194,-113,113,142,3,1,151,345,193,345,10,1318,1056
1562,9,4.0.165,0,538,0,60,165,225,0,165,225,225,0,0,29,1,6,207,60,207,225,10,1318,1056
1562,9,5.1.165,1,538,0,58,165,223,165,0,223,223,-39,68,68,2,5,199,64,276,161,10,1318,1056
1562,10,0.2.76,0,548,2,93,76,169,76,0,169,223,-76,76,144,3,1,219,345,295,345,11,1318,998
1562,10,1.2.123,0,538,0,48,123,171,123,0,171,223,-123,123,191,3,1,185,345,234,345,11,1318,998
1562,10,2.2.126,0,541,1,23,126,149,126,0,149,223,-126,126,194,3,1,95,345,113,345,11,1318,998
1562,10,3.2.113,0,582,3,81,113,194,113,0,194,223,-113,113,181,3,1,151,345,193,345,11,1318,998
1562,10,4.0.165,1,538,0,60,165,225,0,165,225,225,0,0,68,1,6,207,60,207,225,11,1318,998
1562,10,5.2.223,0,548,2,51,223,274,223,0,274,274,-223,223,291,3,1,141,345,276,345,11,1318,998
1562,11,0.2.76,0,548,2,93,76,169,76,0,169,225,-76,76,144,3,1,219,345,295,345,12,1318,938
1562,11,1.2.123,0,538,0,48,123,171,123,0,171,225,-123,123,191,3,1,185,345,234,345,12,1318,938
1562,11,2.2.126,0,541,1,23,126,149,126,0,149,225,-126,126,194,3,1,95,345,113,345,12,1318,938
1562,11,3.2.113,0,582,3,81,113,194,113,0,194,225,-113,113,181,3,1,151,345,193,345,12,1318,938
1562,11,4.1.225,1,538,0,6,225,231,225,0,231,231,-2,70,70,2,6,147,6,207,161,12,1318,938
1562,11,5.2.223,0,548,2,51,223,274,223,0,274,274,-223,223,291,3,1,141,345,276,345,12,1318,938
1562,12,0.2.76,1,548,2,93,76,169,76,0,169,231,-76,76,146,3,1,219,345,295,345,13,1318,932
1562,12,1.2.123,0,538,0,48,123,171,123,0,171,231,-123,123,193,3,1,185,345,234,345,13,1318,932
1562,12,2.2.126,0,541,1,23,126,149,126,0,149,231,-126,126,196,3,1,95,345,113,345,13,1318,932
1562,12,3.2.113,0,582,3,81,113,194,113,0,194,231,-113,113,183,3,1,151,345,193,345,13,1318,932
1562,12,4.2.231,0,548,2,49,231,280,231,0,280,280,-231,231,301,3,1,141,345,207,345,13,1318,932
1562,12,5.2.223,0,548,2,51,223,274,223,0,274,274,-223,223,293,3,1,141,345,276,345,13,1318,932
1562,13,0.3.169,1,548,0,63,169,232,169,0,232,232,-169,169,315,4,1,126,271,295,271,14,1318,839
1562,13,1.2.169,0,548,0,48,169,217,123,46,217,231,0,76,146,3,2,185,252,234,345,14,1318,839
1562,13,2.2.169,0,548,0,23,169,192,126,43,192,231,0,76,146,3,2,95,252,113,345,14,1318,839
1562,13,3.2.169,0,574,1,81,169,250,113,56,250,250,0,76,146,3,2,151,252,193,345,14,1318,839
1562,13,4.2.231,0,548,0,49,231,280,231,0,280,280,-62,138,208,3,2,141,252,207,345,14,1318,839
1562,13,5.2.223,0,548,0,51,223,274,223,0,274,274,-54,130,200,3,2,141,252,276,345,14,1318,839
1562,14,0.4.232,1,548,0,63,232,295,232,0,295,295,-232,232,547,5,1,63,316,295,316,15,1318,776
1562,14,1.2.169,0,548,0,48,169,217,123,46,217,232,0,76,315,3,2,185,252,234,345,15,1318,776
1562,14,2.2.169,0,548,0,23,169,192,126,43,192,232,0,76,315,3,2,95,252,113,345,15,1318,776
1562,14,3.2.169,0,574,1,81,169,250,113,56,250,250,0,76,315,3,2,151,252,193,345,15,1318,776
1562,14,4.2.231,0,548,0,49,231,280,231,0,280,280,-62,138,377,3,2,141,252,207,345,15,1318,776
1562,14,5.2.223,0,548,0,51,223,274,223,0,274,274,-54,130,369,3,2,141,252,276,345,15,1318,776
1562,15,1.2.169,1,548,0,48,169,217,123,46,217,295,0,76,547,3,2,185,252,234,345,16,1318,713
1562,15,2.2.169,0,548,0,23,169,192,126,43,192,295,0,76,547,3,2,95,252,113,345,16,1318,713
1562,15,3.2.169,0,574,1,81,169,250,113,56,250,295,0,76,547,3,2,151,252,193,345,16,1318,713
1562,15,4.2.231,0,548,0,49,231,280,231,0,280,295,-62,138,609,3,2,141,252,207,345,16,1318,713
1562,15,5.2.223,0,548,0,51,223,274,223,0,274,295,-54,130,601,3,2,141,252,276,345,16,1318,713
1562,16,1.3.232,1,548,0,38,232,270,217,15,270,295,0,169,547,4,2,137,208,234,271,17,1318,665
1562,16,2.2.217,0,548,0,23,217,240,126,91,240,295,0,76,547,3,3,95,204,113,345,17,1318,665
1562,16,3.2.217,0,548,0,81,217,298,113,104,298,298,0,76,547,3,3,151,204,193,345,17,1318,665
1562,16,4.2.231,0,548,0,49,231,280,231,0,280,295,-14,90,561,3,3,141,204,207,345,17,1318,665
1562,16,5.2.223,0,548,0,51,223,274,223,0,274,295,-6,82,553,3,3,141,204,276,345,17,1318,665
1562,17,1.4.295,0,548,0,99,295,394,270,25,394,394,0,232,547,5,2,99,253,234,316,18,1318,627
1562,17,2.2.217,1,548,0,23,217,240,126,91,240,295,0,76,547,3,3,95,204,113,345,18,1318,627
1562,17,3.2.217,0,548,0,81,217,298,113,104,298,298,0,76,547,3,3,151,204,193,345,18,1318,627
1562,17,4.2.231,0,548,0,49,231,280,231,0,280,295,-14,90,561,3,3,141,204,207,345,18,1318,627
1562,17,5.2.223,0,548,0,51,223,274,223,0,274,295,-6,82,553,3,3,141,204,276,345,18,1318,627
1562,18,1.4.295,0,548,0,99,295,394,270,25,394,394,0,232,547,5,2,99,253,234,316,19,1318,604
1562,18,2.3.270,1,548,0,39,270,309,240,30,309,309,0,169,547,4,3,72,170,113,271,19,1318,604
1562,18,3.2.240,0,548,0,81,240,321,113,127,321,321,0,76,547,3,4,151,181,193,345,19,1318,604
1562,18,4.2.240,0,548,0,49,240,289,231,9,289,295,0,76,547,3,4,141,181,207,345,19,1318,604
1562,18,5.2.240,0,548,0,51,240,291,223,17,291,295,0,76,547,3,4,141,181,276,345,19,1318,604
1562,19,1.4.295,0,548,0,99,295,394,270,25,394,394,0,232,547,5,2,99,253,234,316,20,1318,565
1562,19,2.4.309,0,562,1,33,309,342,309,0,342,342,-14,246,561,5,2,33,253,113,316,20,1318,565
1562,19,3.2.240,0,548,0,81,240,321,113,127,321,321,0,76,547,3,4,151,181,193,345,20,1318,565
1562,19,4.2.240,0,548,0,49,240,289,231,9,289,309,0,76,547,3,4,141,181,207,345,20,1318,565
1562,19,5.2.240,1,548,0,51,240,291,223,17,291,309,0,76,547,3,4,141,181,276,345,20,1318,565
1562,20,1.4.295,0,548,0,99,295,394,270,25,394,394,0,232,547,5,2,99,253,234,316,21,1318,514
1562,20,2.4.309,0,562,1,33,309,342,309,0,342,342,-14,246,561,5,2,33,253,113,316,21,1318,514
1562,20,3.2.291,0,548,0,81,291,372,113,178,372,372,0,76,547,3,5,151,130,193,345,21,1318,514
1562,20,4.2.291,0,548,0,49,291,340,231,60,340,340,0,76,547,3,5,141,130,207,345,21,1318,514
1562,20,5.3.309,1,548,0,42,309,351,291,18,351,351,0,169,547,4,4,90,131,276,271,21,1318,514
1562,21,1.4.295,0,548,0,99,295,394,270,25,394,394,0,232,547,5,2,99,253,234,316,22,1318,472
1562,21,2.4.309,0,562,1,33,309,342,309,0,342,351,-14,246,561,5,2,33,253,113,316,22,1318,472
1562,21,3.2.291,1,548,0,81,291,372,113,178,372,372,0,76,547,3,5,151,130,193,345,22,1318,472
1562,21,4.2.291,0,548,0,49,291,340,231,60,340,351,0,76,547,3,5,141,130,207,345,22,1318,472
1562,21,5.4.351,0,571,2,48,351,399,351,0,399,399,-56,288,603,5,2,48,253,276,316,22,1318,472
1562,22,1.4.295,0,548,0,99,295,394,270,25,394,394,0,232,547,5,2,99,253,234,316,23,1318,391
1562,22,2.4.309,0,562,1,33,309,342,309,0,342,372,-14,246,561,5,2,33,253,113,316,23,1318,391
1562,22,3.3.372,0,548,0,52,372,424,372,0,424,424,-21,190,568,4,5,70,89,193,271,23,1318,391
1562,22,4.2.372,1,548,0,49,372,421,231,141,421,421,0,76,547,3,6,141,49,207,345,23,1318,391
1562,22,5.4.351,0,571,2,48,351,399,351,0,399,399,-56,288,603,5,2,48,253,276,316,23,1318,391
1562,23,1.4.295,0,548,0,99,295,394,270,25,394,421,0,232,547,5,2,99,253,234,316,24,1318,342
1562,23,2.4.309,0,562,1,33,309,342,309,0,342,421,-14,246,561,5,2,33,253,113,316,24,1318,342
1562,23,3.3.372,1,548,0,52,372,424,372,0,424,424,-21,190,568,4,5,70,89,193,271,24,1318,342
1562,23,4.3.421,0,548,0,37,421,458,421,0,458,458,-70,239,617,4,5,92,89,207,271,24,1318,342
1562,23,5.4.351,0,571,2,48,351,399,351,0,399,421,-56,288,603,5,2,48,253,276,316,24,1318,342
1562,24,1.4.295,0,548,0,99,295,394,270,25,394,424,0,232,568,5,2,99,253,234,316,25,1318,290
1562,24,2.4.309,0,562,1,33,309,342,309,0,342,424,-14,246,582,5,2,33,253,113,316,25,1318,290
1562,24,3.4.424,0,578,3,18,424,442,424,0,442,442,-129,361,697,5,2,18,253,193,316,25,1318,290
1562,24,4.3.424,1,548,0,37,424,461,421,3,461,461,0,190,568,4,6,92,37,207,271,25,1318,290
1562,24,5.4.351,0,571,2,48,351,399,351,0,399,424,-56,288,624,5,2,48,253,276,316,25,1318,290
1562,25,1.4.295,0,548,0,99,295,394,270,25,394,461,0,232,568,5,2,99,253,234,316,26,1318,253
1562,25,2.4.309,0,562,2,33,309,342,309,0,342,461,-14,246,582,5,2,33,253,113,316,26,1318,253
1562,25,3.4.424,0,578,4,18,424,442,424,0,442,461,-129,361,697,5,2,18,253,193,316,26,1318,253
1562,25,4.4.461,0,549,1,55,461,516,461,0,516,516,-166,398,734,5,2,55,253,207,316,26,1318,253
1562,25,5.4.351,1,571,3,48,351,399,351,0,399,461,-56,288,624,5,2,48,253,276,316,26,1318,253
1562,26,1.4.399,0,571,0,99,399,498,270,129,498,498,0,288,624,5,3,99,205,234,316,27,1318,205
1562,26,2.4.309,1,571,0,33,309,342,309,0,399,461,33,255,591,5,3,33,205,113,316,27,1318,205
1562,26,3.4.424,0,596,1,18,424,442,424,0,442,461,-25,313,649,5,3,18,205,193,316,27,1318,205
1562,26,4.4.461,0,615,2,55,461,516,461,0,516,516,-62,350,686,5,3,55,205,207,316,27,1318,205
1562,27,1.4.399,1,571,0,99,399,498,270,129,498,498,0,255,591,5,4,99,172,234,316,28,1318,172
1562,27,3.4.424,0,596,1,18,424,442,424,0,442,461,-25,280,616,5,4,18,172,193,316,28,1318,172
1562,27,4.4.461,0,615,2,55,461,516,461,0,516,516,-62,317,653,5,4,55,172,207,316,28,1318,172
1562,28,3.4.498,1,571,0,18,498,516,424,74,516,516,0,255,591,5,5,18,73,193,316,29,1318,73
1562,28,4.4.498,0,571,0,55,498,553,461,37,553,553,0,255,591,5,5,55,73,207,316,29,1318,73
1562,29,4.4.516,1,571,0,55,516,571,461,55,571,571,0,255,591,5,6,55,55,207,316,30,1318,55
1563,0,0.0.0,0,549,0,42,0,42,0,0,42,42,0,0,0,1,1,239,339,239,339,1,1585,1585
1563,0,1.0.0,1,560,1,14,0,14,0,0,14,14,0,0,0,1,1,232,339,232,339,1,1585,1585
1563,0,2.0.0,0,588,2,61,0,61,0,0,61,61,0,0,0,1,1,338,339,338,339,1,1585,1585
1563,0,3.0.0,0,602,3,58,0,58,0,0,58,58,0,0,0,1,1,252,339,252,339,1,1585,1585
1563,0,4.0.0,0,628,5,82,0,82,0,0,82,82,0,0,0,1,1,246,339,246,339,1,1585,1585
1563,0,5.0.0,0,613,4,82,0,82,0,0,82,82,0,0,0,1,1,278,339,278,339,1,1585,1585
1563,1,0.0.14,0,560,0,42,14,56,0,14,56,56,0,0,0,1,2,239,325,239,339,2,1585,1571
1563,1,1.1.14,0,560,0,77,14,91,14,0,91,91,-14,14,14,2,1,218,361,232,361,2,1585,1571
1563,1,2.0.14,1,560,0,61,14,75,0,14,75,75,0,0,0,1,2,338,325,338,339,2,1585,1571
1563,1,3.0.14,0,571,1,58,14,72,0,14,72,72,0,0,0,1,2,252,325,252,339,2,1585,1571
1563,1,4.0.14,0,582,2,82,14,96,0,14,96,96,0,0,0,1,2,246,325,246,339,2,1585,1571
1563,1,5.0.14,0,587,3,82,14,96,0,14,96,96,0,0,0,1,2,278,325,278,339,2,1585,1571
1563,2,0.0.75,1,560,0,42,75,117,0,75,117,117,0,0,0,1,3,239,264,239,339,3,1585,1510
1563,2,1.1.14,0,560,0,77,14,91,14,0,91,91,-14,14,14,2,1,218,361,232,361,3,1585,1510
1563,2,2.1.75,0,640,2,96,75,171,75,0,171,171,-75,75,75,2,1,277,361,338,361,3,1585,1510
1563,2,3.0.75,0,603,1,58,75,133,0,75,133,133,0,0,0,1,3,252,264,252,339,3,1585,1510
1563,2,4.0.75,0,603,1,82,75,157,0,75,157,157,0,0,0,1,3,246,264,246,339,3,1585,1510
1563,2,5.0.75,0,603,1,82,75,157,0,75,157,157,0,0,0,1,3,278,264,278,339,3,1585,1510
1563,3,0.1.117,0,560,0,15,117,132,117,0,132,132,-117,117,117,2,1,197,361,239,361,4,1585,1468
1563,3,1.1.14,0,560,0,77,14,91,14,0,91,117,-14,14,14,2,1,218,361,232,361,4,1585,1468
1563,3,2.1.75,0,640,2,96,75,171,75,0,171,171,-75,75,75,2,1,277,361,338,361,4,1585,1468
1563,3,3.0.117,1,560,0,58,117,175,0,117,175,175,0,0,0,1,4,252,222,252,339,4,1585,1468
1563,3,4.0.117,0,569,1,82,117,199,0,117,199,199,0,0,0,1,4,246,222,246,339,4,1585,1468
1563,3,5.0.117,0,560,0,82,117,199,0,117,199,199,0,0,0,1,4,278,222,278,339,4,1585,1468
1563,4,0.1.117,0,560,0,15,117,132,117,0,132,175,-117,117,117,2,1,197,361,239,361,5,1585,1410
1563,4,1.1.14,0,560,0,77,14,91,14,0,91,175,-14,14,14,2,1,218,361,232,361,5,1585,1410
1563,4,2.1.75,0,640,3,96,75,171,75,0,171,175,-75,75,75,2,1,277,361,338,361,5,1585,1410
1563,4,3.1.175,0,601,2,75,175,250,175,0,250,250,-175,175,175,2,1,194,361,252,361,5,1585,1410
1563,4,4.0.175,0,569,1,82,175,257,0,175,257,257,0,0,0,1,5,246,164,246,339,5,1585,1410
1563,4,5.0.175,1,560,0,82,175,257,0,175,257,257,0,0,0,1,5,278,164,278,339,5,1585,1410
1563,5,0.1.117,0,560,0,15,117,132,117,0,132,257,-117,117,117,2,1,197,361,239,361,6,1585,1328
1563,5,1.1.14,0,560,0,77,14,91,14,0,91,257,-14,14,14,2,1,218,361,232,361,6,1585,1328
1563,5,2.1.75,0,640,2,96,75,171,75,0,171,257,-75,75,75,2,1,277,361,338,361,6,1585,1328
1563,5,3.1.175,0,601,1,75,175,250,175,0,250,257,-175,175,175,2,1,194,361,252,361,6,1585,1328
1563,5,4.0.257,1,560,0,82,257,339,0,257,339,339,0,0,0,1,6,246,82,246,339,6,1585,1328
1563,5,5.1.257,0,560,0,41,257,298,257,0,298,298,-257,257,257,2,1,196,361,278,361,6,1585,1328
1563,6,0.1.117,0,560,0,15,117,132,117,0,132,339,-117,117,117,2,1,197,361,239,361,7,1585,1246
1563,6,1.1.14,1,560,0,77,14,91,14,0,91,339,-14,14,14,2,1,218,361,232,361,7,1585,1246
1563,6,2.1.75,0,640,3,96,75,171,75,0,171,339,-75,75,75,2,1,277,361,338,361,7,1585,1246
1563,6,3.1.175,0,601,2,75,175,250,175,0,250,339,-175,175,175,2,1,194,361,252,361,7,1585,1246
1563,6,4.1.339,0,590,1,57,339,396,339,0,396,396,-339,339,339,2,1,164,361,246,361,7,1585,1246
1563,6,5.1.257,0,560,0,41,257,298,257,0,298,339,-257,257,257,2,1,196,361,278,361,7,1585,1246
1563,7,0.1.117,1,560,0,15,117,132,117,0,132,339,-26,40,40,2,2,197,284,239,361,8,1585,1169
1563,7,1.2.91,0,560,0,53,91,144,91,0,144,339,-91,91,105,3,1,141,412,232,412,8,1585,1169
1563,7,2.1.91,0,603,3,96,91,187,75,16,187,339,0,14,14,2,2,277,284,338,361,8,1585,1169
1563,7,3.1.175,0,601,2,75,175,250,175,0,250,339,-84,98,98,2,2,194,284,252,361,8,1585,1169
1563,7,4.1.339,0,590,1,57,339,396,339,0,396,396,-248,262,262,2,2,164,284,246,361,8,1585,1169
1563,7,5.1.257,0,560,0,41,257,298,257,0,298,339,-166,180,180,2,2,196,284,278,361,8,1585,1169
1563,8,0.2.132,0,601,2,97,132,229,132,0,229,339,-132,132,172,3,1,182,412,239,412,9,1585,1154
1563,8,1.2.91,0,560,0,53,91,144,91,0,144,339,-91,91,131,3,1,141,412,232,412,9,1585,1154
1563,8,2.1.132,1,560,0,96,132,228,75,57,228,339,0,40,40,2,3,277,269,338,361,9,1585,1154
1563,8,3.1.175,0,601,2,75,175,250,175,0,250,339,-43,83,83,2,3,194,269,252,361,9,1585,1154
1563,8,4.1.339,0,590,1,57,339,396,339,0,396,396,-207,247,247,2,3,164,269,246,361,9,1585,1154
1563,8,5.1.257,0,560,0,41,257,298,257,0,298,339,-125,165,165,2,3,196,269,278,361,9,1585,1154
1563,9,0.2.132,0,601,2,97,132,229,132,0,229,339,-132,132,172,3,1,182,412,239,412,10,1585,1058
1563,9,1.2.91,0,560,0,53,91,144,91,0,144,339,-91,91,131,3,1,141,412,232,412,10,1585,1058
1563,9,2.2.228,0,644,3,75,228,303,228,0,303,339,-228,228,268,3,1,181,412,338,412,10,1585,1058
1563,9,3.1.228,1,560,0,75,228,303,175,53,303,339,0,40,40,2,4,194,173,252,361,10,1585,1058
1563,9,4.1.339,0,590,1,57,339,396,339,0,396,396,-111,151,151,2,4,164,173,246,361,10,1585,1058
1563,9,5.1.257,0,560,0,41,257,298,257,0,298,339,-29,69,69,2,4,196,173,278,361,10,1585,1058
1563,10,0.2.132,0,601,1,97,132,229,132,0,229,339,-132,132,172,3,1,182,412,239,412,11,1585,983
1563,10,1.2.91,0,560,0,53,91,144,91,0,144,339,-91,91,131,3,1,141,412,232,412,11,1585,983
1563,10,2.2.228,0,644,3,75,228,303,228,0,303,339,-228,228,268,3,1,181,412,338,412,11,1585,983
1563,10,3.2.303,0,622,2,48,303,351,303,0,351,351,-303,303,343,3,1,119,412,252,412,11,1585,983
1563,10,4.1.339,0,601,1,57,339,396,339,0,396,396,-36,76,76,2,5,164,98,246,361,11,1585,983
1563,10,5.1.303,1,560,0,41,303,344,257,46,344,344,0,40,40,2,5,196,98,278,361,11,1585,983
1563,11,0.2.132,0,601,2,97,132,229,132,0,229,344,-132,132,172,3,1,182,412,239,412,12,1585,942
1563,11,1.2.91,0,560,0,53,91,144,91,0,144,344,-91,91,131,3,1,141,412,232,412,12,1585,942
1563,11,2.2.228,0,644,4,75,228,303,228,0,303,344,-228,228,268,3,1,181,412,338,412,12,1585,942
1563,11,3.2.303,0,622,3,48,303,351,303,0,351,351,-303,303,343,3,1,119,412,252,412,12,1585,942
1563,11,4.1.344,1,560,0,57,344,401,339,5,401,401,0,40,40,2,6,164,57,246,361,12,1585,942
1563,11,5.2.344,0,588,1,89,344,433,344,0,433,433,-344,344,384,3,1,155,412,278,412,12,1585,942
1563,12,0.2.132,0,601,2,97,132,229,132,0,229,401,-132,132,172,3,1,182,412,239,412,13,1585,885
1563,12,1.2.91,1,560,0,53,91,144,91,0,144,401,-91,91,131,3,1,141,412,232,412,13,1585,885
1563,12,2.2.228,0,644,5,75,228,303,228,0,303,401,-228,228,268,3,1,181,412,338,412,13,1585,885
1563,12,3.2.303,0,622,4,48,303,351,303,0,351,401,-303,303,343,3,1,119,412,252,412,13,1585,885
1563,12,4.2.401,0,606,3,50,401,451,401,0,451,451,-401,401,441,3,1,107,412,246,412,13,1585,885
1563,12,5.2.344,0,588,1,89,344,433,344,0,433,433,-344,344,384,3,1,155,412,278,412,13,1585,885
1563,13,0.2.144,0,560,0,97,144,241,132,12,241,401,0,91,131,3,2,182,359,239,412,14,1585,832
1563,13,1.3.144,1,560,0,79,144,223,144,0,223,401,-144,144,275,4,1,88,225,232,225,14,1585,832
1563,13,2.2.228,0,644,4,75,228,303,228,0,303,401,-84,175,215,3,2,181,359,338,412,14,1585,832
1563,13,3.2.303,0,622,3,48,303,351,303,0,351,401,-159,250,290,3,2,119,359,252,412,14,1585,832
1563,13,4.2.401,0,606,2,50,401,451,401,0,451,451,-257,348,388,3,2,107,359,246,412,14,1585,832
1563,13,5.2.344,0,588,1,89,344,433,344,0,433,433,-200,291,331,3,2,155,359,278,412,14,1585,832
1563,14,0.2.144,0,560,0,97,144,241,132,12,241,401,0,91,275,3,2,182,359,239,412,15,1585,753
1563,14,1.4.223,1,560,0,9,223,232,223,0,232,401,-223,223,498,5,1,9,248,232,248,15,1585,753
1563,14,2.2.228,0,644,4,75,228,303,228,0,303,401,-84,175,359,3,2,181,359,338,412,15,1585,753
1563,14,3.2.303,0,622,3,48,303,351,303,0,351,401,-159,250,434,3,2,119,359,252,412,15,1585,753
1563,14,4.2.401,0,606,2,50,401,451,401,0,451,451,-257,348,532,3,2,107,359,246,412,15,1585,753
1563,14,5.2.344,0,588,1,89,344,433,344,0,433,433,-200,291,475,3,2,155,359,278,412,15,1585,753
1563,15,0.2.144,1,560,0,97,144,241,132,12,241,401,0,91,498,3,2,182,359,239,412,16,1585,744
1563,15,2.2.228,0,644,4,75,228,303,228,0,303,401,-84,175,582,3,2,181,359,338,412,16,1585,744
1563,15,3.2.303,0,622,3,48,303,351,303,0,351,401,-159,250,657,3,2,119,359,252,412,16,1585,744
1563,15,4.2.401,0,606,2,50,401,451,401,0,451,451,-257,348,755,3,2,107,359,246,412,16,1585,744
1563,15,5.2.344,0,588,1,89,344,433,344,0,433,433,-200,291,698,3,2,155,359,278,412,16,1585,744
1563,16,0.3.241,1,560,0,69,241,310,241,0,310,401,-18,162,516,4,2,85,146,239,225,17,1585,647
1563,16,2.2.241,0,560,0,75,241,316,228,13,316,401,0,91,498,3,3,181,262,338,412,17,1585,647
1563,16,3.2.303,0,622,3,48,303,351,303,0,351,401,-62,153,560,3,3,119,262,252,412,17,1585,647
1563,16,4.2.401,0,606,2,50,401,451,401,0,451,451,-160,251,658,3,3,107,262,246,412,17,1585,647
1563,16,5.2.344,0,588,1,89,344,433,344,0,433,433,-103,194,601,3,3,155,262,278,412,17,1585,647
1563,17,0.4.310,1,560,0,16,310,326,310,0,326,401,-78,301,594,5,2,16,239,239,248,18,1585,578
1563,17,2.2.241,0,560,0,75,241,316,228,13,316,401,0,91,516,3,3,181,262,338,412,18,1585,578
1563,17,3.2.303,0,622,3,48,303,351,303,0,351,401,-62,153,578,3,3,119,262,252,412,18,1585,578
1563,17,4.2.401,0,606,2,50,401,451,401,0,451,451,-160,251,676,3,3,107,262,246,412,18,1585,578
1563,17,5.2.344,0,588,1,89,344,433,344,0,433,433,-103,194,619,3,3,155,262,278,412,18,1585,578
1563,18,2.2.241,1,560,0,75,241,316,228,13,316,401,0,91,594,3,3,181,262,338,412,19,1585,562
1563,18,3.2.303,0,622,3,48,303,351,303,0,351,401,-62,153,656,3,3,119,262,252,412,19,1585,562
1563,18,4.2.401,0,606,2,50,401,451,401,0,451,451,-160,251,754,3,3,107,262,246,412,19,1585,562
1563,18,5.2.344,0,588,1,89,344,433,344,0,433,433,-103,194,697,3,3,155,262,278,412,19,1585,562
1563,19,2.3.316,1,560,0,8,316,324,316,0,324,401,-6,168,600,4,3,106,77,338,225,20,1585,487
1563,19,3.2.316,0,560,0,48,316,364,303,13,364,401,0,91,594,3,4,119,187,252,412,20,1585,487
1563,19,4.2.401,0,606,2,50,401,451,401,0,451,451,-85,176,679,3,4,107,187,246,412,20,1585,487
1563,19,5.2.344,0,588,1,89,344,433,344,0,433,433,-28,119,622,3,4,155,187,278,412,20,1585,487
1563,20,2.4.326,1,560,0,98,326,424,324,2,424,424,0,301,600,5,3,98,223,338,248,21,1585,479
1563,20,3.2.316,0,560,0,48,316,364,303,13,364,401,0,91,600,3,4,119,187,252,412,21,1585,479
1563,20,4.2.401,0,606,2,50,401,451,401,0,451,451,-85,176,685,3,4,107,187,246,412,21,1585,479
1563,20,5.2.344,0,588,1,89,344,433,344,0,433,433,-28,119,628,3,4,155,187,278,412,21,1585,479
1563,21,3.2.316,1,560,0,48,316,364,303,13,364,424,0,91,600,3,4,119,187,252,412,22,1585,381
1563,21,4.2.401,0,606,2,50,401,451,401,0,451,451,-85,176,685,3,4,107,187,246,412,22,1585,381
1563,21,5.2.344,0,588,1,89,344,433,344,0,433,433,-28,119,628,3,4,155,187,278,412,22,1585,381
1563,22,3.3.364,1,560,0,11,364,375,364,0,375,424,-40,208,640,4,4,71,69,252,225,23,1585,333
1563,22,4.2.401,0,606,1,50,401,451,401,0,451,451,-37,128,637,3,5,107,139,246,412,23,1585,333
1563,22,5.2.364,0,560,0,89,364,453,344,20,453,453,0,91,600,3,5,155,139,278,412,23,1585,333
1563,23,3.4.424,1,560,0,60,424,484,375,49,484,484,0,301,640,5,4,60,125,252,248,24,1585,322
1563,23,4.2.401,0,606,1,50,401,451,401,0,451,451,-37,128,677,3,5,107,139,246,412,24,1585,322
1563,23,5.2.364,0,560,0,89,364,453,344,20,453,453,0,91,640,3,5,155,139,278,412,24,1585,322
1563,24,4.2.401,0,606,1,50,401,451,401,0,451,484,-37,128,677,3,5,107,139,246,412,25,1585,262
1563,24,5.2.364,1,560,0,89,364,453,344,20,453,484,0,91,640,3,5,155,139,278,412,25,1585,262
1563,25,4.2.453,0,560,0,50,453,503,401,52,503,503,0,91,640,3,6,107,50,246,412,26,1585,173
1563,25,5.3.453,1,560,0,27,453,480,453,0,480,484,-78,286,718,4,5,66,58,278,225,26,1585,173
1563,26,4.2.453,0,560,0,50,453,503,401,52,503,503,0,91,718,3,6,107,50,246,412,27,1585,146
1563,26,5.4.484,1,560,0,39,484,523,480,4,523,523,0,301,718,5,5,39,65,278,248,27,1585,146
1563,27,4.2.453,1,560,0,50,453,503,401,52,503,523,0,91,718,3,6,107,50,246,412,28,1585,107
1563,28,4.3.503,1,560,0,31,503,534,503,0,534,534,-23,309,741,4,6,57,31,246,225,29,1585,57
1563,29,4.4.534,1,560,0,26,534,560,534,0,560,560,-11,312,752,5,6,26,26,246,248,30,1585,26
1564,0,0.0.0,0,459,3,55,0,55,0,0,55,55,0,0,0,1,1,283,254,283,254,1,1259,1259
1564,0,1.0.0,0,493,5,89,0,89,0,0,89,89,0,0,0,1,1,232,254,232,254,1,1259,1259
1564,0,2.0.0,1,411,1,7,0,7,0,0,7,7,0,0,0,1,1,265,254,265,254,1,1259,1259
1564,0,3.0.0,0,412,2,12,0,12,0,0,12,12,0,0,0,1,1,114,254,114,254,1,1259,1259
1564,0,4.0.0,0,404,0,4,0,4,0,0,4,4,0,0,0,1,1,183,254,183,254,1,1259,1259
1564,0,5.0.0,0,487,4,87,0,87,0,0,87,87,0,0,0,1,1,182,254,182,254,1,1259,1259
1564,1,0.0.7,0,458,2,55,7,62,0,7,62,62,0,0,0,1,2,283,247,283,254,2,1259,1252
1564,1,1.0.7,0,462,4,89,7,96,0,7,96,96,0,0,0,1,2,232,247,232,254,2,1259,1252
1564,1,2.1.7,0,458,2,89,7,96,7,0,96,96,-7,7,7,2,1,258,265,265,265,2,1259,1252
1564,1,3.0.7,0,419,1,12,7,19,0,7,19,19,0,0,0,1,2,114,247,114,254,2,1259,1252
1564,1,4.0.7,1,411,0,4,7,11,0,7,11,11,0,0,0,1,2,183,247,183,254,2,1259,1252
1564,1,5.0.7,0,460,3,87,7,94,0,7,94,94,0,0,0,1,2,182,247,182,254,2,1259,1252
1564,2,0.0.11,0,411,0,55,11,66,0,11,66,66,0,0,0,1,3,283,243,283,254,3,1259,1248
1564,2,1.0.11,0,416,1,89,11,100,0,11,100,100,0,0,0,1,3,232,243,232,254,3,1259,1248
1564,2,2.1.7,0,458,3,89,7,96,7,0,96,96,-7,7,7,2,1,258,265,265,265,3,1259,1248
1564,2,3.0.11,0,411,0,12,11,23,0,11,23,23,0,0,0,1,3,114,243,114,254,3,1259,1248
1564,2,4.1.11,1,411,0,9,11,20,11,0,20,20,-11,11,11,2,1,179,265,183,265,3,1259,1248
1564,2,5.0.11,0,422,2,87,11,98,0,11,98,98,0,0,0,1,3,182,243,182,254,3,1259,1248
1564,3,0.0.11,0,411,0,55,11,66,0,11,66,66,0,0,11,1,3,283,243,283,254,4,1259,1239
1564,3,1.0.11,0,416,1,89,11,100,0,11,100,100,0,0,11,1,3,232,243,232,254,4,1259,1239
1564,3,2.1.20,0,411,0,89,20,109,7,13,109,109,0,11,11,2,2,258,256,265,265,4,1259,1239
1564,3,3.0.11,0,411,0,12,11,23,0,11,23,23,0,0,11,1,3,114,243,114,254,4,1259,1239
1564,3,4.2.20,1,411,0,51,20,71,20,0,71,71,-20,20,31,3,1,170,183,183,183,4,1259,1239
1564,3,5.0.11,0,422,2,87,11,98,0,11,98,98,0,0,11,1,3,182,243,182,254,4,1259,1239
1564,4,0.0.11,0,411,0,55,11,66,0,11,66,71,0,0,31,1,3,283,243,283,254,5,1259,1188
1564,4,1.0.11,0,416,1,89,11,100,0,11,100,100,0,0,31,1,3,232,243,232,254,5,1259,1188
1564,4,2.1.20,0,411,0,89,20,109,7,13,109,109,0,11,31,2,2,258,256,265,265,5,1259,1188
1564,4,3.0.11,0,411,0,12,11,23,0,11,23,71,0,0,31,1,3,114,243,114,254,5,1259,1188
1564,4,4.3.71,1,411,0,24,71,95,71,0,95,95,-71,71,102,4,1,119,279,183,279,5,1259,1188
1564,4,5.0.11,0,422,2,87,11,98,0,11,98,98,0,0,31,1,3,182,243,182,254,5,1259,1188
1564,5,0.0.11,0,411,0,55,11,66,0,11,66,95,0,0,102,1,3,283,243,283,254,6,1259,1164
1564,5,1.0.11,0,416,1,89,11,100,0,11,100,100,0,0,102,1,3,232,243,232,254,6,1259,1164
1564,5,2.1.20,0,411,0,89,20,109,7,13,109,109,0,11,102,2,2,258,256,265,265,6,1259,1164
1564,5,3.0.11,0,411,0,12,11,23,0,11,23,95,0,0,102,1,3,114,243,114,254,6,1259,1164
1564,5,4.4.95,1,411,0,95,95,190,95,0,190,190,-95,95,197,5,1,95,278,183,278,6,1259,1164
1564,5,5.0.11,0,422,2,87,11,98,0,11,98,98,0,0,102,1,3,182,243,182,254,6,1259,1164
1564,6,0.0.11,0,411,0,55,11,66,0,11,66,190,0,0,197,1,3,283,243,283,254,7,1259,1069
1564,6,1.0.11,0,416,1,89,11,100,0,11,100,190,0,0,197,1,3,232,243,232,254,7,1259,1069
1564,6,2.1.20,1,411,0,89,20,109,7,13,109,190,0,11,197,2,2,258,256,265,265,7,1259,1069
1564,6,3.0.11,0,411,0,12,11,23,0,11,23,190,0,0,197,1,3,114,243,114,254,7,1259,1069
1564,6,5.0.11,0,422,2,87,11,98,0,11,98,190,0,0,197,1,3,182,243,182,254,7,1259,1069
1564,7,0.0.11,0,411,0,55,11,66,0,11,66,190,0,0,197,1,3,283,243,283,254,8,1259,980
1564,7,1.0.11,0,416,1,89,11,100,0,11,100,190,0,0,197,1,3,232,243,232,254,8,1259,980
1564,7,2.2.109,1,411,0,29,109,138,109,0,138,190,-38,58,235,3,2,169,132,265,183,8,1259,980
1564,7,3.0.11,0,411,0,12,11,23,0,11,23,190,0,0,197,1,3,114,243,114,254,8,1259,980
1564,7,5.0.11,0,422,2,87,11,98,0,11,98,190,0,0,197,1,3,182,243,182,254,8,1259,980
1564,8,0.0.11,0,411,0,55,11,66,0,11,66,190,0,0,235,1,3,283,243,283,254,9,1259,951
1564,8,1.0.11,0,416,1,89,11,100,0,11,100,190,0,0,235,1,3,232,243,232,254,9,1259,951
1564,8,2.3.138,1,411,0,76,138,214,138,0,214,214,-43,114,278,4,2,140,255,265,279,9,1259,951
1564,8,3.0.11,0,411,0,12,11,23,0,11,23,190,0,0,235,1,3,114,243,114,254,9,1259,951
1564,8,5.0.11,0,422,2,87,11,98,0,11,98,190,0,0,235,1,3,182,243,182,254,9,1259,951
1564,9,0.0.11,0,411,0,55,11,66,0,11,66,214,0,0,278,1,3,283,243,283,254,10,1259,875
1564,9,1.0.11,0,416,1,89,11,100,0,11,100,214,0,0,278,1,3,232,243,232,254,10,1259,875
1564,9,2.4.214,1,411,0,64,214,278,214,0,278,278,-24,119,302,5,2,64,183,265,278,10,1259,875
1564,9,3.0.11,0,411,0,12,11,23,0,11,23,214,0,0,278,1,3,114,243,114,254,10,1259,875
1564,9,5.0.11,0,422,2,87,11,98,0,11,98,214,0,0,278,1,3,182,243,182,254,10,1259,875
1564,10,0.0.11,1,411,0,55,11,66,0,11,66,278,0,0,302,1,3,283,243,283,254,11,1259,811
1564,10,1.0.11,0,416,1,89,11,100,0,11,100,278,0,0,302,1,3,232,243,232,254,11,1259,811
1564,10,3.0.11,0,411,0,12,11,23,0,11,23,278,0,0,302,1,3,114,243,114,254,11,1259,811
1564,10,5.0.11,0,422,2,87,11,98,0,11,98,278,0,0,302,1,3,182,243,182,254,11,1259,811
1564,11,0.1.109,1,411,0,83,109,192,66,43,192,278,0,11,302,2,3,228,167,283,265,12,1259,756
1564,11,1.0.66,0,412,1,89,66,155,0,66,155,278,0,0,302,1,4,232,188,232,254,12,1259,756
1564,11,3.0.66,0,411,0,12,66,78,0,66,78,278,0,0,302,1,4,114,188,114,254,12,1259,756
1564,11,5.0.66,0,411,0,87,66,153,0,66,153,278,0,0,302,1,4,182,188,182,254,12,1259,756
1564,12,0.2.192,1,411,0,1,192,193,192,0,193,278,-54,112,356,3,3,145,103,283,183,13,1259,673
1564,12,1.0.66,0,412,1,89,66,155,0,66,155,278,0,0,302,1,4,232,188,232,254,13,1259,673
1564,12,3.0.66,0,411,0,12,66,78,0,66,78,278,0,0,302,1,4,114,188,114,254,13,1259,673
1564,12,5.0.66,0,411,0,87,66,153,0,66,153,278,0,0,302,1,4,182,188,182,254,13,1259,673
1564,13,0.3.214,1,411,0,76,214,290,193,21,290,290,0,114,356,4,3,144,179,283,279,14,1259,672
1564,13,1.0.66,0,412,1,89,66,155,0,66,155,278,0,0,356,1,4,232,188,232,254,14,1259,672
1564,13,3.0.66,0,411,0,12,66,78,0,66,78,278,0,0,356,1,4,114,188,114,254,14,1259,672
1564,13,5.0.66,0,411,0,87,66,153,0,66,153,278,0,0,356,1,4,182,188,182,254,14,1259,672
1564,14,0.4.290,1,411,0,68,290,358,290,0,358,358,-12,131,368,5,3,68,119,283,278,15,1259,596
1564,14,1.0.66,0,412,1,89,66,155,0,66,155,290,0,0,356,1,4,232,188,232,254,15,1259,596
1564,14,3.0.66,0,411,0,12,66,78,0,66,78,290,0,0,356,1,4,114,188,114,254,15,1259,596
1564,14,5.0.66,0,411,0,87,66,153,0,66,153,290,0,0,356,1,4,182,188,182,254,15,1259,596
1564,15,1.0.66,0,412,1,89,66,155,0,66,155,358,0,0,368,1,4,232,188,232,254,16,1259,528
1564,15,3.0.66,1,411,0,12,66,78,0,66,78,358,0,0,368,1,4,114,188,114,254,16,1259,528
1564,15,5.0.66,0,411,0,87,66,153,0,66,153,358,0,0,368,1,4,182,188,182,254,16,1259,528
1564,16,1.0.78,0,412,1,89,78,167,0,78,167,358,0,0,368,1,5,232,176,232,254,17,1259,516
1564,16,3.1.192,1,411,0,14,192,206,78,114,206,358,0,11,368,2,4,102,84,114,265,17,1259,516
1564,16,5.0.78,0,411,0,87,78,165,0,78,165,358,0,0,368,1,5,182,176,182,254,17,1259,516
1564,17,1.0.78,0,421,1,89,78,167,0,78,167,358,0,0,368,1,5,232,176,232,254,18,1259,502
1564,17,3.2.206,1,411,0,16,206,222,206,0,222,358,-13,125,381,3,4,88,102,114,183,18,1259,502
1564,17,5.0.78,0,411,0,87,78,165,0,78,165,358,0,0,368,1,5,182,176,182,254,18,1259,502
1564,18,1.0.78,0,421,1,89,78,167,0,78,167,358,0,0,381,1,5,232,176,232,254,19,1259,486
1564,18,3.3.290,1,421,1,70,290,360,222,68,360,360,0,114,381,4,4,72,103,114,279,19,1259,486
1564,18,5.0.78,0,411,0,87,78,165,0,78,165,358,0,0,381,1,5,182,176,182,254,19,1259,486
1564,19,1.0.78,0,421,0,89,78,167,0,78,167,360,0,0,381,1,5,232,176,232,254,20,1259,416
1564,19,3.4.360,1,421,0,2,360,362,360,0,362,362,-2,133,383,5,4,2,51,114,278,20,1259,416
1564,19,5.0.78,0,421,0,87,78,165,0,78,165,360,0,0,381,1,5,182,176,182,254,20,1259,416
1564,20,1.0.78,1,421,0,89,78,167,0,78,167,362,0,0,383,1,5,232,176,232,254,21,1259,414
1564,20,5.0.78,0,421,0,87,78,165,0,78,165,362,0,0,383,1,5,182,176,182,254,21,1259,414
1564,21,1.1.206,1,421,0,46,206,252,167,39,252,362,0,11,383,2,5,143,70,232,265,22,1259,325
1564,21,5.0.167,0,421,0,87,167,254,0,167,254,362,0,0,383,1,6,182,87,182,254,22,1259,325
1564,22,1.2.252,1,421,0,58,252,310,252,0,310,362,-30,155,413,3,5,97,86,232,183,23,1259,279
1564,22,5.0.167,0,421,0,87,167,254,0,167,254,362,0,0,383,1,6,182,87,182,254,23,1259,279
1564,23,1.3.360,1,430,1,21,360,381,310,50,381,381,0,114,413,4,5,39,33,232,279,24,1259,221
1564,23,5.0.167,0,421,0,87,167,254,0,167,254,362,0,0,413,1,6,182,87,182,254,24,1259,221
1564,24,1.4.381,1,430,0,18,381,399,381,0,399,399,-19,152,432,5,5,18,49,232,278,25,1259,200
1564,24,5.0.167,0,430,0,87,167,254,0,167,254,381,0,0,413,1,6,182,87,182,254,25,1259,200
1564,25,5.0.167,1,430,0,87,167,254,0,167,254,399,0,0,432,1,6,182,87,182,254,26,1259,182
1564,26,5.1.254,1,430,0,24,254,278,254,0,278,399,-2,13,434,2,6,95,24,182,265,27,1259,95
1564,27,5.2.310,1,430,0,28,310,338,278,32,338,399,0,155,434,3,6,71,28,182,183,28,1259,71
1564,28,5.3.381,1,430,0,12,381,393,338,43,393,399,0,114,434,4,6,43,12,182,279,29,1259,43
1564,29,5.4.399,1,430,0,31,399,430,393,6,430,430,0,152,434,5,6,31,31,182,278,30,1259,31
1565,0,0.0.0,0,605,4,68,0,68,0,0,68,68,0,0,0,1,1,227,367,227,367,1,1527,1527
1565,0,1.0.0,0,594,2,65,0,65,0,0,65,65,0,0,0,1,1,234,367,234,367,1,1527,1527
1565,0,2.0.0,0,590,0,53,0,53,0,0,53,53,0,0,0,1,1,291,367,291,367,1,1527,1527
1565,0,3.0.0,0,597,3,64,0,64,0,0,64,64,0,0,0,1,1,270,367,270,367,1,1527,1527
1565,0,4.0.0,1,591,1,26,0,26,0,0,26,26,0,0,0,1,1,222,367,222,367,1,1527,1527
1565,0,5.0.0,0,594,2,91,0,91,0,0,91,91,0,0,0,1,1,283,367,283,367,1,1527,1527
1565,1,0.0.26,0,605,4,68,26,94,0,26,94,94,0,0,0,1,2,227,341,227,367,2,1527,1501
1565,1,1.0.26,0,594,2,65,26,91,0,26,91,91,0,0,0,1,2,234,341,234,367,2,1527,1501
1565,1,2.0.26,0,591,0,53,26,79,0,26,79,79,0,0,0,1,2,291,341,291,367,2,1527,1501
1565,1,3.0.26,0,600,3,64,26,90,0,26,90,90,0,0,0,1,2,270,341,270,367,2,1527,1501
1565,1,4.1.26,1,591,0,61,26,87,26,0,87,87,-26,26,26,2,1,196,269,222,269,2,1527,1501
1565,1,5.0.26,0,593,1,91,26,117,0,26,117,117,0,0,0,1,2,283,341,283,367,2,1527,1501
1565,2,0.0.26,0,605,4,68,26,94,0,26,94,94,0,0,26,1,2,227,341,227,367,3,1527,1440
1565,2,1.0.26,0,594,2,65,26,91,0,26,91,91,0,0,26,1,2,234,341,234,367,3,1527,1440
1565,2,2.0.26,0,591,0,53,26,79,0,26,79,87,0,0,26,1,2,291,341,291,367,3,1527,1440
1565,2,3.0.26,0,600,3,64,26,90,0,26,90,90,0,0,26,1,2,270,341,270,367,3,1527,1440
1565,2,4.2.87,1,591,0,52,87,139,87,0,139,139,-87,87,113,3,1,135,349,222,349,3,1527,1440
1565,2,5.0.26,0,593,1,91,26,117,0,26,117,117,0,0,26,1,2,283,341,283,367,3,1527,1440
1565,3,0.0.26,0,605,4,68,26,94,0,26,94,139,0,0,113,1,2,227,341,227,367,4,1527,1388
1565,3,1.0.26,0,594,2,65,26,91,0,26,91,139,0,0,113,1,2,234,341,234,367,4,1527,1388
1565,3,2.0.26,0,591,0,53,26,79,0,26,79,139,0,0,113,1,2,291,341,291,367,4,1527,1388
1565,3,3.0.26,0,600,3,64,26,90,0,26,90,139,0,0,113,1,2,270,341,270,367,4,1527,1388
1565,3,4.3.139,1,591,0,17,139,156,139,0,156,156,-139,139,252,4,1,83,333,222,333,4,1527,1388
1565,3,5.0.26,0,593,1,91,26,117,0,26,117,139,0,0,113,1,2,283,341,283,367,4,1527,1388
1565,4,0.0.26,0,605,4,68,26,94,0,26,94,156,0,0,252,1,2,227,341,227,367,5,1527,1371
1565,4,1.0.26,0,594,2,65,26,91,0,26,91,156,0,0,252,1,2,234,341,234,367,5,1527,1371
1565,4,2.0.26,0,591,0,53,26,79,0,26,79,156,0,0,252,1,2,291,341,291,367,5,1527,1371
1565,4,3.0.26,0,600,3,64,26,90,0,26,90,156,0,0,252,1,2,270,341,270,367,5,1527,1371
1565,4,4.4.156,1,591,0,66,156,222,156,0,222,222,-156,156,408,5,1,66,209,222,209,5,1527,1371
1565,4,5.0.26,0,593,1,91,26,117,0,26,117,156,0,0,252,1,2,283,341,283,367,5,1527,1371
1565,5,0.0.26,0,605,4,68,26,94,0,26,94,222,0,0,408,1,2,227,341,227,367,6,1527,1305
1565,5,1.0.26,0,594,2,65,26,91,0,26,91,222,0,0,408,1,2,234,341,234,367,6,1527,1305
1565,5,2.0.26,1,591,0,53,26,79,0,26,79,222,0,0,408,1,2,291,341,291,367,6,1527,1305
1565,5,3.0.26,0,600,3,64,26,90,0,26,90,222,0,0,408,1,2,270,341,270,367,6,1527,1305
1565,5,5.0.26,0,593,1,91,26,117,0,26,117,222,0,0,408,1,2,283,341,283,367,6,1527,1305
1565,6,0.0.79,0,594,1,68,79,147,0,79,147,222,0,0,408,1,3,227,288,227,367,7,1527,1252
1565,6,1.0.79,0,597,2,65,79,144,0,79,144,222,0,0,408,1,3,234,288,234,367,7,1527,1252
1565,6,2.1.87,1,591,0,83,87,170,79,8,170,222,0,26,408,2,2,238,208,291,269,7,1527,1252
1565,6,3.0.79,0,607,3,64,79,143,0,79,143,222,0,0,408,1,3,270,288,270,367,7,1527,1252
1565,6,5.0.79,0,591,0,91,79,170,0,79,170,222,0,0,408,1,3,283,288,283,367,7,1527,1252
1565,7,0.0.79,0,594,1,68,79,147,0,79,147,222,0,0,408,1,3,227,288,227,367,8,1527,1169
1565,7,1.0.79,0,597,2,65,79,144,0,79,144,222,0,0,408,1,3,234,288,234,367,8,1527,1169
1565,7,2.2.170,1,594,1,81,170,251,170,0,251,251,-31,118,439,3,2,155,297,291,349,8,1527,1169
1565,7,3.0.79,0,607,3,64,79,143,0,79,143,222,0,0,408,1,3,270,288,270,367,8,1527,1169
1565,7,5.0.79,0,591,0,91,79,170,0,79,170,222,0,0,408,1,3,283,288,283,367,8,1527,1169
1565,8,0.0.79,0,594,0,68,79,147,0,79,147,251,0,0,439,1,3,227,288,227,367,9,1527,1088
1565,8,1.0.79,0,597,2,65,79,144,0,79,144,251,0,0,439,1,3,234,288,234,367,9,1527,1088
1565,8,2.3.251,1,594,0,45,251,296,251,0,296,296,-95,234,534,4,2,74,316,291,333,9,1527,1088
1565,8,3.0.79,0,607,3,64,79,143,0,79,143,251,0,0,439,1,3,270,288,270,367,9,1527,1088
1565,8,5.0.79,0,596,1,91,79,170,0,79,170,251,0,0,439,1,3,283,288,283,367,9,1527,1088
1565,9,0.0.79,0,594,0,68,79,147,0,79,147,296,0,0,534,1,3,227,288,227,367,10,1527,1043
1565,9,1.0.79,0,597,2,65,79,144,0,79,144,296,0,0,534,1,3,234,288,234,367,10,1527,1043
1565,9,2.4.296,1,594,0,29,296,325,296,0,325,325,-74,230,608,5,2,29,143,291,209,10,1527,1043
1565,9,3.0.79,0,607,3,64,79,143,0,79,143,296,0,0,534,1,3,270,288,270,367,10,1527,1043
1565,9,5.0.79,0,596,1,91,79,170,0,79,170,296,0,0,534,1,3,283,288,283,367,10,1527,1043
1565,10,0.0.79,0,594,0,68,79,147,0,79,147,325,0,0,608,1,3,227,288,227,367,11,1527,1014
1565,10,1.0.79,0,597,2,65,79,144,0,79,144,325,0,0,608,1,3,234,288,234,367,11,1527,1014
1565,10,3.0.79,1,607,3,64,79,143,0,79,143,325,0,0,608,1,3,270,288,270,367,11,1527,1014
1565,10,5.0.79,0,596,1,91,79,170,0,79,170,325,0,0,608,1,3,283,288,283,367,11,1527,1014
1565,11,0.0.143,0,607,0,68,143,211,0,143,211,325,0,0,608,1,4,227,224,227,367,12,1527,950
1565,11,1.0.143,0,608,1,65,143,208,0,143,208,325,0,0,608,1,4,234,224,234,367,12,1527,950
1565,11,3.1.170,1,607,0,52,170,222,143,27,222,325,0,26,608,2,3,206,125,270,269,12,1527,950
1565,11,5.0.143,0,609,2,91,143,234,0,143,234,325,0,0,608,1,4,283,224,283,367,12,1527,950
1565,12,0.0.143,0,607,0,68,143,211,0,143,211,325,0,0,608,1,4,227,224,227,367,13,1527,898
1565,12,1.0.143,0,608,1,65,143,208,0,143,208,325,0,0,608,1,4,234,224,234,367,13,1527,898
1565,12,3.2.251,1,626,3,82,251,333,222,29,333,333,0,118,608,3,3,154,216,270,349,13,1527,898
1565,12,5.0.143,0,609,2,91,143,234,0,143,234,325,0,0,608,1,4,283,224,283,367,13,1527,898
1565,13,0.0.143,0,626,0,68,143,211,0,143,211,333,0,0,608,1,4,227,224,227,367,14,1527,816
1565,13,1.0.143,0,626,0,65,143,208,0,143,208,333,0,0,608,1,4,234,224,234,367,14,1527,816
1565,13,3.3.333,1,626,0,29,333,362,333,0,362,362,-37,271,645,4,3,72,271,270,333,14,1527,816
1565,13,5.0.143,0,629,1,91,143,234,0,143,234,333,0,0,608,1,4,283,224,283,367,14,1527,816
1565,14,0.0.143,0,626,0,68,143,211,0,143,211,362,0,0,645,1,4,227,224,227,367,15,1527,787
1565,14,1.0.143,0,626,0,65,143,208,0,143,208,362,0,0,645,1,4,234,224,234,367,15,1527,787
1565,14,3.4.362,1,626,0,43,362,405,362,0,405,405,-37,267,682,5,3,43,114,270,209,15,1527,787
1565,14,5.0.143,0,629,1,91,143,234,0,143,234,362,0,0,645,1,4,283,224,283,367,15,1527,787
1565,15,0.0.143,0,626,0,68,143,211,0,143,211,405,0,0,682,1,4,227,224,227,367,16,1527,744
1565,15,1.0.143,1,626,0,65,143,208,0,143,208,405,0,0,682,1,4,234,224,234,367,16,1527,744
1565,15,5.0.143,0,629,1,91,143,234,0,143,234,405,0,0,682,1,4,283,224,283,367,16,1527,744
1565,16,0.0.208,0,626,0,68,208,276,0,208,276,405,0,0,682,1,5,227,159,227,367,17,1527,679
1565,16,1.1.222,1,626,0,14,222,236,208,14,236,405,0,26,682,2,4,169,73,234,269,17,1527,679
1565,16,5.0.208,0,661,1,91,208,299,0,208,299,405,0,0,682,1,5,283,159,283,367,17,1527,679
1565,17,0.0.208,0,626,0,68,208,276,0,208,276,405,0,0,682,1,5,227,159,227,367,18,1527,665
1565,17,1.2.333,1,661,1,64,333,397,236,97,397,405,0,118,682,3,4,155,134,234,349,18,1527,665
1565,17,5.0.208,0,661,1,91,208,299,0,208,299,405,0,0,682,1,5,283,159,283,367,18,1527,665
1565,18,0.0.208,1,661,0,68,208,276,0,208,276,405,0,0,682,1,5,227,159,227,367,19,1527,601
1565,18,1.3.397,0,661,0,63,397,460,397,0,460,460,-35,306,717,4,4,91,242,234,333,19,1527,601
1565,18,5.0.208,0,661,0,91,208,299,0,208,299,405,0,0,682,1,5,283,159,283,367,19,1527,601
1565,19,0.1.276,0,661,0,51,276,327,276,0,327,405,-40,66,722,2,5,159,59,227,269,20,1527,533
1565,19,1.3.397,0,661,0,63,397,460,397,0,460,460,-35,306,717,4,4,91,242,234,333,20,1527,533
1565,19,5.0.276,1,661,0,91,276,367,0,276,367,405,0,0,682,1,6,283,91,283,367,20,1527,533
1565,20,0.1.276,1,661,0,51,276,327,276,0,327,405,-40,66,722,2,5,159,59,227,269,21,1527,442
1565,20,1.3.397,0,661,0,63,397,460,397,0,460,460,-35,306,717,4,4,91,242,234,333,21,1527,442
1565,20,5.1.367,0,661,0,8,367,375,367,0,375,405,-131,157,813,2,5,192,59,283,269,21,1527,442
1565,21,0.2.397,0,661,0,4,397,401,327,70,401,405,0,118,722,3,5,108,70,227,349,22,1527,391
1565,21,1.3.397,0,661,0,63,397,460,397,0,460,460,-35,306,757,4,4,91,242,234,333,22,1527,391
1565,21,5.1.367,1,661,0,8,367,375,367,0,375,405,-40,106,762,2,6,192,8,283,269,22,1527,391
1565,22,0.2.397,1,661,0,4,397,401,327,70,401,405,0,118,762,3,5,108,70,227,349,23,1527,383
1565,22,1.3.397,0,661,0,63,397,460,397,0,460,460,-35,306,797,4,4,91,242,234,333,23,1527,383
1565,22,5.2.397,0,663,1,66,397,463,375,22,463,463,0,118,762,3,5,184,70,283,349,23,1527,383
1565,23,0.3.401,0,665,1,83,401,484,401,0,484,484,-39,310,801,4,4,104,242,227,333,24,1527,379
1565,23,1.3.397,0,661,0,63,397,460,397,0,460,460,-35,306,797,4,4,91,242,234,333,24,1527,379
1565,23,5.2.401,1,661,0,66,401,467,375,26,467,467,0,118,762,3,6,184,66,283,349,24,1527,379
1565,24,0.3.401,0,665,1,83,401,484,401,0,484,484,-39,310,801,4,4,104,242,227,333,25,1527,313
1565,24,1.3.397,1,661,0,63,397,460,397,0,460,467,-35,306,797,4,4,91,242,234,333,25,1527,313
1565,24,5.3.467,0,667,2,96,467,563,467,0,563,563,-105,376,867,4,4,118,242,283,333,25,1527,313
1565,25,0.3.460,0,661,0,83,460,543,401,59,543,543,0,306,797,4,5,104,179,227,333,26,1527,250
1565,25,1.4.460,1,661,0,28,460,488,460,0,488,488,-55,322,852,5,4,28,71,234,209,26,1527,250
1565,25,5.3.467,0,667,1,96,467,563,467,0,563,563,-7,313,804,4,5,118,179,283,333,26,1527,250
1565,26,0.3.460,1,661,0,83,460,543,401,59,543,543,0,306,852,4,5,104,179,227,333,27,1527,222
1565,26,5.3.467,0,667,1,96,467,563,467,0,563,563,-7,313,859,4,5,118,179,283,333,27,1527,222
1565,27,0.4.543,1,661,0,21,543,564,543,0,564,564,-55,377,907,5,5,21,43,227,209,28,1527,139
1565,27,5.3.543,0,661,0,96,543,639,467,76,639,639,0,306,852,4,6,118,96,283,333,28,1527,139
1565,28,5.3.543,1,661,0,96,543,639,467,76,639,639,0,306,907,4,6,118,96,283,333,29,1527,118
1565,29,5.4.639,1,661,0,22,639,661,639,0,661,661,-75,452,982,5,6,22,22,283,209,30,1527,22
1566,0,0.0.0,0,585,1,81,0,81,0,0,81,81,0,0,0,1,1,270,382,270,382,1,1592,1592
1566,0,1.0.0,0,589,3,41,0,41,0,0,41,41,0,0,0,1,1,233,382,233,382,1,1592,1592
1566,0,2.0.0,0,595,4,98,0,98,0,0,98,98,0,0,0,1,1,316,382,316,382,1,1592,1592
1566,0,3.0.0,1,571,0,18,0,18,0,0,18,18,0,0,0,1,1,329,382,329,382,1,1592,1592
1566,0,4.0.0,0,587,2,48,0,48,0,0,48,48,0,0,0,1,1,159,382,159,382,1,1592,1592
1566,0,5.0.0,0,658,5,96,0,96,0,0,96,96,0,0,0,1,1,285,382,285,382,1,1592,1592
1566,1,0.0.18,0,571,0,81,18,99,0,18,99,99,0,0,0,1,2,270,364,270,382,2,1592,1574
1566,1,1.0.18,0,582,2,41,18,59,0,18,59,59,0,0,0,1,2,233,364,233,382,2,1592,1574
1566,1,2.0.18,0,577,1,98,18,116,0,18,116,116,0,0,0,1,2,316,364,316,382,2,1592,1574
1566,1,3.1.18,1,571,0,90,18,108,18,0,108,108,-18,18,18,2,1,311,369,329,369,2,1592,1574
1566,1,4.0.18,0,582,2,48,18,66,0,18,66,66,0,0,0,1,2,159,364,159,382,2,1592,1574
1566,1,5.0.18,0,582,2,96,18,114,0,18,114,114,0,0,0,1,2,285,364,285,382,2,1592,1574
1566,2,0.0.18,0,571,0,81,18,99,0,18,99,108,0,0,18,1,2,270,364,270,382,3,1592,1484
1566,2,1.0.18,0,582,2,41,18,59,0,18,59,108,0,0,18,1,2,233,364,233,382,3,1592,1484
1566,2,2.0.18,0,577,1,98,18,116,0,18,116,116,0,0,18,1,2,316,364,316,382,3,1592,1484
1566,2,3.2.108,1,577,1,50,108,158,108,0,158,158,-108,108,126,3,1,221,218,329,218,3,1592,1484
1566,2,4.0.18,0,582,2,48,18,66,0,18,66,108,0,0,18,1,2,159,364,159,382,3,1592,1484
1566,2,5.0.18,0,582,2,96,18,114,0,18,114,114,0,0,18,1,2,285,364,285,382,3,1592,1484
1566,3,0.0.18,0,582,1,81,18,99,0,18,99,158,0,0,126,1,2,270,364,270,382,4,1592,1434
1566,3,1.0.18,0,582,1,41,18,59,0,18,59,158,0,0,126,1,2,233,364,233,382,4,1592,1434
1566,3,2.0.18,0,577,0,98,18,116,0,18,116,158,0,0,126,1,2,316,364,316,382,4,1592,1434
1566,3,3.3.158,1,582,1,87,158,245,158,0,245,245,-158,158,284,4,1,171,286,329,286,4,1592,1434
1566,3,4.0.18,0,582,1,48,18,66,0,18,66,158,0,0,126,1,2,159,364,159,382,4,1592,1434
1566,3,5.0.18,0,582,1,96,18,114,0,18,114,158,0,0,126,1,2,285,364,285,382,4,1592,1434
1566,4,0.0.18,0,582,0,81,18,99,0,18,99,245,0,0,284,1,2,270,364,270,382,5,1592,1347
1566,4,1.0.18,0,582,0,41,18,59,0,18,59,245,0,0,284,1,2,233,364,233,382,5,1592,1347
1566,4,2.0.18,0,582,0,98,18,116,0,18,116,245,0,0,284,1,2,316,364,316,382,5,1592,1347
1566,4,3.4.245,1,582,0,84,245,329,245,0,329,329,-245,245,529,5,1,84,337,329,337,5,1592,1347
1566,4,4.0.18,0,582,0,48,18,66,0,18,66,245,0,0,284,1,2,159,364,159,382,5,1592,1347
1566,4,5.0.18,0,582,0,96,18,114,0,18,114,245,0,0,284,1,2,285,364,285,382,5,1592,1347
1566,5,0.0.18,0,582,0,81,18,99,0,18,99,329,0,0,529,1,2,270,364,270,382,6,1592,1263
1566,5,1.0.18,1,582,0,41,18,59,0,18,59,329,0,0,529,1,2,233,364,233,382,6,1592,1263
1566,5,2.0.18,0,582,0,98,18,116,0,18,116,329,0,0,529,1,2,316,364,316,382,6,1592,1263
1566,5,4.0.18,0,582,0,48,18,66,0,18,66,329,0,0,529,1,2,159,364,159,382,6,1592,1263
1566,5,5.0.18,0,582,0,96,18,114,0,18,114,329,0,0,529,1,2,285,364,285,382,6,1592,1263
1566,6,0.0.59,0,582,0,81,59,140,0,59,140,329,0,0,529,1,3,270,323,270,382,7,1592,1222
1566,6,1.1.108,1,582,0,81,108,189,59,49,189,329,0,18,529,2,2,192,279,233,369,7,1592,1222
1566,6,2.0.59,0,582,0,98,59,157,0,59,157,329,0,0,529,1,3,316,323,316,382,7,1592,1222
1566,6,4.0.59,0,582,0,48,59,107,0,59,107,329,0,0,529,1,3,159,323,159,382,7,1592,1222
1566,6,5.0.59,0,592,1,96,59,155,0,59,155,329,0,0,529,1,3,285,323,285,382,7,1592,1222
1566,7,0.0.59,0,582,0,81,59,140,0,59,140,329,0,0,529,1,3,270,323,270,382,8,1592,1141
1566,7,1.2.189,1,582,0,69,189,258,189,0,258,329,-31,139,560,3,2,111,168,233,218,8,1592,1141
1566,7,2.0.59,0,582,0,98,59,157,0,59,157,329,0,0,529,1,3,316,323,316,382,8,1592,1141
1566,7,4.0.59,0,582,0,48,59,107,0,59,107,329,0,0,529,1,3,159,323,159,382,8,1592,1141
1566,7,5.0.59,0,592,1,96,59,155,0,59,155,329,0,0,529,1,3,285,323,285,382,8,1592,1141
1566,8,0.0.59,0,582,0,81,59,140,0,59,140,329,0,0,560,1,3,270,323,270,382,9,1592,1072
1566,8,1.3.258,1,582,0,5,258,263,258,0,263,329,-13,171,573,4,2,42,199,233,286,9,1592,1072
1566,8,2.0.59,0,582,0,98,59,157,0,59,157,329,0,0,560,1,3,316,323,316,382,9,1592,1072
1566,8,4.0.59,0,582,0,48,59,107,0,59,107,329,0,0,560,1,3,159,323,159,382,9,1592,1072
1566,8,5.0.59,0,592,1,96,59,155,0,59,155,329,0,0,560,1,3,285,323,285,382,9,1592,1072
1566,9,0.0.59,0,582,0,81,59,140,0,59,140,329,0,0,573,1,3,270,323,270,382,10,1592,1067
1566,9,1.4.329,1,582,0,37,329,366,263,66,366,366,0,245,573,5,2,37,253,233,337,10,1592,1067
1566,9,2.0.59,0,582,0,98,59,157,0,59,157,329,0,0,573,1,3,316,323,316,382,10,1592,1067
1566,9,4.0.59,0,582,0,48,59,107,0,59,107,329,0,0,573,1,3,159,323,159,382,10,1592,1067
1566,9,5.0.59,0,592,1,96,59,155,0,59,155,329,0,0,573,1,3,285,323,285,382,10,1592,1067
1566,10,0.0.59,0,582,0,81,59,140,0,59,140,366,0,0,573,1,3,270,323,270,382,11,1592,1030
1566,10,2.0.59,1,582,0,98,59,157,0,59,157,366,0,0,573,1,3,316,323,316,382,11,1592,1030
1566,10,4.0.59,0,582,0,48,59,107,0,59,107,366,0,0,573,1,3,159,323,159,382,11,1592,1030
1566,10,5.0.59,0,592,1,96,59,155,0,59,155,366,0,0,573,1,3,285,323,285,382,11,1592,1030
1566,11,0.0.157,0,582,0,81,157,238,0,157,238,366,0,0,573,1,4,270,225,270,382,12,1592,932
1566,11,2.1.189,1,582,0,76,189,265,157,32,265,366,0,18,573,2,3,218,198,316,369,12,1592,932
1566,11,4.0.157,0,582,0,48,157,205,0,157,205,366,0,0,573,1,4,159,225,159,382,12,1592,932
1566,11,5.0.157,0,582,0,96,157,253,0,157,253,366,0,0,573,1,4,285,225,285,382,12,1592,932
1566,12,0.0.157,0,582,0,81,157,238,0,157,238,366,0,0,573,1,4,270,225,270,382,13,1592,856
1566,12,2.2.265,1,582,0,34,265,299,265,0,299,366,-7,146,580,3,3,142,99,316,218,13,1592,856
1566,12,4.0.157,0,582,0,48,157,205,0,157,205,366,0,0,573,1,4,159,225,159,382,13,1592,856
1566,12,5.0.157,0,582,0,96,157,253,0,157,253,366,0,0,573,1,4,285,225,285,382,13,1592,856
1566,13,0.0.157,0,582,0,81,157,238,0,157,238,366,0,0,580,1,4,270,225,270,382,14,1592,822
1566,13,2.3.299,1,582,0,14,299,313,299,0,313,366,-36,207,616,4,3,108,194,316,286,14,1592,822
1566,13,4.0.157,0,582,0,48,157,205,0,157,205,366,0,0,580,1,4,159,225,159,382,14,1592,822
1566,13,5.0.157,0,582,0,96,157,253,0,157,253,366,0,0,580,1,4,285,225,285,382,14,1592,822
1566,14,0.0.157,0,582,0,81,157,238,0,157,238,366,0,0,616,1,4,270,225,270,382,15,1592,808
1566,14,2.4.366,1,582,0,94,366,460,313,53,460,460,0,245,616,5,3,94,216,316,337,15,1592,808
1566,14,4.0.157,0,582,0,48,157,205,0,157,205,366,0,0,616,1,4,159,225,159,382,15,1592,808
1566,14,5.0.157,0,582,0,96,157,253,0,157,253,366,0,0,616,1,4,285,225,285,382,15,1592,808
1566,15,0.0.157,1,582,0,81,157,238,0,157,238,460,0,0,616,1,4,270,225,270,382,16,1592,714
1566,15,4.0.157,0,582,0,48,157,205,0,157,205,460,0,0,616,1,4,159,225,159,382,16,1592,714
1566,15,5.0.157,0,582,0,96,157,253,0,157,253,460,0,0,616,1,4,285,225,285,382,16,1592,714
1566,16,0.1.265,1,582,0,19,265,284,238,27,284,460,0,18,616,2,4,189,122,270,369,17,1592,633
1566,16,4.0.238,0,582,0,48,238,286,0,238,286,460,0,0,616,1,5,159,144,159,382,17,1592,633
1566,16,5.0.238,0,582,0,96,238,334,0,238,334,460,0,0,616,1,5,285,144,285,382,17,1592,633
1566,17,0.2.299,1,582,0,8,299,307,284,15,307,460,0,146,616,3,4,170,65,270,218,18,1592,614
1566,17,4.0.238,0,582,0,48,238,286,0,238,286,460,0,0,616,1,5,159,144,159,382,18,1592,614
1566,17,5.0.238,0,582,0,96,238,334,0,238,334,460,0,0,616,1,5,285,144,285,382,18,1592,614
1566,18,0.3.313,1,582,0,89,313,402,307,6,402,460,0,207,616,4,4,162,180,270,286,19,1592,606
1566,18,4.0.238,0,582,0,48,238,286,0,238,286,460,0,0,616,1,5,159,144,159,382,19,1592,606
1566,18,5.0.238,0,582,0,96,238,334,0,238,334,460,0,0,616,1,5,285,144,285,382,19,1592,606
1566,19,0.4.460,1,582,0,73,460,533,402,58,533,533,0,245,616,5,4,73,122,270,337,20,1592,517
1566,19,4.0.238,0,582,0,48,238,286,0,238,286,460,0,0,616,1,5,159,144,159,382,20,1592,517
1566,19,5.0.238,0,582,0,96,238,334,0,238,334,460,0,0,616,1,5,285,144,285,382,20,1592,517
1566,20,4.0.238,0,582,0,48,238,286,0,238,286,533,0,0,616,1,5,159,144,159,382,21,1592,444
1566,20,5.0.238,1,582,0,96,238,334,0,238,334,533,0,0,616,1,5,285,144,285,382,21,1592,444
1566,21,4.0.334,1,582,0,48,334,382,0,334,382,533,0,0,616,1,6,159,48,159,382,22,1592,348
1566,21,5.1.334,0,582,0,90,334,424,334,0,424,533,-50,68,666,2,5,189,103,285,369,22,1592,348
1566,22,4.1.382,0,584,1,13,382,395,382,0,395,533,-98,116,714,2,5,111,103,159,369,23,1592,300
1566,22,5.1.334,1,582,0,90,334,424,334,0,424,533,-50,68,666,2,5,189,103,285,369,23,1592,300
1566,23,4.1.424,0,582,0,13,424,437,382,42,437,533,0,68,666,2,6,111,13,159,369,24,1592,210
1566,23,5.2.424,1,582,0,5,424,429,424,0,429,533,-117,263,783,3,5,99,57,285,218,24,1592,210
1566,24,4.1.424,0,582,0,13,424,437,382,42,437,533,0,68,783,2,6,111,13,159,369,25,1592,205
1566,24,5.3.429,1,582,0,81,429,510,429,0,510,533,-27,234,810,4,5,94,91,285,286,25,1592,205
1566,25,4.1.424,0,582,0,13,424,437,382,42,437,533,0,68,810,2,6,111,13,159,369,26,1592,124
1566,25,5.4.533,1,582,0,13,533,546,510,23,546,546,0,245,810,5,5,13,49,285,337,26,1592,124
1566,26,4.1.424,1,582,0,13,424,437,382,42,437,546,0,68,810,2,6,111,13,159,369,27,1592,111
1566,27,4.2.437,1,582,0,52,437,489,437,0,489,546,-8,271,818,3,6,98,52,159,218,28,1592,98
1566,28,4.3.510,1,582,0,10,510,520,489,21,520,546,0,234,818,4,6,46,10,159,286,29,1592,46
1566,29,4.4.546,1,582,0,36,546,582,520,26,582,582,0,245,818,5,6,36,36,159,337,30,1592,36
1567,0,0.0.0,0,571,4,95,0,95,0,0,95,95,0,0,0,1,1,314,298,314,298,1,1463,1463
1567,0,1.0.0,0,519,1,17,0,17,0,0,17,17,0,0,0,1,1,232,298,232,298,1,1463,1463
1567,0,2.0.0,1,544,2,44,0,44,0,0,44,44,0,0,0,1,1,343,298,343,298,1,1463,1463
1567,0,3.0.0,0,563,3,71,0,71,0,0,71,71,0,0,0,1,1,190,298,190,298,1,1463,1463
1567,0,4.0.0,0,586,5,69,0,69,0,0,69,69,0,0,0,1,1,197,298,197,298,1,1463,1463
1567,0,5.0.0,0,517,0,2,0,2,0,0,2,2,0,0,0,1,1,187,298,187,298,1,1463,1463
1567,1,0.0.44,0,548,1,95,44,139,0,44,139,139,0,0,0,1,2,314,254,314,298,2,1463,1419
1567,1,1.0.44,0,544,0,17,44,61,0,44,61,61,0,0,0,1,2,232,254,232,298,2,1463,1419
1567,1,2.1.44,0,544,0,70,44,114,44,0,114,114,-44,44,44,2,1,299,372,343,372,2,1463,1419
1567,1,3.0.44,0,544,0,71,44,115,0,44,115,115,0,0,0,1,2,190,254,190,298,2,1463,1419
1567,1,4.0.44,0,548,1,69,44,113,0,44,113,113,0,0,0,1,2,197,254,197,298,2,1463,1419
1567,1,5.0.44,1,544,0,2,44,46,0,44,46,46,0,0,0,1,2,187,254,187,298,2,1463,1419
1567,2,0.0.46,0,548,1,95,46,141,0,46,141,141,0,0,0,1,3,314,252,314,298,3,1463,1417
1567,2,1.0.46,1,544,0,17,46,63,0,46,63,63,0,0,0,1,3,232,252,232,298,3,1463,1417
1567,2,2.1.44,0,544,0,70,44,114,44,0,114,114,-44,44,44,2,1,299,372,343,372,3,1463,1417
1567,2,3.0.46,0,544,0,71,46,117,0,46,117,117,0,0,0,1,3,190,252,190,298,3,1463,1417
1567,2,4.0.46,0,548,1,69,46,115,0,46,115,115,0,0,0,1,3,197,252,197,298,3,1463,1417
1567,2,5.1.46,0,561,2,73,46,119,46,0,119,119,-46,46,46,2,1,185,372,187,372,3,1463,1417
1567,3,0.0.63,1,544,0,95,63,158,0,63,158,158,0,0,0,1,4,314,235,314,298,4,1463,1400
1567,3,1.1.63,0,565,2,49,63,112,63,0,112,112,-63,63,63,2,1,215,372,232,372,4,1463,1400
1567,3,2.1.44,0,544,0,70,44,114,44,0,114,114,-44,44,44,2,1,299,372,343,372,4,1463,1400
1567,3,3.0.63,0,544,0,71,63,134,0,63,134,134,0,0,0,1,4,190,235,190,298,4,1463,1400
1567,3,4.0.63,0,544,0,69,63,132,0,63,132,132,0,0,0,1,4,197,235,197,298,4,1463,1400
1567,3,5.1.46,0,561,1,73,46,119,46,0,119,119,-46,46,46,2,1,185,372,187,372,4,1463,1400
1567,4,0.1.158,0,548,1,86,158,244,158,0,244,244,-158,158,158,2,1,219,372,314,372,5,1463,1305
1567,4,1.1.63,0,570,2,49,63,112,63,0,112,158,-63,63,63,2,1,215,372,232,372,5,1463,1305
1567,4,2.1.44,0,544,0,70,44,114,44,0,114,158,-44,44,44,2,1,299,372,343,372,5,1463,1305
1567,4,3.0.158,0,544,0,71,158,229,0,158,229,229,0,0,0,1,5,190,140,190,298,5,1463,1305
1567,4,4.0.158,1,544,0,69,158,227,0,158,227,227,0,0,0,1,5,197,140,197,298,5,1463,1305
1567,4,5.1.46,0,576,3,73,46,119,46,0,119,158,-46,46,46,2,1,185,372,187,372,5,1463,1305
1567,5,0.1.158,0,548,1,86,158,244,158,0,244,244,-158,158,158,2,1,219,372,314,372,6,1463,1236
1567,5,1.1.63,0,570,2,49,63,112,63,0,112,227,-63,63,63,2,1,215,372,232,372,6,1463,1236
1567,5,2.1.44,0,544,0,70,44,114,44,0,114,227,-44,44,44,2,1,299,372,343,372,6,1463,1236
1567,5,3.0.227,1,544,0,71,227,298,0,227,298,298,0,0,0,1,6,190,71,190,298,6,1463,1236
1567,5,4.1.227,0,598,4,65,227,292,227,0,292,292,-227,227,227,2,1,128,372,197,372,6,1463,1236
1567,5,5.1.46,0,576,3,73,46,119,46,0,119,227,-46,46,46,2,1,185,372,187,372,6,1463,1236
1567,6,0.1.158,0,548,1,86,158,244,158,0,244,298,-158,158,158,2,1,219,372,314,372,7,1463,1165
1567,6,1.1.63,0,570,2,49,63,112,63,0,112,298,-63,63,63,2,1,215,372,232,372,7,1463,1165
1567,6,2.1.44,1,544,0,70,44,114,44,0,114,298,-44,44,44,2,1,299,372,343,372,7,1463,1165
1567,6,3.1.298,0,548,1,29,298,327,298,0,327,327,-298,298,298,2,1,119,372,190,372,7,1463,1165
1567,6,4.1.227,0,598,4,65,227,292,227,0,292,298,-227,227,227,2,1,128,372,197,372,7,1463,1165
1567,6,5.1.46,0,576,3,73,46,119,46,0,119,298,-46,46,46,2,1,185,372,187,372,7,1463,1165
1567,7,0.1.158,0,548,1,86,158,244,158,0,244,298,-44,88,88,2,2,219,302,314,372,8,1463,1095
1567,7,1.1.114,0,544,0,49,114,163,63,51,163,298,0,44,44,2,2,215,302,232,372,8,1463,1095
1567,7,2.2.114,1,544,0,87,114,201,114,0,201,298,-114,114,158,3,1,229,285,343,285,8,1463,1095
1567,7,3.1.298,0,548,1,29,298,327,298,0,327,327,-184,228,228,2,2,119,302,190,372,8,1463,1095
1567,7,4.1.227,0,598,3,65,227,292,227,0,292,298,-113,157,157,2,2,128,302,197,372,8,1463,1095
1567,7,5.1.114,0,561,2,73,114,187,46,68,187,298,0,44,44,2,2,185,302,187,372,8,1463,1095
1567,8,0.1.158,0,548,1,86,158,244,158,0,244,298,-44,88,202,2,2,219,302,314,372,9,1463,1008
1567,8,1.1.114,0,544,0,49,114,163,63,51,163,298,0,44,158,2,2,215,302,232,372,9,1463,1008
1567,8,2.3.201,1,544,0,82,201,283,201,0,283,298,-201,201,359,4,1,142,339,343,339,9,1463,1008
1567,8,3.1.298,0,548,1,29,298,327,298,0,327,327,-184,228,342,2,2,119,302,190,372,9,1463,1008
1567,8,4.1.227,0,598,3,65,227,292,227,0,292,298,-113,157,271,2,2,128,302,197,372,9,1463,1008
1567,8,5.1.114,0,561,2,73,114,187,46,68,187,298,0,44,158,2,2,185,302,187,372,9,1463,1008
1567,9,0.1.158,0,548,1,86,158,244,158,0,244,298,-44,88,403,2,2,219,302,314,372,10,1463,926
1567,9,1.1.114,0,544,0,49,114,163,63,51,163,298,0,44,359,2,2,215,302,232,372,10,1463,926
1567,9,2.4.283,1,544,0,60,283,343,283,0,343,343,-283,283,642,5,1,60,169,343,169,10,1463,926
1567,9,3.1.298,0,548,1,29,298,327,298,0,327,327,-184,228,543,2,2,119,302,190,372,10,1463,926
1567,9,4.1.227,0,598,3,65,227,292,227,0,292,298,-113,157,472,2,2,128,302,197,372,10,1463,926
1567,9,5.1.114,0,561,2,73,114,187,46,68,187,298,0,44,359,2,2,185,302,187,372,10,1463,926
1567,10,0.1.158,0,548,1,86,158,244,158,0,244,343,-44,88,686,2,2,219,302,314,372,11,1463,866
1567,10,1.1.114,1,544,0,49,114,163,63,51,163,343,0,44,642,2,2,215,302,232,372,11,1463,866
1567,10,3.1.298,0,548,1,29,298,327,298,0,327,343,-184,228,826,2,2,119,302,190,372,11,1463,866
1567,10,4.1.227,0,598,3,65,227,292,227,0,292,343,-113,157,755,2,2,128,302,197,372,11,1463,866
1567,10,5.1.114,0,561,2,73,114,187,46,68,187,343,0,44,642,2,2,185,302,187,372,11,1463,866
1567,11,0.1.163,0,544,0,86,163,249,158,5,249,343,0,44,642,2,3,219,253,314,372,12,1463,817
1567,11,1.2.201,1,544,0,74,201,275,163,38,275,343,0,114,642,3,2,166,198,232,285,12,1463,817
1567,11,3.1.298,0,548,1,29,298,327,298,0,327,343,-135,179,777,2,3,119,253,190,372,12,1463,817
1567,11,4.1.227,0,598,2,65,227,292,227,0,292,343,-64,108,706,2,3,128,253,197,372,12,1463,817
1567,11,5.1.163,0,548,1,73,163,236,46,117,236,343,0,44,642,2,3,185,253,187,372,12,1463,817
1567,12,0.1.163,0,544,0,86,163,249,158,5,249,343,0,44,642,2,3,219,253,314,372,13,1463,743
1567,12,1.3.283,1,544,0,46,283,329,275,8,329,343,0,201,642,4,2,92,257,232,339,13,1463,743
1567,12,3.1.298,0,548,1,29,298,327,298,0,327,343,-135,179,777,2,3,119,253,190,372,13,1463,743
1567,12,4.1.227,0,598,2,65,227,292,227,0,292,343,-64,108,706,2,3,128,253,197,372,13,1463,743
1567,12,5.1.163,0,548,1,73,163,236,46,117,236,343,0,44,642,2,3,185,253,187,372,13,1463,743
1567,13,0.1.163,0,544,0,86,163,249,158,5,249,343,0,44,642,2,3,219,253,314,372,14,1463,697
1567,13,1.4.343,1,544,0,46,343,389,329,14,389,389,0,283,642,5,2,46,109,232,169,14,1463,697
1567,13,3.1.298,0,548,1,29,298,327,298,0,327,343,-135,179,777,2,3,119,253,190,372,14,1463,697
1567,13,4.1.227,0,598,2,65,227,292,227,0,292,343,-64,108,706,2,3,128,253,197,372,14,1463,697
1567,13,5.1.163,0,548,1,73,163,236,46,117,236,343,0,44,642,2,3,185,253,187,372,14,1463,697
1567,14,0.1.163,0,544,0,86,163,249,158,5,249,389,0,44,642,2,3,219,253,314,372,15,1463,651
1567,14,3.1.298,0,548,1,29,298,327,298,0,327,389,-135,179,777,2,3,119,253,190,372,15,1463,651
1567,14,4.1.227,0,598,2,65,227,292,227,0,292,389,-64,108,706,2,3,128,253,197,372,15,1463,651
1567,14,5.1.163,1,548,1,73,163,236,46,117,236,389,0,44,642,2,3,185,253,187,372,15,1463,651
1567,15,0.1.236,0,548,0,86,236,322,158,78,322,389,0,44,642,2,4,219,180,314,372,16,1463,578
1567,15,3.1.298,0,570,2,29,298,327,298,0,327,389,-62,106,704,2,4,119,180,190,372,16,1463,578
1567,15,4.1.236,0,566,1,65,236,301,227,9,301,389,0,44,642,2,4,128,180,197,372,16,1463,578
1567,15,5.2.275,1,548,0,43,275,318,236,39,318,389,0,114,642,3,3,112,124,187,285,16,1463,578
1567,16,0.1.236,1,548,0,86,236,322,158,78,322,389,0,44,642,2,4,219,180,314,372,17,1463,535
1567,16,3.1.298,0,570,2,29,298,327,298,0,327,389,-62,106,704,2,4,119,180,190,372,17,1463,535
1567,16,4.1.236,0,566,1,65,236,301,227,9,301,389,0,44,642,2,4,128,180,197,372,17,1463,535
1567,16,5.3.329,0,566,1,65,329,394,318,11,394,394,0,201,642,4,3,69,211,187,339,17,1463,535
1567,17,0.2.322,1,548,0,11,322,333,322,0,333,389,-4,118,646,3,4,133,81,314,285,18,1463,449
1567,17,3.1.322,0,548,0,29,322,351,298,24,351,389,0,44,642,2,5,119,94,190,372,18,1463,449
1567,17,4.1.322,0,556,1,65,322,387,227,95,387,389,0,44,642,2,5,128,94,197,372,18,1463,449
1567,17,5.3.329,0,566,2,65,329,394,318,11,394,394,0,201,642,4,3,69,211,187,339,18,1463,449
1567,18,0.3.333,0,548,0,96,333,429,333,0,429,429,-4,205,650,4,3,122,211,314,339,19,1463,438
1567,18,3.1.322,1,548,0,29,322,351,298,24,351,389,0,44,646,2,5,119,94,190,372,19,1463,438
1567,18,4.1.322,0,556,1,65,322,387,227,95,387,389,0,44,646,2,5,128,94,197,372,19,1463,438
1567,18,5.3.329,0,566,2,65,329,394,318,11,394,394,0,201,646,4,3,69,211,187,339,19,1463,438
1567,19,0.3.333,0,548,0,96,333,429,333,0,429,429,-4,205,650,4,3,122,211,314,339,20,1463,409
1567,19,3.2.351,1,548,0,17,351,368,351,0,368,389,-18,136,664,3,5,90,70,190,285,20,1463,409
1567,19,4.1.351,0,548,0,65,351,416,227,124,416,416,0,44,646,2,6,128,65,197,372,20,1463,409
1567,19,5.3.329,0,566,1,65,329,394,318,11,394,394,0,201,646,4,3,69,211,187,339,20,1463,409
1567,20,0.3.333,0,548,0,96,333,429,333,0,429,429,-4,205,668,4,3,122,211,314,339,21,1463,392
1567,20,3.3.368,0,583,2,47,368,415,368,0,415,415,-39,240,703,4,3,73,211,190,339,21,1463,392
1567,20,4.1.351,1,548,0,65,351,416,227,124,416,416,0,44,664,2,6,128,65,197,372,21,1463,392
1567,20,5.3.329,0,566,1,65,329,394,318,11,394,394,0,201,664,4,3,69,211,187,339,21,1463,392
1567,21,0.3.333,0,548,0,96,333,429,333,0,429,429,-4,205,668,4,3,122,211,314,339,22,1463,327
1567,21,3.3.368,0,583,2,47,368,415,368,0,415,416,-39,240,703,4,3,73,211,190,339,22,1463,327
1567,21,4.2.416,1,548,0,53,416,469,416,0,469,469,-48,184,712,3,6,63,53,197,285,22,1463,327
1567,21,5.3.329,0,566,1,65,329,394,318,11,394,416,0,201,664,4,3,69,211,187,339,22,1463,327
1567,22,0.3.333,1,548,0,96,333,429,333,0,429,469,-4,205,716,4,3,122,211,314,339,23,1463,274
1567,22,3.3.368,0,583,2,47,368,415,368,0,415,469,-39,240,751,4,3,73,211,190,339,23,1463,274
1567,22,4.3.469,0,588,3,3,469,472,469,0,472,472,-140,341,852,4,3,10,211,197,339,23,1463,274
1567,22,5.3.329,0,566,1,65,329,394,318,11,394,469,0,201,712,4,3,69,211,187,339,23,1463,274
1567,23,0.4.429,1,548,0,26,429,455,429,0,455,469,-40,323,756,5,3,26,63,314,169,24,1463,178
1567,23,3.3.429,0,548,0,47,429,476,368,61,476,476,0,205,716,4,4,73,115,190,339,24,1463,178
1567,23,4.3.469,0,588,2,3,469,472,469,0,472,472,-40,245,756,4,4,10,115,197,339,24,1463,178
1567,23,5.3.429,0,570,1,65,429,494,318,111,494,494,0,205,716,4,4,69,115,187,339,24,1463,178
1567,24,3.3.429,1,548,0,47,429,476,368,61,476,476,0,205,756,4,4,73,115,190,339,25,1463,152
1567,24,4.3.469,0,588,2,3,469,472,469,0,472,472,-40,245,796,4,4,10,115,197,339,25,1463,152
1567,24,5.3.429,0,570,1,65,429,494,318,111,494,494,0,205,756,4,4,69,115,187,339,25,1463,152
1567,25,3.4.476,1,548,0,26,476,502,476,0,502,502,-21,344,777,5,4,26,37,190,169,26,1463,105
1567,25,4.3.476,0,548,0,3,476,479,469,7,479,479,0,205,756,4,5,10,68,197,339,26,1463,105
1567,25,5.3.476,0,552,1,65,476,541,318,158,541,541,0,205,756,4,5,69,68,187,339,26,1463,105
1567,26,4.3.476,0,548,0,3,476,479,469,7,479,502,0,205,777,4,5,10,68,197,339,27,1463,79
1567,26,5.3.476,1,552,1,65,476,541,318,158,541,541,0,205,777,4,5,69,68,187,339,27,1463,79
1567,27,4.3.541,0,552,0,3,541,544,469,72,544,544,0,205,777,4,6,10,3,197,339,28,1463,14
1567,27,5.4.541,1,552,0,4,541,545,541,0,545,545,-39,383,816,5,5,4,11,187,169,28,1463,14
1567,28,4.3.541,1,552,0,3,541,544,469,72,544,545,0,205,816,4,6,10,3,197,339,29,1463,10
1567,29,4.4.545,1,552,0,7,545,552,544,1,552,552,0,383,816,5,6,7,7,197,169,30,1463,7
1568,0,0.0.0,0,567,1,9,0,9,0,0,9,9,0,0,0,1,1,160,312,160,312,1,1630,1630
1568,0,1.0.0,0,618,4,91,0,91,0,0,91,91,0,0,0,1,1,332,312,332,312,1,1630,1630
1568,0,2.0.0,0,648,5,90,0,90,0,0,90,90,0,0,0,1,1,269,312,269,312,1,1630,1630
1568,0,3.0.0,0,583,2,25,0,25,0,0,25,25,0,0,0,1,1,249,312,249,312,1,1630,1630
1568,0,4.0.0,0,615,3,91,0,91,0,0,91,91,0,0,0,1,1,333,312,333,312,1,1630,1630
1568,0,5.0.0,1,558,0,6,0,6,0,0,6,6,0,0,0,1,1,287,312,287,312,1,1630,1630
1568,1,0.0.6,0,558,0,9,6,15,0,6,15,15,0,0,0,1,2,160,306,160,312,2,1630,1624
1568,1,1.0.6,0,590,2,91,6,97,0,6,97,97,0,0,0,1,2,332,306,332,312,2,1630,1624
1568,1,2.0.6,0,596,3,90,6,96,0,6,96,96,0,0,0,1,2,269,306,269,312,2,1630,1624
1568,1,3.0.6,0,558,0,25,6,31,0,6,31,31,0,0,0,1,2,249,306,249,312,2,1630,1624
1568,1,4.0.6,0,575,1,91,6,97,0,6,97,97,0,0,0,1,2,333,306,333,312,2,1630,1624
1568,1,5.1.6,1,558,0,56,6,62,6,0,62,62,-6,6,6,2,1,281,275,287,275,2,1630,1624
1568,2,0.0.6,0,558,0,9,6,15,0,6,15,62,0,0,6,1,2,160,306,160,312,3,1630,1568
1568,2,1.0.6,0,590,2,91,6,97,0,6,97,97,0,0,6,1,2,332,306,332,312,3,1630,1568
1568,2,2.0.6,0,596,3,90,6,96,0,6,96,96,0,0,6,1,2,269,306,269,312,3,1630,1568
1568,2,3.0.6,0,558,0,25,6,31,0,6,31,62,0,0,6,1,2,249,306,249,312,3,1630,1568
1568,2,4.0.6,0,575,1,91,6,97,0,6,97,97,0,0,6,1,2,333,306,333,312,3,1630,1568
1568,2,5.2.62,1,558,0,81,62,143,62,0,143,143,-62,62,68,3,1,225,353,287,353,3,1630,1568
1568,3,0.0.6,0,558,0,9,6,15,0,6,15,143,0,0,68,1,2,160,306,160,312,4,1630,1487
1568,3,1.0.6,0,590,2,91,6,97,0,6,97,143,0,0,68,1,2,332,306,332,312,4,1630,1487
1568,3,2.0.6,0,596,3,90,6,96,0,6,96,143,0,0,68,1,2,269,306,269,312,4,1630,1487
1568,3,3.0.6,0,558,0,25,6,31,0,6,31,143,0,0,68,1,2,249,306,249,312,4,1630,1487
1568,3,4.0.6,0,575,1,91,6,97,0,6,97,143,0,0,68,1,2,333,306,333,312,4,1630,1487
1568,3,5.3.143,1,590,2,50,143,193,143,0,193,193,-143,143,211,4,1,144,293,287,293,4,1630,1487
1568,4,0.0.6,0,590,0,9,6,15,0,6,15,193,0,0,211,1,2,160,306,160,312,5,1630,1437
1568,4,1.0.6,0,590,0,91,6,97,0,6,97,193,0,0,211,1,2,332,306,332,312,5,1630,1437
1568,4,2.0.6,0,596,1,90,6,96,0,6,96,193,0,0,211,1,2,269,306,269,312,5,1630,1437
1568,4,3.0.6,0,590,0,25,6,31,0,6,31,193,0,0,211,1,2,249,306,249,312,5,1630,1437
1568,4,4.0.6,0,590,0,91,6,97,0,6,97,193,0,0,211,1,2,333,306,333,312,5,1630,1437
1568,4,5.4.193,1,590,0,94,193,287,193,0,287,287,-193,193,404,5,1,94,397,287,397,5,1630,1437
1568,5,0.0.6,0,590,0,9,6,15,0,6,15,287,0,0,404,1,2,160,306,160,312,6,1630,1343
1568,5,1.0.6,0,590,0,91,6,97,0,6,97,287,0,0,404,1,2,332,306,332,312,6,1630,1343
1568,5,2.0.6,0,596,1,90,6,96,0,6,96,287,0,0,404,1,2,269,306,269,312,6,1630,1343
1568,5,3.0.6,1,590,0,25,6,31,0,6,31,287,0,0,404,1,2,249,306,249,312,6,1630,1343
1568,5,4.0.6,0,590,0,91,6,97,0,6,97,287,0,0,404,1,2,333,306,333,312,6,1630,1343
1568,6,0.0.31,0,590,0,9,31,40,0,31,40,287,0,0,404,1,3,160,281,160,312,7,1630,1318
1568,6,1.0.31,0,590,0,91,31,122,0,31,122,287,0,0,404,1,3,332,281,332,312,7,1630,1318
1568,6,2.0.31,0,590,0,90,31,121,0,31,121,287,0,0,404,1,3,269,281,269,312,7,1630,1318
1568,6,3.1.62,1,590,0,67,62,129,31,31,129,287,0,6,404,2,2,224,219,249,275,7,1630,1318
1568,6,4.0.31,0,590,0,91,31,122,0,31,122,287,0,0,404,1,3,333,281,333,312,7,1630,1318
1568,7,0.0.31,0,590,0,9,31,40,0,31,40,287,0,0,404,1,3,160,281,160,312,8,1630,1251
1568,7,1.0.31,0,590,0,91,31,122,0,31,122,287,0,0,404,1,3,332,281,332,312,8,1630,1251
1568,7,2.0.31,0,590,0,90,31,121,0,31,121,287,0,0,404,1,3,269,281,269,312,8,1630,1251
1568,7,3.2.143,1,590,0,83,143,226,129,14,226,287,0,62,404,3,2,157,272,249,353,8,1630,1251
1568,7,4.0.31,0,590,0,91,31,122,0,31,122,287,0,0,404,1,3,333,281,333,312,8,1630,1251
1568,8,0.0.31,0,590,0,9,31,40,0,31,40,287,0,0,404,1,3,160,281,160,312,9,1630,1168
1568,8,1.0.31,0,590,0,91,31,122,0,31,122,287,0,0,404,1,3,332,281,332,312,9,1630,1168
1568,8,2.0.31,0,590,0,90,31,121,0,31,121,287,0,0,404,1,3,269,281,269,312,9,1630,1168
1568,8,3.3.226,1,590,0,6,226,232,226,0,232,287,-33,176,437,4,2,74,243,249,293,9,1630,1168
1568,8,4.0.31,0,590,0,91,31,122,0,31,122,287,0,0,404,1,3,333,281,333,312,9,1630,1168
1568,9,0.0.31,0,590,0,9,31,40,0,31,40,287,0,0,437,1,3,160,281,160,312,10,1630,1162
1568,9,1.0.31,0,590,0,91,31,122,0,31,122,287,0,0,437,1,3,332,281,332,312,10,1630,1162
1568,9,2.0.31,0,590,0,90,31,121,0,31,121,287,0,0,437,1,3,269,281,269,312,10,1630,1162
1568,9,3.4.287,1,590,0,68,287,355,232,55,355,355,0,193,437,5,2,68,303,249,397,10,1630,1162
1568,9,4.0.31,0,590,0,91,31,122,0,31,122,287,0,0,437,1,3,333,281,333,312,10,1630,1162
1568,10,0.0.31,1,590,0,9,31,40,0,31,40,355,0,0,437,1,3,160,281,160,312,11,1630,1094
1568,10,1.0.31,0,590,0,91,31,122,0,31,122,355,0,0,437,1,3,332,281,332,312,11,1630,1094
1568,10,2.0.31,0,590,0,90,31,121,0,31,121,355,0,0,437,1,3,269,281,269,312,11,1630,1094
1568,10,4.0.31,0,590,0,91,31,122,0,31,122,355,0,0,437,1,3,333,281,333,312,11,1630,1094
1568,11,0.1.129,1,590,0,54,129,183,40,89,183,355,0,6,437,2,3,151,152,160,275,12,1630,1085
1568,11,1.0.40,0,590,0,91,40,131,0,40,131,355,0,0,437,1,4,332,272,332,312,12,1630,1085
1568,11,2.0.40,0,590,0,90,40,130,0,40,130,355,0,0,437,1,4,269,272,269,312,12,1630,1085
1568,11,4.0.40,0,590,0,91,40,131,0,40,131,355,0,0,437,1,4,333,272,333,312,12,1630,1085
1568,12,0.2.226,1,590,0,15,226,241,183,43,241,355,0,62,437,3,3,97,189,160,353,13,1630,1031
1568,12,1.0.40,0,590,0,91,40,131,0,40,131,355,0,0,437,1,4,332,272,332,312,13,1630,1031
1568,12,2.0.40,0,590,0,90,40,130,0,40,130,355,0,0,437,1,4,269,272,269,312,13,1630,1031
1568,12,4.0.40,0,590,0,91,40,131,0,40,131,355,0,0,437,1,4,333,272,333,312,13,1630,1031
1568,13,0.3.241,1,590,0,3,241,244,241,0,244,355,-9,185,446,4,3,82,237,160,293,14,1630,1016
1568,13,1.0.40,0,590,0,91,40,131,0,40,131,355,0,0,437,1,4,332,272,332,312,14,1630,1016
1568,13,2.0.40,0,590,0,90,40,130,0,40,130,355,0,0,437,1,4,269,272,269,312,14,1630,1016
1568,13,4.0.40,0,590,0,91,40,131,0,40,131,355,0,0,437,1,4,333,272,333,312,14,1630,1016
1568,14,0.4.355,1,590,0,79,355,434,244,111,434,434,0,193,446,5,3,79,235,160,397,15,1630,1013
1568,14,1.0.40,0,590,0,91,40,131,0,40,131,355,0,0,446,1,4,332,272,332,312,15,1630,1013
1568,14,2.0.40,0,590,0,90,40,130,0,40,130,355,0,0,446,1,4,269,272,269,312,15,1630,1013
1568,14,4.0.40,0,590,0,91,40,131,0,40,131,355,0,0,446,1,4,333,272,333,312,15,1630,1013
1568,15,1.0.40,0,590,0,91,40,131,0,40,131,434,0,0,446,1,4,332,272,332,312,16,1630,934
1568,15,2.0.40,0,590,0,90,40,130,0,40,130,434,0,0,446,1,4,269,272,269,312,16,1630,934
1568,15,4.0.40,1,590,0,91,40,131,0,40,131,434,0,0,446,1,4,333,272,333,312,16,1630,934
1568,16,1.0.131,0,590,0,91,131,222,0,131,222,434,0,0,446,1,5,332,181,332,312,17,1630,843
1568,16,2.0.131,0,590,0,90,131,221,0,131,221,434,0,0,446,1,5,269,181,269,312,17,1630,843
1568,16,4.1.183,1,590,0,17,183,200,131,52,200,434,0,6,446,2,4,242,98,333,275,17,1630,843
1568,17,1.0.131,0,590,0,91,131,222,0,131,222,434,0,0,446,1,5,332,181,332,312,18,1630,826
1568,17,2.0.131,0,590,0,90,131,221,0,131,221,434,0,0,446,1,5,269,181,269,312,18,1630,826
1568,17,4.2.241,1,590,0,54,241,295,200,41,295,434,0,62,446,3,4,225,174,333,353,18,1630,826
1568,18,1.0.131,1,590,0,91,131,222,0,131,222,434,0,0,446,1,5,332,181,332,312,19,1630,772
1568,18,2.0.131,0,590,0,90,131,221,0,131,221,434,0,0,446,1,5,269,181,269,312,19,1630,772
1568,18,4.3.295,0,590,0,95,295,390,295,0,390,434,-51,236,497,4,4,171,234,333,293,19,1630,772
1568,19,1.1.222,1,590,0,18,222,240,222,0,240,434,-22,28,468,2,5,241,81,332,275,20,1630,681
1568,19,2.0.222,0,590,0,90,222,312,0,222,312,434,0,0,446,1,6,269,90,269,312,20,1630,681
1568,19,4.3.295,0,590,0,95,295,390,295,0,390,434,-51,236,497,4,4,171,234,333,293,20,1630,681
1568,20,1.2.295,1,590,0,80,295,375,240,55,375,434,0,62,468,3,5,223,120,332,353,21,1630,663
1568,20,2.0.222,0,590,0,90,222,312,0,222,312,434,0,0,468,1,6,269,90,269,312,21,1630,663
1568,20,4.3.295,0,590,0,95,295,390,295,0,390,434,-51,236,519,4,4,171,234,333,293,21,1630,663
1568,21,1.3.375,0,659,1,88,375,463,375,0,463,463,-131,316,599,4,4,143,234,332,293,22,1630,583
1568,21,2.0.222,1,590,0,90,222,312,0,222,312,434,0,0,468,1,6,269,90,269,312,22,1630,583
1568,21,4.3.295,0,590,0,95,295,390,295,0,390,434,-51,236,519,4,4,171,234,333,293,22,1630,583
1568,22,1.3.375,0,659,1,88,375,463,375,0,463,463,-131,316,599,4,4,143,234,332,293,23,1630,493
1568,22,2.1.312,1,590,0,63,312,375,312,0,375,434,-72,100,540,2,6,179,63,269,275,23,1630,493
1568,22,4.3.295,0,590,0,95,295,390,295,0,390,434,-51,236,519,4,4,171,234,333,293,23,1630,493
1568,23,1.3.375,0,659,1,88,375,463,375,0,463,463,-131,316,671,4,4,143,234,332,293,24,1630,430
1568,23,2.2.375,1,590,0,40,375,415,375,0,415,434,0,62,540,3,6,116,40,269,353,24,1630,430
1568,23,4.3.295,0,590,0,95,295,390,295,0,390,434,-51,236,591,4,4,171,234,333,293,24,1630,430
1568,24,1.3.375,0,659,2,88,375,463,375,0,463,463,-131,316,671,4,4,143,234,332,293,25,1630,390
1568,24,2.3.415,0,609,1,51,415,466,415,0,466,466,-171,356,711,4,4,76,234,269,293,25,1630,390
1568,24,4.3.295,1,590,0,95,295,390,295,0,390,434,-51,236,591,4,4,171,234,333,293,25,1630,390
1568,25,1.3.390,0,590,0,88,390,478,375,15,478,478,0,236,591,4,5,143,139,332,293,26,1630,295
1568,25,2.3.415,0,609,1,51,415,466,415,0,466,466,-25,261,616,4,5,76,139,269,293,26,1630,295
1568,25,4.4.434,1,590,0,76,434,510,390,44,510,510,0,193,591,5,4,76,156,333,397,26,1630,295
1568,26,1.3.390,1,590,0,88,390,478,375,15,478,510,0,236,591,4,5,143,139,332,293,27,1630,219
1568,26,2.3.415,0,609,1,51,415,466,415,0,466,510,-25,261,616,4,5,76,139,269,293,27,1630,219
1568,27,1.4.510,0,590,0,55,510,565,478,32,565,565,0,193,591,5,5,55,80,332,397,28,1630,131
1568,27,2.3.478,1,590,0,51,478,529,415,63,529,529,0,236,591,4,6,76,51,269,293,28,1630,131
1568,28,1.4.510,1,590,0,55,510,565,478,32,565,565,0,193,591,5,5,55,80,332,397,29,1630,80
1568,28,2.4.529,0,609,1,25,529,554,529,0,554,554,-19,212,610,5,5,25,80,269,397,29,1630,80
1568,29,2.4.565,1,590,0,25,565,590,529,36,590,590,0,193,591,5,6,25,25,269,397,30,1630,25
1569,0,0.0.0,0,505,1,22,0,22,0,0,22,22,0,0,0,1,1,105,227,105,227,1,1402,1402
1569,0,1.0.0,0,561,5,67,0,67,0,0,67,67,0,0,0,1,1,331,227,331,227,1,1402,1402
1569,0,2.0.0,0,529,3,36,0,36,0,0,36,36,0,0,0,1,1,296,227,296,227,1,1402,1402
1569,0,3.0.0,0,549,4,77,0,77,0,0,77,77,0,0,0,1,1,208,227,208,227,1,1402,1402
1569,0,4.0.0,1,508,2,14,0,14,0,0,14,14,0,0,0,1,1,271,227,271,227,1,1402,1402
1569,0,5.0.0,0,494,0,11,0,11,0,0,11,11,0,0,0,1,1,191,227,191,227,1,1402,1402
1569,1,0.0.14,0,508,0,22,14,36,0,14,36,36,0,0,0,1,2,105,213,105,227,2,1402,1388
1569,1,1.0.14,0,518,1,67,14,81,0,14,81,81,0,0,0,1,2,331,213,331,227,2,1402,1388
1569,1,2.0.14,1,508,0,36,14,50,0,14,50,50,0,0,0,1,2,296,213,296,227,2,1402,1388
1569,1,3.0.14,0,524,2,77,14,91,0,14,91,91,0,0,0,1,2,208,213,208,227,2,1402,1388
1569,1,4.1.14,0,508,0,68,14,82,14,0,82,82,-14,14,14,2,1,257,279,271,279,2,1402,1388
1569,1,5.0.14,0,508,0,11,14,25,0,14,25,25,0,0,0,1,2,191,213,191,227,2,1402,1388
1569,2,0.0.50,0,508,0,22,50,72,0,50,72,72,0,0,0,1,3,105,177,105,227,3,1402,1352
1569,2,1.0.50,0,547,2,67,50,117,0,50,117,117,0,0,0,1,3,331,177,331,227,3,1402,1352
1569,2,2.1.50,0,543,1,57,50,107,50,0,107,107,-50,50,50,2,1,260,279,296,279,3,1402,1352
1569,2,3.0.50,0,547,2,77,50,127,0,50,127,127,0,0,0,1,3,208,177,208,227,3,1402,1352
1569,2,4.1.14,0,508,0,68,14,82,14,0,82,82,-14,14,14,2,1,257,279,271,279,3,1402,1352
1569,2,5.0.50,1,508,0,11,50,61,0,50,61,61,0,0,0,1,3,191,177,191,227,3,1402,1352
1569,3,0.0.61,0,508,0,22,61,83,0,61,83,83,0,0,0,1,4,105,166,105,227,4,1402,1341
1569,3,1.0.61,1,522,1,67,61,128,0,61,128,128,0,0,0,1,4,331,166,331,227,4,1402,1341
1569,3,2.1.50,0,543,2,57,50,107,50,0,107,107,-50,50,50,2,1,260,279,296,279,4,1402,1341
1569,3,3.0.61,0,522,1,77,61,138,0,61,138,138,0,0,0,1,4,208,166,208,227,4,1402,1341
1569,3,4.1.14,0,508,0,68,14,82,14,0,82,82,-14,14,14,2,1,257,279,271,279,4,1402,1341
1569,3,5.1.61,0,544,3,40,61,101,61,0,101,101,-61,61,61,2,1,180,279,191,279,4,1402,1341
1569,4,0.0.128,1,522,0,22,128,150,0,128,150,150,0,0,0,1,5,105,99,105,227,5,1402,1274
1569,4,1.1.128,0,534,1,85,128,213,128,0,213,213,-128,128,128,2,1,264,279,331,279,5,1402,1274
1569,4,2.1.50,0,543,2,57,50,107,50,0,107,128,-50,50,50,2,1,260,279,296,279,5,1402,1274
1569,4,3.0.128,0,522,0,77,128,205,0,128,205,205,0,0,0,1,5,208,99,208,227,5,1402,1274
1569,4,4.1.14,0,522,0,68,14,82,14,0,82,128,-14,14,14,2,1,257,279,271,279,5,1402,1274
1569,4,5.1.61,0,544,3,40,61,101,61,0,101,128,-61,61,61,2,1,180,279,191,279,5,1402,1274
1569,5,0.1.150,0,533,1,23,150,173,150,0,173,173,-150,150,150,2,1,83,279,105,279,6,1402,1252
1569,5,1.1.128,0,534,2,85,128,213,128,0,213,213,-128,128,128,2,1,264,279,331,279,6,1402,1252
1569,5,2.1.50,0,543,3,57,50,107,50,0,107,150,-50,50,50,2,1,260,279,296,279,6,1402,1252
1569,5,3.0.150,1,522,0,77,150,227,0,150,227,227,0,0,0,1,6,208,77,208,227,6,1402,1252
1569,5,4.1.14,0,522,0,68,14,82,14,0,82,150,-14,14,14,2,1,257,279,271,279,6,1402,1252
1569,5,5.1.61,0,544,4,40,61,101,61,0,101,150,-61,61,61,2,1,180,279,191,279,6,1402,1252
1569,6,0.1.150,0,533,1,23,150,173,150,0,173,227,-150,150,150,2,1,83,279,105,279,7,1402,1175
1569,6,1.1.128,0,534,2,85,128,213,128,0,213,227,-128,128,128,2,1,264,279,331,279,7,1402,1175
1569,6,2.1.50,0,543,3,57,50,107,50,0,107,227,-50,50,50,2,1,260,279,296,279,7,1402,1175
1569,6,3.1.227,0,522,0,6,227,233,227,0,233,233,-227,227,227,2,1,131,279,208,279,7,1402,1175
1569,6,4.1.14,1,522,0,68,14,82,14,0,82,227,-14,14,14,2,1,257,279,271,279,7,1402,1175
1569,6,5.1.61,0,544,4,40,61,101,61,0,101,227,-61,61,61,2,1,180,279,191,279,7,1402,1175
1569,7,0.1.150,0,533,1,23,150,173,150,0,173,227,-68,82,82,2,2,83,211,105,279,8,1402,1107
1569,7,1.1.128,0,534,2,85,128,213,128,0,213,227,-46,60,60,2,2,264,211,331,279,8,1402,1107
1569,7,2.1.82,1,552,3,57,82,139,50,32,139,227,0,14,14,2,2,260,211,296,279,8,1402,1107
1569,7,3.1.227,0,522,0,6,227,233,227,0,233,233,-145,159,159,2,2,131,211,208,279,8,1402,1107
1569,7,4.2.82,0,522,0,55,82,137,82,0,137,227,-82,82,96,3,1,189,322,271,322,8,1402,1107
1569,7,5.1.82,0,522,0,40,82,122,61,21,122,227,0,14,14,2,2,180,211,191,279,8,1402,1107
1569,8,0.1.150,0,552,0,23,150,173,150,0,173,227,-11,25,25,2,3,83,154,105,279,9,1402,1050
1569,8,1.1.139,0,552,0,85,139,224,128,11,224,227,0,14,14,2,3,264,154,331,279,9,1402,1050
1569,8,2.2.139,0,552,0,93,139,232,139,0,232,232,-139,139,153,3,1,203,322,296,322,9,1402,1050
1569,8,3.1.227,0,552,0,6,227,233,227,0,233,233,-88,102,102,2,3,131,154,208,279,9,1402,1050
1569,8,4.2.82,0,552,0,55,82,137,82,0,137,227,-82,82,96,3,1,189,322,271,322,9,1402,1050
1569,8,5.1.139,1,552,0,40,139,179,61,78,179,227,0,14,14,2,3,180,154,191,279,9,1402,1050
1569,9,0.1.179,0,552,0,23,179,202,150,29,202,227,0,14,14,2,4,83,114,105,279,10,1402,1010
1569,9,1.1.179,1,552,0,85,179,264,128,51,264,264,0,14,14,2,4,264,114,331,279,10,1402,1010
1569,9,2.2.139,0,552,0,93,139,232,139,0,232,232,-139,139,153,3,1,203,322,296,322,10,1402,1010
1569,9,3.1.227,0,552,0,6,227,233,227,0,233,233,-48,62,62,2,4,131,114,208,279,10,1402,1010
1569,9,4.2.82,0,552,0,55,82,137,82,0,137,227,-82,82,96,3,1,189,322,271,322,10,1402,1010
1569,9,5.2.179,0,552,0,20,179,199,179,0,199,227,-179,179,193,3,1,140,322,191,322,10,1402,1010
1569,10,0.1.264,0,552,0,23,264,287,150,114,287,287,0,14,14,2,5,83,29,105,279,11,1402,925
1569,10,1.2.264,0,552,0,85,264,349,264,0,349,349,-264,264,278,3,1,179,322,331,322,11,1402,925
1569,10,2.2.139,0,552,0,93,139,232,139,0,232,264,-139,139,153,3,1,203,322,296,322,11,1402,925
1569,10,3.1.264,1,552,0,6,264,270,227,37,270,270,0,14,14,2,5,131,29,208,279,11,1402,925
1569,10,4.2.82,0,552,0,55,82,137,82,0,137,264,-82,82,96,3,1,189,322,271,322,11,1402,925
1569,10,5.2.179,0,552,0,20,179,199,179,0,199,264,-179,179,193,3,1,140,322,191,322,11,1402,925
1569,11,0.1.270,1,552,0,23,270,293,150,120,293,293,0,14,14,2,6,83,23,105,279,12,1402,919
1569,11,1.2.264,0,552,0,85,264,349,264,0,349,349,-264,264,278,3,1,179,322,331,322,12,1402,919
1569,11,2.2.139,0,552,0,93,139,232,139,0,232,270,-139,139,153,3,1,203,322,296,322,12,1402,919
1569,11,3.2.270,0,552,0,51,270,321,270,0,321,321,-270,270,284,3,1,125,322,208,322,12,1402,919
1569,11,4.2.82,0,552,0,55,82,137,82,0,137,270,-82,82,96,3,1,189,322,271,322,12,1402,919
1569,11,5.2.179,0,552,0,20,179,199,179,0,199,270,-179,179,193,3,1,140,322,191,322,12,1402,919
1569,12,0.2.293,0,552,0,18,293,311,293,0,311,311,-293,293,307,3,1,60,322,105,322,13,1402,896
1569,12,1.2.264,0,552,0,85,264,349,264,0,349,349,-264,264,278,3,1,179,322,331,322,13,1402,896
1569,12,2.2.139,0,552,0,93,139,232,139,0,232,293,-139,139,153,3,1,203,322,296,322,13,1402,896
1569,12,3.2.270,0,552,0,51,270,321,270,0,321,321,-270,270,284,3,1,125,322,208,322,13,1402,896
1569,12,4.2.82,1,552,0,55,82,137,82,0,137,293,-82,82,96,3,1,189,322,271,322,13,1402,896
1569,12,5.2.179,0,552,0,20,179,199,179,0,199,293,-179,179,193,3,1,140,322,191,322,13,1402,896
1569,13,0.2.293,0,552,0,18,293,311,293,0,311,311,-156,238,252,3,2,60,267,105,322,14,1402,841
1569,13,1.2.264,0,552,0,85,264,349,264,0,349,349,-127,209,223,3,2,179,267,331,322,14,1402,841
1569,13,2.2.139,0,552,0,93,139,232,139,0,232,293,-2,84,98,3,2,203,267,296,322,14,1402,841
1569,13,3.2.270,0,552,0,51,270,321,270,0,321,321,-133,215,229,3,2,125,267,208,322,14,1402,841
1569,13,4.3.137,1,552,0,88,137,225,137,0,225,293,-137,137,233,4,1,134,247,271,247,14,1402,841
1569,13,5.2.179,0,552,0,20,179,199,179,0,199,293,-42,124,138,3,2,140,267,191,322,14,1402,841
1569,14,0.2.293,0,552,0,18,293,311,293,0,311,311,-156,238,389,3,2,60,267,105,322,15,1402,753
1569,14,1.2.264,0,552,0,85,264,349,264,0,349,349,-127,209,360,3,2,179,267,331,322,15,1402,753
1569,14,2.2.139,0,552,0,93,139,232,139,0,232,293,-2,84,235,3,2,203,267,296,322,15,1402,753
1569,14,3.2.270,0,552,0,51,270,321,270,0,321,321,-133,215,366,3,2,125,267,208,322,15,1402,753
1569,14,4.4.225,1,552,0,46,225,271,225,0,271,293,-225,225,458,5,1,46,327,271,327,15,1402,753
1569,14,5.2.179,0,552,0,20,179,199,179,0,199,293,-42,124,275,3,2,140,267,191,322,15,1402,753
1569,15,0.2.293,0,552,0,18,293,311,293,0,311,311,-156,238,614,3,2,60,267,105,322,16,1402,707
1569,15,1.2.264,0,552,0,85,264,349,264,0,349,349,-127,209,585,3,2,179,267,331,322,16,1402,707
1569,15,2.2.139,0,552,0,93,139,232,139,0,232,293,-2,84,460,3,2,203,267,296,322,16,1402,707
1569,15,3.2.270,0,552,0,51,270,321,270,0,321,321,-133,215,591,3,2,125,267,208,322,16,1402,707
1569,15,5.2.179,1,552,0,20,179,199,179,0,199,293,-42,124,500,3,2,140,267,191,322,16,1402,707
1569,16,0.2.293,0,552,0,18,293,311,293,0,311,311,-94,218,594,3,3,60,247,105,322,17,1402,687
1569,16,1.2.264,0,585,1,85,264,349,264,0,349,349,-65,189,565,3,3,179,247,331,322,17,1402,687
1569,16,2.2.199,0,552,0,93,199,292,139,60,292,293,0,124,500,3,3,203,247,296,322,17,1402,687
1569,16,3.2.270,0,611,2,51,270,321,270,0,321,321,-71,195,571,3,3,125,247,208,322,17,1402,687
1569,16,5.3.225,1,552,0,35,225,260,199,26,260,293,0,137,500,4,2,120,159,191,247,17,1402,687
1569,17,0.2.293,0,552,0,18,293,311,293,0,311,311,-94,218,594,3,3,60,247,105,322,18,1402,652
1569,17,1.2.264,0,585,1,85,264,349,264,0,349,349,-65,189,565,3,3,179,247,331,322,18,1402,652
1569,17,2.2.199,1,552,0,93,199,292,139,60,292,293,0,124,500,3,3,203,247,296,322,18,1402,652
1569,17,3.2.270,0,611,2,51,270,321,270,0,321,321,-71,195,571,3,3,125,247,208,322,18,1402,652
1569,17,5.4.271,0,552,0,85,271,356,260,11,356,356,0,225,500,5,2,85,281,191,327,18,1402,652
1569,18,0.2.293,0,552,0,18,293,311,293,0,311,311,-1,125,501,3,4,60,154,105,322,19,1402,559
1569,18,1.2.292,0,552,0,85,292,377,264,28,377,377,0,124,500,3,4,179,154,331,322,19,1402,559
1569,18,2.3.292,1,552,0,20,292,312,292,0,312,312,-32,169,532,4,3,110,124,296,247,19,1402,559
1569,18,3.2.292,0,552,0,51,292,343,270,22,343,343,0,124,500,3,4,125,154,208,322,19,1402,559
1569,18,5.4.271,0,552,0,85,271,356,260,11,356,356,0,225,500,5,2,85,281,191,327,19,1402,559
1569,19,0.2.293,0,552,0,18,293,311,293,0,311,312,-1,125,533,3,4,60,154,105,322,20,1402,539
1569,19,1.2.292,1,552,0,85,292,377,264,28,377,377,0,124,532,3,4,179,154,331,322,20,1402,539
1569,19,2.4.312,0,593,1,90,312,402,312,0,402,402,-41,266,573,5,2,90,281,296,327,20,1402,539
1569,19,3.2.292,0,552,0,51,292,343,270,22,343,343,0,124,532,3,4,125,154,208,322,20,1402,539
1569,19,5.4.271,0,552,0,85,271,356,260,11,356,356,0,225,532,5,2,85,281,191,327,20,1402,539
1569,20,0.2.377,0,552,0,18,377,395,293,84,395,395,0,124,532,3,5,60,69,105,322,21,1402,454
1569,20,1.3.377,1,552,0,30,377,407,377,0,407,407,-65,234,597,4,4,94,104,331,247,21,1402,454
1569,20,2.4.312,0,593,1,90,312,402,312,0,402,402,-41,266,573,5,2,90,281,296,327,21,1402,454
1569,20,3.2.377,0,552,0,51,377,428,270,107,428,428,0,124,532,3,5,125,69,208,322,21,1402,454
1569,20,5.4.271,0,552,0,85,271,356,260,11,356,377,0,225,532,5,2,85,281,191,327,21,1402,454
1569,21,0.2.377,0,552,0,18,377,395,293,84,395,407,0,124,597,3,5,60,69,105,322,22,1402,424
1569,21,1.4.407,0,598,2,64,407,471,407,0,471,471,-136,361,733,5,2,64,281,331,327,22,1402,424
1569,21,2.4.312,0,593,1,90,312,402,312,0,402,407,-41,266,638,5,2,90,281,296,327,22,1402,424
1569,21,3.2.377,1,552,0,51,377,428,270,107,428,428,0,124,597,3,5,125,69,208,322,22,1402,424
1569,21,5.4.271,0,552,0,85,271,356,260,11,356,407,0,225,597,5,2,85,281,191,327,22,1402,424
1569,22,0.2.428,1,552,0,18,428,446,293,135,446,446,0,124,597,3,6,60,18,105,322,23,1402,373
1569,22,1.4.407,0,598,2,64,407,471,407,0,471,471,-136,361,733,5,2,64,281,331,327,23,1402,373
1569,22,2.4.312,0,593,1,90,312,402,312,0,402,428,-41,266,638,5,2,90,281,296,327,23,1402,373
1569,22,3.3.428,0,552,0,64,428,492,428,0,492,492,-21,255,618,4,5,74,74,208,247,23,1402,373
1569,22,5.4.271,0,552,0,85,271,356,260,11,356,428,0,225,597,5,2,85,281,191,327,23,1402,373
1569,23,0.3.446,1,552,0,10,446,456,446,0,456,456,-39,273,636,4,5,42,74,105,247,24,1402,355
1569,23,1.4.407,0,598,2,64,407,471,407,0,471,471,-136,361,733,5,2,64,281,331,327,24,1402,355
1569,23,2.4.312,0,593,1,90,312,402,312,0,402,446,-41,266,638,5,2,90,281,296,327,24,1402,355
1569,23,3.3.428,0,552,0,64,428,492,428,0,492,492,-21,255,618,4,5,74,74,208,247,24,1402,355
1569,23,5.4.271,0,552,0,85,271,356,260,11,356,446,0,225,597,5,2,85,281,191,327,24,1402,355
1569,24,0.4.456,0,562,1,32,456,488,456,0,488,488,-185,410,821,5,2,32,281,105,327,25,1402,345
1569,24,1.4.407,0,598,3,64,407,471,407,0,471,471,-136,361,772,5,2,64,281,331,327,25,1402,345
1569,24,2.4.312,0,593,2,90,312,402,312,0,402,456,-41,266,677,5,2,90,281,296,327,25,1402,345
1569,24,3.3.456,1,552,0,64,456,520,428,28,520,520,0,273,636,4,6,74,64,208,247,25,1402,345
1569,24,5.4.271,0,552,0,85,271,356,260,11,356,456,0,225,636,5,2,85,281,191,327,25,1402,345
1569,25,0.4.456,0,562,1,32,456,488,456,0,488,520,-185,410,821,5,2,32,281,105,327,26,1402,281
1569,25,1.4.407,0,598,3,64,407,471,407,0,471,520,-136,361,772,5,2,64,281,331,327,26,1402,281
1569,25,2.4.312,0,593,2,90,312,402,312,0,402,520,-41,266,677,5,2,90,281,296,327,26,1402,281
1569,25,3.4.520,0,562,1,10,520,530,520,0,530,530,-249,474,885,5,2,10,281,208,327,26,1402,281
1569,25,5.4.271,1,552,0,85,271,356,260,11,356,520,0,225,636,5,2,85,281,191,327,26,1402,281
1569,26,0.4.456,0,562,1,32,456,488,456,0,488,520,-100,325,736,5,3,32,196,105,327,27,1402,196
1569,26,1.4.407,0,603,2,64,407,471,407,0,471,520,-51,276,687,5,3,64,196,331,327,27,1402,196
1569,26,2.4.356,1,552,0,90,356,446,312,44,446,520,0,225,636,5,3,90,196,296,327,27,1402,196
1569,26,3.4.520,0,562,1,10,520,530,520,0,530,530,-164,389,800,5,3,10,196,208,327,27,1402,196
1569,27,0.4.456,0,562,1,32,456,488,456,0,488,520,-10,235,646,5,4,32,106,105,327,28,1402,106
1569,27,1.4.446,1,552,0,64,446,510,407,39,510,520,0,225,636,5,4,64,106,331,327,28,1402,106
1569,27,3.4.520,0,562,1,10,520,530,520,0,530,530,-74,299,710,5,4,10,106,208,327,28,1402,106
1569,28,0.4.510,0,552,0,32,510,542,456,54,542,542,0,225,636,5,5,32,42,105,327,29,1402,42
1569,28,3.4.520,1,562,1,10,520,530,520,0,530,530,-10,235,646,5,5,10,42,208,327,29,1402,42
1569,29,0.4.530,1,562,0,32,530,562,456,74,562,562,0,235,646,5,6,32,32,105,327,30,1402,32
1570,0,0.0.0,0,553,4,35,0,35,0,0,35,35,0,0,0,1,1,248,242,248,242,1,1470,1470
1570,0,1.0.0,1,550,3,43,0,43,0,0,43,43,0,0,0,1,1,330,242,330,242,1,1470,1470
1570,0,2.0.0,0,585,5,82,0,82,0,0,82,82,0,0,0,1,1,322,242,322,242,1,1470,1470
1570,0,3.0.0,0,542,2,31,0,31,0,0,31,31,0,0,0,1,1,168,242,168,242,1,1470,1470
1570,0,4.0.0,0,535,1,35,0,35,0,0,35,35,0,0,0,1,1,209,242,209,242,1,1470,1470
1570,0,5.0.0,0,522,0,16,0,16,0,0,16,16,0,0,0,1,1,193,242,193,242,1,1470,1470
1570,1,0.0.43,0,581,2,35,43,78,0,43,78,78,0,0,0,1,2,248,199,248,242,2,1470,1427
1570,1,1.1.43,0,581,2,53,43,96,43,0,96,96,-43,43,43,2,1,287,281,330,281,2,1470,1427
1570,1,2.0.43,0,607,3,82,43,125,0,43,125,125,0,0,0,1,2,322,199,322,242,2,1470,1427
1570,1,3.0.43,0,581,2,31,43,74,0,43,74,74,0,0,0,1,2,168,199,168,242,2,1470,1427
1570,1,4.0.43,0,578,1,35,43,78,0,43,78,78,0,0,0,1,2,209,199,209,242,2,1470,1427
1570,1,5.0.43,1,550,0,16,43,59,0,43,59,59,0,0,0,1,2,193,199,193,242,2,1470,1427
1570,2,0.0.59,1,550,0,35,59,94,0,59,94,94,0,0,0,1,3,248,183,248,242,3,1470,1411
1570,2,1.1.43,0,581,2,53,43,96,43,0,96,96,-43,43,43,2,1,287,281,330,281,3,1470,1411
1570,2,2.0.59,0,578,1,82,59,141,0,59,141,141,0,0,0,1,3,322,183,322,242,3,1470,1411
1570,2,3.0.59,0,550,0,31,59,90,0,59,90,90,0,0,0,1,3,168,183,168,242,3,1470,1411
1570,2,4.0.59,0,550,0,35,59,94,0,59,94,94,0,0,0,1,3,209,183,209,242,3,1470,1411
1570,2,5.1.59,0,550,0,23,59,82,59,0,82,82,-59,59,59,2,1,177,281,193,281,3,1470,1411
1570,3,0.1.94,0,588,2,90,94,184,94,0,184,184,-94,94,94,2,1,213,281,248,281,4,1470,1376
1570,3,1.1.43,0,581,1,53,43,96,43,0,96,96,-43,43,43,2,1,287,281,330,281,4,1470,1376
1570,3,2.0.94,0,550,0,82,94,176,0,94,176,176,0,0,0,1,4,322,148,322,242,4,1470,1376
1570,3,3.0.94,0,550,0,31,94,125,0,94,125,125,0,0,0,1,4,168,148,168,242,4,1470,1376
1570,3,4.0.94,1,550,0,35,94,129,0,94,129,129,0,0,0,1,4,209,148,209,242,4,1470,1376
1570,3,5.1.59,0,550,0,23,59,82,59,0,82,94,-59,59,59,2,1,177,281,193,281,4,1470,1376
1570,4,0.1.94,0,598,4,90,94,184,94,0,184,184,-94,94,94,2,1,213,281,248,281,5,1470,1341
1570,4,1.1.43,0,582,2,53,43,96,43,0,96,129,-43,43,43,2,1,287,281,330,281,5,1470,1341
1570,4,2.0.129,0,550,0,82,129,211,0,129,211,211,0,0,0,1,5,322,113,322,242,5,1470,1341
1570,4,3.0.129,1,551,1,31,129,160,0,129,160,160,0,0,0,1,5,168,113,168,242,5,1470,1341
1570,4,4.1.129,0,587,3,21,129,150,129,0,150,150,-129,129,129,2,1,174,281,209,281,5,1470,1341
1570,4,5.1.59,0,550,0,23,59,82,59,0,82,129,-59,59,59,2,1,177,281,193,281,5,1470,1341
1570,5,0.1.94,0,598,4,90,94,184,94,0,184,184,-94,94,94,2,1,213,281,248,281,6,1470,1310
1570,5,1.1.43,0,582,2,53,43,96,43,0,96,160,-43,43,43,2,1,287,281,330,281,6,1470,1310
1570,5,2.0.160,1,551,0,82,160,242,0,160,242,242,0,0,0,1,6,322,82,322,242,6,1470,1310
1570,5,3.1.160,0,573,1,44,160,204,160,0,204,204,-160,160,160,2,1,137,281,168,281,6,1470,1310
1570,5,4.1.129,0,587,3,21,129,150,129,0,150,160,-129,129,129,2,1,174,281,209,281,6,1470,1310
1570,5,5.1.59,0,551,0,23,59,82,59,0,82,160,-59,59,59,2,1,177,281,193,281,6,1470,1310
1570,6,0.1.94,0,598,5,90,94,184,94,0,184,242,-94,94,94,2,1,213,281,248,281,7,1470,1228
1570,6,1.1.43,1,582,3,53,43,96,43,0,96,242,-43,43,43,2,1,287,281,330,281,7,1470,1228
1570,6,2.1.242,0,552,1,50,242,292,242,0,292,292,-242,242,242,2,1,240,281,322,281,7,1470,1228
1570,6,3.1.160,0,573,2,44,160,204,160,0,204,242,-160,160,160,2,1,137,281,168,281,7,1470,1228
1570,6,4.1.129,0,587,4,21,129,150,129,0,150,242,-129,129,129,2,1,174,281,209,281,7,1470,1228
1570,6,5.1.59,0,551,0,23,59,82,59,0,82,242,-59,59,59,2,1,177,281,193,281,7,1470,1228
1570,7,0.1.96,0,582,0,90,96,186,94,2,186,242,0,43,43,2,2,213,228,248,281,8,1470,1175
1570,7,1.2.96,0,582,0,90,96,186,96,0,186,242,-96,96,139,3,1,234,289,330,289,8,1470,1175
1570,7,2.1.242,0,582,0,50,242,292,242,0,292,292,-146,189,189,2,2,240,228,322,281,8,1470,1175
1570,7,3.1.160,0,590,2,44,160,204,160,0,204,242,-64,107,107,2,2,137,228,168,281,8,1470,1175
1570,7,4.1.129,0,587,1,21,129,150,129,0,150,242,-33,76,76,2,2,174,228,209,281,8,1470,1175
1570,7,5.1.96,1,587,1,23,96,119,59,37,119,242,0,43,43,2,2,177,228,193,281,8,1470,1175
1570,8,0.1.119,0,587,0,90,119,209,94,25,209,242,0,43,43,2,3,213,205,248,281,9,1470,1152
1570,8,1.2.96,0,605,2,90,96,186,96,0,186,242,-96,96,139,3,1,234,289,330,289,9,1470,1152
1570,8,2.1.242,0,587,0,50,242,292,242,0,292,292,-123,166,166,2,3,240,205,322,281,9,1470,1152
1570,8,3.1.160,0,590,1,44,160,204,160,0,204,242,-41,84,84,2,3,137,205,168,281,9,1470,1152
1570,8,4.1.129,1,587,0,21,129,150,129,0,150,242,-10,53,53,2,3,174,205,209,281,9,1470,1152
1570,8,5.2.119,0,587,0,58,119,177,119,0,177,242,-119,119,162,3,1,154,289,193,289,9,1470,1152
1570,9,0.1.150,1,587,0,90,150,240,94,56,240,242,0,53,53,2,4,213,184,248,281,10,1470,1131
1570,9,1.2.96,0,606,2,90,96,186,96,0,186,242,-96,96,149,3,1,234,289,330,289,10,1470,1131
1570,9,2.1.242,0,587,0,50,242,292,242,0,292,292,-92,145,145,2,4,240,184,322,281,10,1470,1131
1570,9,3.1.160,0,590,1,44,160,204,160,0,204,242,-10,63,63,2,4,137,184,168,281,10,1470,1131
1570,9,4.2.150,0,621,3,55,150,205,150,0,205,242,-150,150,203,3,1,153,289,209,289,10,1470,1131
1570,9,5.2.119,0,587,0,58,119,177,119,0,177,242,-119,119,172,3,1,154,289,193,289,10,1470,1131
1570,10,0.2.240,0,603,1,22,240,262,240,0,262,262,-240,240,293,3,1,123,289,248,289,11,1470,1041
1570,10,1.2.96,0,614,2,90,96,186,96,0,186,242,-96,96,149,3,1,234,289,330,289,11,1470,1041
1570,10,2.1.242,1,587,0,50,242,292,242,0,292,292,-2,55,55,2,5,240,94,322,281,11,1470,1041
1570,10,3.1.240,0,587,0,44,240,284,160,80,284,284,0,53,53,2,5,137,94,168,281,11,1470,1041
1570,10,4.2.150,0,636,3,55,150,205,150,0,205,242,-150,150,203,3,1,153,289,209,289,11,1470,1041
1570,10,5.2.119,0,587,0,58,119,177,119,0,177,242,-119,119,172,3,1,154,289,193,289,11,1470,1041
1570,11,0.2.240,0,603,1,22,240,262,240,0,262,292,-240,240,295,3,1,123,289,248,289,12,1470,991
1570,11,1.2.96,0,614,2,90,96,186,96,0,186,292,-96,96,151,3,1,234,289,330,289,12,1470,991
1570,11,2.2.292,0,587,0,46,292,338,292,0,338,338,-292,292,347,3,1,190,289,322,289,12,1470,991
1570,11,3.1.292,1,587,0,44,292,336,160,132,336,336,0,55,55,2,6,137,44,168,281,12,1470,991
1570,11,4.2.150,0,636,3,55,150,205,150,0,205,292,-150,150,205,3,1,153,289,209,289,12,1470,991
1570,11,5.2.119,0,587,0,58,119,177,119,0,177,292,-119,119,174,3,1,154,289,193,289,12,1470,991
1570,12,0.2.240,0,603,1,22,240,262,240,0,262,336,-240,240,295,3,1,123,289,248,289,13,1470,947
1570,12,1.2.96,1,614,2,90,96,186,96,0,186,336,-96,96,151,3,1,234,289,330,289,13,1470,947
1570,12,2.2.292,0,587,0,46,292,338,292,0,338,338,-292,292,347,3,1,190,289,322,289,13,1470,947
1570,12,3.2.336,0,587,0,18,336,354,336,0,354,354,-336,336,391,3,1,93,289,168,289,13,1470,947
1570,12,4.2.150,0,636,3,55,150,205,150,0,205,336,-150,150,205,3,1,153,289,209,289,13,1470,947
1570,12,5.2.119,0,587,0,58,119,177,119,0,177,336,-119,119,174,3,1,154,289,193,289,13,1470,947
1570,13,0.2.240,0,614,0,22,240,262,240,0,262,336,-54,150,205,3,2,123,199,248,289,14,1470,857
1570,13,1.3.186,1,614,0,71,186,257,186,0,257,336,-186,186,337,4,1,144,301,330,301,14,1470,857
1570,13,2.2.292,0,614,0,46,292,338,292,0,338,338,-106,202,257,3,2,190,199,322,289,14,1470,857
1570,13,3.2.336,0,614,0,18,336,354,336,0,354,354,-150,246,301,3,2,93,199,168,289,14,1470,857
1570,13,4.2.186,0,614,0,55,186,241,150,36,241,336,0,96,151,3,2,153,199,209,289,14,1470,857
1570,13,5.2.186,0,614,0,58,186,244,119,67,244,336,0,96,151,3,2,154,199,193,289,14,1470,857
1570,14,0.2.240,0,614,0,22,240,262,240,0,262,336,-54,150,391,3,2,123,199,248,289,15,1470,786
1570,14,1.4.257,0,614,0,73,257,330,257,0,330,336,-257,257,594,5,1,73,357,330,357,15,1470,786
1570,14,2.2.292,0,614,0,46,292,338,292,0,338,338,-106,202,443,3,2,190,199,322,289,15,1470,786
1570,14,3.2.336,0,614,0,18,336,354,336,0,354,354,-150,246,487,3,2,93,199,168,289,15,1470,786
1570,14,4.2.186,0,614,0,55,186,241,150,36,241,336,0,96,337,3,2,153,199,209,289,15,1470,786
1570,14,5.2.186,1,614,0,58,186,244,119,67,244,336,0,96,337,3,2,154,199,193,289,15,1470,786
1570,15,0.2.244,0,614,0,22,244,266,240,4,266,336,0,96,337,3,3,123,141,248,289,16,1470,728
1570,15,1.4.257,0,614,0,73,257,330,257,0,330,336,-257,257,594,5,1,73,357,330,357,16,1470,728
1570,15,2.2.292,0,614,0,46,292,338,292,0,338,338,-48,144,385,3,3,190,141,322,289,16,1470,728
1570,15,3.2.336,0,614,0,18,336,354,336,0,354,354,-92,188,429,3,3,93,141,168,289,16,1470,728
1570,15,4.2.244,1,614,0,55,244,299,150,94,299,336,0,96,337,3,3,153,141,209,289,16,1470,728
1570,15,5.3.257,0,614,0,20,257,277,244,13,277,336,0,186,337,4,2,96,230,193,301,16,1470,728
1570,16,0.2.299,1,614,0,22,299,321,240,59,321,336,0,96,337,3,4,123,86,248,289,17,1470,673
1570,16,1.4.257,0,614,0,73,257,330,257,0,330,336,-257,257,594,5,1,73,357,330,357,17,1470,673
1570,16,2.2.299,0,614,0,46,299,345,292,7,345,345,0,96,337,3,4,190,86,322,289,17,1470,673
1570,16,3.2.336,0,614,0,18,336,354,336,0,354,354,-37,133,374,3,4,93,86,168,289,17,1470,673
1570,16,4.3.299,0,614,0,81,299,380,299,0,380,380,-42,228,379,4,2,98,230,209,301,17,1470,673
1570,16,5.3.257,0,614,0,20,257,277,244,13,277,336,0,186,337,4,2,96,230,193,301,17,1470,673
1570,17,0.3.321,0,614,0,17,321,338,321,0,338,338,-64,250,401,4,2,101,230,248,301,18,1470,651
1570,17,1.4.257,0,614,0,73,257,330,257,0,330,336,-257,257,594,5,1,73,357,330,357,18,1470,651
1570,17,2.2.321,1,614,0,46,321,367,292,29,367,367,0,96,337,3,5,190,64,322,289,18,1470,651
1570,17,3.2.336,0,614,0,18,336,354,336,0,354,354,-15,111,352,3,5,93,64,168,289,18,1470,651
1570,17,4.3.299,0,614,0,81,299,380,299,0,380,380,-42,228,379,4,2,98,230,209,301,18,1470,651
1570,17,5.3.257,0,614,0,20,257,277,244,13,277,336,0,186,337,4,2,96,230,193,301,18,1470,651
1570,18,0.3.321,0,614,0,17,321,338,321,0,338,367,-64,250,401,4,2,101,230,248,301,19,1470,605
1570,18,1.4.257,0,614,0,73,257,330,257,0,330,367,-257,257,594,5,1,73,357,330,357,19,1470,605
1570,18,2.3.367,0,614,0,88,367,455,367,0,455,455,-110,296,447,4,2,144,230,322,301,19,1470,605
1570,18,3.2.367,1,614,0,18,367,385,336,31,385,385,0,96,337,3,6,93,18,168,289,19,1470,605
1570,18,4.3.299,0,614,0,81,299,380,299,0,380,380,-42,228,379,4,2,98,230,209,301,19,1470,605
1570,18,5.3.257,0,614,0,20,257,277,244,13,277,367,0,186,337,4,2,96,230,193,301,19,1470,605
1570,19,0.3.321,0,614,0,17,321,338,321,0,338,385,-64,250,401,4,2,101,230,248,301,20,1470,587
1570,19,1.4.257,0,614,0,73,257,330,257,0,330,385,-257,257,594,5,1,73,357,330,357,20,1470,587
1570,19,2.3.367,0,614,0,88,367,455,367,0,455,455,-110,296,447,4,2,144,230,322,301,20,1470,587
1570,19,3.3.385,0,614,0,24,385,409,385,0,409,409,-128,314,465,4,2,75,230,168,301,20,1470,587
1570,19,4.3.299,0,614,0,81,299,380,299,0,380,385,-42,228,379,4,2,98,230,209,301,20,1470,587
1570,19,5.3.257,1,614,0,20,257,277,244,13,277,385,0,186,337,4,2,96,230,193,301,20,1470,587
1570,20,0.3.321,1,614,0,17,321,338,321,0,338,385,-44,230,381,4,3,101,210,248,301,21,1470,567
1570,20,1.4.257,0,614,0,73,257,330,257,0,330,385,-257,257,594,5,1,73,357,330,357,21,1470,567
1570,20,2.3.367,0,614,0,88,367,455,367,0,455,455,-90,276,427,4,3,144,210,322,301,21,1470,567
1570,20,3.3.385,0,614,0,24,385,409,385,0,409,409,-108,294,445,4,3,75,210,168,301,21,1470,567
1570,20,4.3.299,0,614,0,81,299,380,299,0,380,385,-22,208,359,4,3,98,210,209,301,21,1470,567
1570,20,5.4.277,0,634,1,76,277,353,277,0,353,385,-277,277,614,5,1,76,357,193,357,21,1470,567
1570,21,0.4.338,0,622,1,84,338,422,338,0,422,422,-338,338,719,5,1,84,357,248,357,22,1470,550
1570,21,1.4.257,1,614,0,73,257,330,257,0,330,385,-257,257,638,5,1,73,357,330,357,22,1470,550
1570,21,2.3.367,0,614,0,88,367,455,367,0,455,455,-29,259,410,4,4,144,193,322,301,22,1470,550
1570,21,3.3.385,0,614,0,24,385,409,385,0,409,409,-47,277,428,4,4,75,193,168,301,22,1470,550
1570,21,4.3.338,0,614,0,81,338,419,299,39,419,419,0,230,381,4,4,98,193,209,301,22,1470,550
1570,21,5.4.277,0,634,2,76,277,353,277,0,353,385,-277,277,658,5,1,76,357,193,357,22,1470,550
1570,22,0.4.338,0,622,1,84,338,422,338,0,422,422,-8,265,646,5,2,84,284,248,357,23,1470,477
1570,22,2.3.367,0,614,0,88,367,455,367,0,455,455,-29,259,667,4,4,144,193,322,301,23,1470,477
1570,22,3.3.385,0,614,0,24,385,409,385,0,409,409,-47,277,685,4,4,75,193,168,301,23,1470,477
1570,22,4.3.338,1,614,0,81,338,419,299,39,419,419,0,230,638,4,4,98,193,209,301,23,1470,477
1570,22,5.4.330,0,614,0,76,330,406,277,53,406,406,0,257,638,5,2,76,284,193,357,23,1470,477
1570,23,0.4.338,0,622,1,84,338,422,338,0,422,422,-8,265,646,5,2,84,284,248,357,24,1470,396
1570,23,2.3.419,0,614,0,88,419,507,367,52,507,507,0,230,638,4,5,144,112,322,301,24,1470,396
1570,23,3.3.419,1,614,0,24,419,443,385,34,443,443,0,230,638,4,5,75,112,168,301,24,1470,396
1570,23,4.4.419,0,627,2,17,419,436,419,0,436,436,-89,346,727,5,2,17,284,209,357,24,1470,396
1570,23,5.4.330,0,614,0,76,330,406,277,53,406,419,0,257,638,5,2,76,284,193,357,24,1470,396
1570,24,0.4.338,0,622,1,84,338,422,338,0,422,443,-8,265,646,5,2,84,284,248,357,25,1470,372
1570,24,2.3.443,1,614,0,88,443,531,367,76,531,531,0,230,638,4,6,144,88,322,301,25,1470,372
1570,24,3.4.443,0,626,2,51,443,494,443,0,494,494,-113,370,751,5,2,51,284,168,357,25,1470,372
1570,24,4.4.419,0,627,3,17,419,436,419,0,436,443,-89,346,727,5,2,17,284,209,357,25,1470,372
1570,24,5.4.330,0,614,0,76,330,406,277,53,406,443,0,257,638,5,2,76,284,193,357,25,1470,372
1570,25,0.4.338,0,622,1,84,338,422,338,0,422,531,-8,265,646,5,2,84,284,248,357,26,1470,284
1570,25,2.4.531,0,638,4,56,531,587,531,0,587,587,-201,458,839,5,2,56,284,322,357,26,1470,284
1570,25,3.4.443,0,626,2,51,443,494,443,0,494,531,-113,370,751,5,2,51,284,168,357,26,1470,284
1570,25,4.4.419,0,627,3,17,419,436,419,0,436,531,-89,346,727,5,2,17,284,209,357,26,1470,284
1570,25,5.4.330,1,614,0,76,330,406,277,53,406,531,0,257,638,5,2,76,284,193,357,26,1470,284
1570,26,0.4.406,0,614,0,84,406,490,338,68,490,531,0,257,638,5,3,84,208,248,357,27,1470,208
1570,26,2.4.531,0,638,3,56,531,587,531,0,587,587,-125,382,763,5,3,56,208,322,357,27,1470,208
1570,26,3.4.443,0,634,2,51,443,494,443,0,494,531,-37,294,675,5,3,51,208,168,357,27,1470,208
1570,26,4.4.419,1,627,1,17,419,436,419,0,436,531,-13,270,651,5,3,17,208,209,357,27,1470,208
1570,27,0.4.436,1,627,0,84,436,520,338,98,520,531,0,270,651,5,4,84,191,248,357,28,1470,191
1570,27,2.4.531,0,638,2,56,531,587,531,0,587,587,-95,365,746,5,4,56,191,322,357,28,1470,191
1570,27,3.4.443,0,634,1,51,443,494,443,0,494,531,-7,277,658,5,4,51,191,168,357,28,1470,191
1570,28,2.4.531,0,638,1,56,531,587,531,0,587,587,-11,281,662,5,5,56,107,322,357,29,1470,107
1570,28,3.4.520,1,627,0,51,520,571,443,77,571,571,0,270,651,5,5,51,107,168,357,29,1470,107
1570,29,2.4.571,1,627,0,56,571,627,531,40,627,627,0,270,651,5,6,56,56,322,357,30,1470,56
1571,0,0.0.0,0,627,3,48,0,48,0,0,48,48,0,0,0,1,1,191,256,191,256,1,1635,1635
1571,0,1.0.0,1,593,1,19,0,19,0,0,19,19,0,0,0,1,1,231,256,231,256,1,1635,1635
1571,0,2.0.0,0,619,2,28,0,28,0,0,28,28,0,0,0,1,1,250,256,250,256,1,1635,1635
1571,0,3.0.0,0,664,5,84,0,84,0,0,84,84,0,0,0,1,1,425,256,425,256,1,1635,1635
1571,0,4.0.0,0,636,4,57,0,57,0,0,57,57,0,0,0,1,1,345,256,345,256,1,1635,1635
1571,0,5.0.0,0,591,0,20,0,20,0,0,20,20,0,0,0,1,1,193,256,193,256,1,1635,1635
1571,1,0.0.19,0,593,0,48,19,67,0,19,67,67,0,0,0,1,2,191,237,191,256,2,1635,1616
1571,1,1.1.19,1,593,0,21,19,40,19,0,40,40,-19,19,19,2,1,212,283,231,283,2,1635,1616
1571,1,2.0.19,0,608,2,28,19,47,0,19,47,47,0,0,0,1,2,250,237,250,256,2,1635,1616
1571,1,3.0.19,0,635,3,84,19,103,0,19,103,103,0,0,0,1,2,425,237,425,256,2,1635,1616
1571,1,4.0.19,0,595,1,57,19,76,0,19,76,76,0,0,0,1,2,345,237,345,256,2,1635,1616
1571,1,5.0.19,0,593,0,20,19,39,0,19,39,39,0,0,0,1,2,193,237,193,256,2,1635,1616
1571,2,0.0.19,0,593,0,48,19,67,0,19,67,67,0,0,19,1,2,191,237,191,256,3,1635,1595
1571,2,1.2.40,0,593,0,95,40,135,40,0,135,135,-40,40,59,3,1,191,456,231,456,3,1635,1595
1571,2,2.0.19,0,608,2,28,19,47,0,19,47,47,0,0,19,1,2,250,237,250,256,3,1635,1595
1571,2,3.0.19,0,635,3,84,19,103,0,19,103,103,0,0,19,1,2,425,237,425,256,3,1635,1595
1571,2,4.0.19,1,595,1,57,19,76,0,19,76,76,0,0,19,1,2,345,237,345,256,3,1635,1595
1571,2,5.0.19,0,593,0,20,19,39,0,19,39,40,0,0,19,1,2,193,237,193,256,3,1635,1595
1571,3,0.0.76,0,606,1,48,76,124,0,76,124,124,0,0,19,1,3,191,180,191,256,4,1635,1538
1571,3,1.2.40,0,595,0,95,40,135,40,0,135,135,-40,40,59,3,1,191,456,231,456,4,1635,1538
1571,3,2.0.76,0,608,2,28,76,104,0,76,104,104,0,0,19,1,3,250,180,250,256,4,1635,1538
1571,3,3.0.76,1,618,3,84,76,160,0,76,160,160,0,0,19,1,3,425,180,425,256,4,1635,1538
1571,3,4.1.76,0,606,1,72,76,148,76,0,148,148,-36,55,55,2,2,288,262,345,283,4,1635,1538
1571,3,5.0.76,0,595,0,20,76,96,0,76,96,96,0,0,19,1,3,193,180,193,256,4,1635,1538
1571,4,0.0.160,0,627,1,48,160,208,0,160,208,208,0,0,19,1,4,191,96,191,256,5,1635,1454
1571,4,1.2.40,0,618,0,95,40,135,40,0,135,160,-40,40,59,3,1,191,456,231,456,5,1635,1454
1571,4,2.0.160,1,627,1,28,160,188,0,160,188,188,0,0,19,1,4,250,96,250,256,5,1635,1454
1571,4,3.1.160,0,627,1,82,160,242,160,0,242,242,-120,139,139,2,2,341,262,425,283,5,1635,1454
1571,4,4.1.76,0,618,0,72,76,148,76,0,148,160,-36,55,55,2,2,288,262,345,283,5,1635,1454
1571,4,5.0.160,0,618,0,20,160,180,0,160,180,180,0,0,19,1,4,193,96,193,256,5,1635,1454
1571,5,0.0.188,0,627,0,48,188,236,0,188,236,236,0,0,19,1,5,191,68,191,256,6,1635,1426
1571,5,1.2.40,0,627,0,95,40,135,40,0,135,188,-40,40,59,3,1,191,456,231,456,6,1635,1426
1571,5,2.1.188,0,652,1,44,188,232,188,0,232,232,-148,167,167,2,2,222,262,250,283,6,1635,1426
1571,5,3.1.160,0,627,0,82,160,242,160,0,242,242,-120,139,139,2,2,341,262,425,283,6,1635,1426
1571,5,4.1.76,0,627,0,72,76,148,76,0,148,188,-36,55,55,2,2,288,262,345,283,6,1635,1426
1571,5,5.0.188,1,627,0,20,188,208,0,188,208,208,0,0,19,1,5,193,68,193,256,6,1635,1426
1571,6,0.0.208,1,627,0,48,208,256,0,208,256,256,0,0,19,1,6,191,48,191,256,7,1635,1406
1571,6,1.2.40,0,627,0,95,40,135,40,0,135,208,-40,40,59,3,1,191,456,231,456,7,1635,1406
1571,6,2.1.188,0,652,2,44,188,232,188,0,232,232,-148,167,167,2,2,222,262,250,283,7,1635,1406
1571,6,3.1.160,0,627,0,82,160,242,160,0,242,242,-120,139,139,2,2,341,262,425,283,7,1635,1406
1571,6,4.1.76,0,627,0,72,76,148,76,0,148,208,-36,55,55,2,2,288,262,345,283,7,1635,1406
1571,6,5.1.208,0,628,1,6,208,214,208,0,214,214,-168,187,187,2,2,173,262,193,283,7,1635,1406
1571,7,0.1.256,0,627,0,58,256,314,256,0,314,314,-216,235,235,2,2,143,262,191,283,8,1635,1358
1571,7,1.2.40,0,627,0,95,40,135,40,0,135,256,-40,40,59,3,1,191,456,231,456,8,1635,1358
1571,7,2.1.188,0,652,2,44,188,232,188,0,232,256,-148,167,167,2,2,222,262,250,283,8,1635,1358
1571,7,3.1.160,0,627,0,82,160,242,160,0,242,256,-120,139,139,2,2,341,262,425,283,8,1635,1358
1571,7,4.1.76,1,627,0,72,76,148,76,0,148,256,-36,55,55,2,2,288,262,345,283,8,1635,1358
1571,7,5.1.208,0,628,1,6,208,214,208,0,214,256,-168,187,187,2,2,173,262,193,283,8,1635,1358
1571,8,0.1.256,0,627,0,58,256,314,256,0,314,314,-108,163,163,2,3,143,190,191,283,9,1635,1286
1571,8,1.2.40,0,627,0,95,40,135,40,0,135,256,-40,40,95,3,1,191,456,231,456,9,1635,1286
1571,8,2.1.188,0,652,2,44,188,232,188,0,232,256,-40,95,95,2,3,222,190,250,283,9,1635,1286
1571,8,3.1.160,1,627,0,82,160,242,160,0,242,256,-12,67,67,2,3,341,190,425,283,9,1635,1286
1571,8,4.2.148,0,627,0,56,148,204,148,0,204,256,-148,148,203,3,1,216,456,345,456,9,1635,1286
1571,8,5.1.208,0,628,1,6,208,214,208,0,214,256,-60,115,115,2,3,173,190,193,283,9,1635,1286
1571,9,0.1.256,0,627,0,58,256,314,256,0,314,314,-14,81,81,2,4,143,108,191,283,10,1635,1204
1571,9,1.2.40,0,627,0,95,40,135,40,0,135,256,-40,40,107,3,1,191,456,231,456,10,1635,1204
1571,9,2.1.242,0,627,0,44,242,286,188,54,286,286,0,67,67,2,4,222,108,250,283,10,1635,1204
1571,9,3.2.242,0,627,0,85,242,327,242,0,327,327,-242,242,309,3,1,259,456,425,456,10,1635,1204
1571,9,4.2.148,0,627,0,56,148,204,148,0,204,256,-148,148,215,3,1,216,456,345,456,10,1635,1204
1571,9,5.1.242,1,627,0,6,242,248,208,34,248,256,0,67,67,2,4,173,108,193,283,10,1635,1204
1571,10,0.1.256,0,627,0,58,256,314,256,0,314,314,-8,75,75,2,5,143,102,191,283,11,1635,1198
1571,10,1.2.40,0,627,0,95,40,135,40,0,135,256,-40,40,107,3,1,191,456,231,456,11,1635,1198
1571,10,2.1.248,1,627,0,44,248,292,188,60,292,292,0,67,67,2,5,222,102,250,283,11,1635,1198
1571,10,3.2.242,0,627,0,85,242,327,242,0,327,327,-242,242,309,3,1,259,456,425,456,11,1635,1198
1571,10,4.2.148,0,627,0,56,148,204,148,0,204,256,-148,148,215,3,1,216,456,345,456,11,1635,1198
1571,10,5.2.248,0,650,1,96,248,344,248,0,344,344,-248,248,315,3,1,167,456,193,456,11,1635,1198
1571,11,0.1.292,1,627,0,58,292,350,256,36,350,350,0,67,67,2,6,143,58,191,283,12,1635,1154
1571,11,1.2.40,0,627,0,95,40,135,40,0,135,292,-40,40,107,3,1,191,456,231,456,12,1635,1154
1571,11,2.2.292,0,742,2,99,292,391,292,0,391,391,-292,292,359,3,1,178,456,250,456,12,1635,1154
1571,11,3.2.242,0,627,0,85,242,327,242,0,327,327,-242,242,309,3,1,259,456,425,456,12,1635,1154
1571,11,4.2.148,0,627,0,56,148,204,148,0,204,292,-148,148,215,3,1,216,456,345,456,12,1635,1154
1571,11,5.2.248,0,656,1,96,248,344,248,0,344,344,-248,248,315,3,1,167,456,193,456,12,1635,1154
1571,12,0.2.350,0,641,1,25,350,375,350,0,375,375,-350,350,417,3,1,85,456,191,456,13,1635,1096
1571,12,1.2.40,1,627,0,95,40,135,40,0,135,350,-40,40,107,3,1,191,456,231,456,13,1635,1096
1571,12,2.2.292,0,742,3,99,292,391,292,0,391,391,-292,292,359,3,1,178,456,250,456,13,1635,1096
1571,12,3.2.242,0,627,0,85,242,327,242,0,327,350,-242,242,309,3,1,259,456,425,456,13,1635,1096
1571,12,4.2.148,0,627,0,56,148,204,148,0,204,350,-148,148,215,3,1,216,456,345,456,13,1635,1096
1571,12,5.2.248,0,656,2,96,248,344,248,0,344,350,-248,248,315,3,1,167,456,193,456,13,1635,1096
1571,13,0.2.350,0,641,1,25,350,375,350,0,375,375,-215,255,322,3,2,85,361,191,456,14,1635,1001
1571,13,1.3.135,1,627,0,14,135,149,135,0,149,350,-135,135,242,4,1,96,254,231,254,14,1635,1001
1571,13,2.2.292,0,742,3,99,292,391,292,0,391,391,-157,197,264,3,2,178,361,250,456,14,1635,1001
1571,13,3.2.242,0,627,0,85,242,327,242,0,327,350,-107,147,214,3,2,259,361,425,456,14,1635,1001
1571,13,4.2.148,0,627,0,56,148,204,148,0,204,350,-13,53,120,3,2,216,361,345,456,14,1635,1001
1571,13,5.2.248,0,656,2,96,248,344,248,0,344,350,-113,153,220,3,2,167,361,193,456,14,1635,1001
1571,14,0.2.350,0,641,1,25,350,375,350,0,375,375,-215,255,457,3,2,85,361,191,456,15,1635,987
1571,14,1.4.149,1,627,0,82,149,231,149,0,231,350,-149,149,391,5,1,82,386,231,386,15,1635,987
1571,14,2.2.292,0,742,3,99,292,391,292,0,391,391,-157,197,399,3,2,178,361,250,456,15,1635,987
1571,14,3.2.242,0,627,0,85,242,327,242,0,327,350,-107,147,349,3,2,259,361,425,456,15,1635,987
1571,14,4.2.148,0,627,0,56,148,204,148,0,204,350,-13,53,255,3,2,216,361,345,456,15,1635,987
1571,14,5.2.248,0,656,2,96,248,344,248,0,344,350,-113,153,355,3,2,167,361,193,456,15,1635,987
1571,15,0.2.350,0,641,1,25,350,375,350,0,375,375,-215,255,606,3,2,85,361,191,456,16,1635,905
1571,15,2.2.292,0,742,3,99,292,391,292,0,391,391,-157,197,548,3,2,178,361,250,456,16,1635,905
1571,15,3.2.242,0,627,0,85,242,327,242,0,327,350,-107,147,498,3,2,259,361,425,456,16,1635,905
1571,15,4.2.148,1,627,0,56,148,204,148,0,204,350,-13,53,404,3,2,216,361,345,456,16,1635,905
1571,15,5.2.248,0,656,2,96,248,344,248,0,344,350,-113,153,504,3,2,167,361,193,456,16,1635,905
1571,16,0.2.350,0,641,1,25,350,375,350,0,375,375,-146,199,550,3,3,85,305,191,456,17,1635,849
1571,16,2.2.292,0,742,3,99,292,391,292,0,391,391,-88,141,492,3,3,178,305,250,456,17,1635,849
1571,16,3.2.242,0,627,0,85,242,327,242,0,327,350,-38,91,442,3,3,259,305,425,456,17,1635,849
1571,16,4.3.204,1,627,0,74,204,278,204,0,278,350,-55,190,459,4,2,160,240,345,254,17,1635,849
1571,16,5.2.248,0,656,2,96,248,344,248,0,344,350,-44,97,448,3,3,167,305,193,456,17,1635,849
1571,17,0.2.350,0,641,1,25,350,375,350,0,375,375,-146,199,605,3,3,85,305,191,456,18,1635,775
1571,17,2.2.292,0,742,3,99,292,391,292,0,391,391,-88,141,547,3,3,178,305,250,456,18,1635,775
1571,17,3.2.242,0,627,0,85,242,327,242,0,327,350,-38,91,497,3,3,259,305,425,456,18,1635,775
1571,17,4.4.278,1,627,0,86,278,364,278,0,364,364,-47,196,506,5,2,86,304,345,386,18,1635,775
1571,17,5.2.248,0,656,2,96,248,344,248,0,344,350,-44,97,503,3,3,167,305,193,456,18,1635,775
1571,18,0.2.350,0,641,1,25,350,375,350,0,375,375,-146,199,652,3,3,85,305,191,456,19,1635,689
1571,18,2.2.292,0,742,3,99,292,391,292,0,391,391,-88,141,594,3,3,178,305,250,456,19,1635,689
1571,18,3.2.242,1,627,0,85,242,327,242,0,327,364,-38,91,544,3,3,259,305,425,456,19,1635,689
1571,18,5.2.248,0,656,2,96,248,344,248,0,344,364,-44,97,550,3,3,167,305,193,456,19,1635,689
1571,19,0.2.350,0,641,1,25,350,375,350,0,375,375,-23,114,567,3,4,85,220,191,456,20,1635,604
1571,19,2.2.327,0,627,0,99,327,426,292,35,426,426,0,91,544,3,4,178,220,250,456,20,1635,604
1571,19,3.3.327,1,627,0,82,327,409,327,0,409,409,-49,239,593,4,3,174,166,425,254,20,1635,604
1571,19,5.2.327,0,627,0,96,327,423,248,79,423,423,0,91,544,3,4,167,220,193,456,20,1635,604
1571,20,0.2.350,0,641,1,25,350,375,350,0,375,409,-23,114,616,3,4,85,220,191,456,21,1635,522
1571,20,2.2.327,0,627,0,99,327,426,292,35,426,426,0,91,593,3,4,178,220,250,456,21,1635,522
1571,20,3.4.409,1,627,0,92,409,501,409,0,501,501,-45,241,638,5,3,92,218,425,386,21,1635,522
1571,20,5.2.327,0,627,0,96,327,423,248,79,423,423,0,91,593,3,4,167,220,193,456,21,1635,522
1571,21,0.2.350,1,641,1,25,350,375,350,0,375,501,-23,114,661,3,4,85,220,191,456,22,1635,430
1571,21,2.2.327,0,627,0,99,327,426,292,35,426,501,0,91,638,3,4,178,220,250,456,22,1635,430
1571,21,5.2.327,0,627,0,96,327,423,248,79,423,501,0,91,638,3,4,167,220,193,456,22,1635,430
1571,22,0.3.409,1,641,0,23,409,432,375,34,432,501,0,239,661,4,4,60,84,191,254,23,1635,405
1571,22,2.2.375,0,641,0,99,375,474,292,83,474,501,0,114,661,3,5,178,195,250,456,23,1635,405
1571,22,5.2.375,0,649,1,96,375,471,248,127,471,501,0,114,661,3,5,167,195,193,456,23,1635,405
1571,23,0.4.501,1,641,0,37,501,538,432,69,538,538,0,241,661,5,4,37,126,191,386,24,1635,382
1571,23,2.2.375,0,641,0,99,375,474,292,83,474,501,0,114,661,3,5,178,195,250,456,24,1635,382
1571,23,5.2.375,0,649,1,96,375,471,248,127,471,501,0,114,661,3,5,167,195,193,456,24,1635,382
1571,24,2.2.375,0,641,0,99,375,474,292,83,474,538,0,114,661,3,5,178,195,250,456,25,1635,345
1571,24,5.2.375,1,649,1,96,375,471,248,127,471,538,0,114,661,3,5,167,195,193,456,25,1635,345
1571,25,2.2.471,0,649,0,99,471,570,292,179,570,570,0,114,661,3,6,178,99,250,456,26,1635,249
1571,25,5.3.471,1,649,0,4,471,475,471,0,475,538,-39,278,700,4,5,71,61,193,254,26,1635,249
1571,26,2.2.471,0,649,0,99,471,570,292,179,570,570,0,114,700,3,6,178,99,250,456,27,1635,245
1571,26,5.4.538,1,649,0,67,538,605,475,63,605,605,0,241,700,5,5,67,89,193,386,27,1635,245
1571,27,2.2.471,1,649,0,99,471,570,292,179,570,605,0,114,700,3,6,178,99,250,456,28,1635,178
1571,28,2.3.570,1,649,0,57,570,627,570,0,627,627,-95,373,795,4,6,79,57,250,254,29,1635,79
1571,29,2.4.627,1,649,0,22,627,649,627,0,649,649,-22,263,817,5,6,22,22,250,386,30,1635,22
1572,0,0.0.0,0,614,2,61,0,61,0,0,61,61,0,0,0,1,1,234,369,234,369,1,1605,1605
1572,0,1.0.0,0,655,5,94,0,94,0,0,94,94,0,0,0,1,1,331,369,331,369,1,1605,1605
1572,0,2.0.0,0,607,0,73,0,73,0,0,73,73,0,0,0,1,1,274,369,274,369,1,1605,1605
1572,0,3.0.0,0,615,3,37,0,37,0,0,37,37,0,0,0,1,1,185,369,185,369,1,1605,1605
1572,0,4.0.0,0,640,4,79,0,79,0,0,79,79,0,0,0,1,1,286,369,286,369,1,1605,1605
1572,0,5.0.0,1,613,1,25,0,25,0,0,25,25,0,0,0,1,1,295,369,295,369,1,1605,1605
1572,1,0.0.25,0,613,0,61,25,86,0,25,86,86,0,0,0,1,2,234,344,234,369,2,1605,1580
1572,1,1.0.25,0,652,3,94,25,119,0,25,119,119,0,0,0,1,2,331,344,331,369,2,1605,1580
1572,1,2.0.25,0,629,2,73,25,98,0,25,98,98,0,0,0,1,2,274,344,274,369,2,1605,1580
1572,1,3.0.25,0,623,1,37,25,62,0,25,62,62,0,0,0,1,2,185,344,185,369,2,1605,1580
1572,1,4.0.25,0,652,3,79,25,104,0,25,104,104,0,0,0,1,2,286,344,286,369,2,1605,1580
1572,1,5.1.25,1,613,0,88,25,113,25,0,113,113,-25,25,25,2,1,270,286,295,286,2,1605,1580
1572,2,0.0.25,0,613,0,61,25,86,0,25,86,113,0,0,25,1,2,234,344,234,369,3,1605,1492
1572,2,1.0.25,0,652,4,94,25,119,0,25,119,119,0,0,25,1,2,331,344,331,369,3,1605,1492
1572,2,2.0.25,0,644,3,73,25,98,0,25,98,113,0,0,25,1,2,274,344,274,369,3,1605,1492
1572,2,3.0.25,0,623,2,37,25,62,0,25,62,113,0,0,25,1,2,185,344,185,369,3,1605,1492
1572,2,4.0.25,0,652,4,79,25,104,0,25,104,113,0,0,25,1,2,286,344,286,369,3,1605,1492
1572,2,5.2.113,1,622,1,35,113,148,113,0,148,148,-113,113,138,3,1,182,226,295,226,3,1605,1492
1572,3,0.0.25,0,622,0,61,25,86,0,25,86,148,0,0,138,1,2,234,344,234,369,4,1605,1457
1572,3,1.0.25,0,652,3,94,25,119,0,25,119,148,0,0,138,1,2,331,344,331,369,4,1605,1457
1572,3,2.0.25,0,644,2,73,25,98,0,25,98,148,0,0,138,1,2,274,344,274,369,4,1605,1457
1572,3,3.0.25,0,623,1,37,25,62,0,25,62,148,0,0,138,1,2,185,344,185,369,4,1605,1457
1572,3,4.0.25,0,652,3,79,25,104,0,25,104,148,0,0,138,1,2,286,344,286,369,4,1605,1457
1572,3,5.3.148,1,652,3,88,148,236,148,0,236,236,-148,148,286,4,1,147,308,295,308,4,1605,1457
1572,4,0.0.25,0,652,0,61,25,86,0,25,86,236,0,0,286,1,2,234,344,234,369,5,1605,1369
1572,4,1.0.25,0,652,0,94,25,119,0,25,119,236,0,0,286,1,2,331,344,331,369,5,1605,1369
1572,4,2.0.25,0,652,0,73,25,98,0,25,98,236,0,0,286,1,2,274,344,274,369,5,1605,1369
1572,4,3.0.25,0,652,0,37,25,62,0,25,62,236,0,0,286,1,2,185,344,185,369,5,1605,1369
1572,4,4.0.25,0,652,0,79,25,104,0,25,104,236,0,0,286,1,2,286,344,286,369,5,1605,1369
1572,4,5.4.236,1,652,0,59,236,295,236,0,295,295,-236,236,522,5,1,59,416,295,416,5,1605,1369
1572,5,0.0.25,0,652,0,61,25,86,0,25,86,295,0,0,522,1,2,234,344,234,369,6,1605,1310
1572,5,1.0.25,1,652,0,94,25,119,0,25,119,295,0,0,522,1,2,331,344,331,369,6,1605,1310
1572,5,2.0.25,0,652,0,73,25,98,0,25,98,295,0,0,522,1,2,274,344,274,369,6,1605,1310
1572,5,3.0.25,0,652,0,37,25,62,0,25,62,295,0,0,522,1,2,185,344,185,369,6,1605,1310
1572,5,4.0.25,0,652,0,79,25,104,0,25,104,295,0,0,522,1,2,286,344,286,369,6,1605,1310
1572,6,0.0.119,0,652,0,61,119,180,0,119,180,295,0,0,522,1,3,234,250,234,369,7,1605,1216
1572,6,1.1.119,1,652,0,89,119,208,119,0,208,295,-6,31,528,2,2,237,198,331,286,7,1605,1216
1572,6,2.0.119,0,652,0,73,119,192,0,119,192,295,0,0,522,1,3,274,250,274,369,7,1605,1216
1572,6,3.0.119,0,652,0,37,119,156,0,119,156,295,0,0,522,1,3,185,250,185,369,7,1605,1216
1572,6,4.0.119,0,652,0,79,119,198,0,119,198,295,0,0,522,1,3,286,250,286,369,7,1605,1216
1572,7,0.0.119,0,652,0,61,119,180,0,119,180,295,0,0,528,1,3,234,250,234,369,8,1605,1127
1572,7,1.2.208,1,652,0,2,208,210,208,0,210,295,-60,173,588,3,2,148,191,331,226,8,1605,1127
1572,7,2.0.119,0,652,0,73,119,192,0,119,192,295,0,0,528,1,3,274,250,274,369,8,1605,1127
1572,7,3.0.119,0,652,0,37,119,156,0,119,156,295,0,0,528,1,3,185,250,185,369,8,1605,1127
1572,7,4.0.119,0,652,0,79,119,198,0,119,198,295,0,0,528,1,3,286,250,286,369,8,1605,1127
1572,8,0.0.119,0,652,0,61,119,180,0,119,180,295,0,0,588,1,3,234,250,234,369,9,1605,1125
1572,8,1.3.236,1,652,0,55,236,291,210,26,291,295,0,148,588,4,2,146,220,331,308,9,1605,1125
1572,8,2.0.119,0,652,0,73,119,192,0,119,192,295,0,0,588,1,3,274,250,274,369,9,1605,1125
1572,8,3.0.119,0,652,0,37,119,156,0,119,156,295,0,0,588,1,3,185,250,185,369,9,1605,1125
1572,8,4.0.119,0,652,0,79,119,198,0,119,198,295,0,0,588,1,3,286,250,286,369,9,1605,1125
1572,9,0.0.119,0,652,0,61,119,180,0,119,180,295,0,0,588,1,3,234,250,234,369,10,1605,1070
1572,9,1.4.295,0,652,0,91,295,386,291,4,386,386,0,236,588,5,2,91,357,331,416,10,1605,1070
1572,9,2.0.119,0,652,0,73,119,192,0,119,192,295,0,0,588,1,3,274,250,274,369,10,1605,1070
1572,9,3.0.119,1,652,0,37,119,156,0,119,156,295,0,0,588,1,3,185,250,185,369,10,1605,1070
1572,9,4.0.119,0,652,0,79,119,198,0,119,198,295,0,0,588,1,3,286,250,286,369,10,1605,1070
1572,10,0.0.156,0,652,0,61,156,217,0,156,217,295,0,0,588,1,4,234,213,234,369,11,1605,1033
1572,10,1.4.295,0,652,0,91,295,386,291,4,386,386,0,236,588,5,2,91,357,331,416,11,1605,1033
1572,10,2.0.156,0,652,0,73,156,229,0,156,229,295,0,0,588,1,4,274,213,274,369,11,1605,1033
1572,10,3.1.208,1,652,0,21,208,229,156,52,229,295,0,31,588,2,3,148,109,185,286,11,1605,1033
1572,10,4.0.156,0,652,0,79,156,235,0,156,235,295,0,0,588,1,4,286,213,286,369,11,1605,1033
1572,11,0.0.156,0,652,0,61,156,217,0,156,217,295,0,0,588,1,4,234,213,234,369,12,1605,1012
1572,11,1.4.295,0,652,0,91,295,386,291,4,386,386,0,236,588,5,2,91,357,331,416,12,1605,1012
1572,11,2.0.156,0,652,0,73,156,229,0,156,229,295,0,0,588,1,4,274,213,274,369,12,1605,1012
1572,11,3.2.229,1,652,0,52,229,281,229,0,281,295,-19,192,607,3,3,127,189,185,226,12,1605,1012
1572,11,4.0.156,0,652,0,79,156,235,0,156,235,295,0,0,588,1,4,286,213,286,369,12,1605,1012
1572,12,0.0.156,0,652,0,61,156,217,0,156,217,295,0,0,607,1,4,234,213,234,369,13,1605,960
1572,12,1.4.295,0,652,0,91,295,386,291,4,386,386,0,236,607,5,2,91,357,331,416,13,1605,960
1572,12,2.0.156,0,652,0,73,156,229,0,156,229,295,0,0,607,1,4,274,213,274,369,13,1605,960
1572,12,3.3.291,1,652,0,41,291,332,281,10,332,332,0,148,607,4,3,75,165,185,308,13,1605,960
1572,12,4.0.156,0,652,0,79,156,235,0,156,235,295,0,0,607,1,4,286,213,286,369,13,1605,960
1572,13,0.0.156,0,652,0,61,156,217,0,156,217,332,0,0,607,1,4,234,213,234,369,14,1605,919
1572,13,1.4.295,0,652,0,91,295,386,291,4,386,386,0,236,607,5,2,91,357,331,416,14,1605,919
1572,13,2.0.156,1,652,0,73,156,229,0,156,229,332,0,0,607,1,4,274,213,274,369,14,1605,919
1572,13,3.4.332,0,689,1,34,332,366,332,0,366,366,-37,273,644,5,2,34,357,185,416,14,1605,919
1572,13,4.0.156,0,652,0,79,156,235,0,156,235,332,0,0,607,1,4,286,213,286,369,14,1605,919
1572,14,0.0.229,0,652,0,61,229,290,0,229,290,332,0,0,607,1,5,234,140,234,369,15,1605,846
1572,14,1.4.295,0,652,0,91,295,386,291,4,386,386,0,236,607,5,2,91,357,331,416,15,1605,846
1572,14,2.1.229,1,652,0,37,229,266,229,0,266,332,0,31,607,2,4,201,88,274,286,15,1605,846
1572,14,3.4.332,0,689,1,34,332,366,332,0,366,366,-37,273,644,5,2,34,357,185,416,15,1605,846
1572,14,4.0.229,0,652,0,79,229,308,0,229,308,332,0,0,607,1,5,286,140,286,369,15,1605,846
1572,15,0.0.229,0,652,0,61,229,290,0,229,290,332,0,0,607,1,5,234,140,234,369,16,1605,809
1572,15,1.4.295,0,652,0,91,295,386,291,4,386,386,0,236,607,5,2,91,357,331,416,16,1605,809
1572,15,2.2.281,1,652,0,52,281,333,266,15,333,333,0,192,607,3,4,164,137,274,226,16,1605,809
1572,15,3.4.332,0,689,1,34,332,366,332,0,366,366,-37,273,644,5,2,34,357,185,416,16,1605,809
1572,15,4.0.229,0,652,0,79,229,308,0,229,308,332,0,0,607,1,5,286,140,286,369,16,1605,809
1572,16,0.0.229,0,652,0,61,229,290,0,229,290,333,0,0,607,1,5,234,140,234,369,17,1605,757
1572,16,1.4.295,0,652,0,91,295,386,291,4,386,386,0,236,607,5,2,91,357,331,416,17,1605,757
1572,16,2.3.333,1,652,0,26,333,359,333,0,359,359,-1,149,608,4,4,112,124,274,308,17,1605,757
1572,16,3.4.332,0,689,1,34,332,366,332,0,366,366,-37,273,644,5,2,34,357,185,416,17,1605,757
1572,16,4.0.229,0,652,0,79,229,308,0,229,308,333,0,0,607,1,5,286,140,286,369,17,1605,757
1572,17,0.0.229,0,652,0,61,229,290,0,229,290,359,0,0,608,1,5,234,140,234,369,18,1605,731
1572,17,1.4.295,0,652,0,91,295,386,291,4,386,386,0,236,608,5,2,91,357,331,416,18,1605,731
1572,17,2.4.359,0,716,2,86,359,445,359,0,445,445,-64,300,672,5,2,86,357,274,416,18,1605,731
1572,17,3.4.332,0,689,1,34,332,366,332,0,366,366,-37,273,645,5,2,34,357,185,416,18,1605,731
1572,17,4.0.229,1,652,0,79,229,308,0,229,308,359,0,0,608,1,5,286,140,286,369,18,1605,731
1572,18,0.0.308,1,652,0,61,308,369,0,308,369,369,0,0,608,1,6,234,61,234,369,19,1605,652
1572,18,1.4.295,0,652,0,91,295,386,291,4,386,386,0,236,608,5,2,91,357,331,416,19,1605,652
1572,18,2.4.359,0,716,2,86,359,445,359,0,445,445,-64,300,672,5,2,86,357,274,416,19,1605,652
1572,18,3.4.332,0,689,1,34,332,366,332,0,366,366,-37,273,645,5,2,34,357,185,416,19,1605,652
1572,18,4.1.308,0,652,0,25,308,333,308,0,333,359,-42,73,650,2,5,207,51,286,286,19,1605,652
1572,19,0.1.369,0,652,0,26,369,395,369,0,395,395,-103,134,711,2,5,173,51,234,286,20,1605,591
1572,19,1.4.295,0,652,0,91,295,386,291,4,386,386,0,236,608,5,2,91,357,331,416,20,1605,591
1572,19,2.4.359,0,716,2,86,359,445,359,0,445,445,-64,300,672,5,2,86,357,274,416,20,1605,591
1572,19,3.4.332,0,689,1,34,332,366,332,0,366,369,-37,273,645,5,2,34,357,185,416,20,1605,591
1572,19,4.1.308,1,652,0,25,308,333,308,0,333,369,-42,73,650,2,5,207,51,286,286,20,1605,591
1572,20,0.1.369,0,652,0,26,369,395,369,0,395,395,-36,109,686,2,6,173,26,234,286,21,1605,566
1572,20,1.4.295,0,652,0,91,295,386,291,4,386,386,0,236,650,5,2,91,357,331,416,21,1605,566
1572,20,2.4.359,0,716,2,86,359,445,359,0,445,445,-64,300,714,5,2,86,357,274,416,21,1605,566
1572,20,3.4.332,0,689,1,34,332,366,332,0,366,369,-37,273,687,5,2,34,357,185,416,21,1605,566
1572,20,4.2.333,1,652,0,57,333,390,333,0,390,390,0,192,650,3,5,182,85,286,226,21,1605,566
1572,21,0.1.369,0,652,0,26,369,395,369,0,395,395,-36,109,686,2,6,173,26,234,286,22,1605,509
1572,21,1.4.295,0,652,0,91,295,386,291,4,386,390,0,236,650,5,2,91,357,331,416,22,1605,509
1572,21,2.4.359,0,716,2,86,359,445,359,0,445,445,-64,300,714,5,2,86,357,274,416,22,1605,509
1572,21,3.4.332,0,689,1,34,332,366,332,0,366,390,-37,273,687,5,2,34,357,185,416,22,1605,509
1572,21,4.3.390,1,652,0,68,390,458,390,0,458,458,-31,180,681,4,5,125,98,286,308,22,1605,509
1572,22,0.1.369,1,652,0,26,369,395,369,0,395,458,-36,109,717,2,6,173,26,234,286,23,1605,441
1572,22,1.4.295,0,652,0,91,295,386,291,4,386,458,0,236,681,5,2,91,357,331,416,23,1605,441
1572,22,2.4.359,0,716,3,86,359,445,359,0,445,458,-64,300,745,5,2,86,357,274,416,23,1605,441
1572,22,3.4.332,0,689,1,34,332,366,332,0,366,458,-37,273,718,5,2,34,357,185,416,23,1605,441
1572,22,4.4.458,0,690,2,57,458,515,458,0,515,515,-163,399,844,5,2,57,357,286,416,23,1605,441
1572,23,0.2.395,1,652,0,28,395,423,395,0,423,458,-5,197,722,3,6,147,28,234,226,24,1605,415
1572,23,1.4.295,0,652,0,91,295,386,291,4,386,458,0,236,717,5,2,91,357,331,416,24,1605,415
1572,23,2.4.359,0,716,3,86,359,445,359,0,445,458,-64,300,781,5,2,86,357,274,416,24,1605,415
1572,23,3.4.332,0,689,1,34,332,366,332,0,366,458,-37,273,754,5,2,34,357,185,416,24,1605,415
1572,23,4.4.458,0,690,2,57,458,515,458,0,515,515,-163,399,880,5,2,57,357,286,416,24,1605,415
1572,24,0.3.458,1,652,0,30,458,488,423,35,488,488,0,180,722,4,6,119,30,234,308,25,1605,387
1572,24,1.4.295,0,652,0,91,295,386,291,4,386,458,0,236,722,5,2,91,357,331,416,25,1605,387
1572,24,2.4.359,0,716,3,86,359,445,359,0,445,458,-64,300,786,5,2,86,357,274,416,25,1605,387
1572,24,3.4.332,0,689,1,34,332,366,332,0,366,458,-37,273,759,5,2,34,357,185,416,25,1605,387
1572,24,4.4.458,0,690,2,57,458,515,458,0,515,515,-163,399,885,5,2,57,357,286,416,25,1605,387
1572,25,0.4.488,0,668,1,89,488,577,488,0,577,577,-193,429,915,5,2,89,357,234,416,26,1605,357
1572,25,1.4.295,1,652,0,91,295,386,291,4,386,488,0,236,722,5,2,91,357,331,416,26,1605,357
1572,25,2.4.359,0,716,4,86,359,445,359,0,445,488,-64,300,786,5,2,86,357,274,416,26,1605,357
1572,25,3.4.332,0,689,2,34,332,366,332,0,366,488,-37,273,759,5,2,34,357,185,416,26,1605,357
1572,25,4.4.458,0,690,3,57,458,515,458,0,515,515,-163,399,885,5,2,57,357,286,416,26,1605,357
1572,26,0.4.488,0,668,1,89,488,577,488,0,577,577,-102,338,824,5,3,89,266,234,416,27,1605,266
1572,26,2.4.386,0,652,0,86,386,472,359,27,472,488,0,236,722,5,3,86,266,274,416,27,1605,266
1572,26,3.4.386,1,652,0,34,386,420,332,54,420,488,0,236,722,5,3,34,266,185,416,27,1605,266
1572,26,4.4.458,0,690,2,57,458,515,458,0,515,515,-72,308,794,5,3,57,266,286,416,27,1605,266
1572,27,0.4.488,0,720,2,89,488,577,488,0,577,577,-68,304,790,5,4,89,232,234,416,28,1605,232
1572,27,2.4.420,1,652,0,86,420,506,359,61,506,506,0,236,722,5,4,86,232,274,416,28,1605,232
1572,27,4.4.458,0,690,1,57,458,515,458,0,515,515,-38,274,760,5,4,57,232,286,416,28,1605,232
1572,28,0.4.506,0,652,0,89,506,595,488,18,595,595,0,236,722,5,5,89,146,234,416,29,1605,146
1572,28,4.4.506,1,652,0,57,506,563,458,48,563,563,0,236,722,5,5,57,146,286,416,29,1605,146
1572,29,0.4.563,1,652,0,89,563,652,488,75,652,652,0,236,722,5,6,89,89,234,416,30,1605,89
1573,0,0.0.0,0,572,4,74,0,74,0,0,74,74,0,0,0,1,1,278,284,278,284,1,1478,1478
1573,0,1.0.0,0,567,3,69,0,69,0,0,69,69,0,0,0,1,1,230,284,230,284,1,1478,1478
1573,0,2.0.0,0,513,1,20,0,20,0,0,20,20,0,0,0,1,1,203,284,203,284,1,1478,1478
1573,0,3.0.0,0,588,5,90,0,90,0,0,90,90,0,0,0,1,1,246,284,246,284,1,1478,1478
1573,0,4.0.0,1,498,0,1,0,1,0,0,1,1,0,0,0,1,1,223,284,223,284,1,1478,1478
1573,0,5.0.0,0,523,2,30,0,30,0,0,30,30,0,0,0,1,1,298,284,298,284,1,1478,1478
1573,1,0.0.1,0,529,2,74,1,75,0,1,75,75,0,0,0,1,2,278,283,278,284,2,1478,1477
1573,1,1.0.1,0,524,1,69,1,70,0,1,70,70,0,0,0,1,2,230,283,230,284,2,1478,1477
1573,1,2.0.1,0,498,0,20,1,21,0,1,21,21,0,0,0,1,2,203,283,203,284,2,1478,1477
1573,1,3.0.1,0,532,3,90,1,91,0,1,91,91,0,0,0,1,2,246,283,246,284,2,1478,1477
1573,1,4.1.1,0,498,0,76,1,77,1,0,77,77,-1,1,1,2,1,222,389,223,389,2,1478,1477
1573,1,5.0.1,1,498,0,30,1,31,0,1,31,31,0,0,0,1,2,298,283,298,284,2,1478,1477
1573,2,0.0.31,0,524,2,74,31,105,0,31,105,105,0,0,0,1,3,278,253,278,284,3,1478,1447
1573,2,1.0.31,0,532,3,69,31,100,0,31,100,100,0,0,0,1,3,230,253,230,284,3,1478,1447
1573,2,2.0.31,1,498,0,20,31,51,0,31,51,51,0,0,0,1,3,203,253,203,284,3,1478,1447
1573,2,3.0.31,0,511,1,90,31,121,0,31,121,121,0,0,0,1,3,246,253,246,284,3,1478,1447
1573,2,4.1.1,0,498,0,76,1,77,1,0,77,77,-1,1,1,2,1,222,389,223,389,3,1478,1447
1573,2,5.1.31,0,524,2,72,31,103,31,0,103,103,-31,31,31,2,1,268,389,298,389,3,1478,1447
1573,3,0.0.51,1,511,1,74,51,125,0,51,125,125,0,0,0,1,4,278,233,278,284,4,1478,1427
1573,3,1.0.51,0,511,1,69,51,120,0,51,120,120,0,0,0,1,4,230,233,230,284,4,1478,1427
1573,3,2.1.51,0,544,3,31,51,82,51,0,82,82,-51,51,51,2,1,183,389,203,389,4,1478,1427
1573,3,3.0.51,0,498,0,90,51,141,0,51,141,141,0,0,0,1,4,246,233,246,284,4,1478,1427
1573,3,4.1.1,0,498,0,76,1,77,1,0,77,77,-1,1,1,2,1,222,389,223,389,4,1478,1427
1573,3,5.1.31,0,524,2,72,31,103,31,0,103,103,-31,31,31,2,1,268,389,298,389,4,1478,1427
1573,4,0.1.125,0,549,3,94,125,219,125,0,219,219,-125,125,125,2,1,204,389,278,389,5,1478,1353
1573,4,1.0.125,1,511,0,69,125,194,0,125,194,194,0,0,0,1,5,230,159,230,284,5,1478,1353
1573,4,2.1.51,0,544,2,31,51,82,51,0,82,125,-51,51,51,2,1,183,389,203,389,5,1478,1353
1573,4,3.0.125,0,511,0,90,125,215,0,125,215,215,0,0,0,1,5,246,159,246,284,5,1478,1353
1573,4,4.1.1,0,511,0,76,1,77,1,0,77,125,-1,1,1,2,1,222,389,223,389,5,1478,1353
1573,4,5.1.31,0,524,1,72,31,103,31,0,103,125,-31,31,31,2,1,268,389,298,389,5,1478,1353
1573,5,0.1.125,0,549,4,94,125,219,125,0,219,219,-125,125,125,2,1,204,389,278,389,6,1478,1284
1573,5,1.1.194,0,532,2,57,194,251,194,0,251,251,-194,194,194,2,1,161,389,230,389,6,1478,1284
1573,5,2.1.51,0,544,3,31,51,82,51,0,82,194,-51,51,51,2,1,183,389,203,389,6,1478,1284
1573,5,3.0.194,1,511,0,90,194,284,0,194,284,284,0,0,0,1,6,246,90,246,284,6,1478,1284
1573,5,4.1.1,0,511,0,76,1,77,1,0,77,194,-1,1,1,2,1,222,389,223,389,6,1478,1284
1573,5,5.1.31,0,524,1,72,31,103,31,0,103,194,-31,31,31,2,1,268,389,298,389,6,1478,1284
1573,6,0.1.125,0,549,4,94,125,219,125,0,219,284,-125,125,125,2,1,204,389,278,389,7,1478,1194
1573,6,1.1.194,0,532,2,57,194,251,194,0,251,284,-194,194,194,2,1,161,389,230,389,7,1478,1194
1573,6,2.1.51,0,544,3,31,51,82,51,0,82,284,-51,51,51,2,1,183,389,203,389,7,1478,1194
1573,6,3.1.284,0,511,0,59,284,343,284,0,343,343,-284,284,284,2,1,156,389,246,389,7,1478,1194
1573,6,4.1.1,0,511,0,76,1,77,1,0,77,284,-1,1,1,2,1,222,389,223,389,7,1478,1194
1573,6,5.1.31,1,524,1,72,31,103,31,0,103,284,-31,31,31,2,1,268,389,298,389,7,1478,1194
1573,7,0.1.125,0,549,3,94,125,219,125,0,219,284,-22,53,53,2,2,204,317,278,389,8,1478,1122
1573,7,1.1.194,0,575,4,57,194,251,194,0,251,284,-91,122,122,2,2,161,317,230,389,8,1478,1122
1573,7,2.1.103,0,524,0,31,103,134,51,52,134,284,0,31,31,2,2,183,317,203,389,8,1478,1122
1573,7,3.1.284,0,547,2,59,284,343,284,0,343,343,-181,212,212,2,2,156,317,246,389,8,1478,1122
1573,7,4.1.103,0,542,1,76,103,179,1,102,179,284,0,31,31,2,2,222,317,223,389,8,1478,1122
1573,7,5.2.103,1,542,1,73,103,176,103,0,176,284,-103,103,134,3,1,196,196,298,196,8,1478,1122
1573,8,0.1.125,0,549,1,94,125,219,125,0,219,284,-22,53,156,2,2,204,317,278,389,9,1478,1049
1573,8,1.1.194,0,575,3,57,194,251,194,0,251,284,-91,122,225,2,2,161,317,230,389,9,1478,1049
1573,8,2.1.103,0,542,0,31,103,134,51,52,134,284,0,31,134,2,2,183,317,203,389,9,1478,1049
1573,8,3.1.284,0,571,2,59,284,343,284,0,343,343,-181,212,315,2,2,156,317,246,389,9,1478,1049
1573,8,4.1.103,0,542,0,76,103,179,1,102,179,284,0,31,134,2,2,222,317,223,389,9,1478,1049
1573,8,5.3.176,1,542,0,73,176,249,176,0,249,284,-176,176,310,4,1,123,361,298,361,9,1478,1049
1573,9,0.1.125,0,549,1,94,125,219,125,0,219,284,-22,53,332,2,2,204,317,278,389,10,1478,976
1573,9,1.1.194,0,575,3,57,194,251,194,0,251,284,-91,122,401,2,2,161,317,230,389,10,1478,976
1573,9,2.1.103,0,542,0,31,103,134,51,52,134,284,0,31,310,2,2,183,317,203,389,10,1478,976
1573,9,3.1.284,0,571,2,59,284,343,284,0,343,343,-181,212,491,2,2,156,317,246,389,10,1478,976
1573,9,4.1.103,0,542,0,76,103,179,1,102,179,284,0,31,310,2,2,222,317,223,389,10,1478,976
1573,9,5.4.249,1,542,0,50,249,299,249,0,299,299,-249,249,559,5,1,50,248,298,248,10,1478,976
1573,10,0.1.125,0,549,1,94,125,219,125,0,219,299,-22,53,581,2,2,204,317,278,389,11,1478,926
1573,10,1.1.194,0,575,3,57,194,251,194,0,251,299,-91,122,650,2,2,161,317,230,389,11,1478,926
1573,10,2.1.103,1,542,0,31,103,134,51,52,134,299,0,31,559,2,2,183,317,203,389,11,1478,926
1573,10,3.1.284,0,571,2,59,284,343,284,0,343,343,-181,212,740,2,2,156,317,246,389,11,1478,926
1573,10,4.1.103,0,542,0,76,103,179,1,102,179,299,0,31,559,2,2,222,317,223,389,11,1478,926
1573,11,0.1.134,0,542,0,94,134,228,125,9,228,299,0,31,559,2,3,204,286,278,389,12,1478,895
1573,11,1.1.194,0,590,2,57,194,251,194,0,251,299,-60,91,619,2,3,161,286,230,389,12,1478,895
1573,11,2.2.176,1,542,0,6,176,182,134,42,182,299,0,103,559,3,2,152,123,203,196,12,1478,895
1573,11,3.1.284,0,579,1,59,284,343,284,0,343,343,-150,181,709,2,3,156,286,246,389,12,1478,895
1573,11,4.1.134,0,542,0,76,134,210,1,133,210,299,0,31,559,2,3,222,286,223,389,12,1478,895
1573,12,0.1.134,0,542,0,94,134,228,125,9,228,299,0,31,559,2,3,204,286,278,389,13,1478,889
1573,12,1.1.194,0,590,2,57,194,251,194,0,251,299,-60,91,619,2,3,161,286,230,389,13,1478,889
1573,12,2.3.249,0,542,0,94,249,343,182,67,343,343,0,176,559,4,2,146,288,203,361,13,1478,889
1573,12,3.1.284,0,579,1,59,284,343,284,0,343,343,-150,181,709,2,3,156,286,246,389,13,1478,889
1573,12,4.1.134,1,542,0,76,134,210,1,133,210,299,0,31,559,2,3,222,286,223,389,13,1478,889
1573,13,0.1.210,0,542,0,94,210,304,125,85,304,304,0,31,559,2,4,204,210,278,389,14,1478,813
1573,13,1.1.210,0,559,1,57,210,267,194,16,267,299,0,31,559,2,4,161,210,230,389,14,1478,813
1573,13,2.3.249,0,542,0,94,249,343,182,67,343,343,0,176,559,4,2,146,288,203,361,14,1478,813
1573,13,3.1.284,0,579,2,59,284,343,284,0,343,343,-74,105,633,2,4,156,210,246,389,14,1478,813
1573,13,4.2.210,1,542,0,58,210,268,210,0,268,299,-28,131,587,3,3,146,117,223,196,14,1478,813
1573,14,0.1.210,1,542,0,94,210,304,125,85,304,304,0,31,587,2,4,204,210,278,389,15,1478,755
1573,14,1.1.210,0,559,1,57,210,267,194,16,267,299,0,31,587,2,4,161,210,230,389,15,1478,755
1573,14,2.3.249,0,542,0,94,249,343,182,67,343,343,0,176,587,4,2,146,288,203,361,15,1478,755
1573,14,3.1.284,0,579,3,59,284,343,284,0,343,343,-74,105,661,2,4,156,210,246,389,15,1478,755
1573,14,4.3.268,0,575,2,61,268,329,268,0,329,329,-19,195,606,4,2,88,288,223,361,15,1478,755
1573,15,0.2.304,1,542,0,32,304,336,304,0,336,336,-36,167,623,3,4,110,59,278,196,16,1478,661
1573,15,1.1.304,0,544,1,57,304,361,194,110,361,361,0,31,587,2,5,161,116,230,389,16,1478,661
1573,15,2.3.249,0,542,0,94,249,343,182,67,343,343,0,176,587,4,2,146,288,203,361,16,1478,661
1573,15,3.1.304,0,542,0,59,304,363,284,20,363,363,0,31,587,2,5,156,116,246,389,16,1478,661
1573,15,4.3.268,0,575,2,61,268,329,268,0,329,329,-19,195,606,4,2,88,288,223,361,16,1478,661
1573,16,0.3.336,0,575,2,36,336,372,336,0,372,372,-87,263,710,4,2,78,288,278,361,17,1478,629
1573,16,1.1.304,1,544,1,57,304,361,194,110,361,361,0,31,623,2,5,161,116,230,389,17,1478,629
1573,16,2.3.249,0,542,0,94,249,343,182,67,343,343,0,176,623,4,2,146,288,203,361,17,1478,629
1573,16,3.1.304,0,542,0,59,304,363,284,20,363,363,0,31,623,2,5,156,116,246,389,17,1478,629
1573,16,4.3.268,0,575,2,61,268,329,268,0,329,336,-19,195,642,4,2,88,288,223,361,17,1478,629
1573,17,0.3.336,0,595,2,36,336,372,336,0,372,372,-87,263,710,4,2,78,288,278,361,18,1478,572
1573,17,1.2.361,1,544,0,7,361,368,361,0,368,368,-25,192,648,3,5,104,27,230,196,18,1478,572
1573,17,2.3.249,0,544,0,94,249,343,182,67,343,361,0,176,623,4,2,146,288,203,361,18,1478,572
1573,17,3.1.361,0,544,0,59,361,420,284,77,420,420,0,31,623,2,6,156,59,246,389,18,1478,572
1573,17,4.3.268,0,594,1,61,268,329,268,0,329,361,-19,195,642,4,2,88,288,223,361,18,1478,572
1573,18,0.3.336,0,595,2,36,336,372,336,0,372,372,-87,263,735,4,2,78,288,278,361,19,1478,565
1573,18,1.3.368,0,610,3,96,368,464,368,0,464,464,-119,295,767,4,2,97,288,230,361,19,1478,565
1573,18,2.3.249,0,544,0,94,249,343,182,67,343,368,0,176,648,4,2,146,288,203,361,19,1478,565
1573,18,3.1.361,1,544,0,59,361,420,284,77,420,420,0,31,648,2,6,156,59,246,389,19,1478,565
1573,18,4.3.268,0,594,1,61,268,329,268,0,329,368,-19,195,667,4,2,88,288,223,361,19,1478,565
1573,19,0.3.336,0,595,2,36,336,372,336,0,372,420,-87,263,735,4,2,78,288,278,361,20,1478,506
1573,19,1.3.368,0,610,3,96,368,464,368,0,464,464,-119,295,767,4,2,97,288,230,361,20,1478,506
1573,19,2.3.249,0,544,0,94,249,343,182,67,343,420,0,176,648,4,2,146,288,203,361,20,1478,506
1573,19,3.2.420,1,544,0,20,420,440,420,0,440,440,-52,244,700,3,6,97,20,246,196,20,1478,506
1573,19,4.3.268,0,594,1,61,268,329,268,0,329,420,-19,195,667,4,2,88,288,223,361,20,1478,506
1573,20,0.3.336,0,595,2,36,336,372,336,0,372,440,-87,263,787,4,2,78,288,278,361,21,1478,486
1573,20,1.3.368,0,610,3,96,368,464,368,0,464,464,-119,295,819,4,2,97,288,230,361,21,1478,486
1573,20,2.3.249,1,544,0,94,249,343,182,67,343,440,0,176,700,4,2,146,288,203,361,21,1478,486
1573,20,3.3.440,0,544,0,1,440,441,440,0,441,441,-191,367,891,4,2,77,288,246,361,21,1478,486
1573,20,4.3.268,0,594,1,61,268,329,268,0,329,440,-19,195,719,4,2,88,288,223,361,21,1478,486
1573,21,0.3.343,0,544,0,36,343,379,336,7,379,440,0,176,700,4,3,78,194,278,361,22,1478,392
1573,21,1.3.368,0,610,2,96,368,464,368,0,464,464,-25,201,725,4,3,97,194,230,361,22,1478,392
1573,21,2.4.343,1,544,0,52,343,395,343,0,395,440,-44,293,744,5,2,52,198,203,248,22,1478,392
1573,21,3.3.440,0,544,0,1,440,441,440,0,441,441,-97,273,797,4,3,77,194,246,361,22,1478,392
1573,21,4.3.343,0,559,1,61,343,404,268,75,404,440,0,176,700,4,3,88,194,223,361,22,1478,392
1573,22,0.3.343,1,544,0,36,343,379,336,7,379,440,0,176,744,4,3,78,194,278,361,23,1478,340
1573,22,1.3.368,0,610,2,96,368,464,368,0,464,464,-25,201,769,4,3,97,194,230,361,23,1478,340
1573,22,3.3.440,0,544,0,1,440,441,440,0,441,441,-97,273,841,4,3,77,194,246,361,23,1478,340
1573,22,4.3.343,0,559,1,61,343,404,268,75,404,440,0,176,744,4,3,88,194,223,361,23,1478,340
1573,23,0.4.395,1,544,0,42,395,437,379,16,437,440,0,293,744,5,3,42,146,278,248,24,1478,304
1573,23,1.3.379,0,579,1,96,379,475,368,11,475,475,0,176,744,4,4,97,158,230,361,24,1478,304
1573,23,3.3.440,0,544,0,1,440,441,440,0,441,441,-61,237,805,4,4,77,158,246,361,24,1478,304
1573,23,4.3.379,0,544,0,61,379,440,268,111,440,440,0,176,744,4,4,88,158,223,361,24,1478,304
1573,24,1.3.379,0,579,1,96,379,475,368,11,475,475,0,176,744,4,4,97,158,230,361,25,1478,262
1573,24,3.3.440,0,544,0,1,440,441,440,0,441,441,-61,237,805,4,4,77,158,246,361,25,1478,262
1573,24,4.3.379,1,544,0,61,379,440,268,111,440,440,0,176,744,4,4,88,158,223,361,25,1478,262
1573,25,1.3.440,0,613,1,96,440,536,368,72,536,536,0,176,744,4,5,97,97,230,361,26,1478,201
1573,25,3.3.440,0,544,0,1,440,441,440,0,441,441,0,176,744,4,5,77,97,246,361,26,1478,201
1573,25,4.4.440,1,544,0,27,440,467,440,0,467,467,-3,296,747,5,4,27,104,223,248,26,1478,201
1573,26,1.3.440,0,613,1,96,440,536,368,72,536,536,0,176,747,4,5,97,97,230,361,27,1478,174
1573,26,3.3.440,1,544,0,1,440,441,440,0,441,467,0,176,747,4,5,77,97,246,361,27,1478,174
1573,27,1.3.441,0,544,0,96,441,537,368,73,537,537,0,176,747,4,6,97,96,230,361,28,1478,173
1573,27,3.4.467,1,544,0,76,467,543,441,26,543,543,0,296,747,5,5,76,77,246,248,28,1478,173
1573,28,1.3.441,1,544,0,96,441,537,368,73,537,543,0,176,747,4,6,97,96,230,361,29,1478,97
1573,29,1.4.543,1,544,0,1,543,544,537,6,544,544,0,296,747,5,6,1,1,230,248,30,1478,1
1574,0,0.0.0,0,549,4,87,0,87,0,0,87,87,0,0,0,1,1,322,298,322,298,1,1447,1447
1574,0,1.0.0,0,548,3,45,0,45,0,0,45,45,0,0,0,1,1,132,298,132,298,1,1447,1447
1574,0,2.0.0,0,546,2,65,0,65,0,0,65,65,0,0,0,1,1,228,298,228,298,1,1447,1447
1574,0,3.0.0,0,548,3,44,0,44,0,0,44,44,0,0,0,1,1,304,298,304,298,1,1447,1447
1574,0,4.0.0,1,521,0,23,0,23,0,0,23,23,0,0,0,1,1,261,298,261,298,1,1447,1447
1574,0,5.0.0,0,527,1,34,0,34,0,0,34,34,0,0,0,1,1,200,298,200,298,1,1447,1447
1574,1,0.0.23,0,545,2,87,23,110,0,23,110,110,0,0,0,1,2,322,275,322,298,2,1447,1424
1574,1,1.0.23,0,548,4,45,23,68,0,23,68,68,0,0,0,1,2,132,275,132,298,2,1447,1424
1574,1,2.0.23,0,546,3,65,23,88,0,23,88,88,0,0,0,1,2,228,275,228,298,2,1447,1424
1574,1,3.0.23,0,523,1,44,23,67,0,23,67,67,0,0,0,1,2,304,275,304,298,2,1447,1424
1574,1,4.1.23,1,521,0,29,23,52,23,0,52,52,-23,23,23,2,1,238,292,261,292,2,1447,1424
1574,1,5.0.23,0,521,0,34,23,57,0,23,57,57,0,0,0,1,2,200,275,200,298,2,1447,1424
1574,2,0.0.23,0,545,2,87,23,110,0,23,110,110,0,0,23,1,2,322,275,322,298,3,1447,1395
1574,2,1.0.23,0,548,4,45,23,68,0,23,68,68,0,0,23,1,2,132,275,132,298,3,1447,1395
1574,2,2.0.23,0,546,3,65,23,88,0,23,88,88,0,0,23,1,2,228,275,228,298,3,1447,1395
1574,2,3.0.23,0,523,1,44,23,67,0,23,67,67,0,0,23,1,2,304,275,304,298,3,1447,1395
1574,2,4.2.52,1,521,0,59,52,111,52,0,111,111,-52,52,75,3,1,209,262,261,262,3,1447,1395
1574,2,5.0.23,0,521,0,34,23,57,0,23,57,57,0,0,23,1,2,200,275,200,298,3,1447,1395
1574,3,0.0.23,0,545,2,87,23,110,0,23,110,111,0,0,75,1,2,322,275,322,298,4,1447,1336
1574,3,1.0.23,0,548,4,45,23,68,0,23,68,111,0,0,75,1,2,132,275,132,298,4,1447,1336
1574,3,2.0.23,0,546,3,65,23,88,0,23,88,111,0,0,75,1,2,228,275,228,298,4,1447,1336
1574,3,3.0.23,0,523,1,44,23,67,0,23,67,111,0,0,75,1,2,304,275,304,298,4,1447,1336
1574,3,4.3.111,1,521,0,54,111,165,111,0,165,165,-111,111,186,4,1,150,316,261,316,4,1447,1336
1574,3,5.0.23,0,521,0,34,23,57,0,23,57,111,0,0,75,1,2,200,275,200,298,4,1447,1336
1574,4,0.0.23,0,545,2,87,23,110,0,23,110,165,0,0,186,1,2,322,275,322,298,5,1447,1282
1574,4,1.0.23,0,548,4,45,23,68,0,23,68,165,0,0,186,1,2,132,275,132,298,5,1447,1282
1574,4,2.0.23,0,546,3,65,23,88,0,23,88,165,0,0,186,1,2,228,275,228,298,5,1447,1282
1574,4,3.0.23,0,523,1,44,23,67,0,23,67,165,0,0,186,1,2,304,275,304,298,5,1447,1282
1574,4,4.4.165,1,521,0,96,165,261,165,0,261,261,-165,165,351,5,1,96,279,261,279,5,1447,1282
1574,4,5.0.23,0,521,0,34,23,57,0,23,57,165,0,0,186,1,2,200,275,200,298,5,1447,1282
1574,5,0.0.23,0,545,2,87,23,110,0,23,110,261,0,0,351,1,2,322,275,322,298,6,1447,1186
1574,5,1.0.23,0,548,4,45,23,68,0,23,68,261,0,0,351,1,2,132,275,132,298,6,1447,1186
1574,5,2.0.23,0,546,3,65,23,88,0,23,88,261,0,0,351,1,2,228,275,228,298,6,1447,1186
1574,5,3.0.23,1,523,1,44,23,67,0,23,67,261,0,0,351,1,2,304,275,304,298,6,1447,1186
1574,5,5.0.23,0,521,0,34,23,57,0,23,57,261,0,0,351,1,2,200,275,200,298,6,1447,1186
1574,6,0.0.67,0,523,0,87,67,154,0,67,154,261,0,0,351,1,3,322,231,322,298,7,1447,1142
1574,6,1.0.67,0,523,0,45,67,112,0,67,112,261,0,0,351,1,3,132,231,132,298,7,1447,1142
1574,6,2.0.67,0,530,1,65,67,132,0,67,132,261,0,0,351,1,3,228,231,228,298,7,1447,1142
1574,6,3.1.67,0,523,0,97,67,164,67,0,164,261,-15,38,366,2,2,260,263,304,292,7,1447,1142
1574,6,5.0.67,1,523,0,34,67,101,0,67,101,261,0,0,351,1,3,200,231,200,298,7,1447,1142
1574,7,0.0.101,1,523,0,87,101,188,0,101,188,261,0,0,351,1,4,322,197,322,298,8,1447,1108
1574,7,1.0.101,0,534,2,45,101,146,0,101,146,261,0,0,351,1,4,132,197,132,298,8,1447,1108
1574,7,2.0.101,0,531,1,65,101,166,0,101,166,261,0,0,351,1,4,228,197,228,298,8,1447,1108
1574,7,3.1.67,0,523,0,97,67,164,67,0,164,261,-15,38,366,2,2,260,263,304,292,8,1447,1108
1574,7,5.1.101,0,559,3,55,101,156,101,0,156,261,-49,72,400,2,2,166,263,200,292,8,1447,1108
1574,8,0.1.188,0,523,0,62,188,250,188,0,250,261,-136,159,487,2,2,235,263,322,292,9,1447,1021
1574,8,1.0.188,0,523,0,45,188,233,0,188,233,261,0,0,351,1,5,132,110,132,298,9,1447,1021
1574,8,2.0.188,1,523,0,65,188,253,0,188,253,261,0,0,351,1,5,228,110,228,298,9,1447,1021
1574,8,3.1.67,0,523,0,97,67,164,67,0,164,261,-15,38,366,2,2,260,263,304,292,9,1447,1021
1574,8,5.1.101,0,565,1,55,101,156,101,0,156,261,-49,72,400,2,2,166,263,200,292,9,1447,1021
1574,9,0.1.188,0,523,0,62,188,250,188,0,250,261,-136,159,487,2,2,235,263,322,292,10,1447,956
1574,9,1.0.253,1,523,0,45,253,298,0,253,298,298,0,0,351,1,6,132,45,132,298,10,1447,956
1574,9,2.1.253,0,523,0,24,253,277,253,0,277,277,-201,224,552,2,2,163,263,228,292,10,1447,956
1574,9,3.1.67,0,523,0,97,67,164,67,0,164,261,-15,38,366,2,2,260,263,304,292,10,1447,956
1574,9,5.1.101,0,565,1,55,101,156,101,0,156,261,-49,72,400,2,2,166,263,200,292,10,1447,956
1574,10,0.1.188,0,523,0,62,188,250,188,0,250,298,-136,159,487,2,2,235,263,322,292,11,1447,911
1574,10,1.1.298,0,525,1,25,298,323,298,0,323,323,-246,269,597,2,2,87,263,132,292,11,1447,911
1574,10,2.1.253,0,523,0,24,253,277,253,0,277,298,-201,224,552,2,2,163,263,228,292,11,1447,911
1574,10,3.1.67,1,523,0,97,67,164,67,0,164,298,-15,38,366,2,2,260,263,304,292,11,1447,911
1574,10,5.1.101,0,565,2,55,101,156,101,0,156,298,-49,72,400,2,2,166,263,200,292,11,1447,911
1574,11,0.1.188,0,523,0,62,188,250,188,0,250,298,-24,62,390,2,3,235,166,322,292,12,1447,814
1574,11,1.1.298,0,525,1,25,298,323,298,0,323,323,-134,172,500,2,3,87,166,132,292,12,1447,814
1574,11,2.1.253,0,523,0,24,253,277,253,0,277,298,-89,127,455,2,3,163,166,228,292,12,1447,814
1574,11,3.2.164,1,523,0,86,164,250,164,0,250,298,-53,105,419,3,2,163,203,304,262,12,1447,814
1574,11,5.1.164,0,530,2,55,164,219,101,63,219,298,0,38,366,2,3,166,166,200,292,12,1447,814
1574,12,0.1.188,0,523,0,62,188,250,188,0,250,298,-24,62,443,2,3,235,166,322,292,13,1447,728
1574,12,1.1.298,0,525,1,25,298,323,298,0,323,323,-134,172,553,2,3,87,166,132,292,13,1447,728
1574,12,2.1.253,0,523,0,24,253,277,253,0,277,298,-89,127,508,2,3,163,166,228,292,13,1447,728
1574,12,3.3.250,0,523,0,59,250,309,250,0,309,309,-85,196,504,4,2,77,262,304,316,13,1447,728
1574,12,5.1.164,1,530,2,55,164,219,101,63,219,298,0,38,419,2,3,166,166,200,292,13,1447,728
1574,13,0.1.219,0,530,0,62,219,281,188,31,281,298,0,38,419,2,4,235,111,322,292,14,1447,673
1574,13,1.1.298,0,530,0,25,298,323,298,0,323,323,-79,117,498,2,4,87,111,132,292,14,1447,673
1574,13,2.1.253,0,541,1,24,253,277,253,0,277,298,-34,72,453,2,4,163,111,228,292,14,1447,673
1574,13,3.3.250,0,530,0,59,250,309,250,0,309,309,-85,196,504,4,2,77,262,304,316,14,1447,673
1574,13,5.2.250,1,530,0,12,250,262,219,31,262,298,0,105,419,3,3,111,117,200,262,14,1447,673
1574,14,0.1.219,1,530,0,62,219,281,188,31,281,298,0,38,419,2,4,235,111,322,292,15,1447,661
1574,14,1.1.298,0,530,0,25,298,323,298,0,323,323,-79,117,498,2,4,87,111,132,292,15,1447,661
1574,14,2.1.253,0,541,2,24,253,277,253,0,277,298,-34,72,453,2,4,163,111,228,292,15,1447,661
1574,14,3.3.250,0,530,0,59,250,309,250,0,309,309,-85,196,504,4,2,77,262,304,316,15,1447,661
1574,14,5.3.262,0,535,1,58,262,320,262,0,320,320,-97,208,516,4,2,99,262,200,316,15,1447,661
1574,15,0.2.281,1,530,0,35,281,316,281,0,316,316,-19,124,438,3,4,173,105,322,262,16,1447,599
1574,15,1.1.298,0,530,0,25,298,323,298,0,323,323,-17,55,436,2,5,87,49,132,292,16,1447,599
1574,15,2.1.281,0,530,0,24,281,305,253,28,305,305,0,38,419,2,5,163,49,228,292,16,1447,599
1574,15,3.3.250,0,530,0,59,250,309,250,0,309,309,-85,196,504,4,2,77,262,304,316,16,1447,599
1574,15,5.3.262,0,535,1,58,262,320,262,0,320,320,-97,208,516,4,2,99,262,200,316,16,1447,599
1574,16,0.3.316,0,530,0,43,316,359,316,0,359,359,-151,262,589,4,2,138,262,322,316,17,1447,564
1574,16,1.1.298,0,530,0,25,298,323,298,0,323,323,-17,55,455,2,5,87,49,132,292,17,1447,564
1574,16,2.1.281,1,530,0,24,281,305,253,28,305,316,0,38,438,2,5,163,49,228,292,17,1447,564
1574,16,3.3.250,0,530,0,59,250,309,250,0,309,316,-85,196,523,4,2,77,262,304,316,17,1447,564
1574,16,5.3.262,0,535,1,58,262,320,262,0,320,320,-97,208,535,4,2,99,262,200,316,17,1447,564
1574,17,0.3.316,0,530,0,43,316,359,316,0,359,359,-151,262,589,4,2,138,262,322,316,18,1447,540
1574,17,1.1.305,0,530,0,25,305,330,298,7,330,330,0,38,438,2,6,87,25,132,292,18,1447,540
1574,17,2.2.316,1,530,0,58,316,374,305,11,374,374,0,124,438,3,5,139,70,228,262,18,1447,540
1574,17,3.3.250,0,530,0,59,250,309,250,0,309,316,-85,196,523,4,2,77,262,304,316,18,1447,540
1574,17,5.3.262,0,535,1,58,262,320,262,0,320,320,-97,208,535,4,2,99,262,200,316,18,1447,540
1574,18,0.3.316,0,530,0,43,316,359,316,0,359,374,-151,262,589,4,2,138,262,322,316,19,1447,482
1574,18,1.1.305,1,530,0,25,305,330,298,7,330,374,0,38,438,2,6,87,25,132,292,19,1447,482
1574,18,2.3.374,0,546,2,63,374,437,374,0,437,437,-209,320,647,4,2,81,262,228,316,19,1447,482
1574,18,3.3.250,0,530,0,59,250,309,250,0,309,374,-85,196,523,4,2,77,262,304,316,19,1447,482
1574,18,5.3.262,0,535,1,58,262,320,262,0,320,374,-97,208,535,4,2,99,262,200,316,19,1447,482
1574,19,0.3.316,0,530,0,43,316,359,316,0,359,374,-151,262,589,4,2,138,262,322,316,20,1447,457
1574,19,1.2.374,1,530,0,12,374,386,330,44,386,386,0,124,438,3,6,62,12,132,262,20,1447,457
1574,19,2.3.374,0,546,2,63,374,437,374,0,437,437,-209,320,647,4,2,81,262,228,316,20,1447,457
1574,19,3.3.250,0,530,0,59,250,309,250,0,309,374,-85,196,523,4,2,77,262,304,316,20,1447,457
1574,19,5.3.262,0,535,1,58,262,320,262,0,320,374,-97,208,535,4,2,99,262,200,316,20,1447,457
1574,20,0.3.316,0,530,0,43,316,359,316,0,359,386,-151,262,589,4,2,138,262,322,316,21,1447,445
1574,20,1.3.386,0,564,3,39,386,425,386,0,425,425,-221,332,659,4,2,50,262,132,316,21,1447,445
1574,20,2.3.374,0,546,2,63,374,437,374,0,437,437,-209,320,647,4,2,81,262,228,316,21,1447,445
1574,20,3.3.250,1,530,0,59,250,309,250,0,309,386,-85,196,523,4,2,77,262,304,316,21,1447,445
1574,20,5.3.262,0,535,1,58,262,320,262,0,320,386,-97,208,535,4,2,99,262,200,316,21,1447,445
1574,21,0.3.316,0,530,0,43,316,359,316,0,359,386,-7,203,530,4,3,138,203,322,316,22,1447,386
1574,21,1.3.386,0,564,3,39,386,425,386,0,425,425,-77,273,600,4,3,50,203,132,316,22,1447,386
1574,21,2.3.374,0,547,2,63,374,437,374,0,437,437,-65,261,588,4,3,81,203,228,316,22,1447,386
1574,21,3.4.309,1,530,0,18,309,327,309,0,327,386,-48,213,571,5,2,18,183,304,279,22,1447,386
1574,21,5.3.309,0,534,1,58,309,367,262,47,367,386,0,196,523,4,3,99,203,200,316,22,1447,386
1574,22,0.3.316,1,530,0,43,316,359,316,0,359,386,-7,203,578,4,3,138,203,322,316,23,1447,368
1574,22,1.3.386,0,564,3,39,386,425,386,0,425,425,-77,273,648,4,3,50,203,132,316,23,1447,368
1574,22,2.3.374,0,547,2,63,374,437,374,0,437,437,-65,261,636,4,3,81,203,228,316,23,1447,368
1574,22,5.3.309,0,534,1,58,309,367,262,47,367,386,0,196,571,4,3,99,203,200,316,23,1447,368
1574,23,0.4.359,1,530,0,95,359,454,359,0,454,454,-32,245,610,5,3,95,165,322,279,24,1447,325
1574,23,1.3.386,0,564,2,39,386,425,386,0,425,425,-27,230,605,4,4,50,160,132,316,24,1447,325
1574,23,2.3.374,0,547,1,63,374,437,374,0,437,437,-15,218,593,4,4,81,160,228,316,24,1447,325
1574,23,5.3.359,0,530,0,58,359,417,262,97,417,417,0,203,578,4,4,99,160,200,316,24,1447,325
1574,24,1.3.386,0,564,2,39,386,425,386,0,425,454,-27,230,637,4,4,50,160,132,316,25,1447,230
1574,24,2.3.374,0,547,1,63,374,437,374,0,437,454,-15,218,625,4,4,81,160,228,316,25,1447,230
1574,24,5.3.359,1,530,0,58,359,417,262,97,417,454,0,203,610,4,4,99,160,200,316,25,1447,230
1574,25,1.3.417,0,537,1,39,417,456,386,31,456,456,0,203,610,4,5,50,102,132,316,26,1447,172
1574,25,2.3.417,0,530,0,63,417,480,374,43,480,480,0,203,610,4,5,81,102,228,316,26,1447,172
1574,25,5.4.454,1,530,0,41,454,495,417,37,495,495,0,245,610,5,4,41,70,200,279,26,1447,172
1574,26,1.3.417,0,537,1,39,417,456,386,31,456,495,0,203,610,4,5,50,102,132,316,27,1447,131
1574,26,2.3.417,1,530,0,63,417,480,374,43,480,495,0,203,610,4,5,81,102,228,316,27,1447,131
1574,27,1.3.480,0,530,0,39,480,519,386,94,519,519,0,203,610,4,6,50,39,132,316,28,1447,68
1574,27,2.4.495,1,530,0,18,495,513,480,15,513,513,0,245,610,5,5,18,29,228,279,28,1447,68
1574,28,1.3.480,1,530,0,39,480,519,386,94,519,519,0,203,610,4,6,50,39,132,316,29,1447,50
1574,29,1.4.519,1,530,0,11,519,530,519,0,530,530,-6,251,616,5,6,11,11,132,279,30,1447,11
1575,0,0.0.0,0,440,0,1,0,1,0,0,1,1,0,0,0,1,1,168,215,168,215,1,1317,1317
1575,0,1.0.0,1,461,3,21,0,21,0,0,21,21,0,0,0,1,1,231,215,231,215,1,1317,1317
1575,0,2.0.0,0,440,0,12,0,12,0,0,12,12,0,0,0,1,1,155,215,155,215,1,1317,1317
1575,0,3.0.0,0,510,4,97,0,97,0,0,97,97,0,0,0,1,1,264,215,264,215,1,1317,1317
1575,0,4.0.0,0,458,2,45,0,45,0,0,45,45,0,0,0,1,1,298,215,298,215,1,1317,1317
1575,0,5.0.0,0,457,1,39,0,39,0,0,39,39,0,0,0,1,1,201,215,201,215,1,1317,1317
1575,1,0.0.21,1,461,0,1,21,22,0,21,22,22,0,0,0,1,2,168,194,168,215,2,1317,1296
1575,1,1.1.21,0,482,3,92,21,113,21,0,113,113,-21,21,21,2,1,210,294,231,294,2,1317,1296
1575,1,2.0.21,0,461,0,12,21,33,0,21,33,33,0,0,0,1,2,155,194,155,215,2,1317,1296
1575,1,3.0.21,0,499,4,97,21,118,0,21,118,118,0,0,0,1,2,264,194,264,215,2,1317,1296
1575,1,4.0.21,0,479,2,45,21,66,0,21,66,66,0,0,0,1,2,298,194,298,215,2,1317,1296
1575,1,5.0.21,0,478,1,39,21,60,0,21,60,60,0,0,0,1,2,201,194,201,215,2,1317,1296
1575,2,0.1.22,0,461,0,30,22,52,22,0,52,52,-22,22,22,2,1,167,294,168,294,3,1317,1295
1575,2,1.1.21,0,482,1,92,21,113,21,0,113,113,-21,21,21,2,1,210,294,231,294,3,1317,1295
1575,2,2.0.22,0,461,0,12,22,34,0,22,34,34,0,0,0,1,3,155,193,155,215,3,1317,1295
1575,2,3.0.22,0,483,2,97,22,119,0,22,119,119,0,0,0,1,3,264,193,264,215,3,1317,1295
1575,2,4.0.22,1,461,0,45,22,67,0,22,67,67,0,0,0,1,3,298,193,298,215,3,1317,1295
1575,2,5.0.22,0,461,0,39,22,61,0,22,61,61,0,0,0,1,3,201,193,201,215,3,1317,1295
1575,3,0.1.22,0,461,0,30,22,52,22,0,52,67,-22,22,22,2,1,167,294,168,294,4,1317,1250
1575,3,1.1.21,0,497,2,92,21,113,21,0,113,113,-21,21,21,2,1,210,294,231,294,4,1317,1250
1575,3,2.0.67,1,461,0,12,67,79,0,67,79,79,0,0,0,1,4,155,148,155,215,4,1317,1250
1575,3,3.0.67,0,497,2,97,67,164,0,67,164,164,0,0,0,1,4,264,148,264,215,4,1317,1250
1575,3,4.1.67,0,468,1,80,67,147,67,0,147,147,-67,67,67,2,1,253,294,298,294,4,1317,1250
1575,3,5.0.67,0,468,1,39,67,106,0,67,106,106,0,0,0,1,4,201,148,201,215,4,1317,1250
1575,4,0.1.22,0,461,0,30,22,52,22,0,52,79,-22,22,22,2,1,167,294,168,294,5,1317,1238
1575,4,1.1.21,0,497,3,92,21,113,21,0,113,113,-21,21,21,2,1,210,294,231,294,5,1317,1238
1575,4,2.1.79,0,461,0,18,79,97,79,0,97,97,-79,79,79,2,1,143,294,155,294,5,1317,1238
1575,4,3.0.79,0,473,2,97,79,176,0,79,176,176,0,0,0,1,5,264,136,264,215,5,1317,1238
1575,4,4.1.67,0,468,1,80,67,147,67,0,147,147,-67,67,67,2,1,253,294,298,294,5,1317,1238
1575,4,5.0.79,1,461,0,39,79,118,0,79,118,118,0,0,0,1,5,201,136,201,215,5,1317,1238
1575,5,0.1.22,0,461,0,30,22,52,22,0,52,118,-22,22,22,2,1,167,294,168,294,6,1317,1199
1575,5,1.1.21,0,504,3,92,21,113,21,0,113,118,-21,21,21,2,1,210,294,231,294,6,1317,1199
1575,5,2.1.79,0,461,0,18,79,97,79,0,97,118,-79,79,79,2,1,143,294,155,294,6,1317,1199
1575,5,3.0.118,1,461,0,97,118,215,0,118,215,215,0,0,0,1,6,264,97,264,215,6,1317,1199
1575,5,4.1.67,0,468,1,80,67,147,67,0,147,147,-67,67,67,2,1,253,294,298,294,6,1317,1199
1575,5,5.1.118,0,488,2,38,118,156,118,0,156,156,-118,118,118,2,1,162,294,201,294,6,1317,1199
1575,6,0.1.22,1,461,0,30,22,52,22,0,52,215,-22,22,22,2,1,167,294,168,294,7,1317,1102
1575,6,1.1.21,0,504,3,92,21,113,21,0,113,215,-21,21,21,2,1,210,294,231,294,7,1317,1102
1575,6,2.1.79,0,461,0,18,79,97,79,0,97,215,-79,79,79,2,1,143,294,155,294,7,1317,1102
1575,6,3.1.215,0,461,0,36,215,251,215,0,251,251,-215,215,215,2,1,167,294,264,294,7,1317,1102
1575,6,4.1.67,0,468,1,80,67,147,67,0,147,215,-67,67,67,2,1,253,294,298,294,7,1317,1102
1575,6,5.1.118,0,488,2,38,118,156,118,0,156,215,-118,118,118,2,1,162,294,201,294,7,1317,1102
1575,7,0.2.52,1,461,0,39,52,91,52,0,91,215,-52,52,74,3,1,137,231,168,231,8,1317,1072
1575,7,1.1.52,0,504,3,92,52,144,21,31,144,215,0,22,22,2,2,210,264,231,294,8,1317,1072
1575,7,2.1.79,0,461,0,18,79,97,79,0,97,215,-27,49,49,2,2,143,264,155,294,8,1317,1072
1575,7,3.1.215,0,461,0,36,215,251,215,0,251,251,-163,185,185,2,2,167,264,264,294,8,1317,1072
1575,7,4.1.67,0,468,1,80,67,147,67,0,147,215,-15,37,37,2,2,253,264,298,294,8,1317,1072
1575,7,5.1.118,0,488,2,38,118,156,118,0,156,215,-66,88,88,2,2,162,264,201,294,8,1317,1072
1575,8,0.3.91,1,461,0,50,91,141,91,0,141,215,-91,91,165,4,1,98,268,168,268,9,1317,1033
1575,8,1.1.52,0,504,3,92,52,144,21,31,144,215,0,22,74,2,2,210,264,231,294,9,1317,1033
1575,8,2.1.79,0,461,0,18,79,97,79,0,97,215,-27,49,101,2,2,143,264,155,294,9,1317,1033
1575,8,3.1.215,0,461,0,36,215,251,215,0,251,251,-163,185,237,2,2,167,264,264,294,9,1317,1033
1575,8,4.1.67,0,468,1,80,67,147,67,0,147,215,-15,37,89,2,2,253,264,298,294,9,1317,1033
1575,8,5.1.118,0,488,2,38,118,156,118,0,156,215,-66,88,140,2,2,162,264,201,294,9,1317,1033
1575,9,0.4.141,1,461,0,48,141,189,141,0,189,215,-141,141,306,5,1,48,309,168,309,10,1317,983
1575,9,1.1.52,0,504,3,92,52,144,21,31,144,215,0,22,165,2,2,210,264,231,294,10,1317,983
1575,9,2.1.79,0,461,0,18,79,97,79,0,97,215,-27,49,192,2,2,143,264,155,294,10,1317,983
1575,9,3.1.215,0,461,0,36,215,251,215,0,251,251,-163,185,328,2,2,167,264,264,294,10,1317,983
1575,9,4.1.67,0,468,1,80,67,147,67,0,147,215,-15,37,180,2,2,253,264,298,294,10,1317,983
1575,9,5.1.118,0,488,2,38,118,156,118,0,156,215,-66,88,231,2,2,162,264,201,294,10,1317,983
1575,10,1.1.52,0,504,3,92,52,144,21,31,144,215,0,22,306,2,2,210,264,231,294,11,1317,935
1575,10,2.1.79,1,461,0,18,79,97,79,0,97,215,-27,49,333,2,2,143,264,155,294,11,1317,935
1575,10,3.1.215,0,461,0,36,215,251,215,0,251,251,-163,185,469,2,2,167,264,264,294,11,1317,935
1575,10,4.1.67,0,468,1,80,67,147,67,0,147,215,-15,37,321,2,2,253,264,298,294,11,1317,935
1575,10,5.1.118,0,488,2,38,118,156,118,0,156,215,-66,88,372,2,2,162,264,201,294,11,1317,935
1575,11,1.1.97,0,516,2,92,97,189,21,76,189,215,0,49,333,2,3,210,246,231,294,12,1317,917
1575,11,2.2.97,1,461,0,11,97,108,97,0,108,215,-6,58,339,3,2,125,192,155,231,12,1317,917
1575,11,3.1.215,0,461,0,36,215,251,215,0,251,251,-118,167,451,2,3,167,246,264,294,12,1317,917
1575,11,4.1.97,0,461,0,80,97,177,67,30,177,215,0,49,333,2,3,253,246,298,294,12,1317,917
1575,11,5.1.118,0,488,1,38,118,156,118,0,156,215,-21,70,354,2,3,162,246,201,294,12,1317,917
1575,12,1.1.97,0,516,2,92,97,189,21,76,189,215,0,49,339,2,3,210,246,231,294,13,1317,906
1575,12,2.3.141,1,461,0,31,141,172,108,33,172,215,0,91,339,4,2,114,218,155,268,13,1317,906
1575,12,3.1.215,0,461,0,36,215,251,215,0,251,251,-118,167,457,2,3,167,246,264,294,13,1317,906
1575,12,4.1.97,0,461,0,80,97,177,67,30,177,215,0,49,339,2,3,253,246,298,294,13,1317,906
1575,12,5.1.118,0,488,1,38,118,156,118,0,156,215,-21,70,360,2,3,162,246,201,294,13,1317,906
1575,13,1.1.97,0,516,2,92,97,189,21,76,189,215,0,49,339,2,3,210,246,231,294,14,1317,875
1575,13,2.4.189,1,461,0,83,189,272,172,17,272,272,0,141,339,5,2,83,261,155,309,14,1317,875
1575,13,3.1.215,0,461,0,36,215,251,215,0,251,251,-118,167,457,2,3,167,246,264,294,14,1317,875
1575,13,4.1.97,0,461,0,80,97,177,67,30,177,215,0,49,339,2,3,253,246,298,294,14,1317,875
1575,13,5.1.118,0,488,1,38,118,156,118,0,156,215,-21,70,360,2,3,162,246,201,294,14,1317,875
1575,14,1.1.97,0,516,2,92,97,189,21,76,189,272,0,49,339,2,3,210,246,231,294,15,1317,792
1575,14,3.1.215,0,461,0,36,215,251,215,0,251,272,-118,167,457,2,3,167,246,264,294,15,1317,792
1575,14,4.1.97,1,461,0,80,97,177,67,30,177,272,0,49,339,2,3,253,246,298,294,15,1317,792
1575,14,5.1.118,0,488,1,38,118,156,118,0,156,272,-21,70,360,2,3,162,246,201,294,15,1317,792
1575,15,1.1.177,0,483,1,92,177,269,21,156,269,272,0,49,339,2,4,210,166,231,294,16,1317,712
1575,15,3.1.215,0,461,0,36,215,251,215,0,251,272,-38,87,377,2,4,167,166,264,294,16,1317,712
1575,15,4.2.177,1,461,0,59,177,236,177,0,236,272,-69,127,408,3,3,173,181,298,231,16,1317,712
1575,15,5.1.177,0,461,0,38,177,215,118,59,215,272,0,49,339,2,4,162,166,201,294,16,1317,712
1575,16,1.1.177,0,483,1,92,177,269,21,156,269,272,0,49,408,2,4,210,166,231,294,17,1317,653
1575,16,3.1.215,0,461,0,36,215,251,215,0,251,272,-38,87,446,2,4,167,166,264,294,17,1317,653
1575,16,4.3.236,1,461,0,47,236,283,236,0,283,283,-64,155,472,4,3,114,187,298,268,17,1317,653
1575,16,5.1.177,0,461,0,38,177,215,118,59,215,272,0,49,408,2,4,162,166,201,294,17,1317,653
1575,17,1.1.177,0,483,1,92,177,269,21,156,269,283,0,49,472,2,4,210,166,231,294,18,1317,606
1575,17,3.1.215,0,461,0,36,215,251,215,0,251,283,-38,87,510,2,4,167,166,264,294,18,1317,606
1575,17,4.4.283,1,461,0,67,283,350,283,0,350,350,-11,152,483,5,3,67,178,298,309,18,1317,606
1575,17,5.1.177,0,461,0,38,177,215,118,59,215,283,0,49,472,2,4,162,166,201,294,18,1317,606
1575,18,1.1.177,1,483,1,92,177,269,21,156,269,350,0,49,483,2,4,210,166,231,294,19,1317,539
1575,18,3.1.215,0,461,0,36,215,251,215,0,251,350,-38,87,521,2,4,167,166,264,294,19,1317,539
1575,18,5.1.177,0,461,0,38,177,215,118,59,215,350,0,49,483,2,4,162,166,201,294,19,1317,539
1575,19,1.2.269,0,483,0,18,269,287,269,0,287,350,-33,160,516,3,4,118,122,231,231,20,1317,447
1575,19,3.1.269,0,483,0,36,269,305,215,54,305,350,0,49,483,2,5,167,74,264,294,20,1317,447
1575,19,5.1.269,1,500,1,38,269,307,118,151,307,350,0,49,483,2,5,162,74,201,294,20,1317,447
1575,20,1.2.269,0,500,0,18,269,287,269,0,287,350,-33,160,516,3,4,118,122,231,231,21,1317,409
1575,20,3.1.307,1,500,0,36,307,343,215,92,343,350,0,49,483,2,6,167,36,264,294,21,1317,409
1575,20,5.2.307,0,500,0,50,307,357,307,0,357,357,-71,198,554,3,4,124,122,201,231,21,1317,409
1575,21,1.2.269,1,500,0,18,269,287,269,0,287,350,-33,160,516,3,4,118,122,231,231,22,1317,373
1575,21,3.2.343,0,521,1,54,343,397,343,0,397,397,-107,234,590,3,4,131,122,264,231,22,1317,373
1575,21,5.2.307,0,500,0,50,307,357,307,0,357,357,-71,198,554,3,4,124,122,201,231,22,1317,373
1575,22,1.3.287,1,500,0,80,287,367,287,0,367,367,-4,159,520,4,4,100,140,231,268,23,1317,355
1575,22,3.2.343,0,521,1,54,343,397,343,0,397,397,-56,216,572,3,5,131,104,264,231,23,1317,355
1575,22,5.2.307,0,500,0,50,307,357,307,0,357,357,-20,180,536,3,5,124,104,201,231,23,1317,355
1575,23,1.4.367,1,500,0,20,367,387,367,0,387,387,-17,169,537,5,4,20,111,231,309,24,1317,275
1575,23,3.2.343,0,521,1,54,343,397,343,0,397,397,-56,216,576,3,5,131,104,264,231,24,1317,275
1575,23,5.2.307,0,500,0,50,307,357,307,0,357,367,-20,180,540,3,5,124,104,201,231,24,1317,275
1575,24,3.2.343,0,521,1,54,343,397,343,0,397,397,-56,216,593,3,5,131,104,264,231,25,1317,255
1575,24,5.2.307,1,500,0,50,307,357,307,0,357,387,-20,180,557,3,5,124,104,201,231,25,1317,255
1575,25,3.2.357,0,500,0,54,357,411,343,14,411,411,0,180,557,3,6,131,54,264,231,26,1317,205
1575,25,5.3.367,1,500,0,42,367,409,357,10,409,409,0,159,557,4,5,74,60,201,268,26,1317,205
1575,26,3.2.357,0,500,0,54,357,411,343,14,411,411,0,180,557,3,6,131,54,264,231,27,1317,163
1575,26,5.4.409,1,500,0,32,409,441,409,0,441,441,-22,191,579,5,5,32,91,201,309,27,1317,163
1575,27,3.2.357,1,500,0,54,357,411,343,14,411,441,0,180,579,3,6,131,54,264,231,28,1317,131
1575,28,3.3.411,1,500,0,18,411,429,411,0,429,441,-2,161,581,4,6,77,18,264,268,29,1317,77
1575,29,3.4.441,1,500,0,59,441,500,429,12,500,500,0,191,581,5,6,59,59,264,309,30,1317,59
1576,0,0.0.0,1,491,1,14,0,14,0,0,14,14,0,0,0,1,1,210,327,210,327,1,1380,1380
1576,0,1.0.0,0,545,5,96,0,96,0,0,96,96,0,0,0,1,1,231,327,231,327,1,1380,1380
1576,0,2.0.0,0,482,0,57,0,57,0,0,57,57,0,0,0,1,1,279,327,279,327,1,1380,1380
1576,0,3.0.0,0,501,3,50,0,50,0,0,50,50,0,0,0,1,1,222,327,222,327,1,1380,1380
1576,0,4.0.0,0,508,4,67,0,67,0,0,67,67,0,0,0,1,1,236,327,236,327,1,1380,1380
1576,0,5.0.0,0,496,2,43,0,43,0,0,43,43,0,0,0,1,1,202,327,202,327,1,1380,1380
1576,1,0.1.14,1,505,1,97,14,111,14,0,111,111,-14,14,14,2,1,196,296,210,296,2,1380,1366
1576,1,1.0.14,0,518,3,96,14,110,0,14,110,110,0,0,0,1,2,231,313,231,327,2,1380,1366
1576,1,2.0.14,0,491,0,57,14,71,0,14,71,71,0,0,0,1,2,279,313,279,327,2,1380,1366
1576,1,3.0.14,0,506,2,50,14,64,0,14,64,64,0,0,0,1,2,222,313,222,327,2,1380,1366
1576,1,4.0.14,0,506,2,67,14,81,0,14,81,81,0,0,0,1,2,236,313,236,327,2,1380,1366
1576,1,5.0.14,0,505,1,43,14,57,0,14,57,57,0,0,0,1,2,202,313,202,327,2,1380,1366
1576,2,0.2.111,1,505,0,42,111,153,111,0,153,153,-111,111,125,3,1,99,298,210,298,3,1380,1269
1576,2,1.0.14,0,518,2,96,14,110,0,14,110,111,0,0,14,1,2,231,313,231,327,3,1380,1269
1576,2,2.0.14,0,505,0,57,14,71,0,14,71,111,0,0,14,1,2,279,313,279,327,3,1380,1269
1576,2,3.0.14,0,506,1,50,14,64,0,14,64,111,0,0,14,1,2,222,313,222,327,3,1380,1269
1576,2,4.0.14,0,506,1,67,14,81,0,14,81,111,0,0,14,1,2,236,313,236,327,3,1380,1269
1576,2,5.0.14,0,505,0,43,14,57,0,14,57,111,0,0,14,1,2,202,313,202,327,3,1380,1269
1576,3,0.3.153,1,505,0,56,153,209,153,0,209,209,-153,153,278,4,1,57,320,210,320,4,1380,1227
1576,3,1.0.14,0,518,2,96,14,110,0,14,110,153,0,0,125,1,2,231,313,231,327,4,1380,1227
1576,3,2.0.14,0,505,0,57,14,71,0,14,71,153,0,0,125,1,2,279,313,279,327,4,1380,1227
1576,3,3.0.14,0,506,1,50,14,64,0,14,64,153,0,0,125,1,2,222,313,222,327,4,1380,1227
1576,3,4.0.14,0,506,1,67,14,81,0,14,81,153,0,0,125,1,2,236,313,236,327,4,1380,1227
1576,3,5.0.14,0,505,0,43,14,57,0,14,57,153,0,0,125,1,2,202,313,202,327,4,1380,1227
1576,4,0.4.209,1,505,0,1,209,210,209,0,210,210,-209,209,487,5,1,1,139,210,139,5,1380,1171
1576,4,1.0.14,0,518,2,96,14,110,0,14,110,209,0,0,278,1,2,231,313,231,327,5,1380,1171
1576,4,2.0.14,0,505,0,57,14,71,0,14,71,209,0,0,278,1,2,279,313,279,327,5,1380,1171
1576,4,3.0.14,0,506,1,50,14,64,0,14,64,209,0,0,278,1,2,222,313,222,327,5,1380,1171
1576,4,4.0.14,0,506,1,67,14,81,0,14,81,209,0,0,278,1,2,236,313,236,327,5,1380,1171
1576,4,5.0.14,0,505,0,43,14,57,0,14,57,209,0,0,278,1,2,202,313,202,327,5,1380,1171
1576,5,1.0.14,0,518,2,96,14,110,0,14,110,210,0,0,487,1,2,231,313,231,327,6,1380,1170
1576,5,2.0.14,1,505,0,57,14,71,0,14,71,210,0,0,487,1,2,279,313,279,327,6,1380,1170
1576,5,3.0.14,0,506,1,50,14,64,0,14,64,210,0,0,487,1,2,222,313,222,327,6,1380,1170
1576,5,4.0.14,0,506,1,67,14,81,0,14,81,210,0,0,487,1,2,236,313,236,327,6,1380,1170
1576,5,5.0.14,0,505,0,43,14,57,0,14,57,210,0,0,487,1,2,202,313,202,327,6,1380,1170
1576,6,1.0.71,0,516,2,96,71,167,0,71,167,210,0,0,487,1,3,231,256,231,327,7,1380,1113
1576,6,2.1.111,1,505,0,11,111,122,71,40,122,210,0,14,487,2,2,222,199,279,296,7,1380,1113
1576,6,3.0.71,0,506,1,50,71,121,0,71,121,210,0,0,487,1,3,222,256,222,327,7,1380,1113
1576,6,4.0.71,0,506,1,67,71,138,0,71,138,210,0,0,487,1,3,236,256,236,327,7,1380,1113
1576,6,5.0.71,0,505,0,43,71,114,0,71,114,210,0,0,487,1,3,202,256,202,327,7,1380,1113
1576,7,1.0.71,0,516,2,96,71,167,0,71,167,210,0,0,487,1,3,231,256,231,327,8,1380,1102
1576,7,2.2.153,1,505,0,64,153,217,122,31,217,217,0,111,487,3,2,211,256,279,298,8,1380,1102
1576,7,3.0.71,0,506,1,50,71,121,0,71,121,210,0,0,487,1,3,222,256,222,327,8,1380,1102
1576,7,4.0.71,0,506,1,67,71,138,0,71,138,210,0,0,487,1,3,236,256,236,327,8,1380,1102
1576,7,5.0.71,0,505,0,43,71,114,0,71,114,210,0,0,487,1,3,202,256,202,327,8,1380,1102
1576,8,1.0.71,0,516,2,96,71,167,0,71,167,217,0,0,487,1,3,231,256,231,327,9,1380,1038
1576,8,2.3.217,1,505,0,99,217,316,217,0,316,316,-8,161,495,4,2,147,264,279,320,9,1380,1038
1576,8,3.0.71,0,506,1,50,71,121,0,71,121,217,0,0,487,1,3,222,256,222,327,9,1380,1038
1576,8,4.0.71,0,506,1,67,71,138,0,71,138,217,0,0,487,1,3,236,256,236,327,9,1380,1038
1576,8,5.0.71,0,505,0,43,71,114,0,71,114,217,0,0,487,1,3,202,256,202,327,9,1380,1038
1576,9,1.0.71,0,516,2,96,71,167,0,71,167,316,0,0,495,1,3,231,256,231,327,10,1380,939
1576,9,2.4.316,1,505,0,48,316,364,316,0,364,364,-106,315,601,5,2,48,138,279,139,10,1380,939
1576,9,3.0.71,0,506,1,50,71,121,0,71,121,316,0,0,495,1,3,222,256,222,327,10,1380,939
1576,9,4.0.71,0,506,1,67,71,138,0,71,138,316,0,0,495,1,3,236,256,236,327,10,1380,939
1576,9,5.0.71,0,505,0,43,71,114,0,71,114,316,0,0,495,1,3,202,256,202,327,10,1380,939
1576,10,1.0.71,0,516,2,96,71,167,0,71,167,364,0,0,601,1,3,231,256,231,327,11,1380,891
1576,10,3.0.71,1,506,1,50,71,121,0,71,121,364,0,0,601,1,3,222,256,222,327,11,1380,891
1576,10,4.0.71,0,506,1,67,71,138,0,71,138,364,0,0,601,1,3,236,256,236,327,11,1380,891
1576,10,5.0.71,0,505,0,43,71,114,0,71,114,364,0,0,601,1,3,202,256,202,327,11,1380,891
1576,11,1.0.121,0,514,2,96,121,217,0,121,217,364,0,0,601,1,4,231,206,231,327,12,1380,841
1576,11,3.1.122,1,506,0,74,122,196,121,1,196,364,0,14,601,2,3,172,188,222,296,12,1380,841
1576,11,4.0.121,0,506,0,67,121,188,0,121,188,364,0,0,601,1,4,236,206,236,327,12,1380,841
1576,11,5.0.121,0,510,1,43,121,164,0,121,164,364,0,0,601,1,4,202,206,202,327,12,1380,841
1576,12,1.0.121,0,514,2,96,121,217,0,121,217,364,0,0,601,1,4,231,206,231,327,13,1380,767
1576,12,3.2.217,1,506,0,21,217,238,196,21,238,364,0,111,601,3,3,98,192,222,298,13,1380,767
1576,12,4.0.121,0,506,0,67,121,188,0,121,188,364,0,0,601,1,4,236,206,236,327,13,1380,767
1576,12,5.0.121,0,510,1,43,121,164,0,121,164,364,0,0,601,1,4,202,206,202,327,13,1380,767
1576,13,1.0.121,0,514,2,96,121,217,0,121,217,364,0,0,601,1,4,231,206,231,327,14,1380,746
1576,13,3.3.316,1,514,2,76,316,392,238,78,392,392,0,161,601,4,3,77,165,222,320,14,1380,746
1576,13,4.0.121,0,506,0,67,121,188,0,121,188,364,0,0,601,1,4,236,206,236,327,14,1380,746
1576,13,5.0.121,0,513,1,43,121,164,0,121,164,364,0,0,601,1,4,202,206,202,327,14,1380,746
1576,14,1.0.121,0,514,0,96,121,217,0,121,217,392,0,0,601,1,4,231,206,231,327,15,1380,670
1576,14,3.4.392,1,514,0,1,392,393,392,0,393,393,-28,343,629,5,3,1,90,222,139,15,1380,670
1576,14,4.0.121,0,514,0,67,121,188,0,121,188,392,0,0,601,1,4,236,206,236,327,15,1380,670
1576,14,5.0.121,0,518,1,43,121,164,0,121,164,392,0,0,601,1,4,202,206,202,327,15,1380,670
1576,15,1.0.121,0,514,0,96,121,217,0,121,217,393,0,0,629,1,4,231,206,231,327,16,1380,669
1576,15,4.0.121,0,514,0,67,121,188,0,121,188,393,0,0,629,1,4,236,206,236,327,16,1380,669
1576,15,5.0.121,1,518,1,43,121,164,0,121,164,393,0,0,629,1,4,202,206,202,327,16,1380,669
1576,16,1.0.164,0,518,0,96,164,260,0,164,260,393,0,0,629,1,5,231,163,231,327,17,1380,626
1576,16,4.0.164,0,518,0,67,164,231,0,164,231,393,0,0,629,1,5,236,163,236,327,17,1380,626
1576,16,5.1.196,1,518,0,21,196,217,164,32,217,393,0,14,629,2,4,159,114,202,296,17,1380,626
1576,17,1.0.164,0,518,0,96,164,260,0,164,260,393,0,0,629,1,5,231,163,231,327,18,1380,605
1576,17,4.0.164,1,518,0,67,164,231,0,164,231,393,0,0,629,1,5,236,163,236,327,18,1380,605
1576,17,5.2.238,0,518,0,88,238,326,217,21,326,393,0,111,629,3,4,138,171,202,298,18,1380,605
1576,18,1.0.231,0,518,0,96,231,327,0,231,327,393,0,0,629,1,6,231,96,231,327,19,1380,538
1576,18,4.1.231,1,518,0,32,231,263,231,0,263,393,-14,28,643,2,5,169,93,236,296,19,1380,538
1576,18,5.2.238,0,518,0,88,238,326,217,21,326,393,0,111,629,3,4,138,171,202,298,19,1380,538
1576,19,1.0.231,1,518,0,96,231,327,0,231,327,393,0,0,643,1,6,231,96,231,327,20,1380,506
1576,19,4.2.263,0,521,1,60,263,323,263,0,323,393,-25,136,668,3,4,137,171,236,298,20,1380,506
1576,19,5.2.238,0,518,0,88,238,326,217,21,326,393,0,111,643,3,4,138,171,202,298,20,1380,506
1576,20,1.1.327,1,518,0,61,327,388,327,0,388,393,-64,92,707,2,6,135,61,231,296,21,1380,410
1576,20,4.2.263,0,521,1,60,263,323,263,0,323,393,-25,136,668,3,4,137,171,236,298,21,1380,410
1576,20,5.2.238,0,518,0,88,238,326,217,21,326,393,0,111,643,3,4,138,171,202,298,21,1380,410
1576,21,1.2.388,0,518,0,23,388,411,388,0,411,411,-150,261,857,3,4,74,171,231,298,22,1380,349
1576,21,4.2.263,1,521,1,60,263,323,263,0,323,393,-25,136,732,3,4,137,171,236,298,22,1380,349
1576,21,5.2.238,0,518,0,88,238,326,217,21,326,393,0,111,707,3,4,138,171,202,298,22,1380,349
1576,22,1.2.388,0,549,1,23,388,411,388,0,411,411,-65,201,797,3,5,74,111,231,298,23,1380,289
1576,22,4.3.392,1,521,0,40,392,432,323,69,432,432,0,161,732,4,4,77,89,236,320,23,1380,289
1576,22,5.2.323,0,521,0,88,323,411,217,106,411,411,0,136,732,3,5,138,111,202,298,23,1380,289
1576,23,1.2.388,0,549,1,23,388,411,388,0,411,432,-65,201,797,3,5,74,111,231,298,24,1380,249
1576,23,4.4.432,1,521,0,37,432,469,432,0,469,469,-39,382,771,5,4,37,89,236,139,24,1380,249
1576,23,5.2.323,0,521,0,88,323,411,217,106,411,432,0,136,732,3,5,138,111,202,298,24,1380,249
1576,24,1.2.388,0,549,1,23,388,411,388,0,411,469,-65,201,836,3,5,74,111,231,298,25,1380,212
1576,24,5.2.323,1,521,0,88,323,411,217,106,411,469,0,136,771,3,5,138,111,202,298,25,1380,212
1576,25,1.2.411,0,521,0,23,411,434,388,23,434,469,0,136,771,3,6,74,23,231,298,26,1380,124
1576,25,5.3.432,1,521,0,27,432,459,411,21,459,469,0,161,771,4,5,50,49,202,320,26,1380,124
1576,26,1.2.411,0,521,0,23,411,434,388,23,434,469,0,136,771,3,6,74,23,231,298,27,1380,97
1576,26,5.4.469,1,521,0,23,469,492,459,10,492,492,0,382,771,5,5,23,52,202,139,27,1380,97
1576,27,1.2.411,1,521,0,23,411,434,388,23,434,492,0,136,771,3,6,74,23,231,298,28,1380,74
1576,28,1.3.459,1,521,0,22,459,481,434,25,481,492,0,161,771,4,6,51,22,231,320,29,1380,51
1576,29,1.4.492,1,521,0,29,492,521,481,11,521,521,0,382,771,5,6,29,29,231,139,30,1380,29
1577,0,0.0.0,1,387,0,27,0,27,0,0,27,27,0,0,0,1,1,254,242,254,242,1,1154,1154
1577,0,1.0.0,0,408,1,72,0,72,0,0,72,72,0,0,0,1,1,231,242,231,242,1,1154,1154
1577,0,2.0.0,0,387,0,3,0,3,0,0,3,3,0,0,0,1,1,107,242,107,242,1,1154,1154
1577,0,3.0.0,0,387,0,4,0,4,0,0,4,4,0,0,0,1,1,182,242,182,242,1,1154,1154
1577,0,4.0.0,0,433,3,88,0,88,0,0,88,88,0,0,0,1,1,274,242,274,242,1,1154,1154
1577,0,5.0.0,0,421,2,48,0,48,0,0,48,48,0,0,0,1,1,106,242,106,242,1,1154,1154
1577,1,0.1.27,1,407,1,65,27,92,27,0,92,92,-27,27,27,2,1,227,201,254,201,2,1154,1127
1577,1,1.0.27,0,417,2,72,27,99,0,27,99,99,0,0,0,1,2,231,215,231,242,2,1154,1127
1577,1,2.0.27,0,387,0,3,27,30,0,27,30,30,0,0,0,1,2,107,215,107,242,2,1154,1127
1577,1,3.0.27,0,387,0,4,27,31,0,27,31,31,0,0,0,1,2,182,215,182,242,2,1154,1127
1577,1,4.0.27,0,427,4,88,27,115,0,27,115,115,0,0,0,1,2,274,215,274,242,2,1154,1127
1577,1,5.0.27,0,421,3,48,27,75,0,27,75,75,0,0,0,1,2,106,215,106,242,2,1154,1127
1577,2,0.2.92,1,422,3,46,92,138,92,0,138,138,-92,92,119,3,1,162,266,254,266,3,1154,1062
1577,2,1.0.27,0,417,1,72,27,99,0,27,99,99,0,0,27,1,2,231,215,231,242,3,1154,1062
1577,2,2.0.27,0,407,0,3,27,30,0,27,30,92,0,0,27,1,2,107,215,107,242,3,1154,1062
1577,2,3.0.27,0,407,0,4,27,31,0,27,31,92,0,0,27,1,2,182,215,182,242,3,1154,1062
1577,2,4.0.27,0,427,4,88,27,115,0,27,115,115,0,0,27,1,2,274,215,274,242,3,1154,1062
1577,2,5.0.27,0,421,2,48,27,75,0,27,75,92,0,0,27,1,2,106,215,106,242,3,1154,1062
1577,3,0.3.138,1,422,0,63,138,201,138,0,201,201,-138,138,257,4,1,116,276,254,276,4,1154,1016
1577,3,1.0.27,0,422,0,72,27,99,0,27,99,138,0,0,119,1,2,231,215,231,242,4,1154,1016
1577,3,2.0.27,0,422,0,3,27,30,0,27,30,138,0,0,119,1,2,107,215,107,242,4,1154,1016
1577,3,3.0.27,0,422,0,4,27,31,0,27,31,138,0,0,119,1,2,182,215,182,242,4,1154,1016
1577,3,4.0.27,0,427,1,88,27,115,0,27,115,138,0,0,119,1,2,274,215,274,242,4,1154,1016
1577,3,5.0.27,0,427,1,48,27,75,0,27,75,138,0,0,119,1,2,106,215,106,242,4,1154,1016
1577,4,0.4.201,1,422,0,53,201,254,201,0,254,254,-201,201,458,5,1,53,169,254,169,5,1154,953
1577,4,1.0.27,0,422,0,72,27,99,0,27,99,201,0,0,257,1,2,231,215,231,242,5,1154,953
1577,4,2.0.27,0,422,0,3,27,30,0,27,30,201,0,0,257,1,2,107,215,107,242,5,1154,953
1577,4,3.0.27,0,422,0,4,27,31,0,27,31,201,0,0,257,1,2,182,215,182,242,5,1154,953
1577,4,4.0.27,0,427,1,88,27,115,0,27,115,201,0,0,257,1,2,274,215,274,242,5,1154,953
1577,4,5.0.27,0,427,1,48,27,75,0,27,75,201,0,0,257,1,2,106,215,106,242,5,1154,953
1577,5,1.0.27,0,422,0,72,27,99,0,27,99,254,0,0,458,1,2,231,215,231,242,6,1154,900
1577,5,2.0.27,0,422,0,3,27,30,0,27,30,254,0,0,458,1,2,107,215,107,242,6,1154,900
1577,5,3.0.27,1,422,0,4,27,31,0,27,31,254,0,0,458,1,2,182,215,182,242,6,1154,900
1577,5,4.0.27,0,427,1,88,27,115,0,27,115,254,0,0,458,1,2,274,215,274,242,6,1154,900
1577,5,5.0.27,0,427,1,48,27,75,0,27,75,254,0,0,458,1,2,106,215,106,242,6,1154,900
1577,6,1.0.31,0,422,0,72,31,103,0,31,103,254,0,0,458,1,3,231,211,231,242,7,1154,896
1577,6,2.0.31,0,422,0,3,31,34,0,31,34,254,0,0,458,1,3,107,211,107,242,7,1154,896
1577,6,3.1.92,1,422,0,13,92,105,31,61,105,254,0,27,458,2,2,178,136,182,201,7,1154,896
1577,6,4.0.31,0,427,1,88,31,119,0,31,119,254,0,0,458,1,3,274,211,274,242,7,1154,896
1577,6,5.0.31,0,427,1,48,31,79,0,31,79,254,0,0,458,1,3,106,211,106,242,7,1154,896
1577,7,1.0.31,0,422,0,72,31,103,0,31,103,254,0,0,458,1,3,231,211,231,242,8,1154,883
1577,7,2.0.31,0,422,0,3,31,34,0,31,34,254,0,0,458,1,3,107,211,107,242,8,1154,883
1577,7,3.2.138,1,446,2,87,138,225,105,33,225,254,0,92,458,3,2,165,220,182,266,8,1154,883
1577,7,4.0.31,0,427,1,88,31,119,0,31,119,254,0,0,458,1,3,274,211,274,242,8,1154,883
1577,7,5.0.31,0,427,1,48,31,79,0,31,79,254,0,0,458,1,3,106,211,106,242,8,1154,883
1577,8,1.0.31,0,446,0,72,31,103,0,31,103,254,0,0,458,1,3,231,211,231,242,9,1154,796
1577,8,2.0.31,0,446,0,3,31,34,0,31,34,254,0,0,458,1,3,107,211,107,242,9,1154,796
1577,8,3.3.225,1,446,0,36,225,261,225,0,261,261,-24,162,482,4,2,78,213,182,276,9,1154,796
1577,8,4.0.31,0,446,0,88,31,119,0,31,119,254,0,0,458,1,3,274,211,274,242,9,1154,796
1577,8,5.0.31,0,446,0,48,31,79,0,31,79,254,0,0,458,1,3,106,211,106,242,9,1154,796
1577,9,1.0.31,0,446,0,72,31,103,0,31,103,261,0,0,482,1,3,231,211,231,242,10,1154,760
1577,9,2.0.31,0,446,0,3,31,34,0,31,34,261,0,0,482,1,3,107,211,107,242,10,1154,760
1577,9,3.4.261,1,446,0,42,261,303,261,0,303,303,-7,208,489,5,2,42,116,182,169,10,1154,760
1577,9,4.0.31,0,446,0,88,31,119,0,31,119,261,0,0,482,1,3,274,211,274,242,10,1154,760
1577,9,5.0.31,0,446,0,48,31,79,0,31,79,261,0,0,482,1,3,106,211,106,242,10,1154,760
1577,10,1.0.31,0,446,0,72,31,103,0,31,103,303,0,0,489,1,3,231,211,231,242,11,1154,718
1577,10,2.0.31,1,446,0,3,31,34,0,31,34,303,0,0,489,1,3,107,211,107,242,11,1154,718
1577,10,4.0.31,0,446,0,88,31,119,0,31,119,303,0,0,489,1,3,274,211,274,242,11,1154,718
1577,10,5.0.31,0,446,0,48,31,79,0,31,79,303,0,0,489,1,3,106,211,106,242,11,1154,718
1577,11,1.0.34,0,446,0,72,34,106,0,34,106,303,0,0,489,1,4,231,208,231,242,12,1154,715
1577,11,2.1.105,1,446,0,5,105,110,34,71,110,303,0,27,489,2,3,104,123,107,201,12,1154,715
1577,11,4.0.34,0,446,0,88,34,122,0,34,122,303,0,0,489,1,4,274,208,274,242,12,1154,715
1577,11,5.0.34,0,446,0,48,34,82,0,34,82,303,0,0,489,1,4,106,208,106,242,12,1154,715
1577,12,1.0.34,0,446,0,72,34,106,0,34,106,303,0,0,489,1,4,231,208,231,242,13,1154,710
1577,12,2.2.225,1,451,1,17,225,242,110,115,242,303,0,92,489,3,3,99,133,107,266,13,1154,710
1577,12,4.0.34,0,446,0,88,34,122,0,34,122,303,0,0,489,1,4,274,208,274,242,13,1154,710
1577,12,5.0.34,0,446,0,48,34,82,0,34,82,303,0,0,489,1,4,106,208,106,242,13,1154,710
1577,13,1.0.34,0,451,0,72,34,106,0,34,106,303,0,0,489,1,4,231,208,231,242,14,1154,693
1577,13,2.3.261,1,451,0,68,261,329,242,19,329,329,0,162,489,4,3,82,177,107,276,14,1154,693
1577,13,4.0.34,0,451,0,88,34,122,0,34,122,303,0,0,489,1,4,274,208,274,242,14,1154,693
1577,13,5.0.34,0,451,0,48,34,82,0,34,82,303,0,0,489,1,4,106,208,106,242,14,1154,693
1577,14,1.0.34,0,451,0,72,34,106,0,34,106,329,0,0,489,1,4,231,208,231,242,15,1154,625
1577,14,2.4.329,1,451,0,14,329,343,329,0,343,343,-26,234,515,5,3,14,74,107,169,15,1154,625
1577,14,4.0.34,0,451,0,88,34,122,0,34,122,329,0,0,489,1,4,274,208,274,242,15,1154,625
1577,14,5.0.34,0,451,0,48,34,82,0,34,82,329,0,0,489,1,4,106,208,106,242,15,1154,625
1577,15,1.0.34,0,451,0,72,34,106,0,34,106,343,0,0,515,1,4,231,208,231,242,16,1154,611
1577,15,4.0.34,1,451,0,88,34,122,0,34,122,343,0,0,515,1,4,274,208,274,242,16,1154,611
1577,15,5.0.34,0,451,0,48,34,82,0,34,82,343,0,0,515,1,4,106,208,106,242,16,1154,611
1577,16,1.0.122,0,451,0,72,122,194,0,122,194,343,0,0,515,1,5,231,120,231,242,17,1154,523
1577,16,4.1.122,1,451,0,84,122,206,122,0,206,343,-12,39,527,2,4,186,118,274,201,17,1154,523
1577,16,5.0.122,0,451,0,48,122,170,0,122,170,343,0,0,515,1,5,106,120,106,242,17,1154,523
1577,17,1.0.122,0,451,0,72,122,194,0,122,194,343,0,0,527,1,5,231,120,231,242,18,1154,439
1577,17,4.2.242,1,455,1,61,242,303,206,36,303,343,0,92,527,3,4,102,116,274,266,18,1154,439
1577,17,5.0.122,0,451,0,48,122,170,0,122,170,343,0,0,527,1,5,106,120,106,242,18,1154,439
1577,18,1.0.122,0,455,0,72,122,194,0,122,194,343,0,0,527,1,5,231,120,231,242,19,1154,378
1577,18,4.3.329,1,476,1,33,329,362,303,26,362,362,0,162,527,4,4,41,109,274,276,19,1154,378
1577,18,5.0.122,0,455,0,48,122,170,0,122,170,343,0,0,527,1,5,106,120,106,242,19,1154,378
1577,19,1.0.122,0,476,0,72,122,194,0,122,194,362,0,0,527,1,5,231,120,231,242,20,1154,345
1577,19,4.4.362,1,476,0,8,362,370,362,0,370,370,-19,253,546,5,4,8,60,274,169,20,1154,345
1577,19,5.0.122,0,476,0,48,122,170,0,122,170,362,0,0,527,1,5,106,120,106,242,20,1154,345
1577,20,1.0.122,1,476,0,72,122,194,0,122,194,370,0,0,546,1,5,231,120,231,242,21,1154,337
1577,20,5.0.122,0,476,0,48,122,170,0,122,170,370,0,0,546,1,5,106,120,106,242,21,1154,337
1577,21,1.1.206,1,476,0,29,206,235,194,12,235,370,0,39,546,2,5,159,34,231,201,22,1154,265
1577,21,5.0.194,0,476,0,48,194,242,0,194,242,370,0,0,546,1,6,106,48,106,242,22,1154,265
1577,22,1.2.303,1,476,0,28,303,331,235,68,331,370,0,92,546,3,5,130,55,231,266,23,1154,236
1577,22,5.0.194,0,476,0,48,194,242,0,194,242,370,0,0,546,1,6,106,48,106,242,23,1154,236
1577,23,1.3.362,1,478,1,64,362,426,331,31,426,426,0,162,546,4,5,102,76,231,276,24,1154,208
1577,23,5.0.194,0,476,0,48,194,242,0,194,242,370,0,0,546,1,6,106,48,106,242,24,1154,208
1577,24,1.4.426,1,478,0,38,426,464,426,0,464,464,-56,309,602,5,5,38,52,231,169,25,1154,144
1577,24,5.0.194,0,478,0,48,194,242,0,194,242,426,0,0,546,1,6,106,48,106,242,25,1154,144
1577,25,5.0.194,1,478,0,48,194,242,0,194,242,464,0,0,602,1,6,106,48,106,242,26,1154,106
1577,26,5.1.242,1,478,0,5,242,247,242,0,247,464,-7,46,609,2,6,58,5,106,201,27,1154,58
1577,27,5.2.331,1,478,0,27,331,358,247,84,358,464,0,92,609,3,6,53,27,106,266,28,1154,53
1577,28,5.3.426,1,478,0,12,426,438,358,68,438,464,0,162,609,4,6,26,12,106,276,29,1154,26
1577,29,5.4.464,1,478,0,14,464,478,438,26,478,478,0,309,609,5,6,14,14,106,169,30,1154,14
1578,0,0.0.0,0,560,1,40,0,40,0,0,40,40,0,0,0,1,1,199,257,199,257,1,1619,1619
1578,0,1.0.0,0,595,4,47,0,47,0,0,47,47,0,0,0,1,1,229,257,229,257,1,1619,1619
1578,0,2.0.0,1,584,3,49,0,49,0,0,49,49,0,0,0,1,1,333,257,333,257,1,1619,1619
1578,0,3.0.0,0,571,2,57,0,57,0,0,57,57,0,0,0,1,1,340,257,340,257,1,1619,1619
1578,0,4.0.0,0,548,0,11,0,11,0,0,11,11,0,0,0,1,1,212,257,212,257,1,1619,1619
1578,0,5.0.0,0,599,5,53,0,53,0,0,53,53,0,0,0,1,1,306,257,306,257,1,1619,1619
1578,1,0.0.49,0,584,0,40,49,89,0,49,89,89,0,0,0,1,2,199,208,199,257,2,1619,1570
1578,1,1.0.49,0,584,0,47,49,96,0,49,96,96,0,0,0,1,2,229,208,229,257,2,1619,1570
1578,1,2.1.49,0,584,0,98,49,147,49,0,147,147,-49,49,49,2,1,284,402,333,402,2,1619,1570
1578,1,3.0.49,0,584,0,57,49,106,0,49,106,106,0,0,0,1,2,340,208,340,257,2,1619,1570
1578,1,4.0.49,1,584,0,11,49,60,0,49,60,60,0,0,0,1,2,212,208,212,257,2,1619,1570
1578,1,5.0.49,0,584,0,53,49,102,0,49,102,102,0,0,0,1,2,306,208,306,257,2,1619,1570
1578,2,0.0.60,0,584,0,40,60,100,0,60,100,100,0,0,0,1,3,199,197,199,257,3,1619,1559
1578,2,1.0.60,0,584,0,47,60,107,0,60,107,107,0,0,0,1,3,229,197,229,257,3,1619,1559
1578,2,2.1.49,0,584,0,98,49,147,49,0,147,147,-49,49,49,2,1,284,402,333,402,3,1619,1559
1578,2,3.0.60,1,584,0,57,60,117,0,60,117,117,0,0,0,1,3,340,197,340,257,3,1619,1559
1578,2,4.1.60,0,591,2,36,60,96,60,0,96,96,-60,60,60,2,1,201,402,212,402,3,1619,1559
1578,2,5.0.60,0,589,1,53,60,113,0,60,113,113,0,0,0,1,3,306,197,306,257,3,1619,1559
1578,3,0.0.117,0,584,0,40,117,157,0,117,157,157,0,0,0,1,4,199,140,199,257,4,1619,1502
1578,3,1.0.117,0,584,0,47,117,164,0,117,164,164,0,0,0,1,4,229,140,229,257,4,1619,1502
1578,3,2.1.49,0,584,0,98,49,147,49,0,147,147,-49,49,49,2,1,284,402,333,402,4,1619,1502
1578,3,3.1.117,0,597,2,51,117,168,117,0,168,168,-117,117,117,2,1,283,402,340,402,4,1619,1502
1578,3,4.1.60,0,591,1,36,60,96,60,0,96,117,-60,60,60,2,1,201,402,212,402,4,1619,1502
1578,3,5.0.117,1,584,0,53,117,170,0,117,170,170,0,0,0,1,4,306,140,306,257,4,1619,1502
1578,4,0.0.170,0,584,0,40,170,210,0,170,210,210,0,0,0,1,5,199,87,199,257,5,1619,1449
1578,4,1.0.170,1,584,0,47,170,217,0,170,217,217,0,0,0,1,5,229,87,229,257,5,1619,1449
1578,4,2.1.49,0,584,0,98,49,147,49,0,147,170,-49,49,49,2,1,284,402,333,402,5,1619,1449
1578,4,3.1.117,0,597,2,51,117,168,117,0,168,170,-117,117,117,2,1,283,402,340,402,5,1619,1449
1578,4,4.1.60,0,591,1,36,60,96,60,0,96,170,-60,60,60,2,1,201,402,212,402,5,1619,1449
1578,4,5.1.170,0,597,2,87,170,257,170,0,257,257,-170,170,170,2,1,253,402,306,402,5,1619,1449
1578,5,0.0.217,1,584,0,40,217,257,0,217,257,257,0,0,0,1,6,199,40,199,257,6,1619,1402
1578,5,1.1.217,0,636,3,96,217,313,217,0,313,313,-217,217,217,2,1,182,402,229,402,6,1619,1402
1578,5,2.1.49,0,584,0,98,49,147,49,0,147,217,-49,49,49,2,1,284,402,333,402,6,1619,1402
1578,5,3.1.117,0,597,2,51,117,168,117,0,168,217,-117,117,117,2,1,283,402,340,402,6,1619,1402
1578,5,4.1.60,0,591,1,36,60,96,60,0,96,217,-60,60,60,2,1,201,402,212,402,6,1619,1402
1578,5,5.1.170,0,597,2,87,170,257,170,0,257,257,-170,170,170,2,1,253,402,306,402,6,1619,1402
1578,6,0.1.257,0,611,3,34,257,291,257,0,291,291,-257,257,257,2,1,159,402,199,402,7,1619,1362
1578,6,1.1.217,0,636,4,96,217,313,217,0,313,313,-217,217,217,2,1,182,402,229,402,7,1619,1362
1578,6,2.1.49,0,584,0,98,49,147,49,0,147,257,-49,49,49,2,1,284,402,333,402,7,1619,1362
1578,6,3.1.117,0,597,2,51,117,168,117,0,168,257,-117,117,117,2,1,283,402,340,402,7,1619,1362
1578,6,4.1.60,1,591,1,36,60,96,60,0,96,257,-60,60,60,2,1,201,402,212,402,7,1619,1362
1578,6,5.1.170,0,597,2,87,170,257,170,0,257,257,-170,170,170,2,1,253,402,306,402,7,1619,1362
1578,7,0.1.257,0,614,2,34,257,291,257,0,291,291,-161,221,221,2,2,159,366,199,402,8,1619,1326
1578,7,1.1.217,0,661,3,96,217,313,217,0,313,313,-121,181,181,2,2,182,366,229,402,8,1619,1326
1578,7,2.1.96,0,591,0,98,96,194,49,47,194,257,0,60,60,2,2,284,366,333,402,8,1619,1326
1578,7,3.1.117,0,597,1,51,117,168,117,0,168,257,-21,81,81,2,2,283,366,340,402,8,1619,1326
1578,7,4.2.96,1,591,0,62,96,158,96,0,158,257,-96,96,156,3,1,165,334,212,334,8,1619,1326
1578,7,5.1.170,0,597,1,87,170,257,170,0,257,257,-74,134,134,2,2,253,366,306,402,8,1619,1326
1578,8,0.1.257,0,614,2,34,257,291,257,0,291,291,-161,221,317,2,2,159,366,199,402,9,1619,1264
1578,8,1.1.217,0,661,3,96,217,313,217,0,313,313,-121,181,277,2,2,182,366,229,402,9,1619,1264
1578,8,2.1.96,0,591,0,98,96,194,49,47,194,257,0,60,156,2,2,284,366,333,402,9,1619,1264
1578,8,3.1.117,0,597,1,51,117,168,117,0,168,257,-21,81,177,2,2,283,366,340,402,9,1619,1264
1578,8,4.3.158,1,591,0,26,158,184,158,0,184,257,-158,158,314,4,1,103,329,212,329,9,1619,1264
1578,8,5.1.170,0,597,1,87,170,257,170,0,257,257,-74,134,230,2,2,253,366,306,402,9,1619,1264
1578,9,0.1.257,0,614,2,34,257,291,257,0,291,291,-161,221,475,2,2,159,366,199,402,10,1619,1238
1578,9,1.1.217,0,661,3,96,217,313,217,0,313,313,-121,181,435,2,2,182,366,229,402,10,1619,1238
1578,9,2.1.96,0,591,0,98,96,194,49,47,194,257,0,60,314,2,2,284,366,333,402,10,1619,1238
1578,9,3.1.117,0,597,1,51,117,168,117,0,168,257,-21,81,335,2,2,283,366,340,402,10,1619,1238
1578,9,4.4.184,1,591,0,77,184,261,184,0,261,261,-184,184,498,5,1,77,297,212,297,10,1619,1238
1578,9,5.1.170,0,597,1,87,170,257,170,0,257,257,-74,134,388,2,2,253,366,306,402,10,1619,1238
1578,10,0.1.257,0,614,2,34,257,291,257,0,291,291,-161,221,659,2,2,159,366,199,402,11,1619,1161
1578,10,1.1.217,0,661,3,96,217,313,217,0,313,313,-121,181,619,2,2,182,366,229,402,11,1619,1161
1578,10,2.1.96,0,591,0,98,96,194,49,47,194,261,0,60,498,2,2,284,366,333,402,11,1619,1161
1578,10,3.1.117,1,597,1,51,117,168,117,0,168,261,-21,81,519,2,2,283,366,340,402,11,1619,1161
1578,10,5.1.170,0,597,1,87,170,257,170,0,257,261,-74,134,572,2,2,253,366,306,402,11,1619,1161
1578,11,0.1.257,0,627,2,34,257,291,257,0,291,291,-89,170,608,2,3,159,315,199,402,12,1619,1110
1578,11,1.1.217,0,693,3,96,217,313,217,0,313,313,-49,130,568,2,3,182,315,229,402,12,1619,1110
1578,11,2.1.168,0,598,1,98,168,266,49,119,266,266,0,81,519,2,3,284,315,333,402,12,1619,1110
1578,11,3.2.168,1,597,0,55,168,223,168,0,223,261,-10,106,529,3,2,232,272,340,334,12,1619,1110
1578,11,5.1.170,0,597,0,87,170,257,170,0,257,261,-2,83,521,2,3,253,315,306,402,12,1619,1110
1578,12,0.1.257,0,627,2,34,257,291,257,0,291,291,-89,170,618,2,3,159,315,199,402,13,1619,1055
1578,12,1.1.217,0,693,3,96,217,313,217,0,313,313,-49,130,578,2,3,182,315,229,402,13,1619,1055
1578,12,2.1.168,0,598,1,98,168,266,49,119,266,266,0,81,529,2,3,284,315,333,402,13,1619,1055
1578,12,3.3.223,1,597,0,94,223,317,223,0,317,317,-39,197,568,4,2,177,303,340,329,13,1619,1055
1578,12,5.1.170,0,597,0,87,170,257,170,0,257,261,-2,83,531,2,3,253,315,306,402,13,1619,1055
1578,13,0.1.257,0,627,2,34,257,291,257,0,291,317,-89,170,657,2,3,159,315,199,402,14,1619,961
1578,13,1.1.217,0,693,3,96,217,313,217,0,313,317,-49,130,617,2,3,182,315,229,402,14,1619,961
1578,13,2.1.168,0,598,1,98,168,266,49,119,266,317,0,81,568,2,3,284,315,333,402,14,1619,961
1578,13,3.4.317,1,597,0,83,317,400,317,0,400,400,-56,240,624,5,2,83,220,340,297,14,1619,961
1578,13,5.1.170,0,597,0,87,170,257,170,0,257,317,-2,83,570,2,3,253,315,306,402,14,1619,961
1578,14,0.1.257,0,627,2,34,257,291,257,0,291,400,-89,170,713,2,3,159,315,199,402,15,1619,878
1578,14,1.1.217,0,693,3,96,217,313,217,0,313,400,-49,130,673,2,3,182,315,229,402,15,1619,878
1578,14,2.1.168,1,598,1,98,168,266,49,119,266,400,0,81,624,2,3,284,315,333,402,15,1619,878
1578,14,5.1.170,0,597,0,87,170,257,170,0,257,400,-2,83,626,2,3,253,315,306,402,15,1619,878
1578,15,0.1.266,0,604,1,34,266,300,257,9,300,400,0,81,624,2,4,159,217,199,402,16,1619,780
1578,15,1.1.266,0,649,2,96,266,362,217,49,362,400,0,81,624,2,4,182,217,229,402,16,1619,780
1578,15,2.2.266,1,598,0,70,266,336,266,0,336,400,-43,149,667,3,3,186,217,333,334,16,1619,780
1578,15,5.1.266,0,598,0,87,266,353,170,96,353,400,0,81,624,2,4,253,217,306,402,16,1619,780
1578,16,0.1.266,0,604,1,34,266,300,257,9,300,400,0,81,667,2,4,159,217,199,402,17,1619,710
1578,16,1.1.266,0,649,2,96,266,362,217,49,362,400,0,81,667,2,4,182,217,229,402,17,1619,710
1578,16,2.3.336,1,598,0,37,336,373,336,0,373,400,-19,216,686,4,3,116,209,333,329,17,1619,710
1578,16,5.1.266,0,598,0,87,266,353,170,96,353,400,0,81,667,2,4,253,217,306,402,17,1619,710
1578,17,0.1.266,0,604,1,34,266,300,257,9,300,400,0,81,686,2,4,159,217,199,402,18,1619,673
1578,17,1.1.266,0,649,2,96,266,362,217,49,362,400,0,81,686,2,4,182,217,229,402,18,1619,673
1578,17,2.4.400,1,598,0,79,400,479,373,27,479,479,0,240,686,5,3,79,137,333,297,18,1619,673
1578,17,5.1.266,0,598,0,87,266,353,170,96,353,400,0,81,686,2,4,253,217,306,402,18,1619,673
1578,18,0.1.266,0,604,1,34,266,300,257,9,300,479,0,81,686,2,4,159,217,199,402,19,1619,594
1578,18,1.1.266,0,649,2,96,266,362,217,49,362,479,0,81,686,2,4,182,217,229,402,19,1619,594
1578,18,5.1.266,1,598,0,87,266,353,170,96,353,479,0,81,686,2,4,253,217,306,402,19,1619,594
1578,19,0.1.353,0,598,0,34,353,387,257,96,387,479,0,81,686,2,5,159,130,199,402,20,1619,507
1578,19,1.1.353,0,608,1,96,353,449,217,136,449,479,0,81,686,2,5,182,130,229,402,20,1619,507
1578,19,5.2.353,1,598,0,65,353,418,353,0,418,479,-17,166,703,3,4,166,147,306,334,20,1619,507
1578,20,0.1.353,1,598,0,34,353,387,257,96,387,479,0,81,703,2,5,159,130,199,402,21,1619,442
1578,20,1.1.353,0,608,1,96,353,449,217,136,449,479,0,81,703,2,5,182,130,229,402,21,1619,442
1578,20,5.3.418,0,598,0,96,418,514,418,0,514,514,-45,261,748,4,4,101,172,306,329,21,1619,442
1578,21,0.2.418,1,598,0,49,418,467,387,31,467,479,0,166,703,3,5,125,82,199,334,22,1619,408
1578,21,1.1.387,0,598,0,96,387,483,217,170,483,483,0,81,703,2,6,182,96,229,402,22,1619,408
1578,21,5.3.418,0,598,0,96,418,514,418,0,514,514,-45,261,748,4,4,101,172,306,329,22,1619,408
1578,22,0.3.467,0,644,1,70,467,537,467,0,537,537,-94,310,797,4,4,76,172,199,329,23,1619,359
1578,22,1.1.387,1,598,0,96,387,483,217,170,483,483,0,81,703,2,6,182,96,229,402,23,1619,359
1578,22,5.3.418,0,598,0,96,418,514,418,0,514,514,-45,261,748,4,4,101,172,306,329,23,1619,359
1578,23,0.3.467,0,644,1,70,467,537,467,0,537,537,-94,310,797,4,4,76,172,199,329,24,1619,263
1578,23,1.2.483,1,598,0,33,483,516,483,0,516,516,-16,182,719,3,6,86,33,229,334,24,1619,263
1578,23,5.3.418,0,598,0,96,418,514,418,0,514,514,-45,261,748,4,4,101,172,306,329,24,1619,263
1578,24,0.3.467,0,644,1,70,467,537,467,0,537,537,-94,310,813,4,4,76,172,199,329,25,1619,230
1578,24,1.3.516,0,598,0,6,516,522,516,0,522,522,-143,359,862,4,4,53,172,229,329,25,1619,230
1578,24,5.3.418,1,598,0,96,418,514,418,0,514,516,-45,261,764,4,4,101,172,306,329,25,1619,230
1578,25,0.3.514,0,637,1,70,514,584,467,47,584,584,0,261,764,4,5,76,76,199,329,26,1619,134
1578,25,1.3.516,0,598,0,6,516,522,516,0,522,522,-2,263,766,4,5,53,76,229,329,26,1619,134
1578,25,5.4.514,1,598,0,5,514,519,514,0,519,519,-35,275,799,5,4,5,58,306,297,26,1619,134
1578,26,0.3.514,0,637,1,70,514,584,467,47,584,584,0,261,799,4,5,76,76,199,329,27,1619,129
1578,26,1.3.516,1,598,0,6,516,522,516,0,522,522,-2,263,801,4,5,53,76,229,329,27,1619,129
1578,27,0.3.522,0,598,0,70,522,592,467,55,592,592,0,263,801,4,6,76,70,199,329,28,1619,123
1578,27,1.4.522,1,598,0,47,522,569,522,0,569,569,-3,278,804,5,5,47,53,229,297,28,1619,123
1578,28,0.3.522,1,598,0,70,522,592,467,55,592,592,0,263,804,4,6,76,70,199,329,29,1619,76
1578,29,0.4.592,1,598,0,6,592,598,592,0,598,598,-23,301,827,5,6,6,6,199,297,30,1619,6
1579,0,0.0.0,0,552,3,53,0,53,0,0,53,53,0,0,0,1,1,241,271,241,271,1,1487,1487
1579,0,1.0.0,0,526,0,23,0,23,0,0,23,23,0,0,0,1,1,229,271,229,271,1,1487,1487
1579,0,2.0.0,0,619,5,94,0,94,0,0,94,94,0,0,0,1,1,259,271,259,271,1,1487,1487
1579,0,3.0.0,1,537,1,11,0,11,0,0,11,11,0,0,0,1,1,201,271,201,271,1,1487,1487
1579,0,4.0.0,0,559,4,33,0,33,0,0,33,33,0,0,0,1,1,250,271,250,271,1,1487,1487
1579,0,5.0.0,0,540,2,57,0,57,0,0,57,57,0,0,0,1,1,307,271,307,271,1,1487,1487
1579,1,0.0.11,0,553,2,53,11,64,0,11,64,64,0,0,0,1,2,241,260,241,271,2,1487,1476
1579,1,1.0.11,1,537,0,23,11,34,0,11,34,34,0,0,0,1,2,229,260,229,271,2,1487,1476
1579,1,2.0.11,0,604,3,94,11,105,0,11,105,105,0,0,0,1,2,259,260,259,271,2,1487,1476
1579,1,3.1.11,0,553,2,89,11,100,11,0,100,100,-11,11,11,2,1,190,404,201,404,2,1487,1476
1579,1,4.0.11,0,553,2,33,11,44,0,11,44,44,0,0,0,1,2,250,260,250,271,2,1487,1476
1579,1,5.0.11,0,551,1,57,11,68,0,11,68,68,0,0,0,1,2,307,260,307,271,2,1487,1476
1579,2,0.0.34,0,537,0,53,34,87,0,34,87,87,0,0,0,1,3,241,237,241,271,3,1487,1453
1579,2,1.1.34,0,537,0,64,34,98,34,0,98,98,-34,34,34,2,1,206,404,229,404,3,1487,1453
1579,2,2.0.34,0,577,3,94,34,128,0,34,128,128,0,0,0,1,3,259,237,259,271,3,1487,1453
1579,2,3.1.11,0,556,2,89,11,100,11,0,100,100,-11,11,11,2,1,190,404,201,404,3,1487,1453
1579,2,4.0.34,1,538,1,33,34,67,0,34,67,67,0,0,0,1,3,250,237,250,271,3,1487,1453
1579,2,5.0.34,0,537,0,57,34,91,0,34,91,91,0,0,0,1,3,307,237,307,271,3,1487,1453
1579,3,0.0.67,0,538,0,53,67,120,0,67,120,120,0,0,0,1,4,241,204,241,271,4,1487,1420
1579,3,1.1.34,0,538,0,64,34,98,34,0,98,98,-34,34,34,2,1,206,404,229,404,4,1487,1420
1579,3,2.0.67,0,597,3,94,67,161,0,67,161,161,0,0,0,1,4,259,204,259,271,4,1487,1420
1579,3,3.1.11,0,567,2,89,11,100,11,0,100,100,-11,11,11,2,1,190,404,201,404,4,1487,1420
1579,3,4.1.67,0,597,3,88,67,155,67,0,155,155,-67,67,67,2,1,217,404,250,404,4,1487,1420
1579,3,5.0.67,1,551,1,57,67,124,0,67,124,124,0,0,0,1,4,307,204,307,271,4,1487,1420
1579,4,0.0.124,1,551,0,53,124,177,0,124,177,177,0,0,0,1,5,241,147,241,271,5,1487,1363
1579,4,1.1.34,0,551,0,64,34,98,34,0,98,124,-34,34,34,2,1,206,404,229,404,5,1487,1363
1579,4,2.0.124,0,572,1,94,124,218,0,124,218,218,0,0,0,1,5,259,147,259,271,5,1487,1363
1579,4,3.1.11,0,577,2,89,11,100,11,0,100,124,-11,11,11,2,1,190,404,201,404,5,1487,1363
1579,4,4.1.67,0,597,3,88,67,155,67,0,155,155,-67,67,67,2,1,217,404,250,404,5,1487,1363
1579,4,5.1.124,0,551,0,70,124,194,124,0,194,194,-124,124,124,2,1,250,404,307,404,5,1487,1363
1579,5,0.1.177,0,577,1,2,177,179,177,0,179,179,-177,177,177,2,1,188,404,241,404,6,1487,1310
1579,5,1.1.34,0,551,0,64,34,98,34,0,98,177,-34,34,34,2,1,206,404,229,404,6,1487,1310
1579,5,2.0.177,1,551,0,94,177,271,0,177,271,271,0,0,0,1,6,259,94,259,271,6,1487,1310
1579,5,3.1.11,0,577,1,89,11,100,11,0,100,177,-11,11,11,2,1,190,404,201,404,6,1487,1310
1579,5,4.1.67,0,597,2,88,67,155,67,0,155,177,-67,67,67,2,1,217,404,250,404,6,1487,1310
1579,5,5.1.124,0,551,0,70,124,194,124,0,194,194,-124,124,124,2,1,250,404,307,404,6,1487,1310
1579,6,0.1.177,0,577,2,2,177,179,177,0,179,271,-177,177,177,2,1,188,404,241,404,7,1487,1216
1579,6,1.1.34,1,551,0,64,34,98,34,0,98,271,-34,34,34,2,1,206,404,229,404,7,1487,1216
1579,6,2.1.271,0,572,1,91,271,362,271,0,362,362,-271,271,271,2,1,165,404,259,404,7,1487,1216
1579,6,3.1.11,0,577,2,89,11,100,11,0,100,271,-11,11,11,2,1,190,404,201,404,7,1487,1216
1579,6,4.1.67,0,597,3,88,67,155,67,0,155,271,-67,67,67,2,1,217,404,250,404,7,1487,1216
1579,6,5.1.124,0,551,0,70,124,194,124,0,194,271,-124,124,124,2,1,250,404,307,404,7,1487,1216
1579,7,0.1.177,0,595,3,2,177,179,177,0,179,271,-79,113,113,2,2,188,340,241,404,8,1487,1152
1579,7,1.2.98,1,551,0,39,98,137,98,0,137,271,-98,98,132,3,1,142,202,229,202,8,1487,1152
1579,7,2.1.271,0,572,1,91,271,362,271,0,362,362,-173,207,207,2,2,165,340,259,404,8,1487,1152
1579,7,3.1.98,0,584,2,89,98,187,11,87,187,271,0,34,34,2,2,190,340,201,404,8,1487,1152
1579,7,4.1.98,0,572,1,88,98,186,67,31,186,271,0,34,34,2,2,217,340,250,404,8,1487,1152
1579,7,5.1.124,0,551,0,70,124,194,124,0,194,271,-26,60,60,2,2,250,340,307,404,8,1487,1152
1579,8,0.1.177,0,595,3,2,177,179,177,0,179,271,-79,113,211,2,2,188,340,241,404,9,1487,1113
1579,8,1.3.137,1,551,0,47,137,184,137,0,184,271,-137,137,269,4,1,103,282,229,282,9,1487,1113
1579,8,2.1.271,0,572,1,91,271,362,271,0,362,362,-173,207,305,2,2,165,340,259,404,9,1487,1113
1579,8,3.1.98,0,584,2,89,98,187,11,87,187,271,0,34,132,2,2,190,340,201,404,9,1487,1113
1579,8,4.1.98,0,572,1,88,98,186,67,31,186,271,0,34,132,2,2,217,340,250,404,9,1487,1113
1579,8,5.1.124,0,551,0,70,124,194,124,0,194,271,-26,60,158,2,2,250,340,307,404,9,1487,1113
1579,9,0.1.177,0,595,3,2,177,179,177,0,179,271,-79,113,348,2,2,188,340,241,404,10,1487,1066
1579,9,1.4.184,1,551,0,56,184,240,184,0,240,271,-184,184,453,5,1,56,328,229,328,10,1487,1066
1579,9,2.1.271,0,572,1,91,271,362,271,0,362,362,-173,207,442,2,2,165,340,259,404,10,1487,1066
1579,9,3.1.98,0,584,2,89,98,187,11,87,187,271,0,34,269,2,2,190,340,201,404,10,1487,1066
1579,9,4.1.98,0,572,1,88,98,186,67,31,186,271,0,34,269,2,2,217,340,250,404,10,1487,1066
1579,9,5.1.124,0,551,0,70,124,194,124,0,194,271,-26,60,295,2,2,250,340,307,404,10,1487,1066
1579,10,0.1.177,1,595,3,2,177,179,177,0,179,271,-79,113,532,2,2,188,340,241,404,11,1487,1010
1579,10,2.1.271,0,572,1,91,271,362,271,0,362,362,-173,207,626,2,2,165,340,259,404,11,1487,1010
1579,10,3.1.98,0,584,2,89,98,187,11,87,187,271,0,34,453,2,2,190,340,201,404,11,1487,1010
1579,10,4.1.98,0,572,1,88,98,186,67,31,186,271,0,34,453,2,2,217,340,250,404,11,1487,1010
1579,10,5.1.124,0,551,0,70,124,194,124,0,194,271,-26,60,479,2,2,250,340,307,404,11,1487,1010
1579,11,0.2.179,1,595,0,52,179,231,179,0,231,271,-42,140,574,3,2,186,163,241,202,12,1487,1008
1579,11,2.1.271,0,638,3,91,271,362,271,0,362,362,-92,205,624,2,3,165,338,259,404,12,1487,1008
1579,11,3.1.179,0,629,2,89,179,268,11,168,268,271,0,113,532,2,3,190,338,201,404,12,1487,1008
1579,11,4.1.179,0,595,0,88,179,267,67,112,267,271,0,113,532,2,3,217,338,250,404,12,1487,1008
1579,11,5.1.179,0,602,1,70,179,249,124,55,249,271,0,113,532,2,3,250,338,307,404,12,1487,1008
1579,12,0.3.231,1,595,0,76,231,307,231,0,307,307,-47,184,621,4,2,134,235,241,282,13,1487,956
1579,12,2.1.271,0,638,3,91,271,362,271,0,362,362,-92,205,666,2,3,165,338,259,404,13,1487,956
1579,12,3.1.179,0,629,2,89,179,268,11,168,268,271,0,113,574,2,3,190,338,201,404,13,1487,956
1579,12,4.1.179,0,595,0,88,179,267,67,112,267,271,0,113,574,2,3,217,338,250,404,13,1487,956
1579,12,5.1.179,0,602,1,70,179,249,124,55,249,271,0,113,574,2,3,250,338,307,404,13,1487,956
1579,13,0.4.307,1,595,0,58,307,365,307,0,365,365,-67,251,688,5,2,58,272,241,328,14,1487,880
1579,13,2.1.271,0,638,3,91,271,362,271,0,362,362,-92,205,713,2,3,165,338,259,404,14,1487,880
1579,13,3.1.179,0,629,2,89,179,268,11,168,268,307,0,113,621,2,3,190,338,201,404,14,1487,880
1579,13,4.1.179,0,595,0,88,179,267,67,112,267,307,0,113,621,2,3,217,338,250,404,14,1487,880
1579,13,5.1.179,0,602,1,70,179,249,124,55,249,307,0,113,621,2,3,250,338,307,404,14,1487,880
1579,14,2.1.271,0,638,3,91,271,362,271,0,362,365,-92,205,780,2,3,165,338,259,404,15,1487,822
1579,14,3.1.179,0,629,2,89,179,268,11,168,268,365,0,113,688,2,3,190,338,201,404,15,1487,822
1579,14,4.1.179,0,595,0,88,179,267,67,112,267,365,0,113,688,2,3,217,338,250,404,15,1487,822
1579,14,5.1.179,1,602,1,70,179,249,124,55,249,365,0,113,688,2,3,250,338,307,404,15,1487,822
1579,15,2.1.271,0,640,1,91,271,362,271,0,362,365,-22,135,710,2,4,165,268,259,404,16,1487,752
1579,15,3.1.249,0,602,0,89,249,338,11,238,338,365,0,113,688,2,4,190,268,201,404,16,1487,752
1579,15,4.1.249,0,602,0,88,249,337,67,182,337,365,0,113,688,2,4,217,268,250,404,16,1487,752
1579,15,5.2.249,1,602,0,4,249,253,249,0,253,365,-18,158,706,3,3,180,111,307,202,16,1487,752
1579,16,2.1.271,0,640,1,91,271,362,271,0,362,365,-22,135,728,2,4,165,268,259,404,17,1487,748
1579,16,3.1.249,0,602,0,89,249,338,11,238,338,365,0,113,706,2,4,190,268,201,404,17,1487,748
1579,16,4.1.249,0,602,0,88,249,337,67,182,337,365,0,113,706,2,4,217,268,250,404,17,1487,748
1579,16,5.3.307,1,602,0,81,307,388,253,54,388,388,0,184,706,4,3,176,159,307,282,17,1487,748
1579,17,2.1.271,0,640,1,91,271,362,271,0,362,388,-22,135,728,2,4,165,268,259,404,18,1487,667
1579,17,3.1.249,0,602,0,89,249,338,11,238,338,388,0,113,706,2,4,190,268,201,404,18,1487,667
1579,17,4.1.249,0,602,0,88,249,337,67,182,337,388,0,113,706,2,4,217,268,250,404,18,1487,667
1579,17,5.4.388,1,602,0,95,388,483,388,0,483,483,-23,274,729,5,3,95,214,307,328,18,1487,667
1579,18,2.1.271,0,640,1,91,271,362,271,0,362,483,-22,135,751,2,4,165,268,259,404,19,1487,572
1579,18,3.1.249,1,602,0,89,249,338,11,238,338,483,0,113,729,2,4,190,268,201,404,19,1487,572
1579,18,4.1.249,0,602,0,88,249,337,67,182,337,483,0,113,729,2,4,217,268,250,404,19,1487,572
1579,19,2.1.338,0,646,1,91,338,429,271,67,429,483,0,113,729,2,5,165,179,259,404,20,1487,483
1579,19,3.2.338,1,602,0,22,338,360,338,0,360,483,-85,243,814,3,4,101,107,201,202,20,1487,483
1579,19,4.1.338,0,602,0,88,338,426,67,271,426,483,0,113,729,2,5,217,179,250,404,20,1487,483
1579,20,2.1.338,0,646,1,91,338,429,271,67,429,483,0,113,814,2,5,165,179,259,404,21,1487,461
1579,20,3.3.388,1,602,0,53,388,441,360,28,441,483,0,184,814,4,4,79,78,201,282,21,1487,461
1579,20,4.1.338,0,602,0,88,338,426,67,271,426,483,0,113,814,2,5,217,179,250,404,21,1487,461
1579,21,2.1.338,0,646,1,91,338,429,271,67,429,483,0,113,814,2,5,165,179,259,404,22,1487,408
1579,21,3.4.483,1,602,0,26,483,509,441,42,509,509,0,274,814,5,4,26,119,201,328,22,1487,408
1579,21,4.1.338,0,602,0,88,338,426,67,271,426,483,0,113,814,2,5,217,179,250,404,22,1487,408
1579,22,2.1.338,0,646,1,91,338,429,271,67,429,509,0,113,814,2,5,165,179,259,404,23,1487,382
1579,22,4.1.338,1,602,0,88,338,426,67,271,426,509,0,113,814,2,5,217,179,250,404,23,1487,382
1579,23,2.1.426,0,602,0,91,426,517,271,155,517,517,0,113,814,2,6,165,91,259,404,24,1487,294
1579,23,4.2.426,1,602,0,62,426,488,426,0,488,509,-66,309,880,3,5,129,85,250,202,24,1487,294
1579,24,2.1.426,0,602,0,91,426,517,271,155,517,517,0,113,880,2,6,165,91,259,404,25,1487,232
1579,24,4.3.488,1,602,0,19,488,507,488,0,507,509,-47,231,927,4,5,67,25,250,282,25,1487,232
1579,25,2.1.426,0,602,0,91,426,517,271,155,517,517,0,113,927,2,6,165,91,259,404,26,1487,213
1579,25,4.4.509,1,602,0,48,509,557,507,2,557,557,0,274,927,5,5,48,93,250,328,26,1487,213
1579,26,2.1.426,1,602,0,91,426,517,271,155,517,557,0,113,927,2,6,165,91,259,404,27,1487,165
1579,27,2.2.517,1,602,0,23,517,540,517,0,540,557,-29,338,956,3,6,74,23,259,202,28,1487,74
1579,28,2.3.540,1,602,0,6,540,546,540,0,546,557,-33,264,989,4,6,51,6,259,282,29,1487,51
1579,29,2.4.557,1,602,0,45,557,602,546,11,602,602,0,274,989,5,6,45,45,259,328,30,1487,45
1580,0,0.0.0,0,595,1,66,0,66,0,0,66,66,0,0,0,1,1,286,384,286,384,1,1657,1657
1580,0,1.0.0,0,600,2,98,0,98,0,0,98,98,0,0,0,1,1,329,384,329,384,1,1657,1657
1580,0,2.0.0,1,590,0,41,0,41,0,0,41,41,0,0,0,1,1,286,384,286,384,1,1657,1657
1580,0,3.0.0,0,595,1,63,0,63,0,0,63,63,0,0,0,1,1,259,384,259,384,1,1657,1657
1580,0,4.0.0,0,626,3,54,0,54,0,0,54,54,0,0,0,1,1,187,384,187,384,1,1657,1657
1580,0,5.0.0,0,595,1,62,0,62,0,0,62,62,0,0,0,1,1,310,384,310,384,1,1657,1657
1580,1,0.0.41,0,609,4,66,41,107,0,41,107,107,0,0,0,1,2,286,343,286,384,2,1657,1616
1580,1,1.0.41,0,599,2,98,41,139,0,41,139,139,0,0,0,1,2,329,343,329,384,2,1657,1616
1580,1,2.1.41,1,590,0,85,41,126,41,0,126,126,-41,41,41,2,1,245,308,286,308,2,1657,1616
1580,1,3.0.41,0,597,1,63,41,104,0,41,104,104,0,0,0,1,2,259,343,259,384,2,1657,1616
1580,1,4.0.41,0,604,3,54,41,95,0,41,95,95,0,0,0,1,2,187,343,187,384,2,1657,1616
1580,1,5.0.41,0,590,0,62,41,103,0,41,103,103,0,0,0,1,2,310,343,310,384,2,1657,1616
1580,2,0.0.41,0,609,4,66,41,107,0,41,107,126,0,0,41,1,2,286,343,286,384,3,1657,1531
1580,2,1.0.41,0,599,2,98,41,139,0,41,139,139,0,0,41,1,2,329,343,329,384,3,1657,1531
1580,2,2.2.126,1,590,0,76,126,202,126,0,202,202,-126,126,167,3,1,160,370,286,370,3,1657,1531
1580,2,3.0.41,0,597,1,63,41,104,0,41,104,126,0,0,41,1,2,259,343,259,384,3,1657,1531
1580,2,4.0.41,0,604,3,54,41,95,0,41,95,126,0,0,41,1,2,187,343,187,384,3,1657,1531
1580,2,5.0.41,0,590,0,62,41,103,0,41,103,126,0,0,41,1,2,310,343,310,384,3,1657,1531
1580,3,0.0.41,0,609,4,66,41,107,0,41,107,202,0,0,167,1,2,286,343,286,384,4,1657,1455
1580,3,1.0.41,0,600,2,98,41,139,0,41,139,202,0,0,167,1,2,329,343,329,384,4,1657,1455
1580,3,2.3.202,1,590,0,74,202,276,202,0,276,276,-202,202,369,4,1,84,336,286,336,4,1657,1455
1580,3,3.0.41,0,597,1,63,41,104,0,41,104,202,0,0,167,1,2,259,343,259,384,4,1657,1455
1580,3,4.0.41,0,604,3,54,41,95,0,41,95,202,0,0,167,1,2,187,343,187,384,4,1657,1455
1580,3,5.0.41,0,590,0,62,41,103,0,41,103,202,0,0,167,1,2,310,343,310,384,4,1657,1455
1580,4,0.0.41,0,609,3,66,41,107,0,41,107,276,0,0,369,1,2,286,343,286,384,5,1657,1381
1580,4,1.0.41,0,611,4,98,41,139,0,41,139,276,0,0,369,1,2,329,343,329,384,5,1657,1381
1580,4,2.4.276,1,590,0,10,276,286,276,0,286,286,-276,276,645,5,1,10,259,286,259,5,1657,1381
1580,4,3.0.41,0,597,1,63,41,104,0,41,104,276,0,0,369,1,2,259,343,259,384,5,1657,1381
1580,4,4.0.41,0,604,2,54,41,95,0,41,95,276,0,0,369,1,2,187,343,187,384,5,1657,1381
1580,4,5.0.41,0,590,0,62,41,103,0,41,103,276,0,0,369,1,2,310,343,310,384,5,1657,1381
1580,5,0.0.41,0,609,3,66,41,107,0,41,107,286,0,0,645,1,2,286,343,286,384,6,1657,1371
1580,5,1.0.41,0,611,4,98,41,139,0,41,139,286,0,0,645,1,2,329,343,329,384,6,1657,1371
1580,5,3.0.41,0,597,1,63,41,104,0,41,104,286,0,0,645,1,2,259,343,259,384,6,1657,1371
1580,5,4.0.41,0,604,2,54,41,95,0,41,95,286,0,0,645,1,2,187,343,187,384,6,1657,1371
1580,5,5.0.41,1,590,0,62,41,103,0,41,103,286,0,0,645,1,2,310,343,310,384,6,1657,1371
1580,6,0.0.103,0,600,2,66,103,169,0,103,169,286,0,0,645,1,3,286,281,286,384,7,1657,1309
1580,6,1.0.103,0,592,1,98,103,201,0,103,201,286,0,0,645,1,3,329,281,329,384,7,1657,1309
1580,6,3.0.103,0,590,0,63,103,166,0,103,166,286,0,0,645,1,3,259,281,259,384,7,1657,1309
1580,6,4.0.103,0,604,3,54,103,157,0,103,157,286,0,0,645,1,3,187,281,187,384,7,1657,1309
1580,6,5.1.126,1,590,0,54,126,180,103,23,180,286,0,41,645,2,2,248,223,310,308,7,1657,1309
1580,7,0.0.103,0,600,2,66,103,169,0,103,169,286,0,0,645,1,3,286,281,286,384,8,1657,1255
1580,7,1.0.103,0,592,1,98,103,201,0,103,201,286,0,0,645,1,3,329,281,329,384,8,1657,1255
1580,7,3.0.103,0,590,0,63,103,166,0,103,166,286,0,0,645,1,3,259,281,259,384,8,1657,1255
1580,7,4.0.103,0,604,3,54,103,157,0,103,157,286,0,0,645,1,3,187,281,187,384,8,1657,1255
1580,7,5.2.202,1,590,0,42,202,244,180,22,244,286,0,126,645,3,2,194,294,310,370,8,1657,1255
1580,8,0.0.103,0,600,2,66,103,169,0,103,169,286,0,0,645,1,3,286,281,286,384,9,1657,1213
1580,8,1.0.103,0,592,1,98,103,201,0,103,201,286,0,0,645,1,3,329,281,329,384,9,1657,1213
1580,8,3.0.103,0,590,0,63,103,166,0,103,166,286,0,0,645,1,3,259,281,259,384,9,1657,1213
1580,8,4.0.103,0,604,3,54,103,157,0,103,157,286,0,0,645,1,3,187,281,187,384,9,1657,1213
1580,8,5.3.276,1,590,0,65,276,341,244,32,341,341,0,202,645,4,2,152,262,310,336,9,1657,1213
1580,9,0.0.103,0,600,2,66,103,169,0,103,169,341,0,0,645,1,3,286,281,286,384,10,1657,1148
1580,9,1.0.103,0,592,1,98,103,201,0,103,201,341,0,0,645,1,3,329,281,329,384,10,1657,1148
1580,9,3.0.103,0,590,0,63,103,166,0,103,166,341,0,0,645,1,3,259,281,259,384,10,1657,1148
1580,9,4.0.103,0,604,3,54,103,157,0,103,157,341,0,0,645,1,3,187,281,187,384,10,1657,1148
1580,9,5.4.341,1,590,0,87,341,428,341,0,428,428,-55,331,700,5,2,87,249,310,259,10,1657,1148
1580,10,0.0.103,1,600,2,66,103,169,0,103,169,428,0,0,700,1,3,286,281,286,384,11,1657,1061
1580,10,1.0.103,0,592,1,98,103,201,0,103,201,428,0,0,700,1,3,329,281,329,384,11,1657,1061
1580,10,3.0.103,0,590,0,63,103,166,0,103,166,428,0,0,700,1,3,259,281,259,384,11,1657,1061
1580,10,4.0.103,0,604,3,54,103,157,0,103,157,428,0,0,700,1,3,187,281,187,384,11,1657,1061
1580,11,0.1.180,1,600,0,69,180,249,169,11,249,428,0,41,700,2,3,220,169,286,308,12,1657,995
1580,11,1.0.169,0,600,0,98,169,267,0,169,267,428,0,0,700,1,4,329,215,329,384,12,1657,995
1580,11,3.0.169,0,609,1,63,169,232,0,169,232,428,0,0,700,1,4,259,215,259,384,12,1657,995
1580,11,4.0.169,0,633,2,54,169,223,0,169,223,428,0,0,700,1,4,187,215,187,384,12,1657,995
1580,12,0.2.249,0,600,0,56,249,305,249,0,305,428,-5,131,705,3,3,151,252,286,370,13,1657,926
1580,12,1.0.169,0,600,0,98,169,267,0,169,267,428,0,0,700,1,4,329,215,329,384,13,1657,926
1580,12,3.0.169,1,610,1,63,169,232,0,169,232,428,0,0,700,1,4,259,215,259,384,13,1657,926
1580,12,4.0.169,0,633,2,54,169,223,0,169,223,428,0,0,700,1,4,187,215,187,384,13,1657,926
1580,13,0.2.249,0,610,0,56,249,305,249,0,305,428,-5,131,705,3,3,151,252,286,370,14,1657,863
1580,13,1.0.232,0,610,0,98,232,330,0,232,330,428,0,0,700,1,5,329,152,329,384,14,1657,863
1580,13,3.1.249,1,610,0,27,249,276,232,17,276,428,0,41,700,2,4,196,100,259,308,14,1657,863
1580,13,4.0.232,0,633,1,54,232,286,0,232,286,428,0,0,700,1,5,187,152,187,384,14,1657,863
1580,14,0.2.249,0,610,0,56,249,305,249,0,305,428,-5,131,705,3,3,151,252,286,370,15,1657,836
1580,14,1.0.232,1,610,0,98,232,330,0,232,330,428,0,0,700,1,5,329,152,329,384,15,1657,836
1580,14,3.2.276,0,611,1,89,276,365,276,0,365,428,-32,158,732,3,3,169,252,259,370,15,1657,836
1580,14,4.0.232,0,633,2,54,232,286,0,232,286,428,0,0,700,1,5,187,152,187,384,15,1657,836
1580,15,0.2.249,0,610,0,56,249,305,249,0,305,428,-5,131,705,3,3,151,252,286,370,16,1657,738
1580,15,1.1.330,0,610,0,33,330,363,330,0,363,428,-54,95,754,2,5,231,73,329,308,16,1657,738
1580,15,3.2.276,0,611,1,89,276,365,276,0,365,428,-32,158,732,3,3,169,252,259,370,16,1657,738
1580,15,4.0.330,1,610,0,54,330,384,0,330,384,428,0,0,700,1,6,187,54,187,384,16,1657,738
1580,16,0.2.249,0,610,0,56,249,305,249,0,305,428,-5,131,705,3,3,151,252,286,370,17,1657,684
1580,16,1.1.330,1,610,0,33,330,363,330,0,363,428,-54,95,754,2,5,231,73,329,308,17,1657,684
1580,16,3.2.276,0,611,1,89,276,365,276,0,365,428,-32,158,732,3,3,169,252,259,370,17,1657,684
1580,16,4.1.384,0,610,0,40,384,424,384,0,424,428,-108,149,808,2,5,133,73,187,308,17,1657,684
1580,17,0.2.249,0,610,0,56,249,305,249,0,305,428,-5,131,759,3,3,151,252,286,370,18,1657,651
1580,17,1.2.363,0,658,2,44,363,407,363,0,407,428,-119,245,873,3,3,198,252,329,370,18,1657,651
1580,17,3.2.276,0,611,1,89,276,365,276,0,365,428,-32,158,786,3,3,169,252,259,370,18,1657,651
1580,17,4.1.384,1,610,0,40,384,424,384,0,424,428,-21,116,775,2,6,133,40,187,308,18,1657,651
1580,18,0.2.249,1,610,0,56,249,305,249,0,305,428,-5,131,780,3,3,151,252,286,370,19,1657,611
1580,18,1.2.363,0,658,3,44,363,407,363,0,407,428,-119,245,894,3,3,198,252,329,370,19,1657,611
1580,18,3.2.276,0,611,1,89,276,365,276,0,365,428,-32,158,807,3,3,169,252,259,370,19,1657,611
1580,18,4.2.424,0,638,2,63,424,487,424,0,487,487,-180,306,955,3,3,93,252,187,370,19,1657,611
1580,19,0.3.341,1,610,0,83,341,424,305,36,424,428,0,202,780,4,3,95,197,286,336,20,1657,555
1580,19,1.2.363,0,658,1,44,363,407,363,0,407,428,-58,189,838,3,4,198,196,329,370,20,1657,555
1580,19,3.2.305,0,610,0,89,305,394,276,29,394,428,0,131,780,3,4,169,196,259,370,20,1657,555
1580,19,4.2.424,0,663,2,63,424,487,424,0,487,487,-119,250,899,3,4,93,196,187,370,20,1657,555
1580,20,0.4.428,1,610,0,12,428,440,424,4,440,440,0,331,780,5,3,12,162,286,259,21,1657,472
1580,20,1.2.363,0,663,1,44,363,407,363,0,407,428,-58,189,838,3,4,198,196,329,370,21,1657,472
1580,20,3.2.305,0,610,0,89,305,394,276,29,394,428,0,131,780,3,4,169,196,259,370,21,1657,472
1580,20,4.2.424,0,663,1,63,424,487,424,0,487,487,-119,250,899,3,4,93,196,187,370,21,1657,472
1580,21,1.2.363,1,663,1,44,363,407,363,0,407,440,-58,189,838,3,4,198,196,329,370,22,1657,460
1580,21,3.2.305,0,610,0,89,305,394,276,29,394,440,0,131,780,3,4,169,196,259,370,22,1657,460
1580,21,4.2.424,0,663,1,63,424,487,424,0,487,487,-119,250,899,3,4,93,196,187,370,22,1657,460
1580,22,1.3.424,1,663,0,89,424,513,407,17,513,513,0,202,838,4,4,154,114,329,336,23,1657,416
1580,22,3.2.407,0,663,0,89,407,496,276,131,496,496,0,189,838,3,5,169,152,259,370,23,1657,416
1580,22,4.2.424,0,663,0,63,424,487,424,0,487,487,-17,206,855,3,5,93,152,187,370,23,1657,416
1580,23,1.4.513,1,663,0,65,513,578,513,0,578,578,-73,404,911,5,4,65,150,329,259,24,1657,327
1580,23,3.2.407,0,663,0,89,407,496,276,131,496,513,0,189,838,3,5,169,152,259,370,24,1657,327
1580,23,4.2.424,0,663,0,63,424,487,424,0,487,513,-17,206,855,3,5,93,152,187,370,24,1657,327
1580,24,3.2.407,1,663,0,89,407,496,276,131,496,578,0,189,911,3,5,169,152,259,370,25,1657,262
1580,24,4.2.424,0,663,0,63,424,487,424,0,487,578,-17,206,928,3,5,93,152,187,370,25,1657,262
1580,25,3.3.513,1,663,0,13,513,526,496,17,526,578,0,202,911,4,5,80,25,259,336,26,1657,173
1580,25,4.2.496,0,663,0,63,496,559,424,72,559,578,0,189,911,3,6,93,63,187,370,26,1657,173
1580,26,3.4.578,1,663,0,67,578,645,526,52,645,645,0,404,911,5,5,67,85,259,259,27,1657,160
1580,26,4.2.496,0,663,0,63,496,559,424,72,559,578,0,189,911,3,6,93,63,187,370,27,1657,160
1580,27,4.2.496,1,663,0,63,496,559,424,72,559,645,0,189,911,3,6,93,63,187,370,28,1657,93
1580,28,4.3.559,1,663,0,12,559,571,559,0,571,645,-33,235,944,4,6,30,12,187,336,29,1657,30
1580,29,4.4.645,1,663,0,18,645,663,571,74,663,663,0,404,944,5,6,18,18,187,259,30,1657,18
1581,0,0.0.0,0,651,3,79,0,79,0,0,79,79,0,0,0,1,1,328,399,328,399,1,1723,1723
1581,0,1.0.0,0,648,2,74,0,74,0,0,74,74,0,0,0,1,1,229,399,229,399,1,1723,1723
1581,0,2.0.0,0,658,4,86,0,86,0,0,86,86,0,0,0,1,1,311,399,311,399,1,1723,1723
1581,0,3.0.0,1,648,2,17,0,17,0,0,17,17,0,0,0,1,1,218,399,218,399,1,1723,1723
1581,0,4.0.0,0,647,1,76,0,76,0,0,76,76,0,0,0,1,1,325,399,325,399,1,1723,1723
1581,0,5.0.0,0,641,0,67,0,67,0,0,67,67,0,0,0,1,1,312,399,312,399,1,1723,1723
1581,1,0.0.17,0,668,3,79,17,96,0,17,96,96,0,0,0,1,2,328,382,328,399,2,1723,1706
1581,1,1.0.17,0,649,1,74,17,91,0,17,91,91,0,0,0,1,2,229,382,229,399,2,1723,1706
1581,1,2.0.17,0,659,2,86,17,103,0,17,103,103,0,0,0,1,2,311,382,311,399,2,1723,1706
1581,1,3.1.17,1,648,0,65,17,82,17,0,82,82,-17,17,17,2,1,201,310,218,310,2,1723,1706
1581,1,4.0.17,0,648,0,76,17,93,0,17,93,93,0,0,0,1,2,325,382,325,399,2,1723,1706
1581,1,5.0.17,0,648,0,67,17,84,0,17,84,84,0,0,0,1,2,312,382,312,399,2,1723,1706
1581,2,0.0.17,0,668,3,79,17,96,0,17,96,96,0,0,17,1,2,328,382,328,399,3,1723,1641
1581,2,1.0.17,0,649,1,74,17,91,0,17,91,91,0,0,17,1,2,229,382,229,399,3,1723,1641
1581,2,2.0.17,0,659,2,86,17,103,0,17,103,103,0,0,17,1,2,311,382,311,399,3,1723,1641
1581,2,3.2.82,1,648,0,56,82,138,82,0,138,138,-82,82,99,3,1,136,337,218,337,3,1723,1641
1581,2,4.0.17,0,648,0,76,17,93,0,17,93,93,0,0,17,1,2,325,382,325,399,3,1723,1641
1581,2,5.0.17,0,648,0,67,17,84,0,17,84,84,0,0,17,1,2,312,382,312,399,3,1723,1641
1581,3,0.0.17,0,670,3,79,17,96,0,17,96,138,0,0,99,1,2,328,382,328,399,4,1723,1585
1581,3,1.0.17,0,649,1,74,17,91,0,17,91,138,0,0,99,1,2,229,382,229,399,4,1723,1585
1581,3,2.0.17,0,659,2,86,17,103,0,17,103,138,0,0,99,1,2,311,382,311,399,4,1723,1585
1581,3,3.3.138,1,648,0,71,138,209,138,0,209,209,-138,138,237,4,1,80,290,218,290,4,1723,1585
1581,3,4.0.17,0,648,0,76,17,93,0,17,93,138,0,0,99,1,2,325,382,325,399,4,1723,1585
1581,3,5.0.17,0,648,0,67,17,84,0,17,84,138,0,0,99,1,2,312,382,312,399,4,1723,1585
1581,4,0.0.17,0,670,3,79,17,96,0,17,96,209,0,0,237,1,2,328,382,328,399,5,1723,1514
1581,4,1.0.17,0,649,1,74,17,91,0,17,91,209,0,0,237,1,2,229,382,229,399,5,1723,1514
1581,4,2.0.17,0,659,2,86,17,103,0,17,103,209,0,0,237,1,2,311,382,311,399,5,1723,1514
1581,4,3.4.209,1,648,0,9,209,218,209,0,218,218,-209,209,446,5,1,9,387,218,387,5,1723,1514
1581,4,4.0.17,0,648,0,76,17,93,0,17,93,209,0,0,237,1,2,325,382,325,399,5,1723,1514
1581,4,5.0.17,0,648,0,67,17,84,0,17,84,209,0,0,237,1,2,312,382,312,399,5,1723,1514
1581,5,0.0.17,0,670,3,79,17,96,0,17,96,218,0,0,446,1,2,328,382,328,399,6,1723,1505
1581,5,1.0.17,0,649,1,74,17,91,0,17,91,218,0,0,446,1,2,229,382,229,399,6,1723,1505
1581,5,2.0.17,0,659,2,86,17,103,0,17,103,218,0,0,446,1,2,311,382,311,399,6,1723,1505
1581,5,4.0.17,0,648,0,76,17,93,0,17,93,218,0,0,446,1,2,325,382,325,399,6,1723,1505
1581,5,5.0.17,1,648,0,67,17,84,0,17,84,218,0,0,446,1,2,312,382,312,399,6,1723,1505
1581,6,0.0.84,0,661,2,79,84,163,0,84,163,218,0,0,446,1,3,328,315,328,399,7,1723,1438
1581,6,1.0.84,0,648,0,74,84,158,0,84,158,218,0,0,446,1,3,229,315,229,399,7,1723,1438
1581,6,2.0.84,0,659,1,86,84,170,0,84,170,218,0,0,446,1,3,311,315,311,399,7,1723,1438
1581,6,4.0.84,0,648,0,76,84,160,0,84,160,218,0,0,446,1,3,325,315,325,399,7,1723,1438
1581,6,5.1.84,1,648,0,37,84,121,84,0,121,218,-2,19,448,2,2,245,245,312,310,7,1723,1438
1581,7,0.0.84,0,661,2,79,84,163,0,84,163,218,0,0,448,1,3,328,315,328,399,8,1723,1401
1581,7,1.0.84,0,648,0,74,84,158,0,84,158,218,0,0,448,1,3,229,315,229,399,8,1723,1401
1581,7,2.0.84,0,659,1,86,84,170,0,84,170,218,0,0,448,1,3,311,315,311,399,8,1723,1401
1581,7,4.0.84,0,648,0,76,84,160,0,84,160,218,0,0,448,1,3,325,315,325,399,8,1723,1401
1581,7,5.2.138,1,648,0,80,138,218,121,17,218,218,0,82,448,3,2,208,281,312,337,8,1723,1401
1581,8,0.0.84,0,661,2,79,84,163,0,84,163,218,0,0,448,1,3,328,315,328,399,9,1723,1321
1581,8,1.0.84,0,648,0,74,84,158,0,84,158,218,0,0,448,1,3,229,315,229,399,9,1723,1321
1581,8,2.0.84,0,659,1,86,84,170,0,84,170,218,0,0,448,1,3,311,315,311,399,9,1723,1321
1581,8,4.0.84,0,648,0,76,84,160,0,84,160,218,0,0,448,1,3,325,315,325,399,9,1723,1321
1581,8,5.3.218,1,648,0,50,218,268,218,0,268,268,-9,147,457,4,2,128,219,312,290,9,1723,1321
1581,9,0.0.84,0,661,2,79,84,163,0,84,163,268,0,0,457,1,3,328,315,328,399,10,1723,1271
1581,9,1.0.84,0,648,0,74,84,158,0,84,158,268,0,0,457,1,3,229,315,229,399,10,1723,1271
1581,9,2.0.84,0,659,1,86,84,170,0,84,170,268,0,0,457,1,3,311,315,311,399,10,1723,1271
1581,9,4.0.84,0,648,0,76,84,160,0,84,160,268,0,0,457,1,3,325,315,325,399,10,1723,1271
1581,9,5.4.268,1,648,0,78,268,346,268,0,346,346,-50,259,507,5,2,78,378,312,387,10,1723,1271
1581,10,0.0.84,0,661,2,79,84,163,0,84,163,346,0,0,507,1,3,328,315,328,399,11,1723,1193
1581,10,1.0.84,0,648,0,74,84,158,0,84,158,346,0,0,507,1,3,229,315,229,399,11,1723,1193
1581,10,2.0.84,0,659,1,86,84,170,0,84,170,346,0,0,507,1,3,311,315,311,399,11,1723,1193
1581,10,4.0.84,1,648,0,76,84,160,0,84,160,346,0,0,507,1,3,325,315,325,399,11,1723,1193
1581,11,0.0.160,0,652,1,79,160,239,0,160,239,346,0,0,507,1,4,328,239,328,399,12,1723,1117
1581,11,1.0.160,0,648,0,74,160,234,0,160,234,346,0,0,507,1,4,229,239,229,399,12,1723,1117
1581,11,2.0.160,0,648,0,86,160,246,0,160,246,346,0,0,507,1,4,311,239,311,399,12,1723,1117
1581,11,4.1.160,1,648,0,92,160,252,160,0,252,346,-39,58,546,2,3,249,208,325,310,12,1723,1117
1581,12,0.0.160,0,652,1,79,160,239,0,160,239,346,0,0,546,1,4,328,239,328,399,13,1723,1025
1581,12,1.0.160,0,648,0,74,160,234,0,160,234,346,0,0,546,1,4,229,239,229,399,13,1723,1025
1581,12,2.0.160,0,648,0,86,160,246,0,160,246,346,0,0,546,1,4,311,239,311,399,13,1723,1025
1581,12,4.2.252,1,648,0,64,252,316,252,0,316,346,-34,116,580,3,3,157,201,325,337,13,1723,1025
1581,13,0.0.160,0,652,1,79,160,239,0,160,239,346,0,0,580,1,4,328,239,328,399,14,1723,961
1581,13,1.0.160,0,648,0,74,160,234,0,160,234,346,0,0,580,1,4,229,239,229,399,14,1723,961
1581,13,2.0.160,0,648,0,86,160,246,0,160,246,346,0,0,580,1,4,311,239,311,399,14,1723,961
1581,13,4.3.316,1,648,0,6,316,322,316,0,322,346,-48,195,628,4,3,93,169,325,290,14,1723,961
1581,14,0.0.160,0,652,1,79,160,239,0,160,239,346,0,0,628,1,4,328,239,328,399,15,1723,955
1581,14,1.0.160,0,648,0,74,160,234,0,160,234,346,0,0,628,1,4,229,239,229,399,15,1723,955
1581,14,2.0.160,0,648,0,86,160,246,0,160,246,346,0,0,628,1,4,311,239,311,399,15,1723,955
1581,14,4.4.346,1,648,0,87,346,433,322,24,433,433,0,259,628,5,3,87,300,325,387,15,1723,955
1581,15,0.0.160,1,652,1,79,160,239,0,160,239,433,0,0,628,1,4,328,239,328,399,16,1723,868
1581,15,1.0.160,0,648,0,74,160,234,0,160,234,433,0,0,628,1,4,229,239,229,399,16,1723,868
1581,15,2.0.160,0,648,0,86,160,246,0,160,246,433,0,0,628,1,4,311,239,311,399,16,1723,868
1581,16,0.1.252,1,652,0,37,252,289,239,13,289,433,0,58,628,2,4,249,116,328,310,17,1723,789
1581,16,1.0.239,0,652,0,74,239,313,0,239,313,433,0,0,628,1,5,229,160,229,399,17,1723,789
1581,16,2.0.239,0,677,1,86,239,325,0,239,325,433,0,0,628,1,5,311,160,311,399,17,1723,789
1581,17,0.2.316,1,677,1,59,316,375,289,27,375,433,0,116,628,3,4,212,137,328,337,18,1723,752
1581,17,1.0.239,0,652,0,74,239,313,0,239,313,433,0,0,628,1,5,229,160,229,399,18,1723,752
1581,17,2.0.239,0,677,1,86,239,325,0,239,325,433,0,0,628,1,5,311,160,311,399,18,1723,752
1581,18,0.3.375,1,677,0,89,375,464,375,0,464,464,-53,248,681,4,4,153,163,328,290,19,1723,693
1581,18,1.0.239,0,677,0,74,239,313,0,239,313,433,0,0,628,1,5,229,160,229,399,19,1723,693
1581,18,2.0.239,0,677,0,86,239,325,0,239,325,433,0,0,628,1,5,311,160,311,399,19,1723,693
1581,19,0.4.464,0,677,0,64,464,528,464,0,528,528,-31,290,712,5,4,64,213,328,387,20,1723,604
1581,19,1.0.239,0,677,0,74,239,313,0,239,313,464,0,0,681,1,5,229,160,229,399,20,1723,604
1581,19,2.0.239,1,677,0,86,239,325,0,239,325,464,0,0,681,1,5,311,160,311,399,20,1723,604
1581,20,0.4.464,0,677,0,64,464,528,464,0,528,528,-31,290,712,5,4,64,213,328,387,21,1723,518
1581,20,1.0.325,1,677,0,74,325,399,0,325,399,464,0,0,681,1,6,229,74,229,399,21,1723,518
1581,20,2.1.325,0,677,0,78,325,403,325,0,403,464,-36,94,717,2,5,225,79,311,310,21,1723,518
1581,21,0.4.464,0,677,0,64,464,528,464,0,528,528,-31,290,712,5,4,64,213,328,387,22,1723,444
1581,21,1.1.399,0,677,0,1,399,400,399,0,400,464,-110,168,791,2,5,155,79,229,310,22,1723,444
1581,21,2.1.325,1,677,0,78,325,403,325,0,403,464,-36,94,717,2,5,225,79,311,310,22,1723,444
1581,22,0.4.464,0,677,0,64,464,528,464,0,528,528,-31,290,748,5,4,64,213,328,387,23,1723,366
1581,22,1.1.403,1,677,0,1,403,404,399,4,404,464,0,94,717,2,6,155,1,229,310,23,1723,366
1581,22,2.2.403,0,677,0,29,403,432,403,0,432,464,-28,144,745,3,5,147,78,311,337,23,1723,366
1581,23,0.4.464,0,677,0,64,464,528,464,0,528,528,-31,290,748,5,4,64,213,328,387,24,1723,365
1581,23,1.2.404,0,677,0,49,404,453,404,0,453,464,-29,145,746,3,5,154,78,229,337,24,1723,365
1581,23,2.2.403,1,677,0,29,403,432,403,0,432,464,-28,144,745,3,5,147,78,311,337,24,1723,365
1581,24,0.4.464,0,677,0,64,464,528,464,0,528,528,-31,290,776,5,4,64,213,328,387,25,1723,336
1581,24,1.2.432,0,677,0,49,432,481,404,28,481,481,0,144,745,3,6,154,49,229,337,25,1723,336
1581,24,2.3.464,1,677,0,43,464,507,432,32,507,507,0,248,745,4,5,118,74,311,290,25,1723,336
1581,25,0.4.464,0,677,0,64,464,528,464,0,528,528,-31,290,776,5,4,64,213,328,387,26,1723,293
1581,25,1.2.432,1,677,0,49,432,481,404,28,481,507,0,144,745,3,6,154,49,229,337,26,1723,293
1581,25,2.4.507,0,720,1,75,507,582,507,0,582,582,-74,333,819,5,4,75,213,311,387,26,1723,293
1581,26,0.4.464,0,677,0,64,464,528,464,0,528,528,-31,290,776,5,4,64,213,328,387,27,1723,244
1581,26,1.3.507,1,677,0,31,507,538,481,26,538,538,0,248,745,4,6,105,31,229,290,27,1723,244
1581,26,2.4.507,0,720,1,75,507,582,507,0,582,582,-74,333,819,5,4,75,213,311,387,27,1723,244
1581,27,0.4.464,1,677,0,64,464,528,464,0,528,538,-31,290,776,5,4,64,213,328,387,28,1723,213
1581,27,1.4.538,0,687,1,74,538,612,538,0,612,612,-105,364,850,5,4,74,213,229,387,28,1723,213
1581,27,2.4.507,0,720,2,75,507,582,507,0,582,582,-74,333,819,5,4,75,213,311,387,28,1723,213
1581,28,1.4.538,0,687,1,74,538,612,538,0,612,612,-10,300,786,5,5,74,149,229,387,29,1723,149
1581,28,2.4.528,1,677,0,75,528,603,507,21,603,603,0,290,776,5,5,75,149,311,387,29,1723,149
1581,29,1.4.603,1,677,0,74,603,677,538,65,677,677,0,290,776,5,6,74,74,229,387,30,1723,74
1582,0,0.0.0,0,638,4,92,0,92,0,0,92,92,0,0,0,1,1,273,413,273,413,1,1595,1595
1582,0,1.0.0,1,594,0,50,0,50,0,0,50,50,0,0,0,1,1,328,413,328,413,1,1595,1595
1582,0,2.0.0,0,594,0,32,0,32,0,0,32,32,0,0,0,1,1,239,413,239,413,1,1595,1595
1582,0,3.0.0,0,611,1,70,0,70,0,0,70,70,0,0,0,1,1,178,413,178,413,1,1595,1595
1582,0,4.0.0,0,619,3,98,0,98,0,0,98,98,0,0,0,1,1,363,413,363,413,1,1595,1595
1582,0,5.0.0,0,617,2,71,0,71,0,0,71,71,0,0,0,1,1,214,413,214,413,1,1595,1595
1582,1,0.0.50,0,633,4,92,50,142,0,50,142,142,0,0,0,1,2,273,363,273,413,2,1595,1545
1582,1,1.1.50,1,594,0,68,50,118,50,0,118,118,-50,50,50,2,1,278,213,328,213,2,1595,1545
1582,1,2.0.50,0,597,1,32,50,82,0,50,82,82,0,0,0,1,2,239,363,239,413,2,1595,1545
1582,1,3.0.50,0,611,2,70,50,120,0,50,120,120,0,0,0,1,2,178,363,178,413,2,1595,1545
1582,1,4.0.50,0,594,0,98,50,148,0,50,148,148,0,0,0,1,2,363,363,363,413,2,1595,1545
1582,1,5.0.50,0,613,3,71,50,121,0,50,121,121,0,0,0,1,2,214,363,214,413,2,1595,1545
1582,2,0.0.50,0,633,4,92,50,142,0,50,142,142,0,0,50,1,2,273,363,273,413,3,1595,1477
1582,2,1.2.118,1,594,0,55,118,173,118,0,173,173,-118,118,168,3,1,210,308,328,308,3,1595,1477
1582,2,2.0.50,0,597,1,32,50,82,0,50,82,118,0,0,50,1,2,239,363,239,413,3,1595,1477
1582,2,3.0.50,0,611,2,70,50,120,0,50,120,120,0,0,50,1,2,178,363,178,413,3,1595,1477
1582,2,4.0.50,0,594,0,98,50,148,0,50,148,148,0,0,50,1,2,363,363,363,413,3,1595,1477
1582,2,5.0.50,0,613,3,71,50,121,0,50,121,121,0,0,50,1,2,214,363,214,413,3,1595,1477
1582,3,0.0.50,0,633,4,92,50,142,0,50,142,173,0,0,168,1,2,273,363,273,413,4,1595,1422
1582,3,1.3.173,1,594,0,72,173,245,173,0,245,245,-173,173,341,4,1,155,343,328,343,4,1595,1422
1582,3,2.0.50,0,597,1,32,50,82,0,50,82,173,0,0,168,1,2,239,363,239,413,4,1595,1422
1582,3,3.0.50,0,611,2,70,50,120,0,50,120,173,0,0,168,1,2,178,363,178,413,4,1595,1422
1582,3,4.0.50,0,594,0,98,50,148,0,50,148,173,0,0,168,1,2,363,363,363,413,4,1595,1422
1582,3,5.0.50,0,613,3,71,50,121,0,50,121,173,0,0,168,1,2,214,363,214,413,4,1595,1422
1582,4,0.0.50,0,633,4,92,50,142,0,50,142,245,0,0,341,1,2,273,363,273,413,5,1595,1350
1582,4,1.4.245,1,594,0,83,245,328,245,0,328,328,-245,245,586,5,1,83,318,328,318,5,1595,1350
1582,4,2.0.50,0,597,1,32,50,82,0,50,82,245,0,0,341,1,2,239,363,239,413,5,1595,1350
1582,4,3.0.50,0,611,2,70,50,120,0,50,120,245,0,0,341,1,2,178,363,178,413,5,1595,1350
1582,4,4.0.50,0,594,0,98,50,148,0,50,148,245,0,0,341,1,2,363,363,363,413,5,1595,1350
1582,4,5.0.50,0,613,3,71,50,121,0,50,121,245,0,0,341,1,2,214,363,214,413,5,1595,1350
1582,5,0.0.50,0,633,4,92,50,142,0,50,142,328,0,0,586,1,2,273,363,273,413,6,1595,1267
1582,5,2.0.50,1,597,1,32,50,82,0,50,82,328,0,0,586,1,2,239,363,239,413,6,1595,1267
1582,5,3.0.50,0,611,2,70,50,120,0,50,120,328,0,0,586,1,2,178,363,178,413,6,1595,1267
1582,5,4.0.50,0,594,0,98,50,148,0,50,148,328,0,0,586,1,2,363,363,363,413,6,1595,1267
1582,5,5.0.50,0,613,3,71,50,121,0,50,121,328,0,0,586,1,2,214,363,214,413,6,1595,1267
1582,6,0.0.82,0,638,3,92,82,174,0,82,174,328,0,0,586,1,3,273,331,273,413,7,1595,1235
1582,6,2.1.118,1,597,0,72,118,190,82,36,190,328,0,50,586,2,2,207,145,239,213,7,1595,1235
1582,6,3.0.82,0,607,2,70,82,152,0,82,152,328,0,0,586,1,3,178,331,178,413,7,1595,1235
1582,6,4.0.82,0,597,0,98,82,180,0,82,180,328,0,0,586,1,3,363,331,363,413,7,1595,1235
1582,6,5.0.82,0,601,1,71,82,153,0,82,153,328,0,0,586,1,3,214,331,214,413,7,1595,1235
1582,7,0.0.82,0,645,3,92,82,174,0,82,174,328,0,0,586,1,3,273,331,273,413,8,1595,1163
1582,7,2.2.190,1,597,0,82,190,272,190,0,272,328,-17,135,603,3,2,135,253,239,308,8,1595,1163
1582,7,3.0.82,0,607,2,70,82,152,0,82,152,328,0,0,586,1,3,178,331,178,413,8,1595,1163
1582,7,4.0.82,0,597,0,98,82,180,0,82,180,328,0,0,586,1,3,363,331,363,413,8,1595,1163
1582,7,5.0.82,0,601,1,71,82,153,0,82,153,328,0,0,586,1,3,214,331,214,413,8,1595,1163
1582,8,0.0.82,0,652,3,92,82,174,0,82,174,328,0,0,603,1,3,273,331,273,413,9,1595,1081
1582,8,2.3.272,1,597,0,12,272,284,272,0,284,328,-27,200,630,4,2,53,271,239,343,9,1595,1081
1582,8,3.0.82,0,607,2,70,82,152,0,82,152,328,0,0,603,1,3,178,331,178,413,9,1595,1081
1582,8,4.0.82,0,597,0,98,82,180,0,82,180,328,0,0,603,1,3,363,331,363,413,9,1595,1081
1582,8,5.0.82,0,601,1,71,82,153,0,82,153,328,0,0,603,1,3,214,331,214,413,9,1595,1081
1582,9,0.0.82,0,652,3,92,82,174,0,82,174,328,0,0,630,1,3,273,331,273,413,10,1595,1069
1582,9,2.4.328,1,597,0,41,328,369,284,44,369,369,0,245,630,5,2,41,235,239,318,10,1595,1069
1582,9,3.0.82,0,607,2,70,82,152,0,82,152,328,0,0,630,1,3,178,331,178,413,10,1595,1069
1582,9,4.0.82,0,597,0,98,82,180,0,82,180,328,0,0,630,1,3,363,331,363,413,10,1595,1069
1582,9,5.0.82,0,601,1,71,82,153,0,82,153,328,0,0,630,1,3,214,331,214,413,10,1595,1069
1582,10,0.0.82,0,652,3,92,82,174,0,82,174,369,0,0,630,1,3,273,331,273,413,11,1595,1028
1582,10,3.0.82,0,607,2,70,82,152,0,82,152,369,0,0,630,1,3,178,331,178,413,11,1595,1028
1582,10,4.0.82,1,597,0,98,82,180,0,82,180,369,0,0,630,1,3,363,331,363,413,11,1595,1028
1582,10,5.0.82,0,601,1,71,82,153,0,82,153,369,0,0,630,1,3,214,331,214,413,11,1595,1028
1582,11,0.0.180,0,629,2,92,180,272,0,180,272,369,0,0,630,1,4,273,233,273,413,12,1595,930
1582,11,3.0.180,0,607,1,70,180,250,0,180,250,369,0,0,630,1,4,178,233,178,413,12,1595,930
1582,11,4.1.190,1,597,0,44,190,234,180,10,234,369,0,50,630,2,3,265,73,363,213,12,1595,930
1582,11,5.0.180,0,597,0,71,180,251,0,180,251,369,0,0,630,1,4,214,233,214,413,12,1595,930
1582,12,0.0.180,0,629,2,92,180,272,0,180,272,369,0,0,630,1,4,273,233,273,413,13,1595,886
1582,12,3.0.180,0,607,1,70,180,250,0,180,250,369,0,0,630,1,4,178,233,178,413,13,1595,886
1582,12,4.2.272,1,629,2,65,272,337,234,38,337,369,0,135,630,3,3,221,171,363,308,13,1595,886
1582,12,5.0.180,0,597,0,71,180,251,0,180,251,369,0,0,630,1,4,214,233,214,413,13,1595,886
1582,13,0.0.180,0,629,0,92,180,272,0,180,272,369,0,0,630,1,4,273,233,273,413,14,1595,821
1582,13,3.0.180,0,629,0,70,180,250,0,180,250,369,0,0,630,1,4,178,233,178,413,14,1595,821
1582,13,4.3.337,1,629,0,98,337,435,337,0,435,435,-53,253,683,4,3,156,259,363,343,14,1595,821
1582,13,5.0.180,0,629,0,71,180,251,0,180,251,369,0,0,630,1,4,214,233,214,413,14,1595,821
1582,14,0.0.180,0,629,0,92,180,272,0,180,272,435,0,0,683,1,4,273,233,273,413,15,1595,723
1582,14,3.0.180,0,629,0,70,180,250,0,180,250,435,0,0,683,1,4,178,233,178,413,15,1595,723
1582,14,4.4.435,1,629,0,58,435,493,435,0,493,493,-66,311,749,5,3,58,194,363,318,15,1595,723
1582,14,5.0.180,0,629,0,71,180,251,0,180,251,435,0,0,683,1,4,214,233,214,413,15,1595,723
1582,15,0.0.180,1,629,0,92,180,272,0,180,272,493,0,0,749,1,4,273,233,273,413,16,1595,665
1582,15,3.0.180,0,629,0,70,180,250,0,180,250,493,0,0,749,1,4,178,233,178,413,16,1595,665
1582,15,5.0.180,0,629,0,71,180,251,0,180,251,493,0,0,749,1,4,214,233,214,413,16,1595,665
1582,16,0.1.272,1,629,0,5,272,277,272,0,277,493,-38,88,787,2,4,181,29,273,213,17,1595,573
1582,16,3.0.272,0,629,0,70,272,342,0,272,342,493,0,0,749,1,5,178,141,178,413,17,1595,573
1582,16,5.0.272,0,629,0,71,272,343,0,272,343,493,0,0,749,1,5,214,141,214,413,17,1595,573
1582,17,0.2.337,1,629,0,63,337,400,277,60,400,493,0,135,787,3,4,176,106,273,308,18,1595,568
1582,17,3.0.272,0,629,0,70,272,342,0,272,342,493,0,0,787,1,5,178,141,178,413,18,1595,568
1582,17,5.0.272,0,629,0,71,272,343,0,272,343,493,0,0,787,1,5,214,141,214,413,18,1595,568
1582,18,0.3.435,0,680,1,96,435,531,400,35,531,531,0,253,787,4,4,113,161,273,343,19,1595,505
1582,18,3.0.272,0,629,0,70,272,342,0,272,342,493,0,0,787,1,5,178,141,178,413,19,1595,505
1582,18,5.0.272,1,629,0,71,272,343,0,272,343,493,0,0,787,1,5,214,141,214,413,19,1595,505
1582,19,0.3.435,0,680,1,96,435,531,400,35,531,531,0,253,787,4,4,113,161,273,343,20,1595,434
1582,19,3.0.343,0,629,0,70,343,413,0,343,413,493,0,0,787,1,6,178,70,178,413,20,1595,434
1582,19,5.1.343,1,629,0,20,343,363,343,0,363,493,-66,154,853,2,5,143,24,214,213,20,1595,434
1582,20,0.3.435,0,680,1,96,435,531,400,35,531,531,0,253,853,4,4,113,161,273,343,21,1595,414
1582,20,3.0.343,0,629,0,70,343,413,0,343,413,493,0,0,853,1,6,178,70,178,413,21,1595,414
1582,20,5.2.400,1,629,0,19,400,419,363,37,419,493,0,135,853,3,5,123,43,214,308,21,1595,414
1582,21,0.3.435,0,680,1,96,435,531,400,35,531,531,0,253,853,4,4,113,161,273,343,22,1595,395
1582,21,3.0.343,1,629,0,70,343,413,0,343,413,493,0,0,853,1,6,178,70,178,413,22,1595,395
1582,21,5.3.435,0,629,0,35,435,470,419,16,470,493,0,253,853,4,4,104,161,214,343,22,1595,395
1582,22,0.3.435,0,680,1,96,435,531,400,35,531,531,0,253,853,4,4,113,161,273,343,23,1595,325
1582,22,3.1.413,1,629,0,4,413,417,413,0,417,493,-50,204,903,2,6,108,4,178,213,23,1595,325
1582,22,5.3.435,0,629,0,35,435,470,419,16,470,493,0,253,853,4,4,104,161,214,343,23,1595,325
1582,23,0.3.435,0,680,1,96,435,531,400,35,531,531,0,253,903,4,4,113,161,273,343,24,1595,321
1582,23,3.2.419,1,629,0,24,419,443,417,2,443,493,0,135,903,3,6,104,24,178,308,24,1595,321
1582,23,5.3.435,0,629,0,35,435,470,419,16,470,493,0,253,903,4,4,104,161,214,343,24,1595,321
1582,24,0.3.435,0,680,1,96,435,531,400,35,531,531,0,253,903,4,4,113,161,273,343,25,1595,297
1582,24,3.3.443,0,629,0,30,443,473,443,0,473,493,-8,261,911,4,4,80,161,178,343,25,1595,297
1582,24,5.3.435,1,629,0,35,435,470,419,16,470,493,0,253,903,4,4,104,161,214,343,25,1595,297
1582,25,0.3.470,0,646,1,96,470,566,400,70,566,566,0,253,903,4,5,113,126,273,343,26,1595,262
1582,25,3.3.470,1,629,0,30,470,500,443,27,500,500,0,253,903,4,5,80,126,178,343,26,1595,262
1582,25,5.4.493,0,629,0,69,493,562,470,23,562,562,0,311,903,5,4,69,136,214,318,26,1595,262
1582,26,0.3.500,1,629,0,96,500,596,400,100,596,596,0,253,903,4,6,113,96,273,343,27,1595,232
1582,26,3.4.500,0,636,1,50,500,550,500,0,550,550,-7,318,910,5,4,50,136,178,318,27,1595,232
1582,26,5.4.493,0,629,0,69,493,562,470,23,562,562,0,311,903,5,4,69,136,214,318,27,1595,232
1582,27,0.4.596,0,663,2,17,596,613,596,0,613,613,-103,414,1006,5,4,17,136,273,318,28,1595,136
1582,27,3.4.500,0,636,1,50,500,550,500,0,550,596,-7,318,910,5,4,50,136,178,318,28,1595,136
1582,27,5.4.493,1,629,0,69,493,562,470,23,562,596,0,311,903,5,4,69,136,214,318,28,1595,136
1582,28,0.4.596,1,663,1,17,596,613,596,0,613,613,-34,345,937,5,5,17,67,273,318,29,1595,67
1582,28,3.4.562,0,629,0,50,562,612,500,62,612,612,0,311,903,5,5,50,67,178,318,29,1595,67
1582,29,3.4.613,1,663,0,50,613,663,500,113,663,663,0,345,937,5,6,50,50,178,318,30,1595,50
1583,0,0.0.0,0,558,1,6,0,6,0,0,6,6,0,0,0,1,1,218,229,218,229,1,1562,1562
1583,0,1.0.0,0,552,0,25,0,25,0,0,25,25,0,0,0,1,1,228,229,228,229,1,1562,1562
1583,0,2.0.0,0,630,5,78,0,78,0,0,78,78,0,0,0,1,1,265,229,265,229,1,1562,1562
1583,0,3.0.0,1,576,4,24,0,24,0,0,24,24,0,0,0,1,1,336,229,336,229,1,1562,1562
1583,0,4.0.0,0,572,3,20,0,20,0,0,20,20,0,0,0,1,1,299,229,299,229,1,1562,1562
1583,0,5.0.0,0,571,2,76,0,76,0,0,76,76,0,0,0,1,1,216,229,216,229,1,1562,1562
1583,1,0.0.24,0,578,1,6,24,30,0,24,30,30,0,0,0,1,2,218,205,218,229,2,1562,1538
1583,1,1.0.24,0,576,0,25,24,49,0,24,49,49,0,0,0,1,2,228,205,228,229,2,1562,1538
1583,1,2.0.24,0,585,3,78,24,102,0,24,102,102,0,0,0,1,2,265,205,265,229,2,1562,1538
1583,1,3.1.24,0,578,1,42,24,66,24,0,66,66,-24,24,24,2,1,312,314,336,314,2,1562,1538
1583,1,4.0.24,1,578,1,20,24,44,0,24,44,44,0,0,0,1,2,299,205,299,229,2,1562,1538
1583,1,5.0.24,0,580,2,76,24,100,0,24,100,100,0,0,0,1,2,216,205,216,229,2,1562,1538
1583,2,0.0.44,1,578,0,6,44,50,0,44,50,50,0,0,0,1,3,218,185,218,229,3,1562,1518
1583,2,1.0.44,0,578,0,25,44,69,0,44,69,69,0,0,0,1,3,228,185,228,229,3,1562,1518
1583,2,2.0.44,0,592,2,78,44,122,0,44,122,122,0,0,0,1,3,265,185,265,229,3,1562,1518
1583,2,3.1.24,0,578,0,42,24,66,24,0,66,66,-24,24,24,2,1,312,314,336,314,3,1562,1518
1583,2,4.1.44,0,633,3,95,44,139,44,0,139,139,-44,44,44,2,1,279,314,299,314,3,1562,1518
1583,2,5.0.44,0,580,1,76,44,120,0,44,120,120,0,0,0,1,3,216,185,216,229,3,1562,1518
1583,3,0.1.50,0,621,3,73,50,123,50,0,123,123,-50,50,50,2,1,212,314,218,314,4,1562,1512
1583,3,1.0.50,1,578,0,25,50,75,0,50,75,75,0,0,0,1,4,228,179,228,229,4,1562,1512
1583,3,2.0.50,0,584,2,78,50,128,0,50,128,128,0,0,0,1,4,265,179,265,229,4,1562,1512
1583,3,3.1.24,0,578,0,42,24,66,24,0,66,66,-24,24,24,2,1,312,314,336,314,4,1562,1512
1583,3,4.1.44,0,633,4,95,44,139,44,0,139,139,-44,44,44,2,1,279,314,299,314,4,1562,1512
1583,3,5.0.50,0,580,1,76,50,126,0,50,126,126,0,0,0,1,4,216,179,216,229,4,1562,1512
1583,4,0.1.50,0,626,1,73,50,123,50,0,123,123,-50,50,50,2,1,212,314,218,314,5,1562,1487
1583,4,1.1.75,0,578,0,36,75,111,75,0,111,111,-75,75,75,2,1,203,314,228,314,5,1562,1487
1583,4,2.0.75,1,578,0,78,75,153,0,75,153,153,0,0,0,1,5,265,154,265,229,5,1562,1487
1583,4,3.1.24,0,578,0,42,24,66,24,0,66,75,-24,24,24,2,1,312,314,336,314,5,1562,1487
1583,4,4.1.44,0,645,2,95,44,139,44,0,139,139,-44,44,44,2,1,279,314,299,314,5,1562,1487
1583,4,5.0.75,0,578,0,76,75,151,0,75,151,151,0,0,0,1,5,216,154,216,229,5,1562,1487
1583,5,0.1.50,0,626,2,73,50,123,50,0,123,153,-50,50,50,2,1,212,314,218,314,6,1562,1409
1583,5,1.1.75,0,578,0,36,75,111,75,0,111,153,-75,75,75,2,1,203,314,228,314,6,1562,1409
1583,5,2.1.153,0,584,1,65,153,218,153,0,218,218,-153,153,153,2,1,187,314,265,314,6,1562,1409
1583,5,3.1.24,0,578,0,42,24,66,24,0,66,153,-24,24,24,2,1,312,314,336,314,6,1562,1409
1583,5,4.1.44,0,664,3,95,44,139,44,0,139,153,-44,44,44,2,1,279,314,299,314,6,1562,1409
1583,5,5.0.153,1,578,0,76,153,229,0,153,229,229,0,0,0,1,6,216,76,216,229,6,1562,1409
1583,6,0.1.50,0,626,2,73,50,123,50,0,123,229,-50,50,50,2,1,212,314,218,314,7,1562,1333
1583,6,1.1.75,0,578,0,36,75,111,75,0,111,229,-75,75,75,2,1,203,314,228,314,7,1562,1333
1583,6,2.1.153,0,584,1,65,153,218,153,0,218,229,-153,153,153,2,1,187,314,265,314,7,1562,1333
1583,6,3.1.24,1,578,0,42,24,66,24,0,66,229,-24,24,24,2,1,312,314,336,314,7,1562,1333
1583,6,4.1.44,0,664,3,95,44,139,44,0,139,229,-44,44,44,2,1,279,314,299,314,7,1562,1333
1583,6,5.1.229,0,578,0,3,229,232,229,0,232,232,-229,229,229,2,1,140,314,216,314,7,1562,1333
1583,7,0.1.66,0,584,1,73,66,139,50,16,139,229,0,24,24,2,2,212,272,218,314,8,1562,1291
1583,7,1.1.75,1,578,0,36,75,111,75,0,111,229,-9,33,33,2,2,203,272,228,314,8,1562,1291
1583,7,2.1.153,0,584,1,65,153,218,153,0,218,229,-87,111,111,2,2,187,272,265,314,8,1562,1291
1583,7,3.2.66,0,578,0,90,66,156,66,0,156,229,-66,66,90,3,1,270,373,336,373,8,1562,1291
1583,7,4.1.66,0,592,2,95,66,161,44,22,161,229,0,24,24,2,2,279,272,299,314,8,1562,1291
1583,7,5.1.229,0,578,0,3,229,232,229,0,232,232,-163,187,187,2,2,140,272,216,314,8,1562,1291
1583,8,0.1.111,0,578,0,73,111,184,50,61,184,229,0,33,33,2,3,212,236,218,314,9,1562,1255
1583,8,1.2.111,0,605,2,60,111,171,111,0,171,229,-111,111,144,3,1,167,373,228,373,9,1562,1255
1583,8,2.1.153,0,584,1,65,153,218,153,0,218,229,-42,75,75,2,3,187,236,265,314,9,1562,1255
1583,8,3.2.66,0,578,0,90,66,156,66,0,156,229,-66,66,99,3,1,270,373,336,373,9,1562,1255
1583,8,4.1.111,1,578,0,95,111,206,44,67,206,229,0,33,33,2,3,279,236,299,314,9,1562,1255
1583,8,5.1.229,0,578,0,3,229,232,229,0,232,232,-118,151,151,2,3,140,236,216,314,9,1562,1255
1583,9,0.1.206,1,578,0,73,206,279,50,156,279,279,0,33,33,2,4,212,141,218,314,10,1562,1160
1583,9,1.2.111,0,605,2,60,111,171,111,0,171,229,-111,111,144,3,1,167,373,228,373,10,1562,1160
1583,9,2.1.206,0,578,0,65,206,271,153,53,271,271,0,33,33,2,4,187,141,265,314,10,1562,1160
1583,9,3.2.66,0,578,0,90,66,156,66,0,156,229,-66,66,99,3,1,270,373,336,373,10,1562,1160
1583,9,4.2.206,0,602,1,65,206,271,206,0,271,271,-206,206,239,3,1,184,373,299,373,10,1562,1160
1583,9,5.1.229,0,578,0,3,229,232,229,0,232,232,-23,56,56,2,4,140,141,216,314,10,1562,1160
1583,10,0.2.279,0,608,3,66,279,345,279,0,345,345,-279,279,312,3,1,139,373,218,373,11,1562,1087
1583,10,1.2.111,0,605,2,60,111,171,111,0,171,279,-111,111,144,3,1,167,373,228,373,11,1562,1087
1583,10,2.1.279,0,578,0,65,279,344,153,126,344,344,0,33,33,2,5,187,68,265,314,11,1562,1087
1583,10,3.2.66,0,578,0,90,66,156,66,0,156,279,-66,66,99,3,1,270,373,336,373,11,1562,1087
1583,10,4.2.206,0,602,1,65,206,271,206,0,271,279,-206,206,239,3,1,184,373,299,373,11,1562,1087
1583,10,5.1.279,1,578,0,3,279,282,229,50,282,282,0,33,33,2,5,140,68,216,314,11,1562,1087
1583,11,0.2.279,0,608,3,66,279,345,279,0,345,345,-279,279,312,3,1,139,373,218,373,12,1562,1084
1583,11,1.2.111,0,605,2,60,111,171,111,0,171,282,-111,111,144,3,1,167,373,228,373,12,1562,1084
1583,11,2.1.282,1,578,0,65,282,347,153,129,347,347,0,33,33,2,6,187,65,265,314,12,1562,1084
1583,11,3.2.66,0,578,0,90,66,156,66,0,156,282,-66,66,99,3,1,270,373,336,373,12,1562,1084
1583,11,4.2.206,0,602,1,65,206,271,206,0,271,282,-206,206,239,3,1,184,373,299,373,12,1562,1084
1583,11,5.2.282,0,578,0,57,282,339,282,0,339,339,-282,282,315,3,1,137,373,216,373,12,1562,1084
1583,12,0.2.279,0,608,3,66,279,345,279,0,345,347,-279,279,312,3,1,139,373,218,373,13,1562,1019
1583,12,1.2.111,0,605,2,60,111,171,111,0,171,347,-111,111,144,3,1,167,373,228,373,13,1562,1019
1583,12,2.2.347,0,578,0,35,347,382,347,0,382,382,-347,347,380,3,1,122,373,265,373,13,1562,1019
1583,12,3.2.66,1,578,0,90,66,156,66,0,156,347,-66,66,99,3,1,270,373,336,373,13,1562,1019
1583,12,4.2.206,0,602,1,65,206,271,206,0,271,347,-206,206,239,3,1,184,373,299,373,13,1562,1019
1583,12,5.2.282,0,578,0,57,282,339,282,0,339,347,-282,282,315,3,1,137,373,216,373,13,1562,1019
1583,13,0.2.279,0,608,3,66,279,345,279,0,345,347,-123,189,222,3,2,139,283,218,373,14,1562,929
1583,13,1.2.156,0,578,0,60,156,216,111,45,216,347,0,66,99,3,2,167,283,228,373,14,1562,929
1583,13,2.2.347,0,578,0,35,347,382,347,0,382,382,-191,257,290,3,2,122,283,265,373,14,1562,929
1583,13,3.3.156,1,592,1,89,156,245,156,0,245,347,-156,156,255,4,1,180,299,336,299,14,1562,929
1583,13,4.2.206,0,602,2,65,206,271,206,0,271,347,-50,116,149,3,2,184,283,299,373,14,1562,929
1583,13,5.2.282,0,578,0,57,282,339,282,0,339,347,-126,192,225,3,2,137,283,216,373,14,1562,929
1583,14,0.2.279,0,608,2,66,279,345,279,0,345,347,-123,189,378,3,2,139,283,218,373,15,1562,840
1583,14,1.2.156,0,592,0,60,156,216,111,45,216,347,0,66,255,3,2,167,283,228,373,15,1562,840
1583,14,2.2.347,0,592,0,35,347,382,347,0,382,382,-191,257,446,3,2,122,283,265,373,15,1562,840
1583,14,3.4.245,1,592,0,91,245,336,245,0,336,347,-245,245,500,5,1,91,347,336,347,15,1562,840
1583,14,4.2.206,0,602,1,65,206,271,206,0,271,347,-50,116,305,3,2,184,283,299,373,15,1562,840
1583,14,5.2.282,0,592,0,57,282,339,282,0,339,347,-126,192,381,3,2,137,283,216,373,15,1562,840
1583,15,0.2.279,0,608,2,66,279,345,279,0,345,347,-123,189,623,3,2,139,283,218,373,16,1562,749
1583,15,1.2.156,1,592,0,60,156,216,111,45,216,347,0,66,500,3,2,167,283,228,373,16,1562,749
1583,15,2.2.347,0,592,0,35,347,382,347,0,382,382,-191,257,691,3,2,122,283,265,373,16,1562,749
1583,15,4.2.206,0,602,1,65,206,271,206,0,271,347,-50,116,550,3,2,184,283,299,373,16,1562,749
1583,15,5.2.282,0,592,0,57,282,339,282,0,339,347,-126,192,626,3,2,137,283,216,373,16,1562,749
1583,16,0.2.279,0,608,1,66,279,345,279,0,345,347,-63,129,563,3,3,139,223,218,373,17,1562,689
1583,16,1.3.245,1,592,0,15,245,260,216,29,260,347,0,156,500,4,2,107,210,228,299,17,1562,689
1583,16,2.2.347,0,592,0,35,347,382,347,0,382,382,-131,197,631,3,3,122,223,265,373,17,1562,689
1583,16,4.2.216,0,592,0,65,216,281,206,10,281,347,0,66,500,3,3,184,223,299,373,17,1562,689
1583,16,5.2.282,0,592,0,57,282,339,282,0,339,347,-66,132,566,3,3,137,223,216,373,17,1562,689
1583,17,0.2.279,0,608,1,66,279,345,279,0,345,347,-63,129,563,3,3,139,223,218,373,18,1562,674
1583,17,1.4.336,0,592,0,92,336,428,260,76,428,428,0,245,500,5,2,92,256,228,347,18,1562,674
1583,17,2.2.347,0,592,0,35,347,382,347,0,382,382,-131,197,631,3,3,122,223,265,373,18,1562,674
1583,17,4.2.216,1,592,0,65,216,281,206,10,281,347,0,66,500,3,3,184,223,299,373,18,1562,674
1583,17,5.2.282,0,592,0,57,282,339,282,0,339,347,-66,132,566,3,3,137,223,216,373,18,1562,674
1583,18,0.2.281,0,592,0,66,281,347,279,2,347,347,0,66,500,3,4,139,158,218,373,19,1562,609
1583,18,1.4.336,0,592,0,92,336,428,260,76,428,428,0,245,500,5,2,92,256,228,347,19,1562,609
1583,18,2.2.347,0,592,0,35,347,382,347,0,382,382,-66,132,566,3,4,122,158,265,373,19,1562,609
1583,18,4.3.281,1,592,0,91,281,372,281,0,372,372,-21,177,521,4,3,119,195,299,299,19,1562,609
1583,18,5.2.282,0,592,0,57,282,339,282,0,339,347,-1,67,501,3,4,137,158,216,373,19,1562,609
1583,19,0.2.281,0,592,0,66,281,347,279,2,347,372,0,66,521,3,4,139,158,218,373,20,1562,518
1583,19,1.4.336,0,592,0,92,336,428,260,76,428,428,0,245,521,5,2,92,256,228,347,20,1562,518
1583,19,2.2.347,0,592,0,35,347,382,347,0,382,382,-66,132,587,3,4,122,158,265,373,20,1562,518
1583,19,4.4.372,1,628,1,28,372,400,372,0,400,400,-36,281,557,5,2,28,256,299,347,20,1562,518
1583,19,5.2.282,0,592,0,57,282,339,282,0,339,372,-1,67,522,3,4,137,158,216,373,20,1562,518
1583,20,0.2.281,0,628,0,66,281,347,279,2,347,400,0,66,557,3,4,139,158,218,373,21,1562,490
1583,20,1.4.400,1,628,0,92,400,492,260,140,492,492,0,281,557,5,3,92,228,228,347,21,1562,490
1583,20,2.2.347,0,628,0,35,347,382,347,0,382,400,-66,132,623,3,4,122,158,265,373,21,1562,490
1583,20,5.2.282,0,628,0,57,282,339,282,0,339,400,-1,67,558,3,4,137,158,216,373,21,1562,490
1583,21,0.2.281,0,628,0,66,281,347,279,2,347,492,0,66,557,3,4,139,158,218,373,22,1562,398
1583,21,2.2.347,0,628,0,35,347,382,347,0,382,492,-66,132,623,3,4,122,158,265,373,22,1562,398
1583,21,5.2.282,1,628,0,57,282,339,282,0,339,492,-1,67,558,3,4,137,158,216,373,22,1562,398
1583,22,0.2.339,0,628,0,66,339,405,279,60,405,492,0,67,558,3,5,139,101,218,373,23,1562,341
1583,22,2.2.347,0,628,0,35,347,382,347,0,382,492,-8,75,566,3,5,122,101,265,373,23,1562,341
1583,22,5.3.372,1,628,0,20,372,392,339,33,392,492,0,177,558,4,4,80,104,216,299,23,1562,341
1583,23,0.2.339,0,628,0,66,339,405,279,60,405,492,0,67,558,3,5,139,101,218,373,24,1562,321
1583,23,2.2.347,1,628,0,35,347,382,347,0,382,492,-8,75,566,3,5,122,101,265,373,24,1562,321
1583,23,5.4.492,0,628,0,60,492,552,392,100,552,552,0,281,558,5,4,60,136,216,347,24,1562,321
1583,24,0.2.382,1,628,0,66,382,448,279,103,448,492,0,75,566,3,6,139,66,218,373,25,1562,286
1583,24,2.3.392,0,628,0,80,392,472,382,10,472,492,0,177,566,4,5,87,84,265,299,25,1562,286
1583,24,5.4.492,0,628,0,60,492,552,392,100,552,552,0,281,566,5,4,60,136,216,347,25,1562,286
1583,25,0.3.448,1,628,0,4,448,452,448,0,452,492,-56,233,622,4,5,73,84,218,299,26,1562,220
1583,25,2.3.392,0,628,0,80,392,472,382,10,472,492,0,177,566,4,5,87,84,265,299,26,1562,220
1583,25,5.4.492,0,628,0,60,492,552,392,100,552,552,0,281,566,5,4,60,136,216,347,26,1562,220
1583,26,0.4.492,0,628,0,69,492,561,452,40,561,561,0,281,622,5,4,69,136,218,347,27,1562,216
1583,26,2.3.452,1,628,0,80,452,532,382,70,532,532,0,233,622,4,6,87,80,265,299,27,1562,216
1583,26,5.4.492,0,628,0,60,492,552,392,100,552,552,0,281,622,5,4,60,136,216,347,27,1562,216
1583,27,0.4.492,0,628,0,69,492,561,452,40,561,561,0,281,622,5,4,69,136,218,347,28,1562,136
1583,27,2.4.532,0,668,1,7,532,539,532,0,539,539,-40,321,662,5,4,7,136,265,347,28,1562,136
1583,27,5.4.492,1,628,0,60,492,552,392,100,552,552,0,281,622,5,4,60,136,216,347,28,1562,136
1583,28,0.4.552,0,628,0,69,552,621,452,100,621,621,0,281,622,5,5,69,76,218,347,29,1562,76
1583,28,2.4.552,1,628,0,7,552,559,532,20,559,559,0,281,622,5,5,7,76,265,347,29,1562,76
1583,29,0.4.559,1,628,0,69,559,628,452,107,628,628,0,281,622,5,6,69,69,218,347,30,1562,69
1584,0,0.0.0,0,536,1,19,0,19,0,0,19,19,0,0,0,1,1,162,243,162,243,1,1533,1533
1584,0,1.0.0,0,517,0,1,0,1,0,0,1,1,0,0,0,1,1,130,243,130,243,1,1533,1533
1584,0,2.0.0,1,537,2,24,0,24,0,0,24,24,0,0,0,1,1,290,243,290,243,1,1533,1533
1584,0,3.0.0,0,593,4,76,0,76,0,0,76,76,0,0,0,1,1,296,243,296,243,1,1533,1533
1584,0,4.0.0,0,539,3,42,0,42,0,0,42,42,0,0,0,1,1,338,243,338,243,1,1533,1533
1584,0,5.0.0,0,598,5,81,0,81,0,0,81,81,0,0,0,1,1,317,243,317,243,1,1533,1533
1584,1,0.0.24,0,556,1,19,24,43,0,24,43,43,0,0,0,1,2,162,219,162,243,2,1533,1509
1584,1,1.0.24,0,537,0,1,24,25,0,24,25,25,0,0,0,1,2,130,219,130,243,2,1533,1509
1584,1,2.1.24,0,556,1,59,24,83,24,0,83,83,-24,24,24,2,1,266,319,290,319,2,1533,1509
1584,1,3.0.24,0,566,2,76,24,100,0,24,100,100,0,0,0,1,2,296,219,296,243,2,1533,1509
1584,1,4.0.24,1,556,1,42,24,66,0,24,66,66,0,0,0,1,2,338,219,338,243,2,1533,1509
1584,1,5.0.24,0,579,3,81,24,105,0,24,105,105,0,0,0,1,2,317,219,317,243,2,1533,1509
1584,2,0.0.66,0,556,0,19,66,85,0,66,85,85,0,0,0,1,3,162,177,162,243,3,1533,1467
1584,2,1.0.66,1,556,0,1,66,67,0,66,67,67,0,0,0,1,3,130,177,130,243,3,1533,1467
1584,2,2.1.24,0,556,0,59,24,83,24,0,83,83,-24,24,24,2,1,266,319,290,319,3,1533,1467
1584,2,3.0.66,0,556,0,76,66,142,0,66,142,142,0,0,0,1,3,296,177,296,243,3,1533,1467
1584,2,4.1.66,0,587,1,48,66,114,66,0,114,114,-66,66,66,2,1,296,319,338,319,3,1533,1467
1584,2,5.0.66,0,556,0,81,66,147,0,66,147,147,0,0,0,1,3,317,177,317,243,3,1533,1467
1584,3,0.0.67,1,556,0,19,67,86,0,67,86,86,0,0,0,1,4,162,176,162,243,4,1533,1466
1584,3,1.1.67,0,563,1,5,67,72,67,0,72,72,-67,67,67,2,1,129,319,130,319,4,1533,1466
1584,3,2.1.24,0,556,0,59,24,83,24,0,83,83,-24,24,24,2,1,266,319,290,319,4,1533,1466
1584,3,3.0.67,0,556,0,76,67,143,0,67,143,143,0,0,0,1,4,296,176,296,243,4,1533,1466
1584,3,4.1.66,0,587,2,48,66,114,66,0,114,114,-66,66,66,2,1,296,319,338,319,4,1533,1466
1584,3,5.0.67,0,556,0,81,67,148,0,67,148,148,0,0,0,1,4,317,176,317,243,4,1533,1466
1584,4,0.1.86,0,561,2,41,86,127,86,0,127,127,-86,86,86,2,1,143,319,162,319,5,1533,1447
1584,4,1.1.67,0,563,3,5,67,72,67,0,72,86,-67,67,67,2,1,129,319,130,319,5,1533,1447
1584,4,2.1.24,0,556,0,59,24,83,24,0,83,86,-24,24,24,2,1,266,319,290,319,5,1533,1447
1584,4,3.0.86,0,556,0,76,86,162,0,86,162,162,0,0,0,1,5,296,157,296,243,5,1533,1447
1584,4,4.1.66,0,587,4,48,66,114,66,0,114,114,-66,66,66,2,1,296,319,338,319,5,1533,1447
1584,4,5.0.86,1,558,1,81,86,167,0,86,167,167,0,0,0,1,5,317,157,317,243,5,1533,1447
1584,5,0.1.86,0,563,1,41,86,127,86,0,127,167,-86,86,86,2,1,143,319,162,319,6,1533,1366
1584,5,1.1.67,0,563,1,5,67,72,67,0,72,167,-67,67,67,2,1,129,319,130,319,6,1533,1366
1584,5,2.1.24,0,558,0,59,24,83,24,0,83,167,-24,24,24,2,1,266,319,290,319,6,1533,1366
1584,5,3.0.167,1,558,0,76,167,243,0,167,243,243,0,0,0,1,6,296,76,296,243,6,1533,1366
1584,5,4.1.66,0,587,2,48,66,114,66,0,114,167,-66,66,66,2,1,296,319,338,319,6,1533,1366
1584,5,5.1.167,0,558,0,86,167,253,167,0,253,253,-167,167,167,2,1,236,319,317,319,6,1533,1366
1584,6,0.1.86,0,563,1,41,86,127,86,0,127,243,-86,86,86,2,1,143,319,162,319,7,1533,1290
1584,6,1.1.67,0,563,1,5,67,72,67,0,72,243,-67,67,67,2,1,129,319,130,319,7,1533,1290
1584,6,2.1.24,1,558,0,59,24,83,24,0,83,243,-24,24,24,2,1,266,319,290,319,7,1533,1290
1584,6,3.1.243,0,568,2,80,243,323,243,0,323,323,-243,243,243,2,1,220,319,296,319,7,1533,1290
1584,6,4.1.66,0,587,3,48,66,114,66,0,114,243,-66,66,66,2,1,296,319,338,319,7,1533,1290
1584,6,5.1.167,0,558,0,86,167,253,167,0,253,253,-167,167,167,2,1,236,319,317,319,7,1533,1290
1584,7,0.1.86,0,563,1,41,86,127,86,0,127,243,-3,27,27,2,2,143,260,162,319,8,1533,1231
1584,7,1.1.83,0,558,0,5,83,88,67,16,88,243,0,24,24,2,2,129,260,130,319,8,1533,1231
1584,7,2.2.83,0,558,0,87,83,170,83,0,170,243,-83,83,107,3,1,207,441,290,441,8,1533,1231
1584,7,3.1.243,0,579,2,80,243,323,243,0,323,323,-160,184,184,2,2,220,260,296,319,8,1533,1231
1584,7,4.1.83,1,558,0,48,83,131,66,17,131,243,0,24,24,2,2,296,260,338,319,8,1533,1231
1584,7,5.1.167,0,558,0,86,167,253,167,0,253,253,-84,108,108,2,2,236,260,317,319,8,1533,1231
1584,8,0.1.131,0,558,0,41,131,172,86,45,172,243,0,24,24,2,3,143,212,162,319,9,1533,1183
1584,8,1.1.131,1,558,0,5,131,136,67,64,136,243,0,24,24,2,3,129,212,130,319,9,1533,1183
1584,8,2.2.83,0,558,0,87,83,170,83,0,170,243,-83,83,107,3,1,207,441,290,441,9,1533,1183
1584,8,3.1.243,0,579,1,80,243,323,243,0,323,323,-112,136,136,2,3,220,212,296,319,9,1533,1183
1584,8,4.2.131,0,604,2,66,131,197,131,0,197,243,-131,131,155,3,1,248,441,338,441,9,1533,1183
1584,8,5.1.167,0,558,0,86,167,253,167,0,253,253,-36,60,60,2,3,236,212,317,319,9,1533,1183
1584,9,0.1.136,1,558,0,41,136,177,86,50,177,243,0,24,24,2,4,143,207,162,319,10,1533,1178
1584,9,1.2.136,0,627,3,65,136,201,136,0,201,243,-136,136,160,3,1,124,441,130,441,10,1533,1178
1584,9,2.2.83,0,558,0,87,83,170,83,0,170,243,-83,83,107,3,1,207,441,290,441,10,1533,1178
1584,9,3.1.243,0,579,1,80,243,323,243,0,323,323,-107,131,131,2,4,220,207,296,319,10,1533,1178
1584,9,4.2.131,0,604,2,66,131,197,131,0,197,243,-131,131,155,3,1,248,441,338,441,10,1533,1178
1584,9,5.1.167,0,558,0,86,167,253,167,0,253,253,-31,55,55,2,4,236,207,317,319,10,1533,1178
1584,10,0.2.177,0,586,2,70,177,247,177,0,247,247,-177,177,201,3,1,102,441,162,441,11,1533,1137
1584,10,1.2.136,0,627,4,65,136,201,136,0,201,243,-136,136,160,3,1,124,441,130,441,11,1533,1137
1584,10,2.2.83,0,558,0,87,83,170,83,0,170,243,-83,83,107,3,1,207,441,290,441,11,1533,1137
1584,10,3.1.243,0,579,1,80,243,323,243,0,323,323,-66,90,90,2,5,220,166,296,319,11,1533,1137
1584,10,4.2.131,0,604,3,66,131,197,131,0,197,243,-131,131,155,3,1,248,441,338,441,11,1533,1137
1584,10,5.1.177,1,558,0,86,177,263,167,10,263,263,0,24,24,2,5,236,166,317,319,11,1533,1137
1584,11,0.2.177,0,586,2,70,177,247,177,0,247,263,-177,177,201,3,1,102,441,162,441,12,1533,1051
1584,11,1.2.136,0,627,4,65,136,201,136,0,201,263,-136,136,160,3,1,124,441,130,441,12,1533,1051
1584,11,2.2.83,0,558,0,87,83,170,83,0,170,263,-83,83,107,3,1,207,441,290,441,12,1533,1051
1584,11,3.1.263,1,558,0,80,263,343,243,20,343,343,0,24,24,2,6,220,80,296,319,12,1533,1051
1584,11,4.2.131,0,604,3,66,131,197,131,0,197,263,-131,131,155,3,1,248,441,338,441,12,1533,1051
1584,11,5.2.263,0,583,1,95,263,358,263,0,358,358,-263,263,287,3,1,150,441,317,441,12,1533,1051
1584,12,0.2.177,0,586,2,70,177,247,177,0,247,343,-177,177,201,3,1,102,441,162,441,13,1533,971
1584,12,1.2.136,0,627,5,65,136,201,136,0,201,343,-136,136,160,3,1,124,441,130,441,13,1533,971
1584,12,2.2.83,0,558,0,87,83,170,83,0,170,343,-83,83,107,3,1,207,441,290,441,13,1533,971
1584,12,3.2.343,0,598,3,58,343,401,343,0,401,401,-343,343,367,3,1,140,441,296,441,13,1533,971
1584,12,4.2.131,1,604,4,66,131,197,131,0,197,343,-131,131,155,3,1,248,441,338,441,13,1533,971
1584,12,5.2.263,0,583,1,95,263,358,263,0,358,358,-263,263,287,3,1,150,441,317,441,13,1533,971
1584,13,0.2.197,0,627,2,70,197,267,177,20,267,343,0,131,155,3,2,102,375,162,441,14,1533,905
1584,13,1.2.197,0,604,0,65,197,262,136,61,262,343,0,131,155,3,2,124,375,130,441,14,1533,905
1584,13,2.2.197,0,604,0,87,197,284,83,114,284,343,0,131,155,3,2,207,375,290,441,14,1533,905
1584,13,3.2.343,0,659,3,58,343,401,343,0,401,401,-146,277,301,3,2,140,375,296,441,14,1533,905
1584,13,4.3.197,1,604,0,84,197,281,197,0,281,343,-197,197,352,4,1,182,251,338,251,14,1533,905
1584,13,5.2.263,0,621,1,95,263,358,263,0,358,358,-66,197,221,3,2,150,375,317,441,14,1533,905
1584,14,0.2.197,0,627,2,70,197,267,177,20,267,343,0,131,352,3,2,102,375,162,441,15,1533,821
1584,14,1.2.197,0,604,0,65,197,262,136,61,262,343,0,131,352,3,2,124,375,130,441,15,1533,821
1584,14,2.2.197,0,604,0,87,197,284,83,114,284,343,0,131,352,3,2,207,375,290,441,15,1533,821
1584,14,3.2.343,0,659,3,58,343,401,343,0,401,401,-146,277,498,3,2,140,375,296,441,15,1533,821
1584,14,4.4.281,1,604,0,98,281,379,281,0,379,379,-281,281,633,5,1,98,279,338,279,15,1533,821
1584,14,5.2.263,0,621,1,95,263,358,263,0,358,358,-66,197,418,3,2,150,375,317,441,15,1533,821
1584,15,0.2.197,0,627,2,70,197,267,177,20,267,379,0,131,633,3,2,102,375,162,441,16,1533,723
1584,15,1.2.197,0,604,0,65,197,262,136,61,262,379,0,131,633,3,2,124,375,130,441,16,1533,723
1584,15,2.2.197,1,604,0,87,197,284,83,114,284,379,0,131,633,3,2,207,375,290,441,16,1533,723
1584,15,3.2.343,0,659,3,58,343,401,343,0,401,401,-146,277,779,3,2,140,375,296,441,16,1533,723
1584,15,5.2.263,0,621,1,95,263,358,263,0,358,379,-66,197,699,3,2,150,375,317,441,16,1533,723
1584,16,0.2.284,0,627,1,70,284,354,177,107,354,379,0,131,633,3,3,102,288,162,441,17,1533,636
1584,16,1.2.284,0,604,0,65,284,349,136,148,349,379,0,131,633,3,3,124,288,130,441,17,1533,636
1584,16,2.3.284,1,604,0,49,284,333,284,0,333,379,-3,200,636,4,2,120,167,290,251,17,1533,636
1584,16,3.2.343,0,663,2,58,343,401,343,0,401,401,-59,190,692,3,3,140,288,296,441,17,1533,636
1584,16,5.2.284,0,604,0,95,284,379,263,21,379,379,0,131,633,3,3,150,288,317,441,17,1533,636
1584,17,0.2.284,0,627,1,70,284,354,177,107,354,379,0,131,636,3,3,102,288,162,441,18,1533,587
1584,17,1.2.284,0,604,0,65,284,349,136,148,349,379,0,131,636,3,3,124,288,130,441,18,1533,587
1584,17,2.4.379,1,604,0,71,379,450,333,46,450,450,0,281,636,5,2,71,181,290,279,18,1533,587
1584,17,3.2.343,0,663,2,58,343,401,343,0,401,401,-59,190,695,3,3,140,288,296,441,18,1533,587
1584,17,5.2.284,0,604,0,95,284,379,263,21,379,379,0,131,636,3,3,150,288,317,441,18,1533,587
1584,18,0.2.284,0,627,1,70,284,354,177,107,354,450,0,131,636,3,3,102,288,162,441,19,1533,516
1584,18,1.2.284,1,604,0,65,284,349,136,148,349,450,0,131,636,3,3,124,288,130,441,19,1533,516
1584,18,3.2.343,0,663,2,58,343,401,343,0,401,450,-59,190,695,3,3,140,288,296,441,19,1533,516
1584,18,5.2.284,0,604,0,95,284,379,263,21,379,450,0,131,636,3,3,150,288,317,441,19,1533,516
1584,19,0.2.349,0,627,2,70,349,419,177,172,419,450,0,131,636,3,4,102,223,162,441,20,1533,451
1584,19,1.3.349,1,604,0,56,349,405,349,0,405,450,-16,216,652,4,3,59,118,130,251,20,1533,451
1584,19,3.2.349,0,604,0,58,349,407,343,6,407,450,0,131,636,3,4,140,223,296,441,20,1533,451
1584,19,5.2.349,0,606,1,95,349,444,263,86,444,450,0,131,636,3,4,150,223,317,441,20,1533,451
1584,20,0.2.349,0,627,2,70,349,419,177,172,419,450,0,131,652,3,4,102,223,162,441,21,1533,395
1584,20,1.4.450,1,604,0,3,450,453,405,45,453,453,0,281,652,5,3,3,110,130,279,21,1533,395
1584,20,3.2.349,0,604,0,58,349,407,343,6,407,450,0,131,652,3,4,140,223,296,441,21,1533,395
1584,20,5.2.349,0,606,1,95,349,444,263,86,444,450,0,131,652,3,4,150,223,317,441,21,1533,395
1584,21,0.2.349,1,627,2,70,349,419,177,172,419,453,0,131,652,3,4,102,223,162,441,22,1533,392
1584,21,3.2.349,0,604,0,58,349,407,343,6,407,453,0,131,652,3,4,140,223,296,441,22,1533,392
1584,21,5.2.349,0,606,1,95,349,444,263,86,444,453,0,131,652,3,4,150,223,317,441,22,1533,392
1584,22,0.3.419,1,627,0,10,419,429,419,0,429,453,-14,230,666,4,4,32,62,162,251,23,1533,322
1584,22,3.2.419,0,627,0,58,419,477,343,76,477,477,0,131,652,3,5,140,153,296,441,23,1533,322
1584,22,5.2.419,0,654,1,95,419,514,263,156,514,514,0,131,652,3,5,150,153,317,441,23,1533,322
1584,23,0.4.453,1,627,0,22,453,475,429,24,475,475,0,281,666,5,4,22,107,162,279,24,1533,312
1584,23,3.2.419,0,627,0,58,419,477,343,76,477,477,0,131,666,3,5,140,153,296,441,24,1533,312
1584,23,5.2.419,0,654,1,95,419,514,263,156,514,514,0,131,666,3,5,150,153,317,441,24,1533,312
1584,24,3.2.419,1,627,0,58,419,477,343,76,477,477,0,131,666,3,5,140,153,296,441,25,1533,290
1584,24,5.2.419,0,654,1,95,419,514,263,156,514,514,0,131,666,3,5,150,153,317,441,25,1533,290
1584,25,3.3.477,1,627,0,48,477,525,477,0,525,525,-48,278,714,4,5,82,52,296,251,26,1533,232
1584,25,5.2.477,0,627,0,95,477,572,263,214,572,572,0,131,666,3,6,150,95,317,441,26,1533,232
1584,26,3.4.525,1,627,0,34,525,559,525,0,559,559,-50,331,764,5,5,34,85,296,279,27,1533,184
1584,26,5.2.477,0,627,0,95,477,572,263,214,572,572,0,131,714,3,6,150,95,317,441,27,1533,184
1584,27,5.2.477,1,627,0,95,477,572,263,214,572,572,0,131,764,3,6,150,95,317,441,28,1533,150
1584,28,5.3.572,1,627,0,4,572,576,572,0,576,576,-47,325,811,4,6,55,4,317,251,29,1533,55
1584,29,5.4.576,1,627,0,51,576,627,576,0,627,627,-17,348,828,5,6,51,51,317,279,30,1533,51
1585,0,0.0.0,0,586,0,32,0,32,0,0,32,32,0,0,0,1,1,205,357,205,357,1,1598,1598
1585,0,1.0.0,0,599,3,76,0,76,0,0,76,76,0,0,0,1,1,327,357,327,357,1,1598,1598
1585,0,2.0.0,0,613,5,70,0,70,0,0,70,70,0,0,0,1,1,218,357,218,357,1,1598,1598
1585,0,3.0.0,0,594,1,30,0,30,0,0,30,30,0,0,0,1,1,156,357,156,357,1,1598,1598
1585,0,4.0.0,1,595,2,64,0,64,0,0,64,64,0,0,0,1,1,375,357,375,357,1,1598,1598
1585,0,5.0.0,0,606,4,85,0,85,0,0,85,85,0,0,0,1,1,317,357,317,357,1,1598,1598
1585,1,0.0.64,0,595,0,32,64,96,0,64,96,96,0,0,0,1,2,205,293,205,357,2,1598,1534
1585,1,1.0.64,0,608,2,76,64,140,0,64,140,140,0,0,0,1,2,327,293,327,357,2,1598,1534
1585,1,2.0.64,0,608,2,70,64,134,0,64,134,134,0,0,0,1,2,218,293,218,357,2,1598,1534
1585,1,3.0.64,0,596,1,30,64,94,0,64,94,94,0,0,0,1,2,156,293,156,357,2,1598,1534
1585,1,4.1.64,1,596,1,99,64,163,64,0,163,163,-64,64,64,2,1,311,320,375,320,2,1598,1534
1585,1,5.0.64,0,596,1,85,64,149,0,64,149,149,0,0,0,1,2,317,293,317,357,2,1598,1534
1585,2,0.0.64,0,599,1,32,64,96,0,64,96,163,0,0,64,1,2,205,293,205,357,3,1598,1435
1585,2,1.0.64,0,608,2,76,64,140,0,64,140,163,0,0,64,1,2,327,293,327,357,3,1598,1435
1585,2,2.0.64,0,608,2,70,64,134,0,64,134,163,0,0,64,1,2,218,293,218,357,3,1598,1435
1585,2,3.0.64,0,596,0,30,64,94,0,64,94,163,0,0,64,1,2,156,293,156,357,3,1598,1435
1585,2,4.2.163,1,596,0,67,163,230,163,0,230,230,-163,163,227,3,1,212,309,375,309,3,1598,1435
1585,2,5.0.64,0,596,0,85,64,149,0,64,149,163,0,0,64,1,2,317,293,317,357,3,1598,1435
1585,3,0.0.64,0,599,1,32,64,96,0,64,96,230,0,0,227,1,2,205,293,205,357,4,1598,1368
1585,3,1.0.64,0,608,2,76,64,140,0,64,140,230,0,0,227,1,2,327,293,327,357,4,1598,1368
1585,3,2.0.64,0,608,2,70,64,134,0,64,134,230,0,0,227,1,2,218,293,218,357,4,1598,1368
1585,3,3.0.64,0,596,0,30,64,94,0,64,94,230,0,0,227,1,2,156,293,156,357,4,1598,1368
1585,3,4.3.230,1,615,3,77,230,307,230,0,307,307,-230,230,457,4,1,145,304,375,304,4,1598,1368
1585,3,5.0.64,0,596,0,85,64,149,0,64,149,230,0,0,227,1,2,317,293,317,357,4,1598,1368
1585,4,0.0.64,0,615,0,32,64,96,0,64,96,307,0,0,457,1,2,205,293,205,357,5,1598,1291
1585,4,1.0.64,0,615,0,76,64,140,0,64,140,307,0,0,457,1,2,327,293,327,357,5,1598,1291
1585,4,2.0.64,0,615,0,70,64,134,0,64,134,307,0,0,457,1,2,218,293,218,357,5,1598,1291
1585,4,3.0.64,0,615,0,30,64,94,0,64,94,307,0,0,457,1,2,156,293,156,357,5,1598,1291
1585,4,4.4.307,1,615,0,68,307,375,307,0,375,375,-307,307,764,5,1,68,308,375,308,5,1598,1291
1585,4,5.0.64,0,615,0,85,64,149,0,64,149,307,0,0,457,1,2,317,293,317,357,5,1598,1291
1585,5,0.0.64,0,615,0,32,64,96,0,64,96,375,0,0,764,1,2,205,293,205,357,6,1598,1223
1585,5,1.0.64,1,615,0,76,64,140,0,64,140,375,0,0,764,1,2,327,293,327,357,6,1598,1223
1585,5,2.0.64,0,615,0,70,64,134,0,64,134,375,0,0,764,1,2,218,293,218,357,6,1598,1223
1585,5,3.0.64,0,615,0,30,64,94,0,64,94,375,0,0,764,1,2,156,293,156,357,6,1598,1223
1585,5,5.0.64,0,615,0,85,64,149,0,64,149,375,0,0,764,1,2,317,293,317,357,6,1598,1223
1585,6,0.0.140,1,615,0,32,140,172,0,140,172,375,0,0,764,1,3,205,217,205,357,7,1598,1147
1585,6,1.1.163,0,615,0,72,163,235,140,23,235,375,0,64,764,2,2,251,221,327,320,7,1598,1147
1585,6,2.0.140,0,615,0,70,140,210,0,140,210,375,0,0,764,1,3,218,217,218,357,7,1598,1147
1585,6,3.0.140,0,615,0,30,140,170,0,140,170,375,0,0,764,1,3,156,217,156,357,7,1598,1147
1585,6,5.0.140,0,618,1,85,140,225,0,140,225,375,0,0,764,1,3,317,217,317,357,7,1598,1147
1585,7,0.1.172,0,615,0,9,172,181,172,0,181,375,-9,73,773,2,2,173,221,205,320,8,1598,1115
1585,7,1.1.163,0,615,0,72,163,235,140,23,235,375,0,64,764,2,2,251,221,327,320,8,1598,1115
1585,7,2.0.172,0,615,0,70,172,242,0,172,242,375,0,0,764,1,4,218,185,218,357,8,1598,1115
1585,7,3.0.172,0,615,0,30,172,202,0,172,202,375,0,0,764,1,4,156,185,156,357,8,1598,1115
1585,7,5.0.172,1,615,0,85,172,257,0,172,257,375,0,0,764,1,4,317,185,317,357,8,1598,1115
1585,8,0.1.172,0,615,0,9,172,181,172,0,181,375,-9,73,773,2,2,173,221,205,320,9,1598,1030
1585,8,1.1.163,0,615,0,72,163,235,140,23,235,375,0,64,764,2,2,251,221,327,320,9,1598,1030
1585,8,2.0.257,0,615,0,70,257,327,0,257,327,375,0,0,764,1,5,218,100,218,357,9,1598,1030
1585,8,3.0.257,1,615,0,30,257,287,0,257,287,375,0,0,764,1,5,156,100,156,357,9,1598,1030
1585,8,5.1.257,0,615,0,69,257,326,257,0,326,375,-94,158,858,2,2,232,221,317,320,9,1598,1030
1585,9,0.1.172,0,615,0,9,172,181,172,0,181,375,-9,73,773,2,2,173,221,205,320,10,1598,1000
1585,9,1.1.163,0,615,0,72,163,235,140,23,235,375,0,64,764,2,2,251,221,327,320,10,1598,1000
1585,9,2.0.287,1,615,0,70,287,357,0,287,357,375,0,0,764,1,6,218,70,218,357,10,1598,1000
1585,9,3.1.287,0,619,1,19,287,306,287,0,306,375,-124,188,888,2,2,126,221,156,320,10,1598,1000
1585,9,5.1.257,0,615,0,69,257,326,257,0,326,375,-94,158,858,2,2,232,221,317,320,10,1598,1000
1585,10,0.1.172,1,615,0,9,172,181,172,0,181,375,-9,73,773,2,2,173,221,205,320,11,1598,930
1585,10,1.1.163,0,615,0,72,163,235,140,23,235,375,0,64,764,2,2,251,221,327,320,11,1598,930
1585,10,2.1.357,0,615,0,52,357,409,357,0,409,409,-194,258,958,2,2,148,221,218,320,11,1598,930
1585,10,3.1.287,0,619,1,19,287,306,287,0,306,375,-124,188,888,2,2,126,221,156,320,11,1598,930
1585,10,5.1.257,0,615,0,69,257,326,257,0,326,375,-94,158,858,2,2,232,221,317,320,11,1598,930
1585,11,0.2.230,0,615,0,73,230,303,181,49,303,375,0,163,773,3,2,164,242,205,309,12,1598,921
1585,11,1.1.181,1,615,0,72,181,253,140,41,253,375,0,73,773,2,3,251,212,327,320,12,1598,921
1585,11,2.1.357,0,615,0,52,357,409,357,0,409,409,-176,249,949,2,3,148,212,218,320,12,1598,921
1585,11,3.1.287,0,631,1,19,287,306,287,0,306,375,-106,179,879,2,3,126,212,156,320,12,1598,921
1585,11,5.1.257,0,615,0,69,257,326,257,0,326,375,-76,149,849,2,3,232,212,317,320,12,1598,921
1585,12,0.2.230,0,615,0,73,230,303,181,49,303,375,0,163,773,3,2,164,242,205,309,13,1598,849
1585,12,1.2.253,0,631,1,70,253,323,253,0,323,375,-23,186,796,3,2,179,242,327,309,13,1598,849
1585,12,2.1.357,0,615,0,52,357,409,357,0,409,409,-104,177,877,2,4,148,140,218,320,13,1598,849
1585,12,3.1.287,0,631,1,19,287,306,287,0,306,375,-34,107,807,2,4,126,140,156,320,13,1598,849
1585,12,5.1.257,1,615,0,69,257,326,257,0,326,375,-4,77,777,2,4,232,140,317,320,13,1598,849
1585,13,0.2.230,0,615,0,73,230,303,181,49,303,375,0,163,777,3,2,164,242,205,309,14,1598,780
1585,13,1.2.253,0,644,1,70,253,323,253,0,323,375,-23,186,800,3,2,179,242,327,309,14,1598,780
1585,13,2.1.357,0,615,0,52,357,409,357,0,409,409,-31,108,808,2,5,148,71,218,320,14,1598,780
1585,13,3.1.326,1,615,0,19,326,345,287,39,345,375,0,77,777,2,5,126,71,156,320,14,1598,780
1585,13,5.2.326,0,615,0,33,326,359,326,0,359,375,-96,259,873,3,2,163,242,317,309,14,1598,780
1585,14,0.2.230,0,615,0,73,230,303,181,49,303,375,0,163,777,3,2,164,242,205,309,15,1598,761
1585,14,1.2.253,0,644,2,70,253,323,253,0,323,375,-23,186,800,3,2,179,242,327,309,15,1598,761
1585,14,2.1.357,1,615,0,52,357,409,357,0,409,409,-12,89,789,2,6,148,52,218,320,15,1598,761
1585,14,3.2.345,0,629,1,25,345,370,345,0,370,375,-115,278,892,3,2,107,242,156,309,15,1598,761
1585,14,5.2.326,0,615,0,33,326,359,326,0,359,375,-96,259,873,3,2,163,242,317,309,15,1598,761
1585,15,0.2.230,1,615,0,73,230,303,181,49,303,409,0,163,789,3,2,164,242,205,309,16,1598,709
1585,15,1.2.253,0,644,2,70,253,323,253,0,323,409,-23,186,812,3,2,179,242,327,309,16,1598,709
1585,15,2.2.409,0,629,1,41,409,450,409,0,450,450,-179,342,968,3,2,96,242,218,309,16,1598,709
1585,15,3.2.345,0,629,1,25,345,370,345,0,370,409,-115,278,904,3,2,107,242,156,309,16,1598,709
1585,15,5.2.326,0,615,0,33,326,359,326,0,359,409,-96,259,885,3,2,163,242,317,309,16,1598,709
1585,16,0.3.307,1,615,0,17,307,324,303,4,324,409,0,230,789,4,2,91,227,205,304,17,1598,636
1585,16,1.2.303,0,636,2,70,303,373,253,50,373,409,0,163,789,3,3,179,169,327,309,17,1598,636
1585,16,2.2.409,0,629,1,41,409,450,409,0,450,450,-106,269,895,3,3,96,169,218,309,17,1598,636
1585,16,3.2.345,0,629,1,25,345,370,345,0,370,409,-42,205,831,3,3,107,169,156,309,17,1598,636
1585,16,5.2.326,0,615,0,33,326,359,326,0,359,409,-23,186,812,3,3,163,169,317,309,17,1598,636
1585,17,0.4.375,0,615,0,74,375,449,324,51,449,449,0,307,789,5,2,74,240,205,308,18,1598,619
1585,17,1.2.303,1,636,2,70,303,373,253,50,373,409,0,163,789,3,3,179,169,327,309,18,1598,619
1585,17,2.2.409,0,629,1,41,409,450,409,0,450,450,-106,269,895,3,3,96,169,218,309,18,1598,619
1585,17,3.2.345,0,629,1,25,345,370,345,0,370,409,-42,205,831,3,3,107,169,156,309,18,1598,619
1585,17,5.2.326,0,615,0,33,326,359,326,0,359,409,-23,186,812,3,3,163,169,317,309,18,1598,619
1585,18,0.4.375,0,636,0,74,375,449,324,51,449,449,0,307,789,5,2,74,240,205,308,19,1598,549
1585,18,1.3.373,0,636,0,97,373,470,373,0,470,470,-49,279,838,4,3,109,210,327,304,19,1598,549
1585,18,2.2.409,0,636,0,41,409,450,409,0,450,450,-36,199,825,3,4,96,99,218,309,19,1598,549
1585,18,3.2.373,0,636,0,25,373,398,345,28,398,409,0,163,789,3,4,107,99,156,309,19,1598,549
1585,18,5.2.373,1,636,0,33,373,406,326,47,406,409,0,163,789,3,4,163,99,317,309,19,1598,549
1585,19,0.4.375,0,636,0,74,375,449,324,51,449,449,0,307,789,5,2,74,240,205,308,20,1598,516
1585,19,1.3.373,0,636,0,97,373,470,373,0,470,470,-49,279,838,4,3,109,210,327,304,20,1598,516
1585,19,2.2.409,0,636,0,41,409,450,409,0,450,450,-3,166,792,3,5,96,66,218,309,20,1598,516
1585,19,3.2.406,1,636,0,25,406,431,345,61,431,431,0,163,789,3,5,107,66,156,309,20,1598,516
1585,19,5.3.406,0,660,1,88,406,494,406,0,494,494,-82,312,871,4,3,130,210,317,304,20,1598,516
1585,20,0.4.375,0,636,0,74,375,449,324,51,449,449,0,307,789,5,2,74,240,205,308,21,1598,491
1585,20,1.3.373,0,636,0,97,373,470,373,0,470,470,-49,279,838,4,3,109,210,327,304,21,1598,491
1585,20,2.2.431,1,636,0,41,431,472,409,22,472,472,0,163,789,3,6,96,41,218,309,21,1598,491
1585,20,3.3.431,0,653,1,7,431,438,431,0,438,438,-107,337,896,4,3,82,210,156,304,21,1598,491
1585,20,5.3.406,0,660,2,88,406,494,406,0,494,494,-82,312,871,4,3,130,210,317,304,21,1598,491
1585,21,0.4.375,1,636,0,74,375,449,324,51,449,472,0,307,789,5,2,74,240,205,308,22,1598,450
1585,21,1.3.373,0,636,0,97,373,470,373,0,470,472,-49,279,838,4,3,109,210,327,304,22,1598,450
1585,21,2.3.472,0,644,1,18,472,490,472,0,490,490,-148,378,937,4,3,55,210,218,304,22,1598,450
1585,21,3.3.431,0,653,2,7,431,438,431,0,438,472,-107,337,896,4,3,82,210,156,304,22,1598,450
1585,21,5.3.406,0,660,3,88,406,494,406,0,494,494,-82,312,871,4,3,130,210,317,304,22,1598,450
1585,22,1.3.373,1,636,0,97,373,470,373,0,470,472,-49,279,838,4,3,109,210,327,304,23,1598,376
1585,22,2.3.472,0,644,1,18,472,490,472,0,490,490,-148,378,937,4,3,55,210,218,304,23,1598,376
1585,22,3.3.431,0,653,2,7,431,438,431,0,438,472,-107,337,896,4,3,82,210,156,304,23,1598,376
1585,22,5.3.406,0,660,3,88,406,494,406,0,494,494,-82,312,871,4,3,130,210,317,304,23,1598,376
1585,23,1.4.470,1,636,0,12,470,482,470,0,482,482,-21,328,859,5,3,12,166,327,308,24,1598,279
1585,23,2.3.472,0,644,1,18,472,490,472,0,490,490,-2,281,840,4,4,55,113,218,304,24,1598,279
1585,23,3.3.470,0,636,0,7,470,477,431,39,477,477,0,279,838,4,4,82,113,156,304,24,1598,279
1585,23,5.3.470,0,712,2,88,470,558,406,64,558,558,0,279,838,4,4,130,113,317,304,24,1598,279
1585,24,2.3.472,0,644,1,18,472,490,472,0,490,490,-2,281,861,4,4,55,113,218,304,25,1598,267
1585,24,3.3.470,1,636,0,7,470,477,431,39,477,482,0,279,859,4,4,82,113,156,304,25,1598,267
1585,24,5.3.470,0,712,2,88,470,558,406,64,558,558,0,279,859,4,4,130,113,317,304,25,1598,267
1585,25,2.3.477,1,636,0,18,477,495,472,5,495,495,0,279,859,4,5,55,106,218,304,26,1598,260
1585,25,3.4.482,0,636,0,75,482,557,477,5,557,557,0,328,859,5,4,75,154,156,308,26,1598,260
1585,25,5.3.477,0,644,1,88,477,565,406,71,565,565,0,279,859,4,5,130,106,317,304,26,1598,260
1585,26,2.4.495,0,649,1,37,495,532,495,0,532,532,-13,341,872,5,4,37,154,218,308,27,1598,242
1585,26,3.4.482,0,636,0,75,482,557,477,5,557,557,0,328,859,5,4,75,154,156,308,27,1598,242
1585,26,5.3.495,1,636,0,88,495,583,406,89,583,583,0,279,859,4,6,130,88,317,304,27,1598,242
1585,27,2.4.495,1,649,1,37,495,532,495,0,532,583,-13,341,872,5,4,37,154,218,308,28,1598,154
1585,27,3.4.482,0,636,0,75,482,557,477,5,557,583,0,328,859,5,4,75,154,156,308,28,1598,154
1585,27,5.4.583,0,662,2,42,583,625,583,0,625,625,-101,429,960,5,4,42,154,317,308,28,1598,154
1585,28,3.4.532,0,649,0,75,532,607,477,55,607,607,0,341,872,5,5,75,117,156,308,29,1598,117
1585,28,5.4.583,1,700,1,42,583,625,583,0,625,625,-51,392,923,5,5,42,117,317,308,29,1598,117
1585,29,3.4.625,1,700,0,75,625,700,477,148,700,700,0,392,923,5,6,75,75,156,308,30,1598,75
1586,0,0.0.0,0,640,2,45,0,45,0,0,45,45,0,0,0,1,1,248,371,248,371,1,1668,1668
1586,0,1.0.0,0,618,1,52,0,52,0,0,52,52,0,0,0,1,1,229,371,229,371,1,1668,1668
1586,0,2.0.0,1,595,0,16,0,16,0,0,16,16,0,0,0,1,1,244,371,244,371,1,1668,1668
1586,0,3.0.0,0,666,4,83,0,83,0,0,83,83,0,0,0,1,1,314,371,314,371,1,1668,1668
1586,0,4.0.0,0,663,3,85,0,85,0,0,85,85,0,0,0,1,1,314,371,314,371,1,1668,1668
1586,0,5.0.0,0,668,5,90,0,90,0,0,90,90,0,0,0,1,1,319,371,319,371,1,1668,1668
1586,1,0.0.16,0,598,2,45,16,61,0,16,61,61,0,0,0,1,2,248,355,248,371,2,1668,1652
1586,1,1.0.16,0,595,0,52,16,68,0,16,68,68,0,0,0,1,2,229,355,229,371,2,1668,1652
1586,1,2.1.16,1,595,0,46,16,62,16,0,62,62,-16,16,16,2,1,228,323,244,323,2,1668,1652
1586,1,3.0.16,0,596,1,83,16,99,0,16,99,99,0,0,0,1,2,314,355,314,371,2,1668,1652
1586,1,4.0.16,0,595,0,85,16,101,0,16,101,101,0,0,0,1,2,314,355,314,371,2,1668,1652
1586,1,5.0.16,0,601,3,90,16,106,0,16,106,106,0,0,0,1,2,319,355,319,371,2,1668,1652
1586,2,0.0.16,1,598,2,45,16,61,0,16,61,62,0,0,16,1,2,248,355,248,371,3,1668,1606
1586,2,1.0.16,0,595,0,52,16,68,0,16,68,68,0,0,16,1,2,229,355,229,371,3,1668,1606
1586,2,2.2.62,0,595,0,93,62,155,62,0,155,155,-62,62,78,3,1,182,475,244,475,3,1668,1606
1586,2,3.0.16,0,596,1,83,16,99,0,16,99,99,0,0,16,1,2,314,355,314,371,3,1668,1606
1586,2,4.0.16,0,595,0,85,16,101,0,16,101,101,0,0,16,1,2,314,355,314,371,3,1668,1606
1586,2,5.0.16,0,601,3,90,16,106,0,16,106,106,0,0,16,1,2,319,355,319,371,3,1668,1606
1586,3,0.1.62,1,598,0,76,62,138,61,1,138,138,0,16,16,2,2,203,277,248,323,4,1668,1561
1586,3,1.0.61,0,620,1,52,61,113,0,61,113,113,0,0,16,1,3,229,310,229,371,4,1668,1561
1586,3,2.2.62,0,598,0,93,62,155,62,0,155,155,-62,62,78,3,1,182,475,244,475,4,1668,1561
1586,3,3.0.61,0,598,0,83,61,144,0,61,144,144,0,0,16,1,3,314,310,314,371,4,1668,1561
1586,3,4.0.61,0,598,0,85,61,146,0,61,146,146,0,0,16,1,3,314,310,314,371,4,1668,1561
1586,3,5.0.61,0,598,0,90,61,151,0,61,151,151,0,0,16,1,3,319,310,319,371,4,1668,1561
1586,4,0.2.138,0,674,2,76,138,214,138,0,214,214,-138,138,154,3,1,127,475,248,475,5,1668,1485
1586,4,1.0.61,0,620,1,52,61,113,0,61,113,138,0,0,16,1,3,229,310,229,371,5,1668,1485
1586,4,2.2.62,0,598,0,93,62,155,62,0,155,155,-62,62,78,3,1,182,475,244,475,5,1668,1485
1586,4,3.0.61,1,598,0,83,61,144,0,61,144,144,0,0,16,1,3,314,310,314,371,5,1668,1485
1586,4,4.0.61,0,598,0,85,61,146,0,61,146,146,0,0,16,1,3,314,310,314,371,5,1668,1485
1586,4,5.0.61,0,598,0,90,61,151,0,61,151,151,0,0,16,1,3,319,310,319,371,5,1668,1485
1586,5,0.2.138,0,674,2,76,138,214,138,0,214,214,-138,138,154,3,1,127,475,248,475,6,1668,1402
1586,5,1.0.144,0,628,1,52,144,196,0,144,196,196,0,0,16,1,4,229,227,229,371,6,1668,1402
1586,5,2.2.62,0,598,0,93,62,155,62,0,155,155,-62,62,78,3,1,182,475,244,475,6,1668,1402
1586,5,3.1.144,1,598,0,57,144,201,144,0,201,201,-6,22,22,2,3,231,201,314,323,6,1668,1402
1586,5,4.0.144,0,598,0,85,144,229,0,144,229,229,0,0,16,1,4,314,227,314,371,6,1668,1402
1586,5,5.0.144,0,598,0,90,144,234,0,144,234,234,0,0,16,1,4,319,227,319,371,6,1668,1402
1586,6,0.2.138,0,674,3,76,138,214,138,0,214,214,-138,138,160,3,1,127,475,248,475,7,1668,1345
1586,6,1.0.144,1,628,1,52,144,196,0,144,196,201,0,0,22,1,4,229,227,229,371,7,1668,1345
1586,6,2.2.62,0,598,0,93,62,155,62,0,155,201,-62,62,84,3,1,182,475,244,475,7,1668,1345
1586,6,3.2.201,0,641,2,91,201,292,201,0,292,292,-201,201,223,3,1,174,475,314,475,7,1668,1345
1586,6,4.0.144,0,598,0,85,144,229,0,144,229,229,0,0,22,1,4,314,227,314,371,7,1668,1345
1586,6,5.0.144,0,598,0,90,144,234,0,144,234,234,0,0,22,1,4,319,227,319,371,7,1668,1345
1586,7,0.2.138,0,674,3,76,138,214,138,0,214,214,-138,138,160,3,1,127,475,248,475,8,1668,1293
1586,7,1.1.201,1,628,0,40,201,241,196,5,241,241,0,22,22,2,4,177,144,229,323,8,1668,1293
1586,7,2.2.62,0,628,0,93,62,155,62,0,155,201,-62,62,84,3,1,182,475,244,475,8,1668,1293
1586,7,3.2.201,0,641,2,91,201,292,201,0,292,292,-201,201,223,3,1,174,475,314,475,8,1668,1293
1586,7,4.0.196,0,631,1,85,196,281,0,196,281,281,0,0,22,1,5,314,175,314,371,8,1668,1293
1586,7,5.0.196,0,628,0,90,196,286,0,196,286,286,0,0,22,1,5,319,175,319,371,8,1668,1293
1586,8,0.2.138,0,674,4,76,138,214,138,0,214,241,-138,138,160,3,1,127,475,248,475,9,1668,1253
1586,8,1.2.241,0,653,3,76,241,317,241,0,317,317,-241,241,263,3,1,137,475,229,475,9,1668,1253
1586,8,2.2.62,0,628,0,93,62,155,62,0,155,241,-62,62,84,3,1,182,475,244,475,9,1668,1253
1586,8,3.2.201,0,641,2,91,201,292,201,0,292,292,-201,201,223,3,1,174,475,314,475,9,1668,1253
1586,8,4.0.196,1,631,1,85,196,281,0,196,281,281,0,0,22,1,5,314,175,314,371,9,1668,1253
1586,8,5.0.196,0,628,0,90,196,286,0,196,286,286,0,0,22,1,5,319,175,319,371,9,1668,1253
1586,9,0.2.138,0,674,3,76,138,214,138,0,214,281,-138,138,160,3,1,127,475,248,475,10,1668,1168
1586,9,1.2.241,0,653,2,76,241,317,241,0,317,317,-241,241,263,3,1,137,475,229,475,10,1668,1168
1586,9,2.2.62,0,631,0,93,62,155,62,0,155,281,-62,62,84,3,1,182,475,244,475,10,1668,1168
1586,9,3.2.201,0,641,1,91,201,292,201,0,292,292,-201,201,223,3,1,174,475,314,475,10,1668,1168
1586,9,4.1.281,0,631,0,52,281,333,281,0,333,333,-40,62,62,2,5,229,104,314,323,10,1668,1168
1586,9,5.0.281,1,631,0,90,281,371,0,281,371,371,0,0,22,1,6,319,90,319,371,10,1668,1168
1586,10,0.2.138,0,674,3,76,138,214,138,0,214,371,-138,138,160,3,1,127,475,248,475,11,1668,1078
1586,10,1.2.241,0,653,2,76,241,317,241,0,317,371,-241,241,263,3,1,137,475,229,475,11,1668,1078
1586,10,2.2.62,0,631,0,93,62,155,62,0,155,371,-62,62,84,3,1,182,475,244,475,11,1668,1078
1586,10,3.2.201,0,641,1,91,201,292,201,0,292,371,-201,201,223,3,1,174,475,314,475,11,1668,1078
1586,10,4.1.281,1,631,0,52,281,333,281,0,333,371,-40,62,62,2,5,229,104,314,323,11,1668,1078
1586,10,5.1.371,0,631,0,52,371,423,371,0,423,423,-130,152,152,2,5,229,104,319,323,11,1668,1078
1586,11,0.2.138,0,674,3,76,138,214,138,0,214,371,-138,138,200,3,1,127,475,248,475,12,1668,1026
1586,11,1.2.241,0,653,2,76,241,317,241,0,317,371,-241,241,303,3,1,137,475,229,475,12,1668,1026
1586,11,2.2.62,0,631,0,93,62,155,62,0,155,371,-62,62,124,3,1,182,475,244,475,12,1668,1026
1586,11,3.2.201,0,641,1,91,201,292,201,0,292,371,-201,201,263,3,1,174,475,314,475,12,1668,1026
1586,11,4.2.333,0,631,0,68,333,401,333,0,401,401,-333,333,395,3,1,177,475,314,475,12,1668,1026
1586,11,5.1.371,1,631,0,52,371,423,371,0,423,423,-38,100,100,2,6,229,52,319,323,12,1668,1026
1586,12,0.2.138,0,674,3,76,138,214,138,0,214,423,-138,138,238,3,1,127,475,248,475,13,1668,974
1586,12,1.2.241,0,653,2,76,241,317,241,0,317,423,-241,241,341,3,1,137,475,229,475,13,1668,974
1586,12,2.2.62,1,631,0,93,62,155,62,0,155,423,-62,62,162,3,1,182,475,244,475,13,1668,974
1586,12,3.2.201,0,641,1,91,201,292,201,0,292,423,-201,201,301,3,1,174,475,314,475,13,1668,974
1586,12,4.2.333,0,631,0,68,333,401,333,0,401,423,-333,333,433,3,1,177,475,314,475,13,1668,974
1586,12,5.2.423,0,631,0,71,423,494,423,0,494,494,-423,423,523,3,1,177,475,319,475,13,1668,974
1586,13,0.2.155,0,631,0,76,155,231,138,17,231,423,0,62,162,3,2,127,382,248,475,14,1668,881
1586,13,1.2.241,0,653,2,76,241,317,241,0,317,423,-86,148,248,3,2,137,382,229,475,14,1668,881
1586,13,2.3.155,1,631,0,86,155,241,155,0,241,423,-155,155,317,4,1,89,358,244,358,14,1668,881
1586,13,3.2.201,0,641,1,91,201,292,201,0,292,423,-46,108,208,3,2,174,382,314,475,14,1668,881
1586,13,4.2.333,0,631,0,68,333,401,333,0,401,423,-178,240,340,3,2,177,382,314,475,14,1668,881
1586,13,5.2.423,0,631,0,71,423,494,423,0,494,494,-268,330,430,3,2,177,382,319,475,14,1668,881
1586,14,0.2.155,0,631,0,76,155,231,138,17,231,423,0,62,317,3,2,127,382,248,475,15,1668,795
1586,14,1.2.241,0,653,2,76,241,317,241,0,317,423,-86,148,403,3,2,137,382,229,475,15,1668,795
1586,14,2.4.241,1,631,0,3,241,244,241,0,244,423,-241,241,558,5,1,3,141,244,141,15,1668,795
1586,14,3.2.201,0,641,1,91,201,292,201,0,292,423,-46,108,363,3,2,174,382,314,475,15,1668,795
1586,14,4.2.333,0,631,0,68,333,401,333,0,401,423,-178,240,495,3,2,177,382,314,475,15,1668,795
1586,14,5.2.423,0,631,0,71,423,494,423,0,494,494,-268,330,585,3,2,177,382,319,475,15,1668,795
1586,15,0.2.155,1,631,0,76,155,231,138,17,231,423,0,62,558,3,2,127,382,248,475,16,1668,792
1586,15,1.2.241,0,653,2,76,241,317,241,0,317,423,-86,148,644,3,2,137,382,229,475,16,1668,792
1586,15,3.2.201,0,641,1,91,201,292,201,0,292,423,-46,108,604,3,2,174,382,314,475,16,1668,792
1586,15,4.2.333,0,631,0,68,333,401,333,0,401,423,-178,240,736,3,2,177,382,314,475,16,1668,792
1586,15,5.2.423,0,631,0,71,423,494,423,0,494,494,-268,330,826,3,2,177,382,319,475,16,1668,792
1586,16,0.3.241,1,631,0,23,241,264,231,10,264,423,0,155,558,4,2,51,272,248,358,17,1668,716
1586,16,1.2.241,0,653,1,76,241,317,241,0,317,423,-10,72,568,3,3,137,306,229,475,17,1668,716
1586,16,3.2.231,0,631,0,91,231,322,201,30,322,423,0,62,558,3,3,174,306,314,475,17,1668,716
1586,16,4.2.333,0,631,0,68,333,401,333,0,401,423,-102,164,660,3,3,177,306,314,475,17,1668,716
1586,16,5.2.423,0,631,0,71,423,494,423,0,494,494,-192,254,750,3,3,177,306,319,475,17,1668,716
1586,17,0.4.264,1,631,0,28,264,292,264,0,292,423,-20,261,578,5,2,28,138,248,141,18,1668,693
1586,17,1.2.241,0,653,1,76,241,317,241,0,317,423,-10,72,568,3,3,137,306,229,475,18,1668,693
1586,17,3.2.231,0,631,0,91,231,322,201,30,322,423,0,62,558,3,3,174,306,314,475,18,1668,693
1586,17,4.2.333,0,631,0,68,333,401,333,0,401,423,-102,164,660,3,3,177,306,314,475,18,1668,693
1586,17,5.2.423,0,631,0,71,423,494,423,0,494,494,-192,254,750,3,3,177,306,319,475,18,1668,693
1586,18,1.2.241,0,653,1,76,241,317,241,0,317,423,-10,72,588,3,3,137,306,229,475,19,1668,665
1586,18,3.2.231,1,631,0,91,231,322,201,30,322,423,0,62,578,3,3,174,306,314,475,19,1668,665
1586,18,4.2.333,0,631,0,68,333,401,333,0,401,423,-102,164,680,3,3,177,306,314,475,19,1668,665
1586,18,5.2.423,0,631,0,71,423,494,423,0,494,494,-192,254,770,3,3,177,306,319,475,19,1668,665
1586,19,1.2.322,0,643,1,76,322,398,241,81,398,423,0,62,578,3,4,137,215,229,475,20,1668,574
1586,19,3.3.322,1,631,0,66,322,388,322,0,388,423,-58,213,636,4,3,83,249,314,358,20,1668,574
1586,19,4.2.333,0,631,0,68,333,401,333,0,401,423,-11,73,589,3,4,177,215,314,475,20,1668,574
1586,19,5.2.423,0,631,0,71,423,494,423,0,494,494,-101,163,679,3,4,177,215,319,475,20,1668,574
1586,20,1.2.322,0,643,1,76,322,398,241,81,398,423,0,62,636,3,4,137,215,229,475,21,1668,508
1586,20,3.4.388,1,631,0,17,388,405,388,0,405,423,-96,357,732,5,3,17,110,314,141,21,1668,508
1586,20,4.2.333,0,631,0,68,333,401,333,0,401,423,-11,73,647,3,4,177,215,314,475,21,1668,508
1586,20,5.2.423,0,631,0,71,423,494,423,0,494,494,-101,163,737,3,4,177,215,319,475,21,1668,508
1586,21,1.2.322,1,643,1,76,322,398,241,81,398,423,0,62,732,3,4,137,215,229,475,22,1668,491
1586,21,4.2.333,0,631,0,68,333,401,333,0,401,423,-11,73,743,3,4,177,215,314,475,22,1668,491
1586,21,5.2.423,0,631,0,71,423,494,423,0,494,494,-101,163,833,3,4,177,215,319,475,22,1668,491
1586,22,1.3.398,1,643,0,40,398,438,398,0,438,438,-10,223,742,4,4,61,183,229,358,23,1668,415
1586,22,4.2.398,0,643,0,68,398,466,333,65,466,466,0,62,732,3,5,177,139,314,475,23,1668,415
1586,22,5.2.423,0,676,1,71,423,494,423,0,494,494,-25,87,757,3,5,177,139,319,475,23,1668,415
1586,23,1.4.438,1,643,0,21,438,459,438,0,459,459,-33,390,775,5,4,21,93,229,141,24,1668,375
1586,23,4.2.398,0,643,0,68,398,466,333,65,466,466,0,62,742,3,5,177,139,314,475,24,1668,375
1586,23,5.2.423,0,676,1,71,423,494,423,0,494,494,-25,87,767,3,5,177,139,319,475,24,1668,375
1586,24,4.2.398,1,643,0,68,398,466,333,65,466,466,0,62,775,3,5,177,139,314,475,25,1668,354
1586,24,5.2.423,0,676,1,71,423,494,423,0,494,494,-25,87,800,3,5,177,139,319,475,25,1668,354
1586,25,4.3.466,0,643,0,70,466,536,466,0,536,536,-28,251,803,4,5,109,143,314,358,26,1668,286
1586,25,5.2.466,1,643,0,71,466,537,423,43,537,537,0,62,775,3,6,177,71,319,475,26,1668,286
1586,26,4.3.466,1,643,0,70,466,536,466,0,536,537,-28,251,803,4,5,109,143,314,358,27,1668,215
1586,26,5.3.537,0,643,0,73,537,610,537,0,610,610,-99,322,874,4,5,106,143,319,358,27,1668,215
1586,27,4.4.536,1,643,0,39,536,575,536,0,575,575,-77,467,880,5,5,39,72,314,141,28,1668,145
1586,27,5.3.537,0,643,0,73,537,610,537,0,610,610,-1,252,804,4,6,106,73,319,358,28,1668,145
1586,28,5.3.537,1,643,0,73,537,610,537,0,610,610,-1,252,881,4,6,106,73,319,358,29,1668,106
1586,29,5.4.610,1,643,0,33,610,643,610,0,643,643,-35,502,916,5,6,33,33,319,141,30,1668,33
1587,0,0.0.0,0,524,4,58,0,58,0,0,58,58,0,0,0,1,1,292,288,292,288,1,1438,1438
1587,0,1.0.0,0,491,0,28,0,28,0,0,28,28,0,0,0,1,1,228,288,228,288,1,1438,1438
1587,0,2.0.0,0,523,3,62,0,62,0,0,62,62,0,0,0,1,1,270,288,270,288,1,1438,1438
1587,0,3.0.0,1,514,2,37,0,37,0,0,37,37,0,0,0,1,1,274,288,274,288,1,1438,1438
1587,0,4.0.0,0,499,1,8,0,8,0,0,8,8,0,0,0,1,1,152,288,152,288,1,1438,1438
1587,0,5.0.0,0,566,5,95,0,95,0,0,95,95,0,0,0,1,1,222,288,222,288,1,1438,1438
1587,1,0.0.37,0,561,4,58,37,95,0,37,95,95,0,0,0,1,2,292,251,292,288,2,1438,1401
1587,1,1.0.37,0,514,0,28,37,65,0,37,65,65,0,0,0,1,2,228,251,228,288,2,1438,1401
1587,1,2.0.37,0,551,3,62,37,99,0,37,99,99,0,0,0,1,2,270,251,270,288,2,1438,1401
1587,1,3.1.37,1,549,2,95,37,132,37,0,132,132,-37,37,37,2,1,237,225,274,225,2,1438,1401
1587,1,4.0.37,0,522,1,8,37,45,0,37,45,45,0,0,0,1,2,152,251,152,288,2,1438,1401
1587,1,5.0.37,0,549,2,95,37,132,0,37,132,132,0,0,0,1,2,222,251,222,288,2,1438,1401
1587,2,0.0.37,0,565,3,58,37,95,0,37,95,132,0,0,37,1,2,292,251,292,288,3,1438,1306
1587,2,1.0.37,1,553,2,28,37,65,0,37,65,132,0,0,37,1,2,228,251,228,288,3,1438,1306
1587,2,2.0.37,0,551,1,62,37,99,0,37,99,132,0,0,37,1,2,270,251,270,288,3,1438,1306
1587,2,3.2.132,0,549,0,59,132,191,132,0,191,191,-132,132,169,3,1,142,345,274,345,3,1438,1306
1587,2,4.0.37,0,549,0,8,37,45,0,37,45,132,0,0,37,1,2,152,251,152,288,3,1438,1306
1587,2,5.0.37,0,549,0,95,37,132,0,37,132,132,0,0,37,1,2,222,251,222,288,3,1438,1306
1587,3,0.0.65,0,570,2,58,65,123,0,65,123,132,0,0,37,1,3,292,223,292,288,4,1438,1278
1587,3,1.1.132,1,553,0,8,132,140,65,67,140,140,0,37,37,2,2,200,130,228,225,4,1438,1278
1587,3,2.0.65,0,560,1,62,65,127,0,65,127,132,0,0,37,1,3,270,223,270,288,4,1438,1278
1587,3,3.2.132,0,553,0,59,132,191,132,0,191,191,-132,132,169,3,1,142,345,274,345,4,1438,1278
1587,3,4.0.65,0,560,1,8,65,73,0,65,73,132,0,0,37,1,3,152,223,152,288,4,1438,1278
1587,3,5.0.65,0,553,0,95,65,160,0,65,160,160,0,0,37,1,3,222,223,222,288,4,1438,1278
1587,4,0.0.65,1,570,2,58,65,123,0,65,123,140,0,0,37,1,3,292,223,292,288,5,1438,1270
1587,4,1.2.140,0,570,2,81,140,221,140,0,221,221,-140,140,177,3,1,192,345,228,345,5,1438,1270
1587,4,2.0.65,0,560,1,62,65,127,0,65,127,140,0,0,37,1,3,270,223,270,288,5,1438,1270
1587,4,3.2.132,0,553,0,59,132,191,132,0,191,191,-132,132,169,3,1,142,345,274,345,5,1438,1270
1587,4,4.0.65,0,560,1,8,65,73,0,65,73,140,0,0,37,1,3,152,223,152,288,5,1438,1270
1587,4,5.0.65,0,553,0,95,65,160,0,65,160,160,0,0,37,1,3,222,223,222,288,5,1438,1270
1587,5,0.1.140,1,570,0,44,140,184,123,17,184,184,0,37,37,2,3,234,122,292,225,6,1438,1212
1587,5,1.2.140,0,570,0,81,140,221,140,0,221,221,-140,140,177,3,1,192,345,228,345,6,1438,1212
1587,5,2.0.123,0,570,0,62,123,185,0,123,185,185,0,0,37,1,4,270,165,270,288,6,1438,1212
1587,5,3.2.132,0,572,1,59,132,191,132,0,191,191,-132,132,169,3,1,142,345,274,345,6,1438,1212
1587,5,4.0.123,0,570,0,8,123,131,0,123,131,140,0,0,37,1,4,152,165,152,288,6,1438,1212
1587,5,5.0.123,0,570,0,95,123,218,0,123,218,218,0,0,37,1,4,222,165,222,288,6,1438,1212
1587,6,0.2.184,0,601,2,80,184,264,184,0,264,264,-184,184,221,3,1,190,345,292,345,7,1438,1168
1587,6,1.2.140,0,570,0,81,140,221,140,0,221,221,-140,140,177,3,1,192,345,228,345,7,1438,1168
1587,6,2.0.123,0,570,0,62,123,185,0,123,185,185,0,0,37,1,4,270,165,270,288,7,1438,1168
1587,6,3.2.132,0,572,1,59,132,191,132,0,191,191,-132,132,169,3,1,142,345,274,345,7,1438,1168
1587,6,4.0.123,1,570,0,8,123,131,0,123,131,184,0,0,37,1,4,152,165,152,288,7,1438,1168
1587,6,5.0.123,0,570,0,95,123,218,0,123,218,218,0,0,37,1,4,222,165,222,288,7,1438,1168
1587,7,0.2.184,0,601,2,80,184,264,184,0,264,264,-184,184,221,3,1,190,345,292,345,8,1438,1160
1587,7,1.2.140,0,570,0,81,140,221,140,0,221,221,-140,140,177,3,1,192,345,228,345,8,1438,1160
1587,7,2.0.131,0,570,0,62,131,193,0,131,193,193,0,0,37,1,5,270,157,270,288,8,1438,1160
1587,7,3.2.132,0,572,1,59,132,191,132,0,191,191,-132,132,169,3,1,142,345,274,345,8,1438,1160
1587,7,4.1.184,1,570,0,4,184,188,131,53,188,188,0,37,37,2,4,144,78,152,225,8,1438,1160
1587,7,5.0.131,0,570,0,95,131,226,0,131,226,226,0,0,37,1,5,222,157,222,288,8,1438,1160
1587,8,0.2.184,0,601,2,80,184,264,184,0,264,264,-184,184,221,3,1,190,345,292,345,9,1438,1156
1587,8,1.2.140,0,570,0,81,140,221,140,0,221,221,-140,140,177,3,1,192,345,228,345,9,1438,1156
1587,8,2.0.131,1,570,0,62,131,193,0,131,193,193,0,0,37,1,5,270,157,270,288,9,1438,1156
1587,8,3.2.132,0,572,1,59,132,191,132,0,191,191,-132,132,169,3,1,142,345,274,345,9,1438,1156
1587,8,4.2.188,0,643,3,68,188,256,188,0,256,256,-188,188,225,3,1,140,345,152,345,9,1438,1156
1587,8,5.0.131,0,570,0,95,131,226,0,131,226,226,0,0,37,1,5,222,157,222,288,9,1438,1156
1587,9,0.2.184,0,613,2,80,184,264,184,0,264,264,-184,184,221,3,1,190,345,292,345,10,1438,1094
1587,9,1.2.140,0,570,0,81,140,221,140,0,221,221,-140,140,177,3,1,192,345,228,345,10,1438,1094
1587,9,2.1.193,1,570,0,39,193,232,193,0,232,232,-5,42,42,2,5,208,74,270,225,10,1438,1094
1587,9,3.2.132,0,572,1,59,132,191,132,0,191,193,-132,132,169,3,1,142,345,274,345,10,1438,1094
1587,9,4.2.188,0,643,3,68,188,256,188,0,256,256,-188,188,225,3,1,140,345,152,345,10,1438,1094
1587,9,5.0.193,0,570,0,95,193,288,0,193,288,288,0,0,37,1,6,222,95,222,288,10,1438,1094
1587,10,0.2.184,0,613,3,80,184,264,184,0,264,264,-184,184,226,3,1,190,345,292,345,11,1438,1055
1587,10,1.2.140,0,570,0,81,140,221,140,0,221,232,-140,140,182,3,1,192,345,228,345,11,1438,1055
1587,10,2.2.232,0,595,2,47,232,279,232,0,279,279,-232,232,274,3,1,169,345,270,345,11,1438,1055
1587,10,3.2.132,0,572,1,59,132,191,132,0,191,232,-132,132,174,3,1,142,345,274,345,11,1438,1055
1587,10,4.2.188,0,643,4,68,188,256,188,0,256,256,-188,188,230,3,1,140,345,152,345,11,1438,1055
1587,10,5.0.193,1,570,0,95,193,288,0,193,288,288,0,0,42,1,6,222,95,222,288,11,1438,1055
1587,11,0.2.184,0,613,3,80,184,264,184,0,264,288,-184,184,226,3,1,190,345,292,345,12,1438,960
1587,11,1.2.140,0,570,0,81,140,221,140,0,221,288,-140,140,182,3,1,192,345,228,345,12,1438,960
1587,11,2.2.232,0,595,2,47,232,279,232,0,279,288,-232,232,274,3,1,169,345,270,345,12,1438,960
1587,11,3.2.132,0,572,1,59,132,191,132,0,191,288,-132,132,174,3,1,142,345,274,345,12,1438,960
1587,11,4.2.188,0,643,4,68,188,256,188,0,256,288,-188,188,230,3,1,140,345,152,345,12,1438,960
1587,11,5.1.288,1,570,0,35,288,323,288,0,323,323,-56,98,98,2,6,127,35,222,225,12,1438,960
1587,12,0.2.184,0,613,4,80,184,264,184,0,264,323,-184,184,282,3,1,190,345,292,345,13,1438,925
1587,12,1.2.140,0,570,0,81,140,221,140,0,221,323,-140,140,238,3,1,192,345,228,345,13,1438,925
1587,12,2.2.232,0,595,3,47,232,279,232,0,279,323,-232,232,330,3,1,169,345,270,345,13,1438,925
1587,12,3.2.132,1,572,1,59,132,191,132,0,191,323,-132,132,230,3,1,142,345,274,345,13,1438,925
1587,12,4.2.188,0,643,5,68,188,256,188,0,256,323,-188,188,286,3,1,140,345,152,345,13,1438,925
1587,12,5.2.323,0,579,2,10,323,333,323,0,333,333,-323,323,421,3,1,92,345,222,345,13,1438,925
1587,13,0.2.191,0,584,1,80,191,271,184,7,271,323,0,132,230,3,2,190,286,292,345,14,1438,866
1587,13,1.2.191,0,572,0,81,191,272,140,51,272,323,0,132,230,3,2,192,286,228,345,14,1438,866
1587,13,2.2.232,0,601,3,47,232,279,232,0,279,323,-41,173,271,3,2,169,286,270,345,14,1438,866
1587,13,3.3.191,1,572,0,25,191,216,191,0,216,323,-191,191,421,4,1,83,312,274,312,14,1438,866
1587,13,4.2.191,0,588,2,68,191,259,188,3,259,323,0,132,230,3,2,140,286,152,345,14,1438,866
1587,13,5.2.323,0,584,1,10,323,333,323,0,333,333,-132,264,362,3,2,92,286,222,345,14,1438,866
1587,14,0.2.191,0,584,1,80,191,271,184,7,271,323,0,132,421,3,2,190,286,292,345,15,1438,841
1587,14,1.2.191,0,572,0,81,191,272,140,51,272,323,0,132,421,3,2,192,286,228,345,15,1438,841
1587,14,2.2.232,0,601,3,47,232,279,232,0,279,323,-41,173,462,3,2,169,286,270,345,15,1438,841
1587,14,3.4.216,1,572,0,58,216,274,216,0,274,323,-216,216,637,5,1,58,268,274,268,15,1438,841
1587,14,4.2.191,0,588,2,68,191,259,188,3,259,323,0,132,421,3,2,140,286,152,345,15,1438,841
1587,14,5.2.323,0,584,1,10,323,333,323,0,333,333,-132,264,553,3,2,92,286,222,345,15,1438,841
1587,15,0.2.191,0,584,1,80,191,271,184,7,271,323,0,132,637,3,2,190,286,292,345,16,1438,783
1587,15,1.2.191,1,572,0,81,191,272,140,51,272,323,0,132,637,3,2,192,286,228,345,16,1438,783
1587,15,2.2.232,0,601,3,47,232,279,232,0,279,323,-41,173,678,3,2,169,286,270,345,16,1438,783
1587,15,4.2.191,0,588,2,68,191,259,188,3,259,323,0,132,637,3,2,140,286,152,345,16,1438,783
1587,15,5.2.323,0,584,1,10,323,333,323,0,333,333,-132,264,769,3,2,92,286,222,345,16,1438,783
1587,16,0.2.272,0,572,0,80,272,352,184,88,352,352,0,132,637,3,3,190,205,292,345,17,1438,702
1587,16,1.3.272,0,572,0,81,272,353,272,0,353,353,-56,247,693,4,2,111,287,228,312,17,1438,702
1587,16,2.2.272,1,588,1,47,272,319,232,40,319,323,0,132,637,3,3,169,205,270,345,17,1438,702
1587,16,4.2.272,0,616,2,68,272,340,188,84,340,340,0,132,637,3,3,140,205,152,345,17,1438,702
1587,16,5.2.323,0,588,1,10,323,333,323,0,333,333,-51,183,688,3,3,92,205,222,345,17,1438,702
1587,17,0.2.319,1,588,0,80,319,399,184,135,399,399,0,132,637,3,4,190,158,292,345,18,1438,655
1587,17,1.3.272,0,588,0,81,272,353,272,0,353,353,-56,247,693,4,2,111,287,228,312,18,1438,655
1587,17,2.3.319,0,615,2,55,319,374,319,0,374,374,-103,294,740,4,2,122,287,270,312,18,1438,655
1587,17,4.2.319,0,596,1,68,319,387,188,131,387,387,0,132,637,3,4,140,158,152,345,18,1438,655
1587,17,5.2.323,0,588,0,10,323,333,323,0,333,333,-4,136,641,3,4,92,158,222,345,18,1438,655
1587,18,0.3.399,0,614,2,30,399,429,399,0,429,429,-183,374,820,4,2,110,287,292,312,19,1438,575
1587,18,1.3.272,0,588,0,81,272,353,272,0,353,399,-56,247,693,4,2,111,287,228,312,19,1438,575
1587,18,2.3.319,0,615,3,55,319,374,319,0,374,399,-103,294,740,4,2,122,287,270,312,19,1438,575
1587,18,4.2.399,0,607,1,68,399,467,188,211,467,467,0,132,637,3,5,140,78,152,345,19,1438,575
1587,18,5.2.399,1,588,0,10,399,409,323,76,409,409,0,132,637,3,5,92,78,222,345,19,1438,575
1587,19,0.3.399,0,614,1,30,399,429,399,0,429,429,-183,374,820,4,2,110,287,292,312,20,1438,565
1587,19,1.3.272,0,588,0,81,272,353,272,0,353,409,-56,247,693,4,2,111,287,228,312,20,1438,565
1587,19,2.3.319,0,615,2,55,319,374,319,0,374,409,-103,294,740,4,2,122,287,270,312,20,1438,565
1587,19,4.2.409,1,588,0,68,409,477,188,221,477,477,0,132,637,3,6,140,68,152,345,20,1438,565
1587,19,5.3.409,0,588,0,58,409,467,409,0,467,467,-193,384,830,4,2,82,287,222,312,20,1438,565
1587,20,0.3.399,0,614,1,30,399,429,399,0,429,477,-183,374,820,4,2,110,287,292,312,21,1438,497
1587,20,1.3.272,0,588,0,81,272,353,272,0,353,477,-56,247,693,4,2,111,287,228,312,21,1438,497
1587,20,2.3.319,1,615,2,55,319,374,319,0,374,477,-103,294,740,4,2,122,287,270,312,21,1438,497
1587,20,4.3.477,0,622,3,63,477,540,477,0,540,540,-261,452,898,4,2,72,287,152,312,21,1438,497
1587,20,5.3.409,0,588,0,58,409,467,409,0,467,477,-193,384,830,4,2,82,287,222,312,21,1438,497
1587,21,0.3.399,0,640,1,30,399,429,399,0,429,477,-25,319,765,4,3,110,232,292,312,22,1438,442
1587,21,1.3.374,0,615,0,81,374,455,272,102,455,477,0,294,740,4,3,111,232,228,312,22,1438,442
1587,21,2.4.374,1,615,0,67,374,441,374,0,441,477,-100,316,840,5,2,67,210,270,268,22,1438,442
1587,21,4.3.477,0,674,3,63,477,540,477,0,540,540,-103,397,843,4,3,72,232,152,312,22,1438,442
1587,21,5.3.409,0,650,2,58,409,467,409,0,467,477,-35,329,775,4,3,82,232,222,312,22,1438,442
1587,22,0.3.399,1,640,1,30,399,429,399,0,429,477,-25,319,865,4,3,110,232,292,312,23,1438,375
1587,22,1.3.374,0,615,0,81,374,455,272,102,455,477,0,294,840,4,3,111,232,228,312,23,1438,375
1587,22,4.3.477,0,674,3,63,477,540,477,0,540,540,-103,397,943,4,3,72,232,152,312,23,1438,375
1587,22,5.3.409,0,650,2,58,409,467,409,0,467,477,-35,329,875,4,3,82,232,222,312,23,1438,375
1587,23,0.4.441,1,640,0,80,441,521,429,12,521,521,0,316,865,5,3,80,143,292,268,24,1438,345
1587,23,1.3.429,0,640,0,81,429,510,272,157,510,510,0,319,865,4,4,111,202,228,312,24,1438,345
1587,23,4.3.477,0,703,1,63,477,540,477,0,540,540,-48,367,913,4,4,72,202,152,312,24,1438,345
1587,23,5.3.429,0,640,0,58,429,487,409,20,487,487,0,319,865,4,4,82,202,222,312,24,1438,345
1587,24,1.3.429,1,640,0,81,429,510,272,157,510,521,0,319,865,4,4,111,202,228,312,25,1438,265
1587,24,4.3.477,0,703,1,63,477,540,477,0,540,540,-48,367,913,4,4,72,202,152,312,25,1438,265
1587,24,5.3.429,0,640,0,58,429,487,409,20,487,521,0,319,865,4,4,82,202,222,312,25,1438,265
1587,25,1.4.521,1,640,0,30,521,551,510,11,551,551,0,316,865,5,4,30,63,228,268,26,1438,184
1587,25,4.3.510,0,655,1,63,510,573,477,33,573,573,0,319,865,4,5,72,121,152,312,26,1438,184
1587,25,5.3.510,0,640,0,58,510,568,409,101,568,568,0,319,865,4,5,82,121,222,312,26,1438,184
1587,26,4.3.510,0,655,1,63,510,573,477,33,573,573,0,319,865,4,5,72,121,152,312,27,1438,154
1587,26,5.3.510,1,640,0,58,510,568,409,101,568,568,0,319,865,4,5,82,121,222,312,27,1438,154
1587,27,4.3.568,0,640,0,63,568,631,477,91,631,631,0,319,865,4,6,72,63,152,312,28,1438,96
1587,27,5.4.568,1,640,0,24,568,592,568,0,592,592,-17,333,882,5,5,24,33,222,268,28,1438,96
1587,28,4.3.568,1,640,0,63,568,631,477,91,631,631,0,319,882,4,6,72,63,152,312,29,1438,72
1587,29,4.4.631,1,640,0,9,631,640,631,0,640,640,-39,372,921,5,6,9,9,152,268,30,1438,9
1588,0,0.0.0,0,562,3,71,0,71,0,0,71,71,0,0,0,1,1,237,300,237,300,1,1504,1504
1588,0,1.0.0,1,528,1,3,0,3,0,0,3,3,0,0,0,1,1,227,300,227,300,1,1504,1504
1588,0,2.0.0,0,525,0,8,0,8,0,0,8,8,0,0,0,1,1,197,300,197,300,1,1504,1504
1588,0,3.0.0,0,599,4,89,0,89,0,0,89,89,0,0,0,1,1,331,300,331,300,1,1504,1504
1588,0,4.0.0,0,544,2,30,0,30,0,0,30,30,0,0,0,1,1,288,300,288,300,1,1504,1504
1588,0,5.0.0,0,613,5,99,0,99,0,0,99,99,0,0,0,1,1,224,300,224,300,1,1504,1504
1588,1,0.0.3,0,554,2,71,3,74,0,3,74,74,0,0,0,1,2,237,297,237,300,2,1504,1501
1588,1,1.1.3,1,547,1,76,3,79,3,0,79,79,-3,3,3,2,1,224,230,227,230,2,1504,1501
1588,1,2.0.3,0,528,0,8,3,11,0,3,11,11,0,0,0,1,2,197,297,197,300,2,1504,1501
1588,1,3.0.3,0,547,1,89,3,92,0,3,92,92,0,0,0,1,2,331,297,331,300,2,1504,1501
1588,1,4.0.3,0,547,1,30,3,33,0,3,33,33,0,0,0,1,2,288,297,288,300,2,1504,1501
1588,1,5.0.3,0,576,3,99,3,102,0,3,102,102,0,0,0,1,2,224,297,224,300,2,1504,1501
1588,2,0.0.3,0,554,2,71,3,74,0,3,74,79,0,0,3,1,2,237,297,237,300,3,1504,1425
1588,2,1.2.79,0,547,0,86,79,165,79,0,165,165,-79,79,82,3,1,148,411,227,411,3,1504,1425
1588,2,2.0.3,0,547,0,8,3,11,0,3,11,79,0,0,3,1,2,197,297,197,300,3,1504,1425
1588,2,3.0.3,0,547,0,89,3,92,0,3,92,92,0,0,3,1,2,331,297,331,300,3,1504,1425
1588,2,4.0.3,1,548,1,30,3,33,0,3,33,79,0,0,3,1,2,288,297,288,300,3,1504,1425
1588,2,5.0.3,0,576,3,99,3,102,0,3,102,102,0,0,3,1,2,224,297,224,300,3,1504,1425
1588,3,0.0.33,0,554,2,71,33,104,0,33,104,104,0,0,3,1,3,237,267,237,300,4,1504,1395
1588,3,1.2.79,0,548,0,86,79,165,79,0,165,165,-79,79,82,3,1,148,411,227,411,4,1504,1395
1588,3,2.0.33,0,548,0,8,33,41,0,33,41,79,0,0,3,1,3,197,267,197,300,4,1504,1395
1588,3,3.0.33,0,548,0,89,33,122,0,33,122,122,0,0,3,1,3,331,267,331,300,4,1504,1395
1588,3,4.1.79,1,550,1,55,79,134,33,46,134,134,0,3,3,2,2,258,154,288,230,4,1504,1395
1588,3,5.0.33,0,568,3,99,33,132,0,33,132,132,0,0,3,1,3,224,267,224,300,4,1504,1395
1588,4,0.0.33,0,554,1,71,33,104,0,33,104,134,0,0,3,1,3,237,267,237,300,5,1504,1340
1588,4,1.2.79,0,550,0,86,79,165,79,0,165,165,-79,79,82,3,1,148,411,227,411,5,1504,1340
1588,4,2.0.33,1,550,0,8,33,41,0,33,41,134,0,0,3,1,3,197,267,197,300,5,1504,1340
1588,4,3.0.33,0,550,0,89,33,122,0,33,122,134,0,0,3,1,3,331,267,331,300,5,1504,1340
1588,4,4.2.134,0,602,3,69,134,203,134,0,203,203,-134,134,137,3,1,203,411,288,411,5,1504,1340
1588,4,5.0.33,0,568,2,99,33,132,0,33,132,134,0,0,3,1,3,224,267,224,300,5,1504,1340
1588,5,0.0.41,0,554,1,71,41,112,0,41,112,134,0,0,3,1,4,237,259,237,300,6,1504,1332
1588,5,1.2.79,0,550,0,86,79,165,79,0,165,165,-79,79,82,3,1,148,411,227,411,6,1504,1332
1588,5,2.1.134,1,554,1,33,134,167,41,93,167,167,0,3,3,2,3,189,99,197,230,6,1504,1332
1588,5,3.0.41,0,550,0,89,41,130,0,41,130,134,0,0,3,1,4,331,259,331,300,6,1504,1332
1588,5,4.2.134,0,602,3,69,134,203,134,0,203,203,-134,134,137,3,1,203,411,288,411,6,1504,1332
1588,5,5.0.41,0,572,2,99,41,140,0,41,140,140,0,0,3,1,4,224,259,224,300,6,1504,1332
1588,6,0.0.41,0,554,0,71,41,112,0,41,112,167,0,0,3,1,4,237,259,237,300,7,1504,1299
1588,6,1.2.79,0,554,0,86,79,165,79,0,165,167,-79,79,82,3,1,148,411,227,411,7,1504,1299
1588,6,2.2.167,0,601,2,99,167,266,167,0,266,266,-167,167,170,3,1,156,411,197,411,7,1504,1299
1588,6,3.0.41,1,554,0,89,41,130,0,41,130,167,0,0,3,1,4,331,259,331,300,7,1504,1299
1588,6,4.2.134,0,602,3,69,134,203,134,0,203,203,-134,134,137,3,1,203,411,288,411,7,1504,1299
1588,6,5.0.41,0,572,1,99,41,140,0,41,140,167,0,0,3,1,4,224,259,224,300,7,1504,1299
1588,7,0.0.130,0,554,0,71,130,201,0,130,201,201,0,0,3,1,5,237,170,237,300,8,1504,1210
1588,7,1.2.79,0,554,0,86,79,165,79,0,165,167,-79,79,82,3,1,148,411,227,411,8,1504,1210
1588,7,2.2.167,0,601,1,99,167,266,167,0,266,266,-167,167,170,3,1,156,411,197,411,8,1504,1210
1588,7,3.1.167,1,554,0,34,167,201,130,37,201,201,0,3,3,2,4,242,66,331,230,8,1504,1210
1588,7,4.2.134,0,602,2,69,134,203,134,0,203,203,-134,134,137,3,1,203,411,288,411,8,1504,1210
1588,7,5.0.130,0,554,0,99,130,229,0,130,229,229,0,0,3,1,5,224,170,224,300,8,1504,1210
1588,8,0.0.130,1,554,0,71,130,201,0,130,201,201,0,0,3,1,5,237,170,237,300,9,1504,1176
1588,8,1.2.79,0,554,0,86,79,165,79,0,165,201,-79,79,82,3,1,148,411,227,411,9,1504,1176
1588,8,2.2.167,0,601,2,99,167,266,167,0,266,266,-167,167,170,3,1,156,411,197,411,9,1504,1176
1588,8,3.2.201,0,583,1,26,201,227,201,0,227,227,-201,201,204,3,1,208,411,331,411,9,1504,1176
1588,8,4.2.134,0,602,3,69,134,203,134,0,203,203,-134,134,137,3,1,203,411,288,411,9,1504,1176
1588,8,5.0.130,0,554,0,99,130,229,0,130,229,229,0,0,3,1,5,224,170,224,300,9,1504,1176
1588,9,0.1.201,1,554,0,13,201,214,201,0,214,214,0,3,3,2,5,166,32,237,230,10,1504,1105
1588,9,1.2.79,0,554,0,86,79,165,79,0,165,201,-79,79,82,3,1,148,411,227,411,10,1504,1105
1588,9,2.2.167,0,601,2,99,167,266,167,0,266,266,-167,167,170,3,1,156,411,197,411,10,1504,1105
1588,9,3.2.201,0,583,1,26,201,227,201,0,227,227,-201,201,204,3,1,208,411,331,411,10,1504,1105
1588,9,4.2.134,0,602,3,69,134,203,134,0,203,203,-134,134,137,3,1,203,411,288,411,10,1504,1105
1588,9,5.0.201,0,554,0,99,201,300,0,201,300,300,0,0,3,1,6,224,99,224,300,10,1504,1105
1588,10,0.2.214,0,613,4,83,214,297,214,0,297,297,-214,214,217,3,1,153,411,237,411,11,1504,1092
1588,10,1.2.79,0,554,0,86,79,165,79,0,165,214,-79,79,82,3,1,148,411,227,411,11,1504,1092
1588,10,2.2.167,0,601,2,99,167,266,167,0,266,266,-167,167,170,3,1,156,411,197,411,11,1504,1092
1588,10,3.2.201,0,583,1,26,201,227,201,0,227,227,-201,201,204,3,1,208,411,331,411,11,1504,1092
1588,10,4.2.134,0,602,3,69,134,203,134,0,203,214,-134,134,137,3,1,203,411,288,411,11,1504,1092
1588,10,5.0.201,1,554,0,99,201,300,0,201,300,300,0,0,3,1,6,224,99,224,300,11,1504,1092
1588,11,0.2.214,0,613,4,83,214,297,214,0,297,300,-214,214,217,3,1,153,411,237,411,12,1504,993
1588,11,1.2.79,0,554,0,86,79,165,79,0,165,300,-79,79,82,3,1,148,411,227,411,12,1504,993
1588,11,2.2.167,0,601,2,99,167,266,167,0,266,300,-167,167,170,3,1,156,411,197,411,12,1504,993
1588,11,3.2.201,0,583,1,26,201,227,201,0,227,300,-201,201,204,3,1,208,411,331,411,12,1504,993
1588,11,4.2.134,0,602,3,69,134,203,134,0,203,300,-134,134,137,3,1,203,411,288,411,12,1504,993
1588,11,5.1.300,1,554,0,19,300,319,300,0,319,319,-86,89,89,2,6,125,19,224,230,12,1504,993
1588,12,0.2.214,0,613,5,83,214,297,214,0,297,319,-214,214,303,3,1,153,411,237,411,13,1504,974
1588,12,1.2.79,0,554,0,86,79,165,79,0,165,319,-79,79,168,3,1,148,411,227,411,13,1504,974
1588,12,2.2.167,0,601,2,99,167,266,167,0,266,319,-167,167,256,3,1,156,411,197,411,13,1504,974
1588,12,3.2.201,1,583,1,26,201,227,201,0,227,319,-201,201,290,3,1,208,411,331,411,13,1504,974
1588,12,4.2.134,0,602,3,69,134,203,134,0,203,319,-134,134,223,3,1,203,411,288,411,13,1504,974
1588,12,5.2.319,0,603,4,48,319,367,319,0,367,367,-319,319,408,3,1,106,411,224,411,13,1504,974
1588,13,0.2.227,0,583,0,83,227,310,214,13,310,319,0,201,290,3,2,153,385,237,411,14,1504,948
1588,13,1.2.79,0,583,0,86,79,165,79,0,227,319,86,115,204,3,2,148,385,227,411,14,1504,948
1588,13,2.2.227,0,584,1,99,227,326,167,60,326,326,0,201,290,3,2,156,385,197,411,14,1504,948
1588,13,3.3.227,1,583,0,83,227,310,227,0,310,319,-227,227,517,4,1,182,265,331,265,14,1504,948
1588,13,4.2.227,0,583,0,69,227,296,134,93,296,319,0,201,290,3,2,203,385,288,411,14,1504,948
1588,13,5.2.319,0,603,2,48,319,367,319,0,367,367,-92,293,382,3,2,106,385,224,411,14,1504,948
1588,14,0.2.227,0,583,0,83,227,310,214,13,310,319,0,201,517,3,2,153,385,237,411,15,1504,865
1588,14,1.2.79,0,583,0,86,79,165,79,0,227,319,86,115,431,3,2,148,385,227,411,15,1504,865
1588,14,2.2.227,0,584,1,99,227,326,167,60,326,326,0,201,517,3,2,156,385,197,411,15,1504,865
1588,14,3.4.310,1,583,0,99,310,409,310,0,409,409,-310,310,827,5,1,99,298,331,298,15,1504,865
1588,14,4.2.227,0,583,0,69,227,296,134,93,296,319,0,201,517,3,2,203,385,288,411,15,1504,865
1588,14,5.2.319,0,603,2,48,319,367,319,0,367,367,-92,293,609,3,2,106,385,224,411,15,1504,865
1588,15,0.2.227,0,583,0,83,227,310,214,13,310,409,0,201,827,3,2,153,385,237,411,16,1504,766
1588,15,1.2.79,0,583,0,86,79,165,79,0,227,409,86,115,741,3,2,148,385,227,411,16,1504,766
1588,15,2.2.227,0,584,1,99,227,326,167,60,326,409,0,201,827,3,2,156,385,197,411,16,1504,766
1588,15,4.2.227,1,583,0,69,227,296,134,93,296,409,0,201,827,3,2,203,385,288,411,16,1504,766
1588,15,5.2.319,0,603,2,48,319,367,319,0,367,409,-92,293,919,3,2,106,385,224,411,16,1504,766
1588,16,0.2.296,0,583,0,83,296,379,214,82,379,409,0,201,827,3,3,153,316,237,411,17,1504,697
1588,16,1.2.79,0,583,0,86,79,165,79,0,296,409,86,115,741,3,3,148,316,227,411,17,1504,697
1588,16,2.2.296,0,584,1,99,296,395,167,129,395,409,0,201,827,3,3,156,316,197,411,17,1504,697
1588,16,4.3.310,1,583,0,56,310,366,296,14,366,409,0,227,827,4,2,134,182,288,265,17,1504,697
1588,16,5.2.319,0,606,2,48,319,367,319,0,367,409,-23,224,850,3,3,106,316,224,411,17,1504,697
1588,17,0.2.296,0,583,0,83,296,379,214,82,379,409,0,201,827,3,3,153,316,237,411,18,1504,641
1588,17,1.2.79,0,583,0,86,79,165,79,0,296,409,86,115,741,3,3,148,316,227,411,18,1504,641
1588,17,2.2.296,0,584,1,99,296,395,167,129,395,409,0,201,827,3,3,156,316,197,411,18,1504,641
1588,17,4.4.409,1,583,0,78,409,487,366,43,487,487,0,310,827,5,2,78,199,288,298,18,1504,641
1588,17,5.2.319,0,606,2,48,319,367,319,0,367,409,-23,224,850,3,3,106,316,224,411,18,1504,641
1588,18,0.2.296,0,583,0,83,296,379,214,82,379,487,0,201,827,3,3,153,316,237,411,19,1504,563
1588,18,1.2.79,1,583,0,86,79,165,79,0,296,487,86,115,741,3,3,148,316,227,411,19,1504,563
1588,18,2.2.296,0,584,1,99,296,395,167,129,395,487,0,201,827,3,3,156,316,197,411,19,1504,563
1588,18,5.2.319,0,606,2,48,319,367,319,0,367,487,-23,224,850,3,3,106,316,224,411,19,1504,563
1588,19,0.2.296,0,583,0,83,296,379,214,82,379,487,0,115,741,3,4,153,230,237,411,20,1504,477
1588,19,1.3.165,1,583,0,23,165,188,165,0,366,487,23,204,718,4,3,62,126,227,265,20,1504,477
1588,19,2.2.296,0,584,1,99,296,395,167,129,395,487,0,115,741,3,4,156,230,197,411,20,1504,477
1588,19,5.2.319,0,606,2,48,319,367,319,0,367,487,-23,138,764,3,4,106,230,224,411,20,1504,477
1588,20,0.2.296,0,583,0,83,296,379,214,82,379,487,0,115,718,3,4,153,230,237,411,21,1504,454
1588,20,1.4.188,1,583,0,39,188,227,188,0,487,487,39,271,679,5,3,39,121,227,298,21,1504,454
1588,20,2.2.296,0,584,1,99,296,395,167,129,395,487,0,115,718,3,4,156,230,197,411,21,1504,454
1588,20,5.2.319,0,606,2,48,319,367,319,0,367,487,-23,138,741,3,4,106,230,224,411,21,1504,454
1588,21,0.2.296,1,583,0,83,296,379,214,82,379,487,0,115,679,3,4,153,230,237,411,22,1504,415
1588,21,2.2.296,0,584,1,99,296,395,167,129,395,487,0,115,679,3,4,156,230,197,411,22,1504,415
1588,21,5.2.319,0,606,2,48,319,367,319,0,367,487,-23,138,702,3,4,106,230,224,411,22,1504,415
1588,22,0.3.379,1,583,0,37,379,416,379,0,416,487,-13,217,692,4,4,70,103,237,265,23,1504,332
1588,22,2.2.379,0,584,1,99,379,478,167,212,478,487,0,115,679,3,5,156,147,197,411,23,1504,332
1588,22,5.2.379,0,583,0,48,379,427,319,60,427,487,0,115,679,3,5,106,147,224,411,23,1504,332
1588,23,0.4.487,1,583,0,33,487,520,416,71,520,520,0,271,692,5,4,33,82,237,298,24,1504,295
1588,23,2.2.379,0,584,1,99,379,478,167,212,478,487,0,115,692,3,5,156,147,197,411,24,1504,295
1588,23,5.2.379,0,583,0,48,379,427,319,60,427,487,0,115,692,3,5,106,147,224,411,24,1504,295
1588,24,2.2.379,1,584,1,99,379,478,167,212,478,520,0,115,692,3,5,156,147,197,411,25,1504,262
1588,24,5.2.379,0,583,0,48,379,427,319,60,427,520,0,115,692,3,5,106,147,224,411,25,1504,262
1588,25,2.3.478,1,584,0,24,478,502,478,0,502,520,-62,279,754,4,5,57,66,197,265,26,1504,163
1588,25,5.2.478,0,584,0,48,478,526,319,159,526,526,0,115,692,3,6,106,48,224,411,26,1504,163
1588,26,2.4.520,1,584,0,33,520,553,502,18,553,553,0,271,754,5,5,33,49,197,298,27,1504,139
1588,26,5.2.478,0,584,0,48,478,526,319,159,526,526,0,115,754,3,6,106,48,224,411,27,1504,139
1588,27,5.2.478,1,584,0,48,478,526,319,159,526,553,0,115,754,3,6,106,48,224,411,28,1504,106
1588,28,5.3.526,1,584,0,42,526,568,526,0,568,568,-24,303,778,4,6,58,42,224,265,29,1504,58
1588,29,5.4.568,1,584,0,16,568,584,568,0,584,584,-15,286,793,5,6,16,16,224,298,30,1504,16
1589,0,0.0.0,0,655,4,84,0,84,0,0,84,84,0,0,0,1,1,379,314,379,314,1,1673,1673
1589,0,1.0.0,0,649,3,78,0,78,0,0,78,78,0,0,0,1,1,327,314,327,314,1,1673,1673
1589,0,2.0.0,1,611,1,53,0,53,0,0,53,53,0,0,0,1,1,322,314,322,314,1,1673,1673
1589,0,3.0.0,0,637,2,43,0,43,0,0,43,43,0,0,0,1,1,291,314,291,314,1,1673,1673
1589,0,4.0.0,0,611,1,51,0,51,0,0,51,51,0,0,0,1,1,227,314,227,314,1,1673,1673
1589,0,5.0.0,0,609,0,5,0,5,0,0,5,5,0,0,0,1,1,127,314,127,314,1,1673,1673
1589,1,0.0.53,0,655,4,84,53,137,0,53,137,137,0,0,0,1,2,379,261,379,314,2,1673,1620
1589,1,1.0.53,0,637,3,78,53,131,0,53,131,131,0,0,0,1,2,327,261,327,314,2,1673,1620
1589,1,2.1.53,1,611,0,26,53,79,53,0,79,79,-53,53,53,2,1,269,232,322,232,2,1673,1620
1589,1,3.0.53,0,619,2,43,53,96,0,53,96,96,0,0,0,1,2,291,261,291,314,2,1673,1620
1589,1,4.0.53,0,611,0,51,53,104,0,53,104,104,0,0,0,1,2,227,261,227,314,2,1673,1620
1589,1,5.0.53,0,616,1,5,53,58,0,53,58,58,0,0,0,1,2,127,261,127,314,2,1673,1620
1589,2,0.0.53,0,655,4,84,53,137,0,53,137,137,0,0,53,1,2,379,261,379,314,3,1673,1594
1589,2,1.0.53,0,637,3,78,53,131,0,53,131,131,0,0,53,1,2,327,261,327,314,3,1673,1594
1589,2,2.2.79,0,611,0,53,79,132,79,0,132,132,-79,79,132,3,1,243,481,322,481,3,1673,1594
1589,2,3.0.53,1,619,2,43,53,96,0,53,96,96,0,0,53,1,2,291,261,291,314,3,1673,1594
1589,2,4.0.53,0,611,0,51,53,104,0,53,104,104,0,0,53,1,2,227,261,227,314,3,1673,1594
1589,2,5.0.53,0,616,1,5,53,58,0,53,58,79,0,0,53,1,2,127,261,127,314,3,1673,1594
1589,3,0.0.96,0,630,2,84,96,180,0,96,180,180,0,0,53,1,3,379,218,379,314,4,1673,1551
1589,3,1.0.96,0,630,2,78,96,174,0,96,174,174,0,0,53,1,3,327,218,327,314,4,1673,1551
1589,3,2.2.79,0,619,0,53,79,132,79,0,132,132,-79,79,132,3,1,243,481,322,481,4,1673,1551
1589,3,3.1.96,1,630,2,72,96,168,96,0,168,168,-17,70,70,2,2,248,206,291,232,4,1673,1551
1589,3,4.0.96,0,619,0,51,96,147,0,96,147,147,0,0,53,1,3,227,218,227,314,4,1673,1551
1589,3,5.0.96,0,624,1,5,96,101,0,96,101,101,0,0,53,1,3,127,218,127,314,4,1673,1551
1589,4,0.0.96,1,630,0,84,96,180,0,96,180,180,0,0,70,1,3,379,218,379,314,5,1673,1479
1589,4,1.0.96,0,630,0,78,96,174,0,96,174,174,0,0,70,1,3,327,218,327,314,5,1673,1479
1589,4,2.2.79,0,630,0,53,79,132,79,0,132,168,-79,79,149,3,1,243,481,322,481,5,1673,1479
1589,4,3.2.168,0,630,0,93,168,261,168,0,261,261,-168,168,238,3,1,176,481,291,481,5,1673,1479
1589,4,4.0.96,0,630,0,51,96,147,0,96,147,168,0,0,70,1,3,227,218,227,314,5,1673,1479
1589,4,5.0.96,0,630,0,5,96,101,0,96,101,168,0,0,70,1,3,127,218,127,314,5,1673,1479
1589,5,0.1.180,0,630,0,80,180,260,180,0,260,260,-12,82,82,2,3,295,134,379,232,6,1673,1395
1589,5,1.0.180,0,630,0,78,180,258,0,180,258,258,0,0,70,1,4,327,134,327,314,6,1673,1395
1589,5,2.2.79,0,630,0,53,79,132,79,0,132,180,-79,79,149,3,1,243,481,322,481,6,1673,1395
1589,5,3.2.168,0,630,0,93,168,261,168,0,261,261,-168,168,238,3,1,176,481,291,481,6,1673,1395
1589,5,4.0.180,0,630,0,51,180,231,0,180,231,231,0,0,70,1,4,227,134,227,314,6,1673,1395
1589,5,5.0.180,1,630,0,5,180,185,0,180,185,185,0,0,70,1,4,127,134,127,314,6,1673,1395
1589,6,0.1.180,0,630,0,80,180,260,180,0,260,260,-12,82,82,2,3,295,134,379,232,7,1673,1390
1589,6,1.0.185,1,630,0,78,185,263,0,185,263,263,0,0,70,1,5,327,129,327,314,7,1673,1390
1589,6,2.2.79,0,630,0,53,79,132,79,0,132,185,-79,79,149,3,1,243,481,322,481,7,1673,1390
1589,6,3.2.168,0,630,0,93,168,261,168,0,261,261,-168,168,238,3,1,176,481,291,481,7,1673,1390
1589,6,4.0.185,0,630,0,51,185,236,0,185,236,236,0,0,70,1,5,227,129,227,314,7,1673,1390
1589,6,5.1.185,0,630,0,2,185,187,185,0,187,187,-17,87,87,2,3,122,134,127,232,7,1673,1390
1589,7,0.1.180,0,630,0,80,180,260,180,0,260,263,-12,82,82,2,3,295,134,379,232,8,1673,1312
1589,7,1.1.263,0,630,0,44,263,307,263,0,307,307,-95,165,165,2,3,249,134,327,232,8,1673,1312
1589,7,2.2.79,0,630,0,53,79,132,79,0,132,263,-79,79,149,3,1,243,481,322,481,8,1673,1312
1589,7,3.2.168,0,630,0,93,168,261,168,0,261,263,-168,168,238,3,1,176,481,291,481,8,1673,1312
1589,7,4.0.263,1,630,0,51,263,314,0,263,314,314,0,0,70,1,6,227,51,227,314,8,1673,1312
1589,7,5.1.185,0,636,1,2,185,187,185,0,187,263,-17,87,87,2,3,122,134,127,232,8,1673,1312
1589,8,0.1.180,1,630,0,80,180,260,180,0,260,314,-12,82,82,2,3,295,134,379,232,9,1673,1261
1589,8,1.1.263,0,630,0,44,263,307,263,0,307,314,-95,165,165,2,3,249,134,327,232,9,1673,1261
1589,8,2.2.79,0,630,0,53,79,132,79,0,132,314,-79,79,149,3,1,243,481,322,481,9,1673,1261
1589,8,3.2.168,0,630,0,93,168,261,168,0,261,314,-168,168,238,3,1,176,481,291,481,9,1673,1261
1589,8,4.1.314,0,630,0,8,314,322,314,0,322,322,-146,216,216,2,3,176,134,227,232,9,1673,1261
1589,8,5.1.185,0,636,1,2,185,187,185,0,187,314,-17,87,87,2,3,122,134,127,232,9,1673,1261
1589,9,0.2.260,0,722,1,87,260,347,260,0,347,347,-260,260,342,3,1,215,481,379,481,10,1673,1181
1589,9,1.1.263,0,630,0,44,263,307,263,0,307,314,-3,85,85,2,4,249,54,327,232,10,1673,1181
1589,9,2.2.79,0,630,0,53,79,132,79,0,132,314,-79,79,161,3,1,243,481,322,481,10,1673,1181
1589,9,3.2.168,0,630,0,93,168,261,168,0,261,314,-168,168,250,3,1,176,481,291,481,10,1673,1181
1589,9,4.1.314,0,630,0,8,314,322,314,0,322,322,-54,136,136,2,4,176,54,227,232,10,1673,1181
1589,9,5.1.260,1,630,0,2,260,262,185,75,262,314,0,82,82,2,4,122,54,127,232,10,1673,1181
1589,10,0.2.260,0,722,2,87,260,347,260,0,347,347,-260,260,342,3,1,215,481,379,481,11,1673,1179
1589,10,1.1.263,1,630,0,44,263,307,263,0,307,314,-1,83,83,2,5,249,52,327,232,11,1673,1179
1589,10,2.2.79,0,630,0,53,79,132,79,0,132,314,-79,79,161,3,1,243,481,322,481,11,1673,1179
1589,10,3.2.168,0,630,0,93,168,261,168,0,261,314,-168,168,250,3,1,176,481,291,481,11,1673,1179
1589,10,4.1.314,0,630,0,8,314,322,314,0,322,322,-52,134,134,2,5,176,52,227,232,11,1673,1179
1589,10,5.2.262,0,695,1,86,262,348,262,0,348,348,-262,262,344,3,1,120,481,127,481,11,1673,1179
1589,11,0.2.260,0,722,3,87,260,347,260,0,347,347,-260,260,343,3,1,215,481,379,481,12,1673,1135
1589,11,1.2.307,0,676,1,92,307,399,307,0,399,399,-307,307,390,3,1,205,481,327,481,12,1673,1135
1589,11,2.2.79,0,630,0,53,79,132,79,0,132,314,-79,79,162,3,1,243,481,322,481,12,1673,1135
1589,11,3.2.168,0,630,0,93,168,261,168,0,261,314,-168,168,251,3,1,176,481,291,481,12,1673,1135
1589,11,4.1.314,1,630,0,8,314,322,314,0,322,322,-7,90,90,2,6,176,8,227,232,12,1673,1135
1589,11,5.2.262,0,695,2,86,262,348,262,0,348,348,-262,262,345,3,1,120,481,127,481,12,1673,1135
1589,12,0.2.260,0,722,4,87,260,347,260,0,347,347,-260,260,350,3,1,215,481,379,481,13,1673,1127
1589,12,1.2.307,0,676,1,92,307,399,307,0,399,399,-307,307,397,3,1,205,481,327,481,13,1673,1127
1589,12,2.2.79,1,630,0,53,79,132,79,0,132,322,-79,79,169,3,1,243,481,322,481,13,1673,1127
1589,12,3.2.168,0,630,0,93,168,261,168,0,261,322,-168,168,258,3,1,176,481,291,481,13,1673,1127
1589,12,4.2.322,0,691,2,70,322,392,322,0,392,392,-322,322,412,3,1,168,481,227,481,13,1673,1127
1589,12,5.2.262,0,695,3,86,262,348,262,0,348,348,-262,262,352,3,1,120,481,127,481,13,1673,1127
1589,13,0.2.260,0,722,4,87,260,347,260,0,347,347,-128,207,297,3,2,215,428,379,481,14,1673,1074
1589,13,1.2.307,0,676,1,92,307,399,307,0,399,399,-175,254,344,3,2,205,428,327,481,14,1673,1074
1589,13,2.3.132,1,630,0,92,132,224,132,0,224,322,-132,132,301,4,1,190,318,322,318,14,1673,1074
1589,13,3.2.168,0,630,0,93,168,261,168,0,261,322,-36,115,205,3,2,176,428,291,481,14,1673,1074
1589,13,4.2.322,0,691,2,70,322,392,322,0,392,392,-190,269,359,3,2,168,428,227,481,14,1673,1074
1589,13,5.2.262,0,695,3,86,262,348,262,0,348,348,-130,209,299,3,2,120,428,127,481,14,1673,1074
1589,14,0.2.260,0,722,4,87,260,347,260,0,347,347,-128,207,429,3,2,215,428,379,481,15,1673,982
1589,14,1.2.307,0,676,1,92,307,399,307,0,399,399,-175,254,476,3,2,205,428,327,481,15,1673,982
1589,14,2.4.224,1,630,0,98,224,322,224,0,322,322,-224,224,525,5,1,98,328,322,328,15,1673,982
1589,14,3.2.168,0,630,0,93,168,261,168,0,261,322,-36,115,337,3,2,176,428,291,481,15,1673,982
1589,14,4.2.322,0,691,2,70,322,392,322,0,392,392,-190,269,491,3,2,168,428,227,481,15,1673,982
1589,14,5.2.262,0,695,3,86,262,348,262,0,348,348,-130,209,431,3,2,120,428,127,481,15,1673,982
1589,15,0.2.260,0,722,4,87,260,347,260,0,347,347,-128,207,653,3,2,215,428,379,481,16,1673,884
1589,15,1.2.307,0,676,1,92,307,399,307,0,399,399,-175,254,700,3,2,205,428,327,481,16,1673,884
1589,15,3.2.168,1,630,0,93,168,261,168,0,261,322,-36,115,561,3,2,176,428,291,481,16,1673,884
1589,15,4.2.322,0,691,2,70,322,392,322,0,392,392,-190,269,715,3,2,168,428,227,481,16,1673,884
1589,15,5.2.262,0,695,3,86,262,348,262,0,348,348,-130,209,655,3,2,120,428,127,481,16,1673,884
1589,16,0.2.261,0,630,0,87,261,348,260,1,348,348,0,115,561,3,3,215,335,379,481,17,1673,791
1589,16,1.2.307,0,676,1,92,307,399,307,0,399,399,-46,161,607,3,3,205,335,327,481,17,1673,791
1589,16,3.3.261,1,630,0,42,261,303,261,0,303,322,-37,169,598,4,2,83,226,291,318,17,1673,791
1589,16,4.2.322,0,691,2,70,322,392,322,0,392,392,-61,176,622,3,3,168,335,227,481,17,1673,791
1589,16,5.2.262,0,695,3,86,262,348,262,0,348,348,-1,116,562,3,3,120,335,127,481,17,1673,791
1589,17,0.2.261,0,630,0,87,261,348,260,1,348,348,0,115,598,3,3,215,335,379,481,18,1673,749
1589,17,1.2.307,0,676,1,92,307,399,307,0,399,399,-46,161,644,3,3,205,335,327,481,18,1673,749
1589,17,3.4.322,1,630,0,41,322,363,303,19,363,363,0,224,598,5,2,41,230,291,328,18,1673,749
1589,17,4.2.322,0,691,2,70,322,392,322,0,392,392,-61,176,659,3,3,168,335,227,481,18,1673,749
1589,17,5.2.262,0,695,3,86,262,348,262,0,348,348,-1,116,599,3,3,120,335,127,481,18,1673,749
1589,18,0.2.261,1,630,0,87,261,348,260,1,348,363,0,115,598,3,3,215,335,379,481,19,1673,708
1589,18,1.2.307,0,676,1,92,307,399,307,0,399,399,-46,161,644,3,3,205,335,327,481,19,1673,708
1589,18,4.2.322,0,691,2,70,322,392,322,0,392,392,-61,176,659,3,3,168,335,227,481,19,1673,708
1589,18,5.2.262,0,695,3,86,262,348,262,0,348,363,-1,116,599,3,3,120,335,127,481,19,1673,708
1589,19,0.3.348,1,630,0,43,348,391,348,0,391,391,-45,214,643,4,3,128,184,379,318,20,1673,621
1589,19,1.2.348,0,630,0,92,348,440,307,41,440,440,0,115,598,3,4,205,248,327,481,20,1673,621
1589,19,4.2.348,0,630,0,70,348,418,322,26,418,418,0,115,598,3,4,168,248,227,481,20,1673,621
1589,19,5.2.348,0,694,1,86,348,434,262,86,434,434,0,115,598,3,4,120,248,127,481,20,1673,621
1589,20,0.4.391,1,630,0,85,391,476,391,0,476,476,-28,252,671,5,3,85,189,379,328,21,1673,578
1589,20,1.2.348,0,630,0,92,348,440,307,41,440,440,0,115,643,3,4,205,248,327,481,21,1673,578
1589,20,4.2.348,0,630,0,70,348,418,322,26,418,418,0,115,643,3,4,168,248,227,481,21,1673,578
1589,20,5.2.348,0,694,1,86,348,434,262,86,434,434,0,115,643,3,4,120,248,127,481,21,1673,578
1589,21,1.2.348,1,630,0,92,348,440,307,41,440,476,0,115,671,3,4,205,248,327,481,22,1673,493
1589,21,4.2.348,0,630,0,70,348,418,322,26,418,476,0,115,671,3,4,168,248,227,481,22,1673,493
1589,21,5.2.348,0,694,1,86,348,434,262,86,434,476,0,115,671,3,4,120,248,127,481,22,1673,493
1589,22,1.3.440,1,630,0,65,440,505,440,0,505,505,-49,263,720,4,4,113,141,327,318,23,1673,401
1589,22,4.2.440,0,630,0,70,440,510,322,118,510,510,0,115,671,3,5,168,156,227,481,23,1673,401
1589,22,5.2.440,0,694,1,86,440,526,262,178,526,526,0,115,671,3,5,120,156,127,481,23,1673,401
1589,23,1.4.505,1,630,0,48,505,553,505,0,553,553,-29,281,749,5,4,48,104,327,328,24,1673,336
1589,23,4.2.440,0,630,0,70,440,510,322,118,510,510,0,115,720,3,5,168,156,227,481,24,1673,336
1589,23,5.2.440,0,694,1,86,440,526,262,178,526,526,0,115,720,3,5,120,156,127,481,24,1673,336
1589,24,4.2.440,1,630,0,70,440,510,322,118,510,553,0,115,749,3,5,168,156,227,481,25,1673,288
1589,24,5.2.440,0,694,1,86,440,526,262,178,526,553,0,115,749,3,5,120,156,127,481,25,1673,288
1589,25,4.3.510,1,630,0,49,510,559,510,0,559,559,-5,268,754,4,5,98,76,227,318,26,1673,218
1589,25,5.2.510,0,630,0,86,510,596,262,248,596,596,0,115,749,3,6,120,86,127,481,26,1673,218
1589,26,4.4.559,1,630,0,49,559,608,559,0,608,608,-6,287,760,5,5,49,56,227,328,27,1673,169
1589,26,5.2.510,0,630,0,86,510,596,262,248,596,596,0,115,754,3,6,120,86,127,481,27,1673,169
1589,27,5.2.510,1,630,0,86,510,596,262,248,596,608,0,115,760,3,6,120,86,127,481,28,1673,120
1589,28,5.3.596,1,630,0,27,596,623,596,0,623,623,-37,305,797,4,6,34,27,127,318,29,1673,34
1589,29,5.4.623,1,630,0,7,623,630,623,0,630,630,-15,302,812,5,6,7,7,127,328,30,1673,7
1590,0,0.0.0,0,614,2,97,0,97,0,0,97,97,0,0,0,1,1,323,429,323,429,1,1545,1545
1590,0,1.0.0,0,580,0,54,0,54,0,0,54,54,0,0,0,1,1,227,429,227,429,1,1545,1545
1590,0,2.0.0,0,614,2,99,0,99,0,0,99,99,0,0,0,1,1,250,429,250,429,1,1545,1545
1590,0,3.0.0,0,599,1,96,0,96,0,0,96,96,0,0,0,1,1,252,429,252,429,1,1545,1545
1590,0,4.0.0,0,620,3,73,0,73,0,0,73,73,0,0,0,1,1,265,429,265,429,1,1545,1545
1590,0,5.0.0,1,580,0,10,0,10,0,0,10,10,0,0,0,1,1,228,429,228,429,1,1545,1545
1590,1,0.0.10,0,586,1,97,10,107,0,10,107,107,0,0,0,1,2,323,419,323,429,2,1545,1535
1590,1,1.0.10,0,580,0,54,10,64,0,10,64,64,0,0,0,1,2,227,419,227,429,2,1545,1535
1590,1,2.0.10,0,614,4,99,10,109,0,10,109,109,0,0,0,1,2,250,419,250,429,2,1545,1535
1590,1,3.0.10,0,599,2,96,10,106,0,10,106,106,0,0,0,1,2,252,419,252,429,2,1545,1535
1590,1,4.0.10,0,610,3,73,10,83,0,10,83,83,0,0,0,1,2,265,419,265,429,2,1545,1535
1590,1,5.1.10,1,586,1,84,10,94,10,0,94,94,-10,10,10,2,1,218,234,228,234,2,1545,1535
1590,2,0.0.10,0,586,0,97,10,107,0,10,107,107,0,0,10,1,2,323,419,323,429,3,1545,1451
1590,2,1.0.10,0,586,0,54,10,64,0,10,64,94,0,0,10,1,2,227,419,227,429,3,1545,1451
1590,2,2.0.10,0,614,3,99,10,109,0,10,109,109,0,0,10,1,2,250,419,250,429,3,1545,1451
1590,2,3.0.10,0,599,1,96,10,106,0,10,106,106,0,0,10,1,2,252,419,252,429,3,1545,1451
1590,2,4.0.10,0,610,2,73,10,83,0,10,83,94,0,0,10,1,2,265,419,265,429,3,1545,1451
1590,2,5.2.94,1,586,0,25,94,119,94,0,119,119,-94,94,104,3,1,134,349,228,349,3,1545,1451
1590,3,0.0.10,0,586,0,97,10,107,0,10,107,119,0,0,104,1,2,323,419,323,429,4,1545,1426
1590,3,1.0.10,0,586,0,54,10,64,0,10,64,119,0,0,104,1,2,227,419,227,429,4,1545,1426
1590,3,2.0.10,0,614,3,99,10,109,0,10,109,119,0,0,104,1,2,250,419,250,429,4,1545,1426
1590,3,3.0.10,0,599,1,96,10,106,0,10,106,119,0,0,104,1,2,252,419,252,429,4,1545,1426
1590,3,4.0.10,0,610,2,73,10,83,0,10,83,119,0,0,104,1,2,265,419,265,429,4,1545,1426
1590,3,5.3.119,1,586,0,12,119,131,119,0,131,131,-119,119,223,4,1,109,175,228,175,4,1545,1426
1590,4,0.0.10,0,586,0,97,10,107,0,10,107,131,0,0,223,1,2,323,419,323,429,5,1545,1414
1590,4,1.0.10,0,586,0,54,10,64,0,10,64,131,0,0,223,1,2,227,419,227,429,5,1545,1414
1590,4,2.0.10,0,614,3,99,10,109,0,10,109,131,0,0,223,1,2,250,419,250,429,5,1545,1414
1590,4,3.0.10,0,599,1,96,10,106,0,10,106,131,0,0,223,1,2,252,419,252,429,5,1545,1414
1590,4,4.0.10,0,610,2,73,10,83,0,10,83,131,0,0,223,1,2,265,419,265,429,5,1545,1414
1590,4,5.4.131,1,586,0,97,131,228,131,0,228,228,-131,131,354,5,1,97,358,228,358,5,1545,1414
1590,5,0.0.10,0,586,0,97,10,107,0,10,107,228,0,0,354,1,2,323,419,323,429,6,1545,1317
1590,5,1.0.10,1,586,0,54,10,64,0,10,64,228,0,0,354,1,2,227,419,227,429,6,1545,1317
1590,5,2.0.10,0,614,3,99,10,109,0,10,109,228,0,0,354,1,2,250,419,250,429,6,1545,1317
1590,5,3.0.10,0,599,1,96,10,106,0,10,106,228,0,0,354,1,2,252,419,252,429,6,1545,1317
1590,5,4.0.10,0,610,2,73,10,83,0,10,83,228,0,0,354,1,2,265,419,265,429,6,1545,1317
1590,6,0.0.64,0,586,0,97,64,161,0,64,161,228,0,0,354,1,3,323,365,323,429,7,1545,1263
1590,6,1.1.94,1,586,0,12,94,106,64,30,106,228,0,10,354,2,2,173,150,227,234,7,1545,1263
1590,6,2.0.64,0,614,3,99,64,163,0,64,163,228,0,0,354,1,3,250,365,250,429,7,1545,1263
1590,6,3.0.64,0,599,1,96,64,160,0,64,160,228,0,0,354,1,3,252,365,252,429,7,1545,1263
1590,6,4.0.64,0,612,2,73,64,137,0,64,137,228,0,0,354,1,3,265,365,265,429,7,1545,1263
1590,7,0.0.64,0,586,0,97,64,161,0,64,161,228,0,0,354,1,3,323,365,323,429,8,1545,1251
1590,7,1.2.119,1,586,0,97,119,216,106,13,216,228,0,94,354,3,2,161,324,227,349,8,1545,1251
1590,7,2.0.64,0,614,3,99,64,163,0,64,163,228,0,0,354,1,3,250,365,250,429,8,1545,1251
1590,7,3.0.64,0,599,1,96,64,160,0,64,160,228,0,0,354,1,3,252,365,252,429,8,1545,1251
1590,7,4.0.64,0,612,2,73,64,137,0,64,137,228,0,0,354,1,3,265,365,265,429,8,1545,1251
1590,8,0.0.64,0,586,0,97,64,161,0,64,161,228,0,0,354,1,3,323,365,323,429,9,1545,1154
1590,8,1.3.216,1,586,0,7,216,223,216,0,223,228,-85,204,439,4,2,64,163,227,175,9,1545,1154
1590,8,2.0.64,0,614,3,99,64,163,0,64,163,228,0,0,354,1,3,250,365,250,429,9,1545,1154
1590,8,3.0.64,0,599,1,96,64,160,0,64,160,228,0,0,354,1,3,252,365,252,429,9,1545,1154
1590,8,4.0.64,0,612,2,73,64,137,0,64,137,228,0,0,354,1,3,265,365,265,429,9,1545,1154
1590,9,0.0.64,0,586,0,97,64,161,0,64,161,228,0,0,439,1,3,323,365,323,429,10,1545,1147
1590,9,1.4.228,1,586,0,57,228,285,223,5,285,285,0,131,439,5,2,57,261,227,358,10,1545,1147
1590,9,2.0.64,0,614,3,99,64,163,0,64,163,228,0,0,439,1,3,250,365,250,429,10,1545,1147
1590,9,3.0.64,0,599,1,96,64,160,0,64,160,228,0,0,439,1,3,252,365,252,429,10,1545,1147
1590,9,4.0.64,0,612,2,73,64,137,0,64,137,228,0,0,439,1,3,265,365,265,429,10,1545,1147
1590,10,0.0.64,0,586,0,97,64,161,0,64,161,285,0,0,439,1,3,323,365,323,429,11,1545,1090
1590,10,2.0.64,0,614,3,99,64,163,0,64,163,285,0,0,439,1,3,250,365,250,429,11,1545,1090
1590,10,3.0.64,0,599,1,96,64,160,0,64,160,285,0,0,439,1,3,252,365,252,429,11,1545,1090
1590,10,4.0.64,1,612,2,73,64,137,0,64,137,285,0,0,439,1,3,265,365,265,429,11,1545,1090
1590,11,0.0.137,0,612,0,97,137,234,0,137,234,285,0,0,439,1,4,323,292,323,429,12,1545,1017
1590,11,2.0.137,0,642,2,99,137,236,0,137,236,285,0,0,439,1,4,250,292,250,429,12,1545,1017
1590,11,3.0.137,0,633,1,96,137,233,0,137,233,285,0,0,439,1,4,252,292,252,429,12,1545,1017
1590,11,4.1.137,1,612,0,59,137,196,137,0,196,285,-31,41,470,2,3,192,138,265,234,12,1545,1017
1590,12,0.0.137,0,612,0,97,137,234,0,137,234,285,0,0,470,1,4,323,292,323,429,13,1545,958
1590,12,2.0.137,0,642,2,99,137,236,0,137,236,285,0,0,470,1,4,250,292,250,429,13,1545,958
1590,12,3.0.137,0,633,1,96,137,233,0,137,233,285,0,0,470,1,4,252,292,252,429,13,1545,958
1590,12,4.2.216,1,612,0,71,216,287,196,20,287,287,0,94,470,3,3,133,227,265,349,13,1545,958
1590,13,0.0.137,0,612,0,97,137,234,0,137,234,287,0,0,470,1,4,323,292,323,429,14,1545,887
1590,13,2.0.137,0,642,2,99,137,236,0,137,236,287,0,0,470,1,4,250,292,250,429,14,1545,887
1590,13,3.0.137,0,633,1,96,137,233,0,137,233,287,0,0,470,1,4,252,292,252,429,14,1545,887
1590,13,4.3.287,1,612,0,43,287,330,287,0,330,330,-64,268,534,4,3,62,156,265,175,14,1545,887
1590,14,0.0.137,0,612,0,97,137,234,0,137,234,330,0,0,534,1,4,323,292,323,429,15,1545,844
1590,14,2.0.137,0,642,2,99,137,236,0,137,236,330,0,0,534,1,4,250,292,250,429,15,1545,844
1590,14,3.0.137,0,633,1,96,137,233,0,137,233,330,0,0,534,1,4,252,292,252,429,15,1545,844
1590,14,4.4.330,1,612,0,19,330,349,330,0,349,349,-45,176,579,5,3,19,204,265,358,15,1545,844
1590,15,0.0.137,1,612,0,97,137,234,0,137,234,349,0,0,579,1,4,323,292,323,429,16,1545,825
1590,15,2.0.137,0,642,2,99,137,236,0,137,236,349,0,0,579,1,4,250,292,250,429,16,1545,825
1590,15,3.0.137,0,633,1,96,137,233,0,137,233,349,0,0,579,1,4,252,292,252,429,16,1545,825
1590,16,0.1.234,1,612,0,48,234,282,234,0,282,349,-38,79,617,2,4,226,79,323,234,17,1545,728
1590,16,2.0.234,0,620,1,99,234,333,0,234,333,349,0,0,579,1,5,250,195,250,429,17,1545,728
1590,16,3.0.234,0,612,0,96,234,330,0,234,330,349,0,0,579,1,5,252,195,252,429,17,1545,728
1590,17,0.2.287,1,612,0,90,287,377,282,5,377,377,0,94,617,3,4,178,156,323,349,18,1545,680
1590,17,2.0.234,0,620,1,99,234,333,0,234,333,349,0,0,617,1,5,250,195,250,429,18,1545,680
1590,17,3.0.234,0,612,0,96,234,330,0,234,330,349,0,0,617,1,5,252,195,252,429,18,1545,680
1590,18,0.3.377,1,612,0,50,377,427,377,0,427,427,-47,315,664,4,4,88,113,323,175,19,1545,590
1590,18,2.0.234,0,629,1,99,234,333,0,234,333,377,0,0,617,1,5,250,195,250,429,19,1545,590
1590,18,3.0.234,0,612,0,96,234,330,0,234,330,377,0,0,617,1,5,252,195,252,429,19,1545,590
1590,19,0.4.427,1,612,0,38,427,465,427,0,465,465,-78,254,742,5,4,38,185,323,358,20,1545,540
1590,19,2.0.234,0,635,1,99,234,333,0,234,333,427,0,0,664,1,5,250,195,250,429,20,1545,540
1590,19,3.0.234,0,612,0,96,234,330,0,234,330,427,0,0,664,1,5,252,195,252,429,20,1545,540
1590,20,2.0.234,0,635,1,99,234,333,0,234,333,465,0,0,742,1,5,250,195,250,429,21,1545,502
1590,20,3.0.234,1,612,0,96,234,330,0,234,330,465,0,0,742,1,5,252,195,252,429,21,1545,502
1590,21,2.0.330,0,612,0,99,330,429,0,330,429,465,0,0,742,1,6,250,99,250,429,22,1545,406
1590,21,3.1.330,1,612,0,11,330,341,330,0,341,465,-48,127,790,2,5,156,31,252,234,22,1545,406
1590,22,2.0.330,0,612,0,99,330,429,0,330,429,465,0,0,790,1,6,250,99,250,429,23,1545,395
1590,22,3.2.377,1,612,0,60,377,437,341,36,437,465,0,94,790,3,5,145,66,252,349,23,1545,395
1590,23,2.0.330,0,612,0,99,330,429,0,330,429,465,0,0,790,1,6,250,99,250,429,24,1545,335
1590,23,3.3.437,1,612,0,2,437,439,437,0,439,465,-10,325,800,4,5,85,63,252,175,24,1545,335
1590,24,2.0.330,0,612,0,99,330,429,0,330,429,465,0,0,800,1,6,250,99,250,429,25,1545,333
1590,24,3.4.465,1,612,0,83,465,548,439,26,548,548,0,254,800,5,5,83,147,252,358,25,1545,333
1590,25,2.0.330,1,612,0,99,330,429,0,330,429,548,0,0,800,1,6,250,99,250,429,26,1545,250
1590,26,2.1.429,1,612,0,20,429,449,429,0,449,548,-88,215,888,2,6,151,20,250,234,27,1545,151
1590,27,2.2.449,1,612,0,6,449,455,449,0,455,548,-12,106,900,3,6,131,6,250,349,28,1545,131
1590,28,2.3.455,1,612,0,61,455,516,455,0,516,548,-16,341,916,4,6,125,61,250,175,29,1545,125
1590,29,2.4.548,1,612,0,64,548,612,516,32,612,612,0,254,916,5,6,64,64,250,358,30,1545,64
1591,0,0.0.0,0,558,0,11,0,11,0,0,11,11,0,0,0,1,1,267,245,267,245,1,1512,1512
1591,0,1.0.0,0,588,2,30,0,30,0,0,30,30,0,0,0,1,1,226,245,226,245,1,1512,1512
1591,0,2.0.0,0,603,3,45,0,45,0,0,45,45,0,0,0,1,1,176,245,176,245,1,1512,1512
1591,0,3.0.0,0,608,4,50,0,50,0,0,50,50,0,0,0,1,1,212,245,212,245,1,1512,1512
1591,0,4.0.0,0,612,5,95,0,95,0,0,95,95,0,0,0,1,1,303,245,303,245,1,1512,1512
1591,0,5.0.0,1,572,1,14,0,14,0,0,14,14,0,0,0,1,1,328,245,328,245,1,1512,1512
1591,1,0.0.14,0,572,0,11,14,25,0,14,25,25,0,0,0,1,2,267,231,267,245,2,1512,1498
1591,1,1.0.14,0,602,1,30,14,44,0,14,44,44,0,0,0,1,2,226,231,226,245,2,1512,1498
1591,1,2.0.14,0,617,4,45,14,59,0,14,59,59,0,0,0,1,2,176,231,176,245,2,1512,1498
1591,1,3.0.14,0,622,5,50,14,64,0,14,64,64,0,0,0,1,2,212,231,212,245,2,1512,1498
1591,1,4.0.14,0,615,3,95,14,109,0,14,109,109,0,0,0,1,2,303,231,303,245,2,1512,1498
1591,1,5.1.14,1,607,2,67,14,81,14,0,81,81,-14,14,14,2,1,314,236,328,236,2,1512,1498
1591,2,0.0.14,1,607,0,11,14,25,0,14,25,81,0,0,14,1,2,267,231,267,245,3,1512,1431
1591,2,1.0.14,0,607,0,30,14,44,0,14,44,81,0,0,14,1,2,226,231,226,245,3,1512,1431
1591,2,2.0.14,0,625,2,45,14,59,0,14,59,81,0,0,14,1,2,176,231,176,245,3,1512,1431
1591,2,3.0.14,0,627,3,50,14,64,0,14,64,81,0,0,14,1,2,212,231,212,245,3,1512,1431
1591,2,4.0.14,0,615,1,95,14,109,0,14,109,109,0,0,14,1,2,303,231,303,245,3,1512,1431
1591,2,5.2.81,0,607,0,63,81,144,81,0,144,144,-81,81,95,3,1,247,317,328,317,3,1512,1431
1591,3,0.1.81,1,623,1,16,81,97,25,56,97,97,0,14,14,2,2,256,169,267,236,4,1512,1420
1591,3,1.0.25,0,607,0,30,25,55,0,25,55,81,0,0,14,1,3,226,220,226,245,4,1512,1420
1591,3,2.0.25,0,625,2,45,25,70,0,25,70,81,0,0,14,1,3,176,220,176,245,4,1512,1420
1591,3,3.0.25,0,627,4,50,25,75,0,25,75,81,0,0,14,1,3,212,220,212,245,4,1512,1420
1591,3,4.0.25,0,626,3,95,25,120,0,25,120,120,0,0,14,1,3,303,220,303,245,4,1512,1420
1591,3,5.2.81,0,607,0,63,81,144,81,0,144,144,-81,81,95,3,1,247,317,328,317,4,1512,1420
1591,4,0.2.97,0,628,3,93,97,190,97,0,190,190,-97,97,111,3,1,240,317,267,317,5,1512,1404
1591,4,1.0.25,1,623,0,30,25,55,0,25,55,97,0,0,14,1,3,226,220,226,245,5,1512,1404
1591,4,2.0.25,0,627,2,45,25,70,0,25,70,97,0,0,14,1,3,176,220,176,245,5,1512,1404
1591,4,3.0.25,0,627,2,50,25,75,0,25,75,97,0,0,14,1,3,212,220,212,245,5,1512,1404
1591,4,4.0.25,0,626,1,95,25,120,0,25,120,120,0,0,14,1,3,303,220,303,245,5,1512,1404
1591,4,5.2.81,0,623,0,63,81,144,81,0,144,144,-81,81,95,3,1,247,317,328,317,5,1512,1404
1591,5,0.2.97,0,628,2,93,97,190,97,0,190,190,-97,97,111,3,1,240,317,267,317,6,1512,1374
1591,5,1.1.97,1,623,0,79,97,176,55,42,176,176,0,14,14,2,3,196,153,226,236,6,1512,1374
1591,5,2.0.55,0,627,1,45,55,100,0,55,100,100,0,0,14,1,4,176,190,176,245,6,1512,1374
1591,5,3.0.55,0,627,1,50,55,105,0,55,105,105,0,0,14,1,4,212,190,212,245,6,1512,1374
1591,5,4.0.55,0,623,0,95,55,150,0,55,150,150,0,0,14,1,4,303,190,303,245,6,1512,1374
1591,5,5.2.81,0,623,0,63,81,144,81,0,144,144,-81,81,95,3,1,247,317,328,317,6,1512,1374
1591,6,0.2.97,0,628,2,93,97,190,97,0,190,190,-97,97,111,3,1,240,317,267,317,7,1512,1295
1591,6,1.2.176,0,623,0,3,176,179,176,0,179,179,-176,176,190,3,1,117,317,226,317,7,1512,1295
1591,6,2.0.55,0,627,1,45,55,100,0,55,100,176,0,0,14,1,4,176,190,176,245,7,1512,1295
1591,6,3.0.55,1,627,1,50,55,105,0,55,105,176,0,0,14,1,4,212,190,212,245,7,1512,1295
1591,6,4.0.55,0,623,0,95,55,150,0,55,150,176,0,0,14,1,4,303,190,303,245,7,1512,1295
1591,6,5.2.81,0,623,0,63,81,144,81,0,144,176,-81,81,95,3,1,247,317,328,317,7,1512,1295
1591,7,0.2.97,0,628,1,93,97,190,97,0,190,190,-97,97,111,3,1,240,317,267,317,8,1512,1245
1591,7,1.2.176,0,627,0,3,176,179,176,0,179,179,-176,176,190,3,1,117,317,226,317,8,1512,1245
1591,7,2.0.105,0,627,0,45,105,150,0,105,150,176,0,0,14,1,5,176,140,176,245,8,1512,1245
1591,7,3.1.176,1,627,0,49,176,225,105,71,225,225,0,14,14,2,4,162,74,212,236,8,1512,1245
1591,7,4.0.105,0,627,0,95,105,200,0,105,200,200,0,0,14,1,5,303,140,303,245,8,1512,1245
1591,7,5.2.81,0,627,0,63,81,144,81,0,144,176,-81,81,95,3,1,247,317,328,317,8,1512,1245
1591,8,0.2.97,0,628,1,93,97,190,97,0,190,225,-97,97,111,3,1,240,317,267,317,9,1512,1196
1591,8,1.2.176,0,627,0,3,176,179,176,0,179,225,-176,176,190,3,1,117,317,226,317,9,1512,1196
1591,8,2.0.105,0,627,0,45,105,150,0,105,150,225,0,0,14,1,5,176,140,176,245,9,1512,1196
1591,8,3.2.225,0,627,0,28,225,253,225,0,253,253,-225,225,239,3,1,113,317,212,317,9,1512,1196
1591,8,4.0.105,1,627,0,95,105,200,0,105,200,225,0,0,14,1,5,303,140,303,245,9,1512,1196
1591,8,5.2.81,0,627,0,63,81,144,81,0,144,225,-81,81,95,3,1,247,317,328,317,9,1512,1196
1591,9,0.2.97,0,628,1,93,97,190,97,0,190,225,-97,97,111,3,1,240,317,267,317,10,1512,1101
1591,9,1.2.176,0,627,0,3,176,179,176,0,179,225,-176,176,190,3,1,117,317,226,317,10,1512,1101
1591,9,2.0.200,0,627,0,45,200,245,0,200,245,245,0,0,14,1,6,176,45,176,245,10,1512,1101
1591,9,3.2.225,0,627,0,28,225,253,225,0,253,253,-225,225,239,3,1,113,317,212,317,10,1512,1101
1591,9,4.1.225,1,627,0,12,225,237,200,25,237,237,0,14,14,2,5,208,25,303,236,10,1512,1101
1591,9,5.2.81,0,627,0,63,81,144,81,0,144,225,-81,81,95,3,1,247,317,328,317,10,1512,1101
1591,10,0.2.97,0,628,1,93,97,190,97,0,190,237,-97,97,111,3,1,240,317,267,317,11,1512,1089
1591,10,1.2.176,0,627,0,3,176,179,176,0,179,237,-176,176,190,3,1,117,317,226,317,11,1512,1089
1591,10,2.0.200,1,627,0,45,200,245,0,200,245,245,0,0,14,1,6,176,45,176,245,11,1512,1089
1591,10,3.2.225,0,627,0,28,225,253,225,0,253,253,-225,225,239,3,1,113,317,212,317,11,1512,1089
1591,10,4.2.237,0,627,0,71,237,308,237,0,308,308,-237,237,251,3,1,196,317,303,317,11,1512,1089
1591,10,5.2.81,0,627,0,63,81,144,81,0,144,237,-81,81,95,3,1,247,317,328,317,11,1512,1089
1591,11,0.2.97,0,628,1,93,97,190,97,0,190,245,-97,97,111,3,1,240,317,267,317,12,1512,1044
1591,11,1.2.176,0,627,0,3,176,179,176,0,179,245,-176,176,190,3,1,117,317,226,317,12,1512,1044
1591,11,2.1.245,1,627,0,13,245,258,245,0,258,258,-8,22,22,2,6,131,13,176,236,12,1512,1044
1591,11,3.2.225,0,627,0,28,225,253,225,0,253,253,-225,225,239,3,1,113,317,212,317,12,1512,1044
1591,11,4.2.237,0,627,0,71,237,308,237,0,308,308,-237,237,251,3,1,196,317,303,317,12,1512,1044
1591,11,5.2.81,0,627,0,63,81,144,81,0,144,245,-81,81,95,3,1,247,317,328,317,12,1512,1044
1591,12,0.2.97,0,628,1,93,97,190,97,0,190,258,-97,97,119,3,1,240,317,267,317,13,1512,1031
1591,12,1.2.176,0,627,0,3,176,179,176,0,179,258,-176,176,198,3,1,117,317,226,317,13,1512,1031
1591,12,2.2.258,0,627,0,59,258,317,258,0,317,317,-258,258,280,3,1,118,317,176,317,13,1512,1031
1591,12,3.2.225,0,627,0,28,225,253,225,0,253,258,-225,225,247,3,1,113,317,212,317,13,1512,1031
1591,12,4.2.237,0,627,0,71,237,308,237,0,308,308,-237,237,259,3,1,196,317,303,317,13,1512,1031
1591,12,5.2.81,1,627,0,63,81,144,81,0,144,258,-81,81,103,3,1,247,317,328,317,13,1512,1031
1591,13,0.2.144,0,627,0,93,144,237,97,47,237,258,0,81,103,3,2,240,254,267,317,14,1512,968
1591,13,1.2.176,1,627,0,3,176,179,176,0,179,258,-32,113,135,3,2,117,254,226,317,14,1512,968
1591,13,2.2.258,0,627,0,59,258,317,258,0,317,317,-114,195,217,3,2,118,254,176,317,14,1512,968
1591,13,3.2.225,0,627,0,28,225,253,225,0,253,258,-81,162,184,3,2,113,254,212,317,14,1512,968
1591,13,4.2.237,0,627,0,71,237,308,237,0,308,308,-93,174,196,3,2,196,254,303,317,14,1512,968
1591,13,5.3.144,0,627,0,96,144,240,144,0,240,258,-144,144,247,4,1,184,327,328,327,14,1512,968
1591,14,0.2.179,0,627,0,93,179,272,97,82,272,272,0,113,135,3,3,240,251,267,317,15,1512,965
1591,14,1.3.179,0,644,2,48,179,227,179,0,227,258,-179,179,314,4,1,114,327,226,327,15,1512,965
1591,14,2.2.258,0,628,1,59,258,317,258,0,317,317,-79,192,214,3,3,118,251,176,317,15,1512,965
1591,14,3.2.225,0,627,0,28,225,253,225,0,253,258,-46,159,181,3,3,113,251,212,317,15,1512,965
1591,14,4.2.237,0,627,0,71,237,308,237,0,308,308,-58,171,193,3,3,196,251,303,317,15,1512,965
1591,14,5.3.144,1,627,0,96,144,240,144,0,240,258,-144,144,279,4,1,184,327,328,327,15,1512,965
1591,15,0.2.179,0,627,0,93,179,272,97,82,272,272,0,113,279,3,3,240,251,267,317,16,1512,869
1591,15,1.3.240,1,627,0,48,240,288,179,61,288,288,0,144,279,4,2,114,231,226,327,16,1512,869
1591,15,2.2.258,0,628,1,59,258,317,258,0,317,317,-79,192,358,3,3,118,251,176,317,16,1512,869
1591,15,3.2.225,0,627,0,28,225,253,225,0,253,258,-46,159,325,3,3,113,251,212,317,16,1512,869
1591,15,4.2.237,0,627,0,71,237,308,237,0,308,308,-58,171,337,3,3,196,251,303,317,16,1512,869
1591,15,5.4.240,0,627,0,88,240,328,240,0,328,328,-240,240,519,5,1,88,387,328,387,16,1512,869
1591,16,0.2.179,1,627,0,93,179,272,97,82,272,288,0,113,279,3,3,240,251,267,317,17,1512,821
1591,16,1.4.288,0,675,2,66,288,354,288,0,354,354,-288,288,567,5,1,66,387,226,387,17,1512,821
1591,16,2.2.258,0,628,1,59,258,317,258,0,317,317,-79,192,358,3,3,118,251,176,317,17,1512,821
1591,16,3.2.225,0,627,0,28,225,253,225,0,253,288,-46,159,325,3,3,113,251,212,317,17,1512,821
1591,16,4.2.237,0,627,0,71,237,308,237,0,308,308,-58,171,337,3,3,196,251,303,317,17,1512,821
1591,16,5.4.240,0,627,0,88,240,328,240,0,328,328,-240,240,519,5,1,88,387,328,387,17,1512,821
1591,17,0.3.288,0,627,0,57,288,345,272,16,345,345,0,144,279,4,3,147,183,267,327,18,1512,728
1591,17,1.4.288,0,675,1,66,288,354,288,0,354,354,-288,288,567,5,1,66,387,226,387,18,1512,728
1591,17,2.2.272,0,627,0,59,272,331,258,14,331,331,0,113,279,3,4,118,158,176,317,18,1512,728
1591,17,3.2.272,1,627,0,28,272,300,225,47,300,300,0,113,279,3,4,113,158,212,317,18,1512,728
1591,17,4.2.272,0,627,0,71,272,343,237,35,343,343,0,113,279,3,4,196,158,303,317,18,1512,728
1591,17,5.4.240,0,627,0,88,240,328,240,0,328,328,-240,240,519,5,1,88,387,328,387,18,1512,728
1591,18,0.3.288,0,627,0,57,288,345,272,16,345,345,0,144,279,4,3,147,183,267,327,19,1512,700
1591,18,1.4.288,0,675,1,66,288,354,288,0,354,354,-288,288,567,5,1,66,387,226,387,19,1512,700
1591,18,2.2.300,0,627,0,59,300,359,258,42,359,359,0,113,279,3,5,118,130,176,317,19,1512,700
1591,18,3.3.300,0,627,0,60,300,360,300,0,360,360,-12,156,291,4,3,85,183,212,327,19,1512,700
1591,18,4.2.300,1,627,0,71,300,371,237,63,371,371,0,113,279,3,5,196,130,303,317,19,1512,700
1591,18,5.4.240,0,627,0,88,240,328,240,0,328,328,-240,240,519,5,1,88,387,328,387,19,1512,700
1591,19,0.3.288,0,627,0,57,288,345,272,16,345,371,0,144,279,4,3,147,183,267,327,20,1512,629
1591,19,1.4.288,0,675,1,66,288,354,288,0,354,371,-288,288,567,5,1,66,387,226,387,20,1512,629
1591,19,2.2.371,1,627,0,59,371,430,258,113,430,430,0,113,279,3,6,118,59,176,317,20,1512,629
1591,19,3.3.300,0,627,0,60,300,360,300,0,360,371,-12,156,291,4,3,85,183,212,327,20,1512,629
1591,19,4.3.371,0,627,0,36,371,407,371,0,407,407,-83,227,362,4,3,125,183,303,327,20,1512,629
1591,19,5.4.240,0,627,0,88,240,328,240,0,328,371,-240,240,519,5,1,88,387,328,387,20,1512,629
1591,20,0.3.288,1,627,0,57,288,345,272,16,345,430,0,144,279,4,3,147,183,267,327,21,1512,570
1591,20,1.4.288,0,675,1,66,288,354,288,0,354,430,-288,288,567,5,1,66,387,226,387,21,1512,570
1591,20,2.3.430,0,627,0,30,430,460,430,0,460,460,-142,286,421,4,3,59,183,176,327,21,1512,570
1591,20,3.3.300,0,627,0,60,300,360,300,0,360,430,-12,156,291,4,3,85,183,212,327,21,1512,570
1591,20,4.3.371,0,627,0,36,371,407,371,0,407,430,-83,227,362,4,3,125,183,303,327,21,1512,570
1591,20,5.4.240,0,627,0,88,240,328,240,0,328,430,-240,240,519,5,1,88,387,328,387,21,1512,570
1591,21,0.4.345,0,644,1,90,345,435,345,0,435,435,-345,345,624,5,1,90,387,267,387,22,1512,513
1591,21,1.4.288,0,675,2,66,288,354,288,0,354,430,-288,288,567,5,1,66,387,226,387,22,1512,513
1591,21,2.3.430,0,627,0,30,430,460,430,0,460,460,-85,229,364,4,4,59,126,176,327,22,1512,513
1591,21,3.3.345,0,627,0,60,345,405,300,45,405,430,0,144,279,4,4,85,126,212,327,22,1512,513
1591,21,4.3.371,1,627,0,36,371,407,371,0,407,430,-26,170,305,4,4,125,126,303,327,22,1512,513
1591,21,5.4.240,0,627,0,88,240,328,240,0,328,430,-240,240,519,5,1,88,387,328,387,22,1512,513
1591,22,0.4.345,0,644,2,90,345,435,345,0,435,435,-345,345,650,5,1,90,387,267,387,23,1512,477
1591,22,1.4.288,0,675,3,66,288,354,288,0,354,430,-288,288,593,5,1,66,387,226,387,23,1512,477
1591,22,2.3.430,0,627,0,30,430,460,430,0,460,460,-23,193,328,4,5,59,90,176,327,23,1512,477
1591,22,3.3.407,1,627,0,60,407,467,300,107,467,467,0,170,305,4,5,85,90,212,327,23,1512,477
1591,22,4.4.407,0,640,1,89,407,496,407,0,496,496,-407,407,712,5,1,89,387,303,387,23,1512,477
1591,22,5.4.240,0,627,0,88,240,328,240,0,328,430,-240,240,545,5,1,88,387,328,387,23,1512,477
1591,23,0.4.345,0,644,2,90,345,435,345,0,435,467,-345,345,650,5,1,90,387,267,387,24,1512,417
1591,23,1.4.288,0,675,3,66,288,354,288,0,354,467,-288,288,593,5,1,66,387,226,387,24,1512,417
1591,23,2.3.467,1,627,0,30,467,497,430,37,497,497,0,170,305,4,6,59,30,176,327,24,1512,417
1591,23,3.4.467,0,676,4,25,467,492,467,0,492,492,-467,467,772,5,1,25,387,212,387,24,1512,417
1591,23,4.4.407,0,640,1,89,407,496,407,0,496,496,-407,407,712,5,1,89,387,303,387,24,1512,417
1591,23,5.4.240,0,627,0,88,240,328,240,0,328,467,-240,240,545,5,1,88,387,328,387,24,1512,417
1591,24,0.4.345,0,644,2,90,345,435,345,0,435,497,-345,345,650,5,1,90,387,267,387,25,1512,387
1591,24,1.4.288,0,675,3,66,288,354,288,0,354,497,-288,288,593,5,1,66,387,226,387,25,1512,387
1591,24,2.4.497,0,640,1,29,497,526,497,0,526,526,-497,497,802,5,1,29,387,176,387,25,1512,387
1591,24,3.4.467,0,676,4,25,467,492,467,0,492,497,-467,467,772,5,1,25,387,212,387,25,1512,387
1591,24,4.4.407,0,640,1,89,407,496,407,0,496,497,-407,407,712,5,1,89,387,303,387,25,1512,387
1591,24,5.4.240,1,627,0,88,240,328,240,0,328,497,-240,240,545,5,1,88,387,328,387,25,1512,387
1591,25,0.4.345,0,644,2,90,345,435,345,0,435,497,-17,257,562,5,2,90,299,267,387,26,1512,299
1591,25,1.4.328,1,627,0,66,328,394,288,40,394,497,0,240,545,5,2,66,299,226,387,26,1512,299
1591,25,2.4.497,0,640,1,29,497,526,497,0,526,526,-169,409,714,5,2,29,299,176,387,26,1512,299
1591,25,3.4.467,0,676,3,25,467,492,467,0,492,497,-139,379,684,5,2,25,299,212,387,26,1512,299
1591,25,4.4.407,0,640,1,89,407,496,407,0,496,497,-79,319,624,5,2,89,299,303,387,26,1512,299
1591,26,0.4.394,1,627,0,90,394,484,345,49,484,497,0,240,545,5,3,90,233,267,387,27,1512,233
1591,26,2.4.497,0,640,1,29,497,526,497,0,526,526,-103,343,648,5,3,29,233,176,387,27,1512,233
1591,26,3.4.467,0,700,2,25,467,492,467,0,492,497,-73,313,618,5,3,25,233,212,387,27,1512,233
1591,26,4.4.407,0,640,1,89,407,496,407,0,496,497,-13,253,558,5,3,89,233,303,387,27,1512,233
1591,27,2.4.497,0,640,1,29,497,526,497,0,526,526,-13,253,558,5,4,29,143,176,387,28,1512,143
1591,27,3.4.484,1,627,0,25,484,509,467,17,509,509,0,240,545,5,4,25,143,212,387,28,1512,143
1591,27,4.4.484,0,627,0,89,484,573,407,77,573,573,0,240,545,5,4,89,143,303,387,28,1512,143
1591,28,2.4.509,0,627,0,29,509,538,497,12,538,538,0,240,545,5,5,29,118,176,387,29,1512,118
1591,28,4.4.509,1,627,0,89,509,598,407,102,598,598,0,240,545,5,5,89,118,303,387,29,1512,118
1591,29,2.4.598,1,627,0,29,598,627,497,101,627,627,0,240,545,5,6,29,29,176,387,30,1512,29
1592,0,0.0.0,0,600,4,24,0,24,0,0,24,24,0,0,0,1,1,311,160,311,160,1,1582,1582
1592,0,1.0.0,0,576,0,6,0,6,0,0,6,6,0,0,0,1,1,228,160,228,160,1,1582,1582
1592,0,2.0.0,0,625,5,91,0,91,0,0,91,91,0,0,0,1,1,302,160,302,160,1,1582,1582
1592,0,3.0.0,1,579,1,3,0,3,0,0,3,3,0,0,0,1,1,269,160,269,160,1,1582,1582
1592,0,4.0.0,0,593,3,17,0,17,0,0,17,17,0,0,0,1,1,240,160,240,160,1,1582,1582
1592,0,5.0.0,0,584,2,19,0,19,0,0,19,19,0,0,0,1,1,232,160,232,160,1,1582,1582
1592,1,0.0.3,1,603,3,24,3,27,0,3,27,27,0,0,0,1,2,311,157,311,160,2,1582,1579
1592,1,1.0.3,0,579,0,6,3,9,0,3,9,9,0,0,0,1,2,228,157,228,160,2,1582,1579
1592,1,2.0.3,0,628,4,91,3,94,0,3,94,94,0,0,0,1,2,302,157,302,160,2,1582,1579
1592,1,3.1.3,0,628,4,87,3,90,3,0,90,90,-3,3,3,2,1,266,339,269,339,2,1582,1579
1592,1,4.0.3,0,596,2,17,3,20,0,3,20,20,0,0,0,1,2,240,157,240,160,2,1582,1579
1592,1,5.0.3,0,587,1,19,3,22,0,3,22,22,0,0,0,1,2,232,157,232,160,2,1582,1579
1592,2,0.1.27,0,652,5,83,27,110,27,0,110,110,-27,27,27,2,1,287,339,311,339,3,1582,1555
1592,2,1.0.27,1,603,0,6,27,33,0,27,33,33,0,0,0,1,3,228,133,228,160,3,1582,1555
1592,2,2.0.27,0,646,4,91,27,118,0,27,118,118,0,0,0,1,3,302,133,302,160,3,1582,1555
1592,2,3.1.3,0,635,3,87,3,90,3,0,90,90,-3,3,3,2,1,266,339,269,339,3,1582,1555
1592,2,4.0.27,0,620,2,17,27,44,0,27,44,44,0,0,0,1,3,240,133,240,160,3,1582,1555
1592,2,5.0.27,0,611,1,19,27,46,0,27,46,46,0,0,0,1,3,232,133,232,160,3,1582,1555
1592,3,0.1.27,0,658,3,83,27,110,27,0,110,110,-27,27,27,2,1,287,339,311,339,4,1582,1549
1592,3,1.1.33,0,603,0,48,33,81,33,0,81,81,-33,33,33,2,1,222,339,228,339,4,1582,1549
1592,3,2.0.33,0,620,1,91,33,124,0,33,124,124,0,0,0,1,4,302,127,302,160,4,1582,1549
1592,3,3.1.3,0,635,2,87,3,90,3,0,90,90,-3,3,3,2,1,266,339,269,339,4,1582,1549
1592,3,4.0.33,1,603,0,17,33,50,0,33,50,50,0,0,0,1,4,240,127,240,160,4,1582,1549
1592,3,5.0.33,0,603,0,19,33,52,0,33,52,52,0,0,0,1,4,232,127,232,160,4,1582,1549
1592,4,0.1.27,0,675,4,83,27,110,27,0,110,110,-27,27,27,2,1,287,339,311,339,5,1582,1532
1592,4,1.1.33,0,603,0,48,33,81,33,0,81,81,-33,33,33,2,1,222,339,228,339,5,1582,1532
1592,4,2.0.50,0,620,1,91,50,141,0,50,141,141,0,0,0,1,5,302,110,302,160,5,1582,1532
1592,4,3.1.3,0,635,2,87,3,90,3,0,90,90,-3,3,3,2,1,266,339,269,339,5,1582,1532
1592,4,4.1.50,0,664,3,63,50,113,50,0,113,113,-50,50,50,2,1,223,339,240,339,5,1582,1532
1592,4,5.0.50,1,603,0,19,50,69,0,50,69,69,0,0,0,1,5,232,110,232,160,5,1582,1532
1592,5,0.1.27,0,675,4,83,27,110,27,0,110,110,-27,27,27,2,1,287,339,311,339,6,1582,1513
1592,5,1.1.33,0,603,0,48,33,81,33,0,81,81,-33,33,33,2,1,222,339,228,339,6,1582,1513
1592,5,2.0.69,1,603,0,91,69,160,0,69,160,160,0,0,0,1,6,302,91,302,160,6,1582,1513
1592,5,3.1.3,0,635,2,87,3,90,3,0,90,90,-3,3,3,2,1,266,339,269,339,6,1582,1513
1592,5,4.1.50,0,664,3,63,50,113,50,0,113,113,-50,50,50,2,1,223,339,240,339,6,1582,1513
1592,5,5.1.69,0,634,1,51,69,120,69,0,120,120,-69,69,69,2,1,213,339,232,339,6,1582,1513
1592,6,0.1.27,1,675,5,83,27,110,27,0,110,160,-27,27,27,2,1,287,339,311,339,7,1582,1422
1592,6,1.1.33,0,603,0,48,33,81,33,0,81,160,-33,33,33,2,1,222,339,228,339,7,1582,1422
1592,6,2.1.160,0,620,1,7,160,167,160,0,167,167,-160,160,160,2,1,211,339,302,339,7,1582,1422
1592,6,3.1.3,0,635,3,87,3,90,3,0,90,160,-3,3,3,2,1,266,339,269,339,7,1582,1422
1592,6,4.1.50,0,664,4,63,50,113,50,0,113,160,-50,50,50,2,1,223,339,240,339,7,1582,1422
1592,6,5.1.69,0,634,2,51,69,120,69,0,120,160,-69,69,69,2,1,213,339,232,339,7,1582,1422
1592,7,0.2.110,0,703,3,97,110,207,110,0,207,207,-110,110,137,3,1,204,286,311,286,8,1582,1339
1592,7,1.1.110,1,680,1,48,110,158,33,77,158,160,0,27,27,2,2,222,256,228,339,8,1582,1339
1592,7,2.1.160,0,681,2,7,160,167,160,0,167,167,-50,77,77,2,2,211,256,302,339,8,1582,1339
1592,7,3.1.110,0,708,4,87,110,197,3,107,197,197,0,27,27,2,2,266,256,269,339,8,1582,1339
1592,7,4.1.110,0,703,3,63,110,173,50,60,173,173,0,27,27,2,2,223,256,240,339,8,1582,1339
1592,7,5.1.110,0,675,0,51,110,161,69,41,161,161,0,27,27,2,2,213,256,232,339,8,1582,1339
1592,8,0.2.110,0,709,4,97,110,207,110,0,207,207,-110,110,137,3,1,204,286,311,286,9,1582,1291
1592,8,1.2.158,0,680,0,9,158,167,158,0,167,167,-158,158,185,3,1,174,286,228,286,9,1582,1291
1592,8,2.1.160,1,681,1,7,160,167,160,0,167,167,-2,29,29,2,3,211,208,302,339,9,1582,1291
1592,8,3.1.158,0,690,3,87,158,245,3,155,245,245,0,27,27,2,3,266,208,269,339,9,1582,1291
1592,8,4.1.158,0,685,2,63,158,221,50,108,221,221,0,27,27,2,3,223,208,240,339,9,1582,1291
1592,8,5.1.158,0,680,0,51,158,209,69,89,209,209,0,27,27,2,3,213,208,232,339,9,1582,1291
1592,9,0.2.110,0,718,3,97,110,207,110,0,207,207,-110,110,139,3,1,204,286,311,286,10,1582,1284
1592,9,1.2.158,0,681,0,9,158,167,158,0,167,167,-158,158,187,3,1,174,286,228,286,10,1582,1284
1592,9,2.2.167,0,681,0,12,167,179,167,0,179,179,-167,167,196,3,1,204,286,302,286,10,1582,1284
1592,9,3.1.167,1,690,2,87,167,254,3,164,254,254,0,29,29,2,4,266,201,269,339,10,1582,1284
1592,9,4.1.167,0,685,1,63,167,230,50,117,230,230,0,29,29,2,4,223,201,240,339,10,1582,1284
1592,9,5.1.167,0,681,0,51,167,218,69,98,218,218,0,29,29,2,4,213,201,232,339,10,1582,1284
1592,10,0.2.110,0,723,2,97,110,207,110,0,207,254,-110,110,139,3,1,204,286,311,286,11,1582,1197
1592,10,1.2.158,0,690,0,9,158,167,158,0,167,254,-158,158,187,3,1,174,286,228,286,11,1582,1197
1592,10,2.2.167,0,694,1,12,167,179,167,0,179,254,-167,167,196,3,1,204,286,302,286,11,1582,1197
1592,10,3.2.254,0,694,1,94,254,348,254,0,348,348,-254,254,283,3,1,179,286,269,286,11,1582,1197
1592,10,4.1.254,0,690,0,63,254,317,50,204,317,317,0,29,29,2,5,223,114,240,339,11,1582,1197
1592,10,5.1.254,1,690,0,51,254,305,69,185,305,305,0,29,29,2,5,213,114,232,339,11,1582,1197
1592,11,0.2.110,0,723,2,97,110,207,110,0,207,305,-110,110,139,3,1,204,286,311,286,12,1582,1146
1592,11,1.2.158,0,690,0,9,158,167,158,0,167,305,-158,158,187,3,1,174,286,228,286,12,1582,1146
1592,11,2.2.167,0,694,1,12,167,179,167,0,179,305,-167,167,196,3,1,204,286,302,286,12,1582,1146
1592,11,3.2.254,0,694,1,94,254,348,254,0,348,348,-254,254,283,3,1,179,286,269,286,12,1582,1146
1592,11,4.1.305,1,690,0,63,305,368,50,255,368,368,0,29,29,2,6,223,63,240,339,12,1582,1146
1592,11,5.2.305,0,694,1,2,305,307,305,0,307,307,-305,305,334,3,1,162,286,232,286,12,1582,1146
1592,12,0.2.110,0,723,2,97,110,207,110,0,207,368,-110,110,139,3,1,204,286,311,286,13,1582,1083
1592,12,1.2.158,0,690,0,9,158,167,158,0,167,368,-158,158,187,3,1,174,286,228,286,13,1582,1083
1592,12,2.2.167,1,694,1,12,167,179,167,0,179,368,-167,167,196,3,1,204,286,302,286,13,1582,1083
1592,12,3.2.254,0,694,1,94,254,348,254,0,348,368,-254,254,283,3,1,179,286,269,286,13,1582,1083
1592,12,4.2.368,0,690,0,72,368,440,368,0,440,440,-368,368,397,3,1,160,286,240,286,13,1582,1083
1592,12,5.2.305,0,694,1,2,305,307,305,0,307,368,-305,305,334,3,1,162,286,232,286,13,1582,1083
1592,13,0.2.179,0,694,0,97,179,276,110,69,276,368,0,167,196,3,2,204,274,311,286,14,1582,1071
1592,13,1.2.158,1,694,0,9,158,167,158,0,179,368,9,158,187,3,2,174,274,228,286,14,1582,1071
1592,13,2.3.179,0,694,0,98,179,277,179,0,277,368,-179,179,375,4,1,192,380,302,380,14,1582,1071
1592,13,3.2.254,0,694,0,94,254,348,254,0,348,368,-75,242,271,3,2,179,274,269,286,14,1582,1071
1592,13,4.2.368,0,694,0,72,368,440,368,0,440,440,-189,356,385,3,2,160,274,240,286,14,1582,1071
1592,13,5.2.305,0,694,0,2,305,307,305,0,307,368,-126,293,322,3,2,162,274,232,286,14,1582,1071
1592,14,0.2.179,1,694,0,97,179,276,110,69,276,368,0,158,187,3,3,204,265,311,286,15,1582,1062
1592,14,1.3.167,0,697,1,90,167,257,167,0,257,368,-167,167,354,4,1,165,380,228,380,15,1582,1062
1592,14,2.3.179,0,694,0,98,179,277,179,0,277,368,-179,179,366,4,1,192,380,302,380,15,1582,1062
1592,14,3.2.254,0,694,0,94,254,348,254,0,348,368,-75,233,262,3,3,179,265,269,286,15,1582,1062
1592,14,4.2.368,0,694,0,72,368,440,368,0,440,440,-189,347,376,3,3,160,265,240,286,15,1582,1062
1592,14,5.2.305,0,694,0,2,305,307,305,0,307,368,-126,284,313,3,3,162,265,232,286,15,1582,1062
1592,15,0.3.276,0,702,3,63,276,339,276,0,339,368,-276,276,463,4,1,107,380,311,380,16,1582,965
1592,15,1.3.167,0,697,2,90,167,257,167,0,257,368,-167,167,354,4,1,165,380,228,380,16,1582,965
1592,15,2.3.179,0,694,0,98,179,277,179,0,277,368,-179,179,366,4,1,192,380,302,380,16,1582,965
1592,15,3.2.276,0,694,0,94,276,370,254,22,370,370,0,158,187,3,4,179,168,269,286,16,1582,965
1592,15,4.2.368,0,695,1,72,368,440,368,0,440,440,-92,250,279,3,4,160,168,240,286,16,1582,965
1592,15,5.2.305,1,694,0,2,305,307,305,0,307,368,-29,187,216,3,4,162,168,232,286,16,1582,965
1592,16,0.3.276,0,718,4,63,276,339,276,0,339,368,-276,276,492,4,1,107,380,311,380,17,1582,963
1592,16,1.3.167,0,697,2,90,167,257,167,0,257,368,-167,167,383,4,1,165,380,228,380,17,1582,963
1592,16,2.3.179,0,694,0,98,179,277,179,0,277,368,-179,179,395,4,1,192,380,302,380,17,1582,963
1592,16,3.2.307,1,694,0,94,307,401,254,53,401,401,0,187,216,3,5,179,166,269,286,17,1582,963
1592,16,4.2.368,0,695,1,72,368,440,368,0,440,440,-61,248,277,3,5,160,166,240,286,17,1582,963
1592,16,5.3.307,0,711,3,81,307,388,307,0,388,388,-307,307,523,4,1,160,380,232,380,17,1582,963
1592,17,0.3.276,0,718,3,63,276,339,276,0,339,401,-276,276,492,4,1,107,380,311,380,18,1582,869
1592,17,1.3.167,0,697,1,90,167,257,167,0,257,401,-167,167,383,4,1,165,380,228,380,18,1582,869
1592,17,2.3.179,0,694,0,98,179,277,179,0,277,401,-179,179,395,4,1,192,380,302,380,18,1582,869
1592,17,3.3.401,0,694,0,19,401,420,401,0,420,420,-401,401,617,4,1,85,380,269,380,18,1582,869
1592,17,4.2.401,1,694,0,72,401,473,368,33,473,473,0,187,216,3,6,160,72,240,286,18,1582,869
1592,17,5.3.307,0,711,2,81,307,388,307,0,388,401,-307,307,523,4,1,160,380,232,380,18,1582,869
1592,18,0.3.276,0,718,3,63,276,339,276,0,339,473,-276,276,492,4,1,107,380,311,380,19,1582,797
1592,18,1.3.167,0,697,1,90,167,257,167,0,257,473,-167,167,383,4,1,165,380,228,380,19,1582,797
1592,18,2.3.179,1,694,0,98,179,277,179,0,277,473,-179,179,395,4,1,192,380,302,380,19,1582,797
1592,18,3.3.401,0,694,0,19,401,420,401,0,420,473,-401,401,617,4,1,85,380,269,380,19,1582,797
1592,18,4.3.473,0,694,0,29,473,502,473,0,502,502,-473,473,689,4,1,88,380,240,380,19,1582,797
1592,18,5.3.307,0,711,2,81,307,388,307,0,388,473,-307,307,523,4,1,160,380,232,380,19,1582,797
1592,19,0.3.277,0,700,1,63,277,340,276,1,340,473,0,179,395,4,2,107,282,311,380,20,1582,699
1592,19,1.3.277,1,694,0,90,277,367,167,110,367,473,0,179,395,4,2,165,282,228,380,20,1582,699
1592,19,2.4.277,0,694,0,94,277,371,277,0,371,473,-277,277,672,5,1,94,417,302,417,20,1582,699
1592,19,3.3.401,0,694,0,19,401,420,401,0,420,473,-124,303,519,4,2,85,282,269,380,20,1582,699
1592,19,4.3.473,0,694,0,29,473,502,473,0,502,502,-196,375,591,4,2,88,282,240,380,20,1582,699
1592,19,5.3.307,0,711,2,81,307,388,307,0,388,473,-30,209,425,4,2,160,282,232,380,20,1582,699
1592,20,0.3.367,1,694,0,63,367,430,276,91,430,473,0,179,395,4,3,107,192,311,380,21,1582,609
1592,20,1.4.367,0,784,2,75,367,442,367,0,442,473,-367,367,762,5,1,75,417,228,417,21,1582,609
1592,20,2.4.277,0,694,0,94,277,371,277,0,371,473,-277,277,672,5,1,94,417,302,417,21,1582,609
1592,20,3.3.401,0,694,0,19,401,420,401,0,420,473,-34,213,429,4,3,85,192,269,380,21,1582,609
1592,20,4.3.473,0,694,0,29,473,502,473,0,502,502,-106,285,501,4,3,88,192,240,380,21,1582,609
1592,20,5.3.367,0,696,1,81,367,448,307,60,448,473,0,179,395,4,3,160,192,232,380,21,1582,609
1592,21,0.4.430,0,753,2,44,430,474,430,0,474,474,-430,430,825,5,1,44,417,311,417,22,1582,546
1592,21,1.4.367,0,784,3,75,367,442,367,0,442,473,-367,367,762,5,1,75,417,228,417,22,1582,546
1592,21,2.4.277,0,694,0,94,277,371,277,0,371,473,-277,277,672,5,1,94,417,302,417,22,1582,546
1592,21,3.3.430,1,694,0,19,430,449,401,29,449,473,0,179,395,4,4,85,129,269,380,22,1582,546
1592,21,4.3.473,0,694,0,29,473,502,473,0,502,502,-43,222,438,4,4,88,129,240,380,22,1582,546
1592,21,5.3.430,0,715,1,81,430,511,307,123,511,511,0,179,395,4,4,160,129,232,380,22,1582,546
1592,22,0.4.430,0,753,2,44,430,474,430,0,474,474,-430,430,825,5,1,44,417,311,417,23,1582,527
1592,22,1.4.367,0,784,3,75,367,442,367,0,442,473,-367,367,762,5,1,75,417,228,417,23,1582,527
1592,22,2.4.277,0,694,0,94,277,371,277,0,371,473,-277,277,672,5,1,94,417,302,417,23,1582,527
1592,22,3.4.449,0,697,1,66,449,515,449,0,515,515,-449,449,844,5,1,66,417,269,417,23,1582,527
1592,22,4.3.473,0,694,0,29,473,502,473,0,502,502,-24,203,419,4,5,88,110,240,380,23,1582,527
1592,22,5.3.449,1,694,0,81,449,530,307,142,530,530,0,179,395,4,5,160,110,232,380,23,1582,527
1592,23,0.4.430,0,753,3,44,430,474,430,0,474,530,-430,430,825,5,1,44,417,311,417,24,1582,446
1592,23,1.4.367,0,784,4,75,367,442,367,0,442,530,-367,367,762,5,1,75,417,228,417,24,1582,446
1592,23,2.4.277,0,694,0,94,277,371,277,0,371,530,-277,277,672,5,1,94,417,302,417,24,1582,446
1592,23,3.4.449,0,697,1,66,449,515,449,0,515,530,-449,449,844,5,1,66,417,269,417,24,1582,446
1592,23,4.3.530,1,694,0,29,530,559,473,57,559,559,0,179,395,4,6,88,29,240,380,24,1582,446
1592,23,5.4.530,0,712,2,79,530,609,530,0,609,609,-530,530,925,5,1,79,417,232,417,24,1582,446
1592,24,0.4.430,0,753,3,44,430,474,430,0,474,559,-430,430,825,5,1,44,417,311,417,25,1582,417
1592,24,1.4.367,0,784,4,75,367,442,367,0,442,559,-367,367,762,5,1,75,417,228,417,25,1582,417
1592,24,2.4.277,1,694,0,94,277,371,277,0,371,559,-277,277,672,5,1,94,417,302,417,25,1582,417
1592,24,3.4.449,0,697,1,66,449,515,449,0,515,559,-449,449,844,5,1,66,417,269,417,25,1582,417
1592,24,4.4.559,0,697,1,59,559,618,559,0,618,618,-559,559,954,5,1,59,417,240,417,25,1582,417
1592,24,5.4.530,0,712,2,79,530,609,530,0,609,609,-530,530,925,5,1,79,417,232,417,25,1582,417
1592,25,0.4.430,1,753,3,44,430,474,430,0,474,559,-59,336,731,5,2,44,323,311,417,26,1582,323
1592,25,1.4.371,0,694,0,75,371,446,367,4,446,559,0,277,672,5,2,75,323,228,417,26,1582,323
1592,25,3.4.449,0,697,1,66,449,515,449,0,515,559,-78,355,750,5,2,66,323,269,417,26,1582,323
1592,25,4.4.559,0,697,1,59,559,618,559,0,618,618,-188,465,860,5,2,59,323,240,417,26,1582,323
1592,25,5.4.530,0,712,2,79,530,609,530,0,609,609,-159,436,831,5,2,79,323,232,417,26,1582,323
1592,26,1.4.474,1,753,0,75,474,549,367,107,549,559,0,336,731,5,3,75,279,228,417,27,1582,279
1592,26,3.4.474,0,753,0,66,474,540,449,25,540,559,0,336,731,5,3,66,279,269,417,27,1582,279
1592,26,4.4.559,0,763,1,59,559,618,559,0,618,618,-85,421,816,5,3,59,279,240,417,27,1582,279
1592,26,5.4.530,0,809,2,79,530,609,530,0,609,609,-56,392,787,5,3,79,279,232,417,27,1582,279
1592,27,3.4.549,1,753,0,66,549,615,449,100,615,615,0,336,731,5,4,66,204,269,417,28,1582,204
1592,27,4.4.559,0,763,1,59,559,618,559,0,618,618,-10,346,741,5,4,59,204,240,417,28,1582,204
1592,27,5.4.549,0,753,0,79,549,628,530,19,628,628,0,336,731,5,4,79,204,232,417,28,1582,204
1592,28,4.4.615,1,753,0,59,615,674,559,56,674,674,0,336,731,5,5,59,138,240,417,29,1582,138
1592,28,5.4.615,0,753,0,79,615,694,530,85,694,694,0,336,731,5,5,79,138,232,417,29,1582,138
1592,29,5.4.674,1,753,0,79,674,753,530,144,753,753,0,336,731,5,6,79,79,232,417,30,1582,79
1593,0,0.0.0,0,508,1,37,0,37,0,0,37,37,0,0,0,1,1,256,274,256,274,1,1355,1355
1593,0,1.0.0,0,504,0,81,0,81,0,0,81,81,0,0,0,1,1,228,274,228,274,1,1355,1355
1593,0,2.0.0,0,517,4,37,0,37,0,0,37,37,0,0,0,1,1,229,274,229,274,1,1355,1355
1593,0,3.0.0,0,560,5,56,0,56,0,0,56,56,0,0,0,1,1,230,274,230,274,1,1355,1355
1593,0,4.0.0,0,514,3,39,0,39,0,0,39,39,0,0,0,1,1,179,274,179,274,1,1355,1355
1593,0,5.0.0,1,511,2,24,0,24,0,0,24,24,0,0,0,1,1,233,274,233,274,1,1355,1355
1593,1,0.0.24,0,511,0,37,24,61,0,24,61,61,0,0,0,1,2,256,250,256,274,2,1355,1331
1593,1,1.0.24,0,511,0,81,24,105,0,24,105,105,0,0,0,1,2,228,250,228,274,2,1355,1331
1593,1,2.0.24,0,511,0,37,24,61,0,24,61,61,0,0,0,1,2,229,250,229,274,2,1355,1331
1593,1,3.0.24,0,514,1,56,24,80,0,24,80,80,0,0,0,1,2,230,250,230,274,2,1355,1331
1593,1,4.0.24,0,511,0,39,24,63,0,24,63,63,0,0,0,1,2,179,250,179,274,2,1355,1331
1593,1,5.1.24,1,511,0,34,24,58,24,0,58,58,-24,24,24,2,1,209,145,233,145,2,1355,1331
1593,2,0.0.24,0,511,0,37,24,61,0,24,61,61,0,0,24,1,2,256,250,256,274,3,1355,1297
1593,2,1.0.24,0,511,0,81,24,105,0,24,105,105,0,0,24,1,2,228,250,228,274,3,1355,1297
1593,2,2.0.24,0,511,0,37,24,61,0,24,61,61,0,0,24,1,2,229,250,229,274,3,1355,1297
1593,2,3.0.24,0,514,1,56,24,80,0,24,80,80,0,0,24,1,2,230,250,230,274,3,1355,1297
1593,2,4.0.24,0,511,0,39,24,63,0,24,63,63,0,0,24,1,2,179,250,179,274,3,1355,1297
1593,2,5.2.58,1,511,0,40,58,98,58,0,98,98,-58,58,82,3,1,175,254,233,254,3,1355,1297
1593,3,0.0.24,0,511,0,37,24,61,0,24,61,98,0,0,82,1,2,256,250,256,274,4,1355,1257
1593,3,1.0.24,0,511,0,81,24,105,0,24,105,105,0,0,82,1,2,228,250,228,274,4,1355,1257
1593,3,2.0.24,0,511,0,37,24,61,0,24,61,98,0,0,82,1,2,229,250,229,274,4,1355,1257
1593,3,3.0.24,0,514,1,56,24,80,0,24,80,98,0,0,82,1,2,230,250,230,274,4,1355,1257
1593,3,4.0.24,0,511,0,39,24,63,0,24,63,98,0,0,82,1,2,179,250,179,274,4,1355,1257
1593,3,5.3.98,1,511,0,65,98,163,98,0,163,163,-98,98,180,4,1,135,334,233,334,4,1355,1257
1593,4,0.0.24,0,511,0,37,24,61,0,24,61,163,0,0,180,1,2,256,250,256,274,5,1355,1192
1593,4,1.0.24,0,511,0,81,24,105,0,24,105,163,0,0,180,1,2,228,250,228,274,5,1355,1192
1593,4,2.0.24,0,511,0,37,24,61,0,24,61,163,0,0,180,1,2,229,250,229,274,5,1355,1192
1593,4,3.0.24,0,514,1,56,24,80,0,24,80,163,0,0,180,1,2,230,250,230,274,5,1355,1192
1593,4,4.0.24,0,511,0,39,24,63,0,24,63,163,0,0,180,1,2,179,250,179,274,5,1355,1192
1593,4,5.4.163,1,511,0,70,163,233,163,0,233,233,-163,163,343,5,1,70,348,233,348,5,1355,1192
1593,5,0.0.24,1,511,0,37,24,61,0,24,61,233,0,0,343,1,2,256,250,256,274,6,1355,1122
1593,5,1.0.24,0,511,0,81,24,105,0,24,105,233,0,0,343,1,2,228,250,228,274,6,1355,1122
1593,5,2.0.24,0,511,0,37,24,61,0,24,61,233,0,0,343,1,2,229,250,229,274,6,1355,1122
1593,5,3.0.24,0,514,1,56,24,80,0,24,80,233,0,0,343,1,2,230,250,230,274,6,1355,1122
1593,5,4.0.24,0,511,0,39,24,63,0,24,63,233,0,0,343,1,2,179,250,179,274,6,1355,1122
1593,6,0.1.61,1,511,0,52,61,113,61,0,113,233,-3,27,346,2,2,219,111,256,145,7,1355,1085
1593,6,1.0.61,0,511,0,81,61,142,0,61,142,233,0,0,343,1,3,228,213,228,274,7,1355,1085
1593,6,2.0.61,0,511,0,37,61,98,0,61,98,233,0,0,343,1,3,229,213,229,274,7,1355,1085
1593,6,3.0.61,0,511,0,56,61,117,0,61,117,233,0,0,343,1,3,230,213,230,274,7,1355,1085
1593,6,4.0.61,0,511,0,39,61,100,0,61,100,233,0,0,343,1,3,179,213,179,274,7,1355,1085
1593,7,0.2.113,1,511,0,1,113,114,113,0,114,233,-15,73,361,3,2,167,214,256,254,8,1355,1033
1593,7,1.0.61,0,511,0,81,61,142,0,61,142,233,0,0,346,1,3,228,213,228,274,8,1355,1033
1593,7,2.0.61,0,511,0,37,61,98,0,61,98,233,0,0,346,1,3,229,213,229,274,8,1355,1033
1593,7,3.0.61,0,511,0,56,61,117,0,61,117,233,0,0,346,1,3,230,213,230,274,8,1355,1033
1593,7,4.0.61,0,511,0,39,61,100,0,61,100,233,0,0,346,1,3,179,213,179,274,8,1355,1033
1593,8,0.3.163,1,511,0,70,163,233,114,49,233,233,0,98,361,4,2,166,269,256,334,9,1355,1032
1593,8,1.0.61,0,511,0,81,61,142,0,61,142,233,0,0,361,1,3,228,213,228,274,9,1355,1032
1593,8,2.0.61,0,511,0,37,61,98,0,61,98,233,0,0,361,1,3,229,213,229,274,9,1355,1032
1593,8,3.0.61,0,511,0,56,61,117,0,61,117,233,0,0,361,1,3,230,213,230,274,9,1355,1032
1593,8,4.0.61,0,511,0,39,61,100,0,61,100,233,0,0,361,1,3,179,213,179,274,9,1355,1032
1593,9,0.4.233,1,511,0,96,233,329,233,0,329,329,0,163,361,5,2,96,278,256,348,10,1355,962
1593,9,1.0.61,0,511,0,81,61,142,0,61,142,233,0,0,361,1,3,228,213,228,274,10,1355,962
1593,9,2.0.61,0,511,0,37,61,98,0,61,98,233,0,0,361,1,3,229,213,229,274,10,1355,962
1593,9,3.0.61,0,511,0,56,61,117,0,61,117,233,0,0,361,1,3,230,213,230,274,10,1355,962
1593,9,4.0.61,0,511,0,39,61,100,0,61,100,233,0,0,361,1,3,179,213,179,274,10,1355,962
1593,10,1.0.61,0,511,0,81,61,142,0,61,142,329,0,0,361,1,3,228,213,228,274,11,1355,866
1593,10,2.0.61,1,511,0,37,61,98,0,61,98,329,0,0,361,1,3,229,213,229,274,11,1355,866
1593,10,3.0.61,0,511,0,56,61,117,0,61,117,329,0,0,361,1,3,230,213,230,274,11,1355,866
1593,10,4.0.61,0,511,0,39,61,100,0,61,100,329,0,0,361,1,3,179,213,179,274,11,1355,866
1593,11,1.0.98,0,511,0,81,98,179,0,98,179,329,0,0,361,1,4,228,176,228,274,12,1355,829
1593,11,2.1.113,1,511,0,1,113,114,98,15,114,329,0,27,361,2,3,192,59,229,145,12,1355,829
1593,11,3.0.98,0,511,0,56,98,154,0,98,154,329,0,0,361,1,4,230,176,230,274,12,1355,829
1593,11,4.0.98,0,511,0,39,98,137,0,98,137,329,0,0,361,1,4,179,176,179,274,12,1355,829
1593,12,1.0.98,0,511,0,81,98,179,0,98,179,329,0,0,361,1,4,228,176,228,274,13,1355,828
1593,12,2.2.114,1,511,0,64,114,178,114,0,178,329,0,73,361,3,3,191,213,229,254,13,1355,828
1593,12,3.0.98,0,511,0,56,98,154,0,98,154,329,0,0,361,1,4,230,176,230,274,13,1355,828
1593,12,4.0.98,0,511,0,39,98,137,0,98,137,329,0,0,361,1,4,179,176,179,274,13,1355,828
1593,13,1.0.98,0,511,0,81,98,179,0,98,179,329,0,0,361,1,4,228,176,228,274,14,1355,764
1593,13,2.3.233,1,511,0,67,233,300,178,55,300,329,0,98,361,4,3,127,199,229,334,14,1355,764
1593,13,3.0.98,0,511,0,56,98,154,0,98,154,329,0,0,361,1,4,230,176,230,274,14,1355,764
1593,13,4.0.98,0,511,0,39,98,137,0,98,137,329,0,0,361,1,4,179,176,179,274,14,1355,764
1593,14,1.0.98,0,511,0,81,98,179,0,98,179,329,0,0,361,1,4,228,176,228,274,15,1355,697
1593,14,2.4.329,1,511,0,60,329,389,300,29,389,389,0,163,361,5,3,60,182,229,348,15,1355,697
1593,14,3.0.98,0,511,0,56,98,154,0,98,154,329,0,0,361,1,4,230,176,230,274,15,1355,697
1593,14,4.0.98,0,511,0,39,98,137,0,98,137,329,0,0,361,1,4,179,176,179,274,15,1355,697
1593,15,1.0.98,0,511,0,81,98,179,0,98,179,389,0,0,361,1,4,228,176,228,274,16,1355,637
1593,15,3.0.98,1,511,0,56,98,154,0,98,154,389,0,0,361,1,4,230,176,230,274,16,1355,637
1593,15,4.0.98,0,511,0,39,98,137,0,98,137,389,0,0,361,1,4,179,176,179,274,16,1355,637
1593,16,1.0.154,0,511,0,81,154,235,0,154,235,389,0,0,361,1,5,228,120,228,274,17,1355,581
1593,16,3.1.154,1,511,0,26,154,180,154,0,180,389,-40,67,401,2,4,174,58,230,145,17,1355,581
1593,16,4.0.154,0,511,0,39,154,193,0,154,193,389,0,0,361,1,5,179,120,179,274,17,1355,581
1593,17,1.0.154,0,511,0,81,154,235,0,154,235,389,0,0,401,1,5,228,120,228,274,18,1355,555
1593,17,3.2.180,1,511,0,62,180,242,180,0,242,389,-2,75,403,3,4,148,149,230,254,18,1355,555
1593,17,4.0.154,0,511,0,39,154,193,0,154,193,389,0,0,401,1,5,179,120,179,274,18,1355,555
1593,18,1.0.154,0,511,0,81,154,235,0,154,235,389,0,0,403,1,5,228,120,228,274,19,1355,493
1593,18,3.3.300,1,517,1,78,300,378,242,58,378,389,0,98,403,4,4,86,132,230,334,19,1355,493
1593,18,4.0.154,0,511,0,39,154,193,0,154,193,389,0,0,403,1,5,179,120,179,274,19,1355,493
1593,19,1.0.154,0,517,0,81,154,235,0,154,235,389,0,0,403,1,5,228,120,228,274,20,1355,415
1593,19,3.4.389,1,517,0,8,389,397,378,11,397,397,0,163,403,5,4,8,122,230,348,20,1355,415
1593,19,4.0.154,0,517,0,39,154,193,0,154,193,389,0,0,403,1,5,179,120,179,274,20,1355,415
1593,20,1.0.154,0,517,0,81,154,235,0,154,235,397,0,0,403,1,5,228,120,228,274,21,1355,407
1593,20,4.0.154,1,517,0,39,154,193,0,154,193,397,0,0,403,1,5,179,120,179,274,21,1355,407
1593,21,1.0.193,0,517,0,81,193,274,0,193,274,397,0,0,403,1,6,228,81,228,274,22,1355,368
1593,21,4.1.193,1,517,0,16,193,209,193,0,209,397,-13,80,416,2,5,140,32,179,145,22,1355,368
1593,22,1.0.193,0,517,0,81,193,274,0,193,274,397,0,0,416,1,6,228,81,228,274,23,1355,352
1593,22,4.2.242,1,517,0,73,242,315,209,33,315,397,0,75,416,3,5,124,87,179,254,23,1355,352
1593,23,1.0.193,0,517,0,81,193,274,0,193,274,397,0,0,416,1,6,228,81,228,274,24,1355,279
1593,23,4.3.378,1,517,0,22,378,400,315,63,400,400,0,98,416,4,5,51,54,179,334,24,1355,279
1593,24,1.0.193,0,517,0,81,193,274,0,193,274,400,0,0,416,1,6,228,81,228,274,25,1355,257
1593,24,4.4.400,1,517,0,29,400,429,400,0,429,429,-3,166,419,5,5,29,114,179,348,25,1355,257
1593,25,1.0.193,1,517,0,81,193,274,0,193,274,429,0,0,419,1,6,228,81,228,274,26,1355,228
1593,26,1.1.274,1,517,0,16,274,290,274,0,290,429,-65,145,484,2,6,147,16,228,145,27,1355,147
1593,27,1.2.315,1,517,0,14,315,329,290,25,329,429,0,75,484,3,6,131,14,228,254,28,1355,131
1593,28,1.3.400,1,517,0,32,400,432,329,71,432,432,0,98,484,4,6,117,32,228,334,29,1355,117
1593,29,1.4.432,1,517,0,85,432,517,432,0,517,517,-3,169,487,5,6,85,85,228,348,30,1355,85
1594,0,0.0.0,0,552,2,50,0,50,0,0,50,50,0,0,0,1,1,200,287,200,287,1,1519,1519
1594,0,1.0.0,0,602,4,56,0,56,0,0,56,56,0,0,0,1,1,325,287,325,287,1,1519,1519
1594,0,2.0.0,0,628,5,82,0,82,0,0,82,82,0,0,0,1,1,255,287,255,287,1,1519,1519
1594,0,3.0.0,1,546,0,10,0,10,0,0,10,10,0,0,0,1,1,189,287,189,287,1,1519,1519
1594,0,4.0.0,0,595,3,61,0,61,0,0,61,61,0,0,0,1,1,316,287,316,287,1,1519,1519
1594,0,5.0.0,0,551,1,28,0,28,0,0,28,28,0,0,0,1,1,234,287,234,287,1,1519,1519
1594,1,0.0.10,0,546,0,50,10,60,0,10,60,60,0,0,0,1,2,200,277,200,287,2,1519,1509
1594,1,1.0.10,1,578,2,56,10,66,0,10,66,66,0,0,0,1,2,325,277,325,287,2,1519,1509
1594,1,2.0.10,0,605,3,82,10,92,0,10,92,92,0,0,0,1,2,255,277,255,287,2,1519,1509
1594,1,3.1.10,0,546,0,64,10,74,10,0,74,74,-10,10,10,2,1,179,344,189,344,2,1519,1509
1594,1,4.0.10,0,559,1,61,10,71,0,10,71,71,0,0,0,1,2,316,277,316,287,2,1519,1509
1594,1,5.0.10,0,546,0,28,10,38,0,10,38,38,0,0,0,1,2,234,277,234,287,2,1519,1509
1594,2,0.0.66,0,578,0,50,66,116,0,66,116,116,0,0,0,1,3,200,221,200,287,3,1519,1453
1594,2,1.1.66,0,619,1,83,66,149,66,0,149,149,-66,66,66,2,1,269,344,325,344,3,1519,1453
1594,2,2.0.66,0,578,0,82,66,148,0,66,148,148,0,0,0,1,3,255,221,255,287,3,1519,1453
1594,2,3.1.10,0,578,0,64,10,74,10,0,74,74,-10,10,10,2,1,179,344,189,344,3,1519,1453
1594,2,4.0.66,0,578,0,61,66,127,0,66,127,127,0,0,0,1,3,316,221,316,287,3,1519,1453
1594,2,5.0.66,1,578,0,28,66,94,0,66,94,94,0,0,0,1,3,234,221,234,287,3,1519,1453
1594,3,0.0.94,0,578,0,50,94,144,0,94,144,144,0,0,0,1,4,200,193,200,287,4,1519,1425
1594,3,1.1.66,0,619,2,83,66,149,66,0,149,149,-66,66,66,2,1,269,344,325,344,4,1519,1425
1594,3,2.0.94,0,578,0,82,94,176,0,94,176,176,0,0,0,1,4,255,193,255,287,4,1519,1425
1594,3,3.1.10,0,578,0,64,10,74,10,0,74,94,-10,10,10,2,1,179,344,189,344,4,1519,1425
1594,3,4.0.94,1,578,0,61,94,155,0,94,155,155,0,0,0,1,4,316,193,316,287,4,1519,1425
1594,3,5.1.94,0,579,1,17,94,111,94,0,111,111,-94,94,94,2,1,206,344,234,344,4,1519,1425
1594,4,0.0.155,1,578,0,50,155,205,0,155,205,205,0,0,0,1,5,200,132,200,287,5,1519,1364
1594,4,1.1.66,0,619,2,83,66,149,66,0,149,155,-66,66,66,2,1,269,344,325,344,5,1519,1364
1594,4,2.0.155,0,578,0,82,155,237,0,155,237,237,0,0,0,1,5,255,132,255,287,5,1519,1364
1594,4,3.1.10,0,578,0,64,10,74,10,0,74,155,-10,10,10,2,1,179,344,189,344,5,1519,1364
1594,4,4.1.155,0,579,1,67,155,222,155,0,222,222,-155,155,155,2,1,255,344,316,344,5,1519,1364
1594,4,5.1.94,0,579,1,17,94,111,94,0,111,155,-94,94,94,2,1,206,344,234,344,5,1519,1364
1594,5,0.1.205,0,578,0,20,205,225,205,0,225,225,-205,205,205,2,1,150,344,200,344,6,1519,1314
1594,5,1.1.66,0,619,2,83,66,149,66,0,149,205,-66,66,66,2,1,269,344,325,344,6,1519,1314
1594,5,2.0.205,1,578,0,82,205,287,0,205,287,287,0,0,0,1,6,255,82,255,287,6,1519,1314
1594,5,3.1.10,0,578,0,64,10,74,10,0,74,205,-10,10,10,2,1,179,344,189,344,6,1519,1314
1594,5,4.1.155,0,579,1,67,155,222,155,0,222,222,-155,155,155,2,1,255,344,316,344,6,1519,1314
1594,5,5.1.94,0,579,1,17,94,111,94,0,111,205,-94,94,94,2,1,206,344,234,344,6,1519,1314
1594,6,0.1.205,0,578,0,20,205,225,205,0,225,287,-205,205,205,2,1,150,344,200,344,7,1519,1232
1594,6,1.1.66,0,619,2,83,66,149,66,0,149,287,-66,66,66,2,1,269,344,325,344,7,1519,1232
1594,6,2.1.287,0,578,0,93,287,380,287,0,380,380,-287,287,287,2,1,173,344,255,344,7,1519,1232
1594,6,3.1.10,0,578,0,64,10,74,10,0,74,287,-10,10,10,2,1,179,344,189,344,7,1519,1232
1594,6,4.1.155,0,579,1,67,155,222,155,0,222,287,-155,155,155,2,1,255,344,316,344,7,1519,1232
1594,6,5.1.94,1,579,1,17,94,111,94,0,111,287,-94,94,94,2,1,206,344,234,344,7,1519,1232
1594,7,0.1.205,0,580,1,20,205,225,205,0,225,287,-94,188,188,2,2,150,327,200,344,8,1519,1215
1594,7,1.1.111,0,580,1,83,111,194,66,45,194,287,0,94,94,2,2,269,327,325,344,8,1519,1215
1594,7,2.1.287,0,580,1,93,287,380,287,0,380,380,-176,270,270,2,2,173,327,255,344,8,1519,1215
1594,7,3.1.10,0,579,0,64,10,74,10,0,111,287,64,30,30,2,2,179,327,189,344,8,1519,1215
1594,7,4.1.155,0,579,0,67,155,222,155,0,222,287,-44,138,138,2,2,255,327,316,344,8,1519,1215
1594,7,5.2.111,1,579,0,78,111,189,111,0,189,287,-111,111,205,3,1,189,223,234,223,8,1519,1215
1594,8,0.1.205,0,580,1,20,205,225,205,0,225,287,-94,188,299,2,2,150,327,200,344,9,1519,1137
1594,8,1.1.111,0,580,1,83,111,194,66,45,194,287,0,94,205,2,2,269,327,325,344,9,1519,1137
1594,8,2.1.287,0,580,1,93,287,380,287,0,380,380,-176,270,381,2,2,173,327,255,344,9,1519,1137
1594,8,3.1.10,0,579,0,64,10,74,10,0,111,287,64,30,141,2,2,179,327,189,344,9,1519,1137
1594,8,4.1.155,0,579,0,67,155,222,155,0,222,287,-44,138,249,2,2,255,327,316,344,9,1519,1137
1594,8,5.3.189,1,579,0,50,189,239,189,0,239,287,-189,189,394,4,1,111,287,234,287,9,1519,1137
1594,9,0.1.205,0,580,1,20,205,225,205,0,225,287,-94,188,488,2,2,150,327,200,344,10,1519,1087
1594,9,1.1.111,0,580,1,83,111,194,66,45,194,287,0,94,394,2,2,269,327,325,344,10,1519,1087
1594,9,2.1.287,0,580,1,93,287,380,287,0,380,380,-176,270,570,2,2,173,327,255,344,10,1519,1087
1594,9,3.1.10,0,579,0,64,10,74,10,0,111,287,64,30,330,2,2,179,327,189,344,10,1519,1087
1594,9,4.1.155,0,579,0,67,155,222,155,0,222,287,-44,138,438,2,2,255,327,316,344,10,1519,1087
1594,9,5.4.239,1,579,0,61,239,300,239,0,300,300,-239,239,633,5,1,61,378,234,378,10,1519,1087
1594,10,0.1.205,0,580,1,20,205,225,205,0,225,300,-94,188,727,2,2,150,327,200,344,11,1519,1026
1594,10,1.1.111,0,580,1,83,111,194,66,45,194,300,0,94,633,2,2,269,327,325,344,11,1519,1026
1594,10,2.1.287,0,580,1,93,287,380,287,0,380,380,-176,270,809,2,2,173,327,255,344,11,1519,1026
1594,10,3.1.10,1,579,0,64,10,74,10,0,111,300,64,30,569,2,2,179,327,189,344,11,1519,1026
1594,10,4.1.155,0,579,0,67,155,222,155,0,222,300,-44,138,677,2,2,255,327,316,344,11,1519,1026
1594,11,0.1.205,0,580,1,20,205,225,205,0,225,300,-94,124,663,2,3,150,263,200,344,12,1519,962
1594,11,1.1.111,0,580,1,83,111,194,66,45,194,300,0,30,569,2,3,269,263,325,344,12,1519,962
1594,11,2.1.287,0,580,1,93,287,380,287,0,380,380,-176,206,745,2,3,173,263,255,344,12,1519,962
1594,11,3.2.74,1,579,0,29,74,103,74,0,189,300,29,82,540,3,2,115,145,189,223,12,1519,962
1594,11,4.1.155,0,579,0,67,155,222,155,0,222,300,-44,74,613,2,3,255,263,316,344,12,1519,962
1594,12,0.1.205,0,580,1,20,205,225,205,0,225,300,-94,124,634,2,3,150,263,200,344,13,1519,933
1594,12,1.1.111,0,580,1,83,111,194,66,45,194,300,0,30,540,2,3,269,263,325,344,13,1519,933
1594,12,2.1.287,0,580,1,93,287,380,287,0,380,380,-176,206,716,2,3,173,263,255,344,13,1519,933
1594,12,3.3.103,1,579,0,37,103,140,103,0,239,300,37,152,503,4,2,86,237,189,287,13,1519,933
1594,12,4.1.155,0,579,0,67,155,222,155,0,222,300,-44,74,584,2,3,255,263,316,344,13,1519,933
1594,13,0.1.205,0,580,1,20,205,225,205,0,225,300,-94,124,597,2,3,150,263,200,344,14,1519,896
1594,13,1.1.111,0,580,1,83,111,194,66,45,194,300,0,30,503,2,3,269,263,325,344,14,1519,896
1594,13,2.1.287,0,580,1,93,287,380,287,0,380,380,-176,206,679,2,3,173,263,255,344,14,1519,896
1594,13,3.4.140,1,579,0,49,140,189,140,0,300,300,49,190,454,5,2,49,317,189,378,14,1519,896
1594,13,4.1.155,0,579,0,67,155,222,155,0,222,300,-44,74,547,2,3,255,263,316,344,14,1519,896
1594,14,0.1.205,0,580,1,20,205,225,205,0,225,300,-94,124,548,2,3,150,263,200,344,15,1519,847
1594,14,1.1.111,1,580,1,83,111,194,66,45,194,300,0,30,454,2,3,269,263,325,344,15,1519,847
1594,14,2.1.287,0,580,1,93,287,380,287,0,380,380,-176,206,630,2,3,173,263,255,344,15,1519,847
1594,14,4.1.155,0,579,0,67,155,222,155,0,222,300,-44,74,498,2,3,255,263,316,344,15,1519,847
1594,15,0.1.205,0,580,0,20,205,225,205,0,225,300,-11,41,465,2,4,150,180,200,344,16,1519,764
1594,15,1.2.194,1,580,0,19,194,213,194,0,213,300,-5,87,459,3,3,186,116,325,223,16,1519,764
1594,15,2.1.287,0,580,0,93,287,380,287,0,380,380,-93,123,547,2,4,173,180,255,344,16,1519,764
1594,15,4.1.194,0,580,0,67,194,261,155,39,261,300,0,30,454,2,4,255,180,316,344,16,1519,764
1594,16,0.1.205,0,580,0,20,205,225,205,0,225,300,-11,41,470,2,4,150,180,200,344,17,1519,745
1594,16,1.3.239,1,580,0,73,239,312,213,26,312,312,0,152,459,4,3,167,200,325,287,17,1519,745
1594,16,2.1.287,0,580,0,93,287,380,287,0,380,380,-93,123,552,2,4,173,180,255,344,17,1519,745
1594,16,4.1.194,0,580,0,67,194,261,155,39,261,300,0,30,459,2,4,255,180,316,344,17,1519,745
1594,17,0.1.205,0,580,0,20,205,225,205,0,225,312,-11,41,470,2,4,150,180,200,344,18,1519,672
1594,17,1.4.312,0,580,0,94,312,406,312,0,406,406,-12,202,471,5,3,94,268,325,378,18,1519,672
1594,17,2.1.287,0,580,0,93,287,380,287,0,380,380,-93,123,552,2,4,173,180,255,344,18,1519,672
1594,17,4.1.194,1,580,0,67,194,261,155,39,261,312,0,30,459,2,4,255,180,316,344,18,1519,672
1594,18,0.1.261,0,580,0,20,261,281,205,56,281,312,0,30,459,2,5,150,113,200,344,19,1519,605
1594,18,1.4.312,0,580,0,94,312,406,312,0,406,406,-12,202,471,5,3,94,268,325,378,19,1519,605
1594,18,2.1.287,0,580,0,93,287,380,287,0,380,380,-26,56,485,2,5,173,113,255,344,19,1519,605
1594,18,4.2.261,1,580,0,74,261,335,261,0,335,335,-48,135,507,3,4,188,97,316,223,19,1519,605
1594,19,0.1.261,0,580,0,20,261,281,205,56,281,335,0,30,507,2,5,150,113,200,344,20,1519,531
1594,19,1.4.312,0,580,0,94,312,406,312,0,406,406,-12,202,519,5,3,94,268,325,378,20,1519,531
1594,19,2.1.287,0,580,0,93,287,380,287,0,380,380,-26,56,533,2,5,173,113,255,344,20,1519,531
1594,19,4.3.335,1,580,0,15,335,350,335,0,350,350,-23,175,530,4,4,114,127,316,287,20,1519,531
1594,20,0.1.261,1,580,0,20,261,281,205,56,281,350,0,30,530,2,5,150,113,200,344,21,1519,516
1594,20,1.4.312,0,580,0,94,312,406,312,0,406,406,-12,202,542,5,3,94,268,325,378,21,1519,516
1594,20,2.1.287,0,580,0,93,287,380,287,0,380,380,-26,56,556,2,5,173,113,255,344,21,1519,516
1594,20,4.4.350,0,618,1,99,350,449,350,0,449,449,-50,240,580,5,3,99,268,316,378,21,1519,516
1594,21,0.2.335,1,580,0,5,335,340,281,54,340,350,0,135,530,3,5,130,23,200,223,22,1519,496
1594,21,1.4.312,0,580,0,94,312,406,312,0,406,406,-12,202,542,5,3,94,268,325,378,22,1519,496
1594,21,2.1.287,0,580,0,93,287,380,287,0,380,380,-6,36,536,2,6,173,93,255,344,22,1519,496
1594,21,4.4.350,0,618,1,99,350,449,350,0,449,449,-50,240,580,5,3,99,268,316,378,22,1519,496
1594,22,0.3.350,1,580,0,76,350,426,340,10,426,426,0,175,530,4,5,125,112,200,287,23,1519,491
1594,22,1.4.312,0,580,0,94,312,406,312,0,406,406,-12,202,542,5,3,94,268,325,378,23,1519,491
1594,22,2.1.287,0,580,0,93,287,380,287,0,380,380,-6,36,536,2,6,173,93,255,344,23,1519,491
1594,22,4.4.350,0,618,1,99,350,449,350,0,449,449,-50,240,580,5,3,99,268,316,378,23,1519,491
1594,23,0.4.426,0,600,1,49,426,475,426,0,475,475,-126,316,656,5,3,49,268,200,378,24,1519,415
1594,23,1.4.312,1,580,0,94,312,406,312,0,406,426,-12,202,542,5,3,94,268,325,378,24,1519,415
1594,23,2.1.287,0,580,0,93,287,380,287,0,380,426,-6,36,536,2,6,173,93,255,344,24,1519,415
1594,23,4.4.350,0,618,2,99,350,449,350,0,449,449,-50,240,580,5,3,99,268,316,378,24,1519,415
1594,24,0.4.426,0,600,1,49,426,475,426,0,475,475,-20,222,562,5,4,49,174,200,378,25,1519,321
1594,24,2.1.287,0,580,0,93,287,380,287,0,380,426,-6,36,548,2,6,173,93,255,344,25,1519,321
1594,24,4.4.406,1,580,0,99,406,505,350,56,505,505,0,202,542,5,4,99,174,316,378,25,1519,321
1594,25,0.4.505,1,580,0,49,505,554,426,79,554,554,0,202,542,5,5,49,75,200,378,26,1519,222
1594,25,2.1.287,0,580,0,93,287,380,287,0,380,505,-6,36,548,2,6,173,93,255,344,26,1519,222
1594,26,2.1.287,1,580,0,93,287,380,287,0,380,554,-6,36,548,2,6,173,93,255,344,27,1519,173
1594,27,2.2.380,1,580,0,18,380,398,380,0,398,554,-40,175,588,3,6,80,18,255,223,28,1519,80
1594,28,2.3.426,1,580,0,36,426,462,398,28,462,554,0,175,588,4,6,62,36,255,287,29,1519,62
1594,29,2.4.554,1,580,0,26,554,580,462,92,580,580,0,202,588,5,6,26,26,255,378,30,1519,26
1595,0,0.0.0,0,603,5,63,0,63,0,0,63,63,0,0,0,1,1,243,302,243,302,1,1389,1389
1595,0,1.0.0,0,568,4,32,0,32,0,0,32,32,0,0,0,1,1,127,302,127,302,1,1389,1389
1595,0,2.0.0,1,550,2,29,0,29,0,0,29,29,0,0,0,1,1,281,302,281,302,1,1389,1389
1595,0,3.0.0,0,540,0,63,0,63,0,0,63,63,0,0,0,1,1,347,302,347,302,1,1389,1389
1595,0,4.0.0,0,562,3,82,0,82,0,0,82,82,0,0,0,1,1,253,302,253,302,1,1389,1389
1595,0,5.0.0,0,545,1,33,0,33,0,0,33,33,0,0,0,1,1,138,302,138,302,1,1389,1389
1595,1,0.0.29,0,559,1,63,29,92,0,29,92,92,0,0,0,1,2,243,273,243,302,2,1389,1360
1595,1,1.0.29,0,559,1,32,29,61,0,29,61,61,0,0,0,1,2,127,273,127,302,2,1389,1360
1595,1,2.1.29,1,559,1,87,29,116,29,0,116,116,-29,29,29,2,1,252,248,281,248,2,1389,1360
1595,1,3.0.29,0,550,0,63,29,92,0,29,92,92,0,0,0,1,2,347,273,347,302,2,1389,1360
1595,1,4.0.29,0,566,2,82,29,111,0,29,111,111,0,0,0,1,2,253,273,253,302,2,1389,1360
1595,1,5.0.29,0,559,1,33,29,62,0,29,62,62,0,0,0,1,2,138,273,138,302,2,1389,1360
1595,2,0.0.29,0,559,0,63,29,92,0,29,92,116,0,0,29,1,2,243,273,243,302,3,1389,1273
1595,2,1.0.29,0,559,0,32,29,61,0,29,61,116,0,0,29,1,2,127,273,127,302,3,1389,1273
1595,2,2.2.116,1,559,0,70,116,186,116,0,186,186,-116,116,145,3,1,165,289,281,289,3,1389,1273
1595,2,3.0.29,0,559,0,63,29,92,0,29,92,116,0,0,29,1,2,347,273,347,302,3,1389,1273
1595,2,4.0.29,0,566,1,82,29,111,0,29,111,116,0,0,29,1,2,253,273,253,302,3,1389,1273
1595,2,5.0.29,0,559,0,33,29,62,0,29,62,116,0,0,29,1,2,138,273,138,302,3,1389,1273
1595,3,0.0.29,0,559,0,63,29,92,0,29,92,186,0,0,145,1,2,243,273,243,302,4,1389,1203
1595,3,1.0.29,0,559,0,32,29,61,0,29,61,186,0,0,145,1,2,127,273,127,302,4,1389,1203
1595,3,2.3.186,1,559,0,5,186,191,186,0,191,191,-186,186,331,4,1,95,242,281,242,4,1389,1203
1595,3,3.0.29,0,559,0,63,29,92,0,29,92,186,0,0,145,1,2,347,273,347,302,4,1389,1203
1595,3,4.0.29,0,566,1,82,29,111,0,29,111,186,0,0,145,1,2,253,273,253,302,4,1389,1203
1595,3,5.0.29,0,559,0,33,29,62,0,29,62,186,0,0,145,1,2,138,273,138,302,4,1389,1203
1595,4,0.0.29,0,559,0,63,29,92,0,29,92,191,0,0,331,1,2,243,273,243,302,5,1389,1198
1595,4,1.0.29,0,559,0,32,29,61,0,29,61,191,0,0,331,1,2,127,273,127,302,5,1389,1198
1595,4,2.4.191,1,559,0,90,191,281,191,0,281,281,-191,191,522,5,1,90,308,281,308,5,1389,1198
1595,4,3.0.29,0,559,0,63,29,92,0,29,92,191,0,0,331,1,2,347,273,347,302,5,1389,1198
1595,4,4.0.29,0,566,1,82,29,111,0,29,111,191,0,0,331,1,2,253,273,253,302,5,1389,1198
1595,4,5.0.29,0,559,0,33,29,62,0,29,62,191,0,0,331,1,2,138,273,138,302,5,1389,1198
1595,5,0.0.29,0,559,0,63,29,92,0,29,92,281,0,0,522,1,2,243,273,243,302,6,1389,1108
1595,5,1.0.29,0,559,0,32,29,61,0,29,61,281,0,0,522,1,2,127,273,127,302,6,1389,1108
1595,5,3.0.29,1,559,0,63,29,92,0,29,92,281,0,0,522,1,2,347,273,347,302,6,1389,1108
1595,5,4.0.29,0,566,1,82,29,111,0,29,111,281,0,0,522,1,2,253,273,253,302,6,1389,1108
1595,5,5.0.29,0,559,0,33,29,62,0,29,62,281,0,0,522,1,2,138,273,138,302,6,1389,1108
1595,6,0.0.92,0,562,1,63,92,155,0,92,155,281,0,0,522,1,3,243,210,243,302,7,1389,1045
1595,6,1.0.92,0,559,0,32,92,124,0,92,124,281,0,0,522,1,3,127,210,127,302,7,1389,1045
1595,6,3.1.116,1,559,0,3,116,119,92,24,119,281,0,29,522,2,2,284,161,347,248,7,1389,1045
1595,6,4.0.92,0,576,2,82,92,174,0,92,174,281,0,0,522,1,3,253,210,253,302,7,1389,1045
1595,6,5.0.92,0,559,0,33,92,125,0,92,125,281,0,0,522,1,3,138,210,138,302,7,1389,1045
1595,7,0.0.92,0,562,1,63,92,155,0,92,155,281,0,0,522,1,3,243,210,243,302,8,1389,1042
1595,7,1.0.92,0,559,0,32,92,124,0,92,124,281,0,0,522,1,3,127,210,127,302,8,1389,1042
1595,7,3.2.186,1,577,3,95,186,281,119,67,281,281,0,116,522,3,2,281,219,347,289,8,1389,1042
1595,7,4.0.92,0,576,2,82,92,174,0,92,174,281,0,0,522,1,3,253,210,253,302,8,1389,1042
1595,7,5.0.92,0,559,0,33,92,125,0,92,125,281,0,0,522,1,3,138,210,138,302,8,1389,1042
1595,8,0.0.92,0,577,0,63,92,155,0,92,155,281,0,0,522,1,3,243,210,243,302,9,1389,947
1595,8,1.0.92,0,577,0,32,92,124,0,92,124,281,0,0,522,1,3,127,210,127,302,9,1389,947
1595,8,3.3.281,1,594,1,95,281,376,281,0,376,376,-90,276,612,4,2,186,237,347,242,9,1389,947
1595,8,4.0.92,0,577,0,82,92,174,0,92,174,281,0,0,522,1,3,253,210,253,302,9,1389,947
1595,8,5.0.92,0,577,0,33,92,125,0,92,125,281,0,0,522,1,3,138,210,138,302,9,1389,947
1595,9,0.0.92,0,594,0,63,92,155,0,92,155,376,0,0,612,1,3,243,210,243,302,10,1389,852
1595,9,1.0.92,0,594,0,32,92,124,0,92,124,376,0,0,612,1,3,127,210,127,302,10,1389,852
1595,9,3.4.376,1,594,0,91,376,467,376,0,467,467,-95,286,707,5,2,91,218,347,308,10,1389,852
1595,9,4.0.92,0,594,0,82,92,174,0,92,174,376,0,0,612,1,3,253,210,253,302,10,1389,852
1595,9,5.0.92,0,594,0,33,92,125,0,92,125,376,0,0,612,1,3,138,210,138,302,10,1389,852
1595,10,0.0.92,1,594,0,63,92,155,0,92,155,467,0,0,707,1,3,243,210,243,302,11,1389,761
1595,10,1.0.92,0,594,0,32,92,124,0,92,124,467,0,0,707,1,3,127,210,127,302,11,1389,761
1595,10,4.0.92,0,594,0,82,92,174,0,92,174,467,0,0,707,1,3,253,210,253,302,11,1389,761
1595,10,5.0.92,0,594,0,33,92,125,0,92,125,467,0,0,707,1,3,138,210,138,302,11,1389,761
1595,11,0.1.155,0,594,0,87,155,242,155,0,242,467,-36,65,743,2,3,180,158,243,248,12,1389,698
1595,11,1.0.155,0,594,0,32,155,187,0,155,187,467,0,0,707,1,4,127,147,127,302,12,1389,698
1595,11,4.0.155,0,594,0,82,155,237,0,155,237,467,0,0,707,1,4,253,147,253,302,12,1389,698
1595,11,5.0.155,1,594,0,33,155,188,0,155,188,467,0,0,707,1,4,138,147,138,302,12,1389,698
1595,12,0.1.155,0,594,0,87,155,242,155,0,242,467,-36,65,743,2,3,180,158,243,248,13,1389,665
1595,12,1.0.188,0,594,0,32,188,220,0,188,220,467,0,0,707,1,5,127,114,127,302,13,1389,665
1595,12,4.0.188,1,594,0,82,188,270,0,188,270,467,0,0,707,1,5,253,114,253,302,13,1389,665
1595,12,5.1.188,0,594,0,1,188,189,188,0,189,467,-69,98,776,2,3,105,158,138,248,13,1389,665
1595,13,0.1.155,0,594,0,87,155,242,155,0,242,467,-36,65,743,2,3,180,158,243,248,14,1389,583
1595,13,1.0.270,1,594,0,32,270,302,0,270,302,467,0,0,707,1,6,127,32,127,302,14,1389,583
1595,13,4.1.270,0,594,0,19,270,289,270,0,289,467,-151,180,858,2,3,171,158,253,248,14,1389,583
1595,13,5.1.188,0,594,0,1,188,189,188,0,189,467,-69,98,776,2,3,105,158,138,248,14,1389,583
1595,14,0.1.155,0,594,0,87,155,242,155,0,242,467,-36,65,743,2,3,180,158,243,248,15,1389,551
1595,14,1.1.302,0,594,0,51,302,353,302,0,353,467,-183,212,890,2,3,95,158,127,248,15,1389,551
1595,14,4.1.270,0,594,0,19,270,289,270,0,289,467,-151,180,858,2,3,171,158,253,248,15,1389,551
1595,14,5.1.188,1,594,0,1,188,189,188,0,189,467,-69,98,776,2,3,105,158,138,248,15,1389,551
1595,15,0.1.189,0,594,0,87,189,276,155,34,276,467,0,98,776,2,4,180,157,243,248,16,1389,550
1595,15,1.1.302,0,594,0,51,302,353,302,0,353,467,-113,211,889,2,4,95,157,127,248,16,1389,550
1595,15,4.1.270,0,594,0,19,270,289,270,0,289,467,-81,179,857,2,4,171,157,253,248,16,1389,550
1595,15,5.2.281,1,594,0,17,281,298,189,92,298,467,0,116,776,3,3,104,124,138,289,16,1389,550
1595,16,0.1.189,0,594,0,87,189,276,155,34,276,467,0,98,776,2,4,180,157,243,248,17,1389,533
1595,16,1.1.302,0,594,0,51,302,353,302,0,353,467,-113,211,889,2,4,95,157,127,248,17,1389,533
1595,16,4.1.270,0,594,0,19,270,289,270,0,289,467,-81,179,857,2,4,171,157,253,248,17,1389,533
1595,16,5.3.376,1,594,0,35,376,411,298,78,411,467,0,276,776,4,3,87,142,138,242,17,1389,533
1595,17,0.1.189,0,594,0,87,189,276,155,34,276,467,0,98,776,2,4,180,157,243,248,18,1389,498
1595,17,1.1.302,0,594,0,51,302,353,302,0,353,467,-113,211,889,2,4,95,157,127,248,18,1389,498
1595,17,4.1.270,0,594,0,19,270,289,270,0,289,467,-81,179,857,2,4,171,157,253,248,18,1389,498
1595,17,5.4.467,1,594,0,52,467,519,411,56,519,519,0,286,776,5,3,52,127,138,308,18,1389,498
1595,18,0.1.189,1,594,0,87,189,276,155,34,276,519,0,98,776,2,4,180,157,243,248,19,1389,446
1595,18,1.1.302,0,594,0,51,302,353,302,0,353,519,-113,211,889,2,4,95,157,127,248,19,1389,446
1595,18,4.1.270,0,594,0,19,270,289,270,0,289,519,-81,179,857,2,4,171,157,253,248,19,1389,446
1595,19,0.2.298,1,594,0,8,298,306,276,22,306,519,0,116,776,3,4,93,107,243,289,20,1389,359
1595,19,1.1.302,0,594,0,51,302,353,302,0,353,519,-26,124,802,2,5,95,70,127,248,20,1389,359
1595,19,4.1.276,0,594,0,19,276,295,270,6,295,519,0,98,776,2,5,171,70,253,248,20,1389,359
1595,20,0.3.411,0,594,0,83,411,494,306,105,494,519,0,276,776,4,4,85,107,243,242,21,1389,351
1595,20,1.1.302,0,594,0,51,302,353,302,0,353,519,-26,124,802,2,5,95,70,127,248,21,1389,351
1595,20,4.1.276,1,594,0,19,276,295,270,6,295,519,0,98,776,2,5,171,70,253,248,21,1389,351
1595,21,0.3.411,0,594,0,83,411,494,306,105,494,519,0,276,776,4,4,85,107,243,242,22,1389,332
1595,21,1.1.302,0,594,0,51,302,353,302,0,353,519,-7,105,783,2,6,95,51,127,248,22,1389,332
1595,21,4.2.306,1,594,0,75,306,381,295,11,381,519,0,116,776,3,5,152,99,253,289,22,1389,332
1595,22,0.3.411,0,594,0,83,411,494,306,105,494,519,0,276,776,4,4,85,107,243,242,23,1389,257
1595,22,1.1.302,0,594,0,51,302,353,302,0,353,519,-7,105,783,2,6,95,51,127,248,23,1389,257
1595,22,4.3.411,1,594,0,8,411,419,381,30,419,519,0,276,776,4,4,77,107,253,242,23,1389,257
1595,23,0.3.419,1,594,0,83,419,502,306,113,502,519,0,276,776,4,5,85,99,243,242,24,1389,249
1595,23,1.1.302,0,594,0,51,302,353,302,0,353,519,-7,105,783,2,6,95,51,127,248,24,1389,249
1595,23,4.4.519,0,594,0,69,519,588,419,100,588,588,0,286,776,5,4,69,75,253,308,24,1389,249
1595,24,0.4.519,1,594,0,2,519,521,502,17,521,521,0,286,776,5,4,2,75,243,308,25,1389,166
1595,24,1.1.302,0,594,0,51,302,353,302,0,353,519,-7,105,783,2,6,95,51,127,248,25,1389,166
1595,24,4.4.519,0,594,0,69,519,588,419,100,588,588,0,286,776,5,4,69,75,253,308,25,1389,166
1595,25,1.1.302,0,594,0,51,302,353,302,0,353,521,-7,105,783,2,6,95,51,127,248,26,1389,164
1595,25,4.4.521,1,594,0,69,521,590,419,102,590,590,0,286,776,5,5,69,73,253,308,26,1389,164
1595,26,1.1.302,1,594,0,51,302,353,302,0,353,590,-7,105,783,2,6,95,51,127,248,27,1389,95
1595,27,1.2.381,1,594,0,24,381,405,353,28,405,590,0,116,783,3,6,44,24,127,289,28,1389,44
1595,28,1.3.502,1,594,0,16,502,518,405,97,518,590,0,276,783,4,6,20,16,127,242,29,1389,20
1595,29,1.4.590,1,594,0,4,590,594,518,72,594,594,0,286,783,5,6,4,4,127,308,30,1389,4
1596,0,0.0.0,0,542,5,76,0,76,0,0,76,76,0,0,0,1,1,287,217,287,217,1,1362,1362
1596,0,1.0.0,0,486,0,8,0,8,0,0,8,8,0,0,0,1,1,128,217,128,217,1,1362,1362
1596,0,2.0.0,0,540,4,74,0,74,0,0,74,74,0,0,0,1,1,307,217,307,217,1,1362,1362
1596,0,3.0.0,0,491,2,16,0,16,0,0,16,16,0,0,0,1,1,208,217,208,217,1,1362,1362
1596,0,4.0.0,1,487,1,5,0,5,0,0,5,5,0,0,0,1,1,192,217,192,217,1,1362,1362
1596,0,5.0.0,0,516,3,38,0,38,0,0,38,38,0,0,0,1,1,240,217,240,217,1,1362,1362
1596,1,0.0.5,0,495,2,76,5,81,0,5,81,81,0,0,0,1,2,287,212,287,217,2,1362,1357
1596,1,1.0.5,0,487,0,8,5,13,0,5,13,13,0,0,0,1,2,128,212,128,217,2,1362,1357
1596,1,2.0.5,0,493,1,74,5,79,0,5,79,79,0,0,0,1,2,307,212,307,217,2,1362,1357
1596,1,3.0.5,1,495,2,16,5,21,0,5,21,21,0,0,0,1,2,208,212,208,217,2,1362,1357
1596,1,4.1.5,0,493,1,71,5,76,5,0,76,76,-5,5,5,2,1,187,350,192,350,2,1362,1357
1596,1,5.0.5,0,510,3,38,5,43,0,5,43,43,0,0,0,1,2,240,212,240,217,2,1362,1357
1596,2,0.0.21,0,495,0,76,21,97,0,21,97,97,0,0,0,1,3,287,196,287,217,3,1362,1341
1596,2,1.0.21,0,497,2,8,21,29,0,21,29,29,0,0,0,1,3,128,196,128,217,3,1362,1341
1596,2,2.0.21,0,509,3,74,21,95,0,21,95,95,0,0,0,1,3,307,196,307,217,3,1362,1341
1596,2,3.1.21,0,496,1,41,21,62,21,0,62,62,-21,21,21,2,1,192,350,208,350,3,1362,1341
1596,2,4.1.5,0,495,0,71,5,76,5,0,76,76,-5,5,5,2,1,187,350,192,350,3,1362,1341
1596,2,5.0.21,1,496,1,38,21,59,0,21,59,59,0,0,0,1,3,240,196,240,217,3,1362,1341
1596,3,0.0.59,0,496,0,76,59,135,0,59,135,135,0,0,0,1,4,287,158,287,217,4,1362,1303
1596,3,1.0.59,1,504,1,8,59,67,0,59,67,67,0,0,0,1,4,128,158,128,217,4,1362,1303
1596,3,2.0.59,0,511,3,74,59,133,0,59,133,133,0,0,0,1,4,307,158,307,217,4,1362,1303
1596,3,3.1.21,0,496,0,41,21,62,21,0,62,62,-21,21,21,2,1,192,350,208,350,4,1362,1303
1596,3,4.1.5,0,510,2,71,5,76,5,0,76,76,-5,5,5,2,1,187,350,192,350,4,1362,1303
1596,3,5.1.59,0,545,4,83,59,142,59,0,142,142,-59,59,59,2,1,202,350,240,350,4,1362,1303
1596,4,0.0.67,0,504,0,76,67,143,0,67,143,143,0,0,0,1,5,287,150,287,217,5,1362,1295
1596,4,1.1.67,0,508,1,20,67,87,67,0,87,87,-67,67,67,2,1,120,350,128,350,5,1362,1295
1596,4,2.0.67,1,519,3,74,67,141,0,67,141,141,0,0,0,1,5,307,150,307,217,5,1362,1295
1596,4,3.1.21,0,504,0,41,21,62,21,0,62,67,-21,21,21,2,1,192,350,208,350,5,1362,1295
1596,4,4.1.5,0,510,2,71,5,76,5,0,76,76,-5,5,5,2,1,187,350,192,350,5,1362,1295
1596,4,5.1.59,0,545,4,83,59,142,59,0,142,142,-59,59,59,2,1,202,350,240,350,5,1362,1295
1596,5,0.0.141,1,519,0,76,141,217,0,141,217,217,0,0,0,1,6,287,76,287,217,6,1362,1221
1596,5,1.1.67,0,523,2,20,67,87,67,0,87,141,-67,67,67,2,1,120,350,128,350,6,1362,1221
1596,5,2.1.141,0,519,0,80,141,221,141,0,221,221,-141,141,141,2,1,233,350,307,350,6,1362,1221
1596,5,3.1.21,0,519,0,41,21,62,21,0,62,141,-21,21,21,2,1,192,350,208,350,6,1362,1221
1596,5,4.1.5,0,522,1,71,5,76,5,0,76,141,-5,5,5,2,1,187,350,192,350,6,1362,1221
1596,5,5.1.59,0,555,3,83,59,142,59,0,142,142,-59,59,59,2,1,202,350,240,350,6,1362,1221
1596,6,0.1.217,0,522,1,55,217,272,217,0,272,272,-217,217,217,2,1,211,350,287,350,7,1362,1145
1596,6,1.1.67,0,523,2,20,67,87,67,0,87,217,-67,67,67,2,1,120,350,128,350,7,1362,1145
1596,6,2.1.141,0,519,0,80,141,221,141,0,221,221,-141,141,141,2,1,233,350,307,350,7,1362,1145
1596,6,3.1.21,1,519,0,41,21,62,21,0,62,217,-21,21,21,2,1,192,350,208,350,7,1362,1145
1596,6,4.1.5,0,522,1,71,5,76,5,0,76,217,-5,5,5,2,1,187,350,192,350,7,1362,1145
1596,6,5.1.59,0,555,3,83,59,142,59,0,142,217,-59,59,59,2,1,202,350,240,350,7,1362,1145
1596,7,0.1.217,0,524,2,55,217,272,217,0,272,272,-155,176,176,2,2,211,309,287,350,8,1362,1104
1596,7,1.1.67,0,523,1,20,67,87,67,0,87,217,-5,26,26,2,2,120,309,128,350,8,1362,1104
1596,7,2.1.141,0,519,0,80,141,221,141,0,221,221,-79,100,100,2,2,233,309,307,350,8,1362,1104
1596,7,3.2.62,1,519,0,63,62,125,62,0,125,217,-62,62,83,3,1,151,259,208,259,8,1362,1104
1596,7,4.1.62,0,519,0,71,62,133,5,57,133,217,0,21,21,2,2,187,309,192,350,8,1362,1104
1596,7,5.1.62,0,519,0,83,62,145,59,3,145,217,0,21,21,2,2,202,309,240,350,8,1362,1104
1596,8,0.1.217,0,524,2,55,217,272,217,0,272,272,-155,176,238,2,2,211,309,287,350,9,1362,1041
1596,8,1.1.67,0,523,1,20,67,87,67,0,87,217,-5,26,88,2,2,120,309,128,350,9,1362,1041
1596,8,2.1.141,0,519,0,80,141,221,141,0,221,221,-79,100,162,2,2,233,309,307,350,9,1362,1041
1596,8,3.3.125,1,519,0,55,125,180,125,0,180,217,-125,125,208,4,1,88,296,208,296,9,1362,1041
1596,8,4.1.62,0,519,0,71,62,133,5,57,133,217,0,21,83,2,2,187,309,192,350,9,1362,1041
1596,8,5.1.62,0,519,0,83,62,145,59,3,145,217,0,21,83,2,2,202,309,240,350,9,1362,1041
1596,9,0.1.217,0,524,2,55,217,272,217,0,272,272,-155,176,363,2,2,211,309,287,350,10,1362,986
1596,9,1.1.67,0,523,1,20,67,87,67,0,87,217,-5,26,213,2,2,120,309,128,350,10,1362,986
1596,9,2.1.141,0,519,0,80,141,221,141,0,221,221,-79,100,287,2,2,233,309,307,350,10,1362,986
1596,9,3.4.180,1,519,0,33,180,213,180,0,213,217,-180,180,388,5,1,33,240,208,240,10,1362,986
1596,9,4.1.62,0,519,0,71,62,133,5,57,133,217,0,21,208,2,2,187,309,192,350,10,1362,986
1596,9,5.1.62,0,519,0,83,62,145,59,3,145,217,0,21,208,2,2,202,309,240,350,10,1362,986
1596,10,0.1.217,0,524,2,55,217,272,217,0,272,272,-155,176,543,2,2,211,309,287,350,11,1362,953
1596,10,1.1.67,0,523,1,20,67,87,67,0,87,217,-5,26,393,2,2,120,309,128,350,11,1362,953
1596,10,2.1.141,0,519,0,80,141,221,141,0,221,221,-79,100,467,2,2,233,309,307,350,11,1362,953
1596,10,4.1.62,1,519,0,71,62,133,5,57,133,217,0,21,388,2,2,187,309,192,350,11,1362,953
1596,10,5.1.62,0,519,0,83,62,145,59,3,145,217,0,21,388,2,2,202,309,240,350,11,1362,953
1596,11,0.1.217,0,524,1,55,217,272,217,0,272,272,-84,105,472,2,3,211,238,287,350,12,1362,882
1596,11,1.1.133,0,531,2,20,133,153,67,66,153,217,0,21,388,2,3,120,238,128,350,12,1362,882
1596,11,2.1.141,0,519,0,80,141,221,141,0,221,221,-8,29,396,2,3,233,238,307,350,12,1362,882
1596,11,4.2.133,1,519,0,75,133,208,133,0,208,217,-8,70,396,3,2,116,196,192,259,12,1362,882
1596,11,5.1.133,0,524,1,83,133,216,59,74,216,217,0,21,388,2,3,202,238,240,350,12,1362,882
1596,12,0.1.217,0,524,1,55,217,272,217,0,272,272,-84,105,480,2,3,211,238,287,350,13,1362,807
1596,12,1.1.133,0,531,2,20,133,153,67,66,153,217,0,21,396,2,3,120,238,128,350,13,1362,807
1596,12,2.1.141,0,519,0,80,141,221,141,0,221,221,-8,29,404,2,3,233,238,307,350,13,1362,807
1596,12,4.3.208,1,519,0,1,208,209,208,0,209,217,-28,153,424,4,2,41,241,192,296,13,1362,807
1596,12,5.1.133,0,524,1,83,133,216,59,74,216,217,0,21,396,2,3,202,238,240,350,13,1362,807
1596,13,0.1.217,0,524,1,55,217,272,217,0,272,272,-84,105,508,2,3,211,238,287,350,14,1362,806
1596,13,1.1.133,0,531,2,20,133,153,67,66,153,217,0,21,424,2,3,120,238,128,350,14,1362,806
1596,13,2.1.141,0,519,0,80,141,221,141,0,221,221,-8,29,432,2,3,233,238,307,350,14,1362,806
1596,13,4.4.213,1,519,0,40,213,253,209,4,253,253,0,180,424,5,2,40,207,192,240,14,1362,806
1596,13,5.1.133,0,524,1,83,133,216,59,74,216,217,0,21,424,2,3,202,238,240,350,14,1362,806
1596,14,0.1.217,0,524,1,55,217,272,217,0,272,272,-84,105,508,2,3,211,238,287,350,15,1362,766
1596,14,1.1.133,1,531,2,20,133,153,67,66,153,253,0,21,424,2,3,120,238,128,350,15,1362,766
1596,14,2.1.141,0,519,0,80,141,221,141,0,221,253,-8,29,432,2,3,233,238,307,350,15,1362,766
1596,14,5.1.133,0,524,1,83,133,216,59,74,216,253,0,21,424,2,3,202,238,240,350,15,1362,766
1596,15,0.1.217,0,558,2,55,217,272,217,0,272,272,-64,85,488,2,4,211,218,287,350,16,1362,746
1596,15,1.2.208,1,534,1,30,208,238,153,55,238,253,0,70,424,3,3,100,121,128,259,16,1362,746
1596,15,2.1.153,0,531,0,80,153,233,141,12,233,253,0,21,424,2,4,233,218,307,350,16,1362,746
1596,15,5.1.153,0,534,1,83,153,236,59,94,236,253,0,21,424,2,4,202,218,240,350,16,1362,746
1596,16,0.1.217,0,558,2,55,217,272,217,0,272,272,-64,85,488,2,4,211,218,287,350,17,1362,716
1596,16,1.3.238,0,534,0,57,238,295,238,0,295,295,-29,182,453,4,3,70,240,128,296,17,1362,716
1596,16,2.1.153,0,535,1,80,153,233,141,12,233,253,0,21,424,2,4,233,218,307,350,17,1362,716
1596,16,5.1.153,1,534,0,83,153,236,59,94,236,253,0,21,424,2,4,202,218,240,350,17,1362,716
1596,17,0.1.236,0,534,0,55,236,291,217,19,291,291,0,21,424,2,5,211,135,287,350,18,1362,633
1596,17,1.3.238,0,534,0,57,238,295,238,0,295,295,-29,182,453,4,3,70,240,128,296,18,1362,633
1596,17,2.1.236,0,557,1,80,236,316,141,95,316,316,0,21,424,2,5,233,135,307,350,18,1362,633
1596,17,5.2.238,1,534,0,55,238,293,236,2,293,293,0,70,424,3,4,119,91,240,259,18,1362,633
1596,18,0.1.236,0,534,0,55,236,291,217,19,291,293,0,21,424,2,5,211,135,287,350,19,1362,578
1596,18,1.3.238,0,534,0,57,238,295,238,0,295,295,-29,182,453,4,3,70,240,128,296,19,1362,578
1596,18,2.1.236,1,557,2,80,236,316,141,95,316,316,0,21,424,2,5,233,135,307,350,19,1362,578
1596,18,5.3.293,0,546,1,20,293,313,293,0,313,313,-84,237,508,4,3,64,240,240,296,19,1362,578
1596,19,0.1.316,0,557,0,55,316,371,217,99,371,371,0,21,424,2,6,211,55,287,350,20,1362,498
1596,19,1.3.238,0,557,0,57,238,295,238,0,295,316,-29,182,453,4,3,70,240,128,296,20,1362,498
1596,19,2.2.316,1,557,0,24,316,340,316,0,340,340,-23,93,447,3,5,153,36,307,259,20,1362,498
1596,19,5.3.293,0,573,1,20,293,313,293,0,313,316,-84,237,508,4,3,64,240,240,296,20,1362,498
1596,20,0.1.316,1,557,0,55,316,371,217,99,371,371,0,21,447,2,6,211,55,287,350,21,1362,474
1596,20,1.3.238,0,557,0,57,238,295,238,0,295,340,-29,182,476,4,3,70,240,128,296,21,1362,474
1596,20,2.3.340,0,557,0,73,340,413,340,0,413,413,-131,284,578,4,3,129,240,307,296,21,1362,474
1596,20,5.3.293,0,573,1,20,293,313,293,0,313,340,-84,237,531,4,3,64,240,240,296,21,1362,474
1596,21,0.2.371,1,557,0,12,371,383,371,0,383,383,-31,124,478,3,6,156,12,287,259,22,1362,419
1596,21,1.3.238,0,557,0,57,238,295,238,0,295,371,-29,182,476,4,3,70,240,128,296,22,1362,419
1596,21,2.3.340,0,557,0,73,340,413,340,0,413,413,-131,284,578,4,3,129,240,307,296,22,1362,419
1596,21,5.3.293,0,573,1,20,293,313,293,0,313,371,-84,237,531,4,3,64,240,240,296,22,1362,419
1596,22,0.3.383,0,602,2,90,383,473,383,0,473,473,-174,327,652,4,3,144,240,287,296,23,1362,407
1596,22,1.3.238,0,557,0,57,238,295,238,0,295,383,-29,182,507,4,3,70,240,128,296,23,1362,407
1596,22,2.3.340,0,557,0,73,340,413,340,0,413,413,-131,284,609,4,3,129,240,307,296,23,1362,407
1596,22,5.3.293,1,573,1,20,293,313,293,0,313,383,-84,237,562,4,3,64,240,240,296,23,1362,407
1596,23,0.3.383,0,602,2,90,383,473,383,0,473,473,-70,307,632,4,4,144,220,287,296,24,1362,387
1596,23,1.3.313,0,587,1,57,313,370,238,75,370,383,0,237,562,4,4,70,220,128,296,24,1362,387
1596,23,2.3.340,0,573,0,73,340,413,340,0,413,413,-27,264,589,4,4,129,220,307,296,24,1362,387
1596,23,5.4.313,1,573,0,44,313,357,313,0,357,383,-60,240,622,5,3,44,167,240,240,24,1362,387
1596,24,0.3.383,0,602,2,90,383,473,383,0,473,473,-70,307,692,4,4,144,220,287,296,25,1362,343
1596,24,1.3.313,1,587,1,57,313,370,238,75,370,383,0,237,622,4,4,70,220,128,296,25,1362,343
1596,24,2.3.340,0,573,0,73,340,413,340,0,413,413,-27,264,649,4,4,129,220,307,296,25,1362,343
1596,25,0.3.383,0,602,1,90,383,473,383,0,473,473,-13,250,635,4,5,144,163,287,296,26,1362,286
1596,25,1.4.370,1,587,0,13,370,383,370,0,383,383,-13,253,635,5,4,13,123,128,240,26,1362,286
1596,25,2.3.370,0,587,0,73,370,443,340,30,443,443,0,237,622,4,5,129,163,307,296,26,1362,286
1596,26,0.3.383,0,602,1,90,383,473,383,0,473,473,-13,250,648,4,5,144,163,287,296,27,1362,273
1596,26,2.3.370,1,587,0,73,370,443,340,30,443,443,0,237,635,4,5,129,163,307,296,27,1362,273
1596,27,0.3.443,0,587,0,90,443,533,383,60,533,533,0,237,635,4,6,144,90,287,296,28,1362,200
1596,27,2.4.443,1,587,0,56,443,499,443,0,499,499,-60,313,695,5,5,56,110,307,240,28,1362,200
1596,28,0.3.443,1,587,0,90,443,533,383,60,533,533,0,237,695,4,6,144,90,287,296,29,1362,144
1596,29,0.4.533,1,587,0,54,533,587,533,0,587,587,-34,347,729,5,6,54,54,287,240,30,1362,54
1597,0,0.0.0,0,577,3,89,0,89,0,0,89,89,0,0,0,1,1,231,331,231,331,1,1526,1526
1597,0,1.0.0,0,579,4,83,0,83,0,0,83,83,0,0,0,1,1,325,331,325,331,1,1526,1526
1597,0,2.0.0,1,533,1,21,0,21,0,0,21,21,0,0,0,1,1,235,331,235,331,1,1526,1526
1597,0,3.0.0,0,583,5,69,0,69,0,0,69,69,0,0,0,1,1,266,331,266,331,1,1526,1526
1597,0,4.0.0,0,525,0,27,0,27,0,0,27,27,0,0,0,1,1,229,331,229,331,1,1526,1526
1597,0,5.0.0,0,554,2,42,0,42,0,0,42,42,0,0,0,1,1,240,331,240,331,1,1526,1526
1597,1,0.0.21,0,573,3,89,21,110,0,21,110,110,0,0,0,1,2,231,310,231,331,2,1526,1505
1597,1,1.0.21,0,543,1,83,21,104,0,21,104,104,0,0,0,1,2,325,310,325,331,2,1526,1505
1597,1,2.1.21,0,543,1,74,21,95,21,0,95,95,-21,21,21,2,1,214,353,235,353,2,1526,1505
1597,1,3.0.21,0,573,3,69,21,90,0,21,90,90,0,0,0,1,2,266,310,266,331,2,1526,1505
1597,1,4.0.21,1,533,0,27,21,48,0,21,48,48,0,0,0,1,2,229,310,229,331,2,1526,1505
1597,1,5.0.21,0,565,2,42,21,63,0,21,63,63,0,0,0,1,2,240,310,240,331,2,1526,1505
1597,2,0.0.48,0,573,4,89,48,137,0,48,137,137,0,0,0,1,3,231,283,231,331,3,1526,1478
1597,2,1.0.48,0,533,0,83,48,131,0,48,131,131,0,0,0,1,3,325,283,325,331,3,1526,1478
1597,2,2.1.21,0,563,2,74,21,95,21,0,95,95,-21,21,21,2,1,214,353,235,353,3,1526,1478
1597,2,3.0.48,0,564,3,69,48,117,0,48,117,117,0,0,0,1,3,266,283,266,331,3,1526,1478
1597,2,4.1.48,0,533,0,23,48,71,48,0,71,71,-48,48,48,2,1,202,353,229,353,3,1526,1478
1597,2,5.0.48,1,561,1,42,48,90,0,48,90,90,0,0,0,1,3,240,283,240,331,3,1526,1478
1597,3,0.0.90,0,573,3,89,90,179,0,90,179,179,0,0,0,1,4,231,241,231,331,4,1526,1436
1597,3,1.0.90,1,561,0,83,90,173,0,90,173,173,0,0,0,1,4,325,241,325,331,4,1526,1436
1597,3,2.1.21,0,565,1,74,21,95,21,0,95,95,-21,21,21,2,1,214,353,235,353,4,1526,1436
1597,3,3.0.90,0,573,3,69,90,159,0,90,159,159,0,0,0,1,4,266,241,266,331,4,1526,1436
1597,3,4.1.48,0,561,0,23,48,71,48,0,71,90,-48,48,48,2,1,202,353,229,353,4,1526,1436
1597,3,5.1.90,0,569,2,66,90,156,90,0,156,156,-90,90,90,2,1,198,353,240,353,4,1526,1436
1597,4,0.0.173,0,565,1,89,173,262,0,173,262,262,0,0,0,1,5,231,158,231,331,5,1526,1353
1597,4,1.1.173,0,561,0,87,173,260,173,0,260,260,-173,173,173,2,1,242,353,325,353,5,1526,1353
1597,4,2.1.21,0,565,1,74,21,95,21,0,95,173,-21,21,21,2,1,214,353,235,353,5,1526,1353
1597,4,3.0.173,1,561,0,69,173,242,0,173,242,242,0,0,0,1,5,266,158,266,331,5,1526,1353
1597,4,4.1.48,0,561,0,23,48,71,48,0,71,173,-48,48,48,2,1,202,353,229,353,5,1526,1353
1597,4,5.1.90,0,569,2,66,90,156,90,0,156,173,-90,90,90,2,1,198,353,240,353,5,1526,1353
1597,5,0.0.242,1,561,0,89,242,331,0,242,331,331,0,0,0,1,6,231,89,231,331,6,1526,1284
1597,5,1.1.173,0,561,0,87,173,260,173,0,260,260,-173,173,173,2,1,242,353,325,353,6,1526,1284
1597,5,2.1.21,0,565,1,74,21,95,21,0,95,242,-21,21,21,2,1,214,353,235,353,6,1526,1284
1597,5,3.1.242,0,597,3,79,242,321,242,0,321,321,-242,242,242,2,1,197,353,266,353,6,1526,1284
1597,5,4.1.48,0,561,0,23,48,71,48,0,71,242,-48,48,48,2,1,202,353,229,353,6,1526,1284
1597,5,5.1.90,0,569,2,66,90,156,90,0,156,242,-90,90,90,2,1,198,353,240,353,6,1526,1284
1597,6,0.1.331,0,581,3,24,331,355,331,0,355,355,-331,331,331,2,1,142,353,231,353,7,1526,1195
1597,6,1.1.173,0,561,0,87,173,260,173,0,260,331,-173,173,173,2,1,242,353,325,353,7,1526,1195
1597,6,2.1.21,0,565,1,74,21,95,21,0,95,331,-21,21,21,2,1,214,353,235,353,7,1526,1195
1597,6,3.1.242,0,597,4,79,242,321,242,0,321,331,-242,242,242,2,1,197,353,266,353,7,1526,1195
1597,6,4.1.48,1,561,0,23,48,71,48,0,71,331,-48,48,48,2,1,202,353,229,353,7,1526,1195
1597,6,5.1.90,0,569,2,66,90,156,90,0,156,331,-90,90,90,2,1,198,353,240,353,7,1526,1195
1597,7,0.1.331,0,581,2,24,331,355,331,0,355,355,-260,308,308,2,2,142,330,231,353,8,1526,1172
1597,7,1.1.173,0,561,0,87,173,260,173,0,260,331,-102,150,150,2,2,242,330,325,353,8,1526,1172
1597,7,2.1.71,0,561,0,74,71,145,21,50,145,331,0,48,48,2,2,214,330,235,353,8,1526,1172
1597,7,3.1.242,0,597,3,79,242,321,242,0,321,331,-171,219,219,2,2,197,330,266,353,8,1526,1172
1597,7,4.2.71,1,561,0,76,71,147,71,0,147,331,-71,71,119,3,1,179,325,229,325,8,1526,1172
1597,7,5.1.90,0,569,1,66,90,156,90,0,156,331,-19,67,67,2,2,198,330,240,353,8,1526,1172
1597,8,0.1.331,0,581,2,24,331,355,331,0,355,355,-260,308,379,2,2,142,330,231,353,9,1526,1096
1597,8,1.1.173,0,561,0,87,173,260,173,0,260,331,-102,150,221,2,2,242,330,325,353,9,1526,1096
1597,8,2.1.71,0,561,0,74,71,145,21,50,145,331,0,48,119,2,2,214,330,235,353,9,1526,1096
1597,8,3.1.242,0,597,3,79,242,321,242,0,321,331,-171,219,290,2,2,197,330,266,353,9,1526,1096
1597,8,4.3.147,1,561,0,93,147,240,147,0,240,331,-147,147,266,4,1,103,347,229,347,9,1526,1096
1597,8,5.1.90,0,569,1,66,90,156,90,0,156,331,-19,67,138,2,2,198,330,240,353,9,1526,1096
1597,9,0.1.331,0,581,2,24,331,355,331,0,355,355,-260,308,526,2,2,142,330,231,353,10,1526,1003
1597,9,1.1.173,0,561,0,87,173,260,173,0,260,331,-102,150,368,2,2,242,330,325,353,10,1526,1003
1597,9,2.1.71,0,561,0,74,71,145,21,50,145,331,0,48,266,2,2,214,330,235,353,10,1526,1003
1597,9,3.1.242,0,597,3,79,242,321,242,0,321,331,-171,219,437,2,2,197,330,266,353,10,1526,1003
1597,9,4.4.240,1,561,0,10,240,250,240,0,250,331,-240,240,506,5,1,10,170,229,170,10,1526,1003
1597,9,5.1.90,0,569,1,66,90,156,90,0,156,331,-19,67,285,2,2,198,330,240,353,10,1526,1003
1597,10,0.1.331,0,581,2,24,331,355,331,0,355,355,-260,308,766,2,2,142,330,231,353,11,1526,993
1597,10,1.1.173,0,561,0,87,173,260,173,0,260,331,-102,150,608,2,2,242,330,325,353,11,1526,993
1597,10,2.1.71,1,561,0,74,71,145,21,50,145,331,0,48,506,2,2,214,330,235,353,11,1526,993
1597,10,3.1.242,0,597,3,79,242,321,242,0,321,331,-171,219,677,2,2,197,330,266,353,11,1526,993
1597,10,5.1.90,0,569,1,66,90,156,90,0,156,331,-19,67,525,2,2,198,330,240,353,11,1526,993
1597,11,0.1.331,0,581,2,24,331,355,331,0,355,355,-186,234,692,2,3,142,256,231,353,12,1526,919
1597,11,1.1.173,0,561,0,87,173,260,173,0,260,331,-28,76,534,2,3,242,256,325,353,12,1526,919
1597,11,2.2.147,1,561,0,76,147,223,145,2,223,331,0,71,506,3,2,140,249,235,325,12,1526,919
1597,11,3.1.242,0,597,3,79,242,321,242,0,321,331,-97,145,603,2,3,197,256,266,353,12,1526,919
1597,11,5.1.145,0,566,1,66,145,211,90,55,211,331,0,48,506,2,3,198,256,240,353,12,1526,919
1597,12,0.1.331,0,581,2,24,331,355,331,0,355,355,-186,234,692,2,3,142,256,231,353,13,1526,843
1597,12,1.1.173,0,561,0,87,173,260,173,0,260,331,-28,76,534,2,3,242,256,325,353,13,1526,843
1597,12,2.3.240,1,561,0,42,240,282,223,17,282,331,0,147,506,4,2,64,254,235,347,13,1526,843
1597,12,3.1.242,0,597,3,79,242,321,242,0,321,331,-97,145,603,2,3,197,256,266,353,13,1526,843
1597,12,5.1.145,0,566,1,66,145,211,90,55,211,331,0,48,506,2,3,198,256,240,353,13,1526,843
1597,13,0.1.331,0,581,2,24,331,355,331,0,355,355,-186,234,692,2,3,142,256,231,353,14,1526,801
1597,13,1.1.173,0,561,0,87,173,260,173,0,260,331,-28,76,534,2,3,242,256,325,353,14,1526,801
1597,13,2.4.282,1,561,0,22,282,304,282,0,304,331,-32,272,538,5,2,22,160,235,170,14,1526,801
1597,13,3.1.242,0,597,3,79,242,321,242,0,321,331,-97,145,603,2,3,197,256,266,353,14,1526,801
1597,13,5.1.145,0,566,1,66,145,211,90,55,211,331,0,48,506,2,3,198,256,240,353,14,1526,801
1597,14,0.1.331,0,581,2,24,331,355,331,0,355,355,-186,234,724,2,3,142,256,231,353,15,1526,779
1597,14,1.1.173,0,561,0,87,173,260,173,0,260,331,-28,76,566,2,3,242,256,325,353,15,1526,779
1597,14,3.1.242,0,597,3,79,242,321,242,0,321,331,-97,145,635,2,3,197,256,266,353,15,1526,779
1597,14,5.1.145,1,566,1,66,145,211,90,55,211,331,0,48,538,2,3,198,256,240,353,15,1526,779
1597,15,0.1.331,0,581,1,24,331,355,331,0,355,355,-120,168,658,2,4,142,190,231,353,16,1526,713
1597,15,1.1.211,0,566,0,87,211,298,173,38,298,331,0,48,538,2,4,242,190,325,353,16,1526,713
1597,15,3.1.242,0,597,2,79,242,321,242,0,321,331,-31,79,569,2,4,197,190,266,353,16,1526,713
1597,15,5.2.223,1,566,0,93,223,316,211,12,316,331,0,71,538,3,3,132,173,240,325,16,1526,713
1597,16,0.1.331,0,581,1,24,331,355,331,0,355,355,-120,168,658,2,4,142,190,231,353,17,1526,620
1597,16,1.1.211,0,566,0,87,211,298,173,38,298,331,0,48,538,2,4,242,190,325,353,17,1526,620
1597,16,3.1.242,0,597,2,79,242,321,242,0,321,331,-31,79,569,2,4,197,190,266,353,17,1526,620
1597,16,5.3.316,1,566,0,4,316,320,316,0,320,331,-34,181,572,4,3,39,212,240,347,17,1526,620
1597,17,0.1.331,0,581,1,24,331,355,331,0,355,355,-120,168,692,2,4,142,190,231,353,18,1526,616
1597,17,1.1.211,0,566,0,87,211,298,173,38,298,331,0,48,572,2,4,242,190,325,353,18,1526,616
1597,17,3.1.242,0,597,2,79,242,321,242,0,321,331,-31,79,603,2,4,197,190,266,353,18,1526,616
1597,17,5.4.320,1,566,0,35,320,355,320,0,355,355,-16,288,588,5,3,35,138,240,170,18,1526,616
1597,18,0.1.331,0,581,1,24,331,355,331,0,355,355,-120,168,708,2,4,142,190,231,353,19,1526,581
1597,18,1.1.211,1,566,0,87,211,298,173,38,298,355,0,48,588,2,4,242,190,325,353,19,1526,581
1597,18,3.1.242,0,597,2,79,242,321,242,0,321,355,-31,79,619,2,4,197,190,266,353,19,1526,581
1597,19,0.1.331,0,581,1,24,331,355,331,0,355,355,-33,81,621,2,5,142,103,231,353,20,1526,494
1597,19,1.2.316,1,566,0,35,316,351,298,18,351,355,0,71,588,3,4,155,80,325,325,20,1526,494
1597,19,3.1.298,0,566,0,79,298,377,242,56,377,377,0,48,588,2,5,197,103,266,353,20,1526,494
1597,20,0.1.331,0,581,1,24,331,355,331,0,355,355,-33,81,621,2,5,142,103,231,353,21,1526,459
1597,20,1.3.351,0,566,0,98,351,449,351,0,449,449,-31,212,619,4,4,120,208,325,347,21,1526,459
1597,20,3.1.298,1,566,0,79,298,377,242,56,377,377,0,48,588,2,5,197,103,266,353,21,1526,459
1597,21,0.1.377,0,566,0,24,377,401,331,46,401,401,0,48,588,2,6,142,24,231,353,22,1526,380
1597,21,1.3.351,0,566,0,98,351,449,351,0,449,449,-31,212,619,4,4,120,208,325,347,22,1526,380
1597,21,3.2.377,1,566,0,30,377,407,377,0,407,407,-26,97,614,3,5,118,45,266,325,22,1526,380
1597,22,0.1.377,1,566,0,24,377,401,331,46,401,407,0,48,614,2,6,142,24,231,353,23,1526,350
1597,22,1.3.351,0,566,0,98,351,449,351,0,449,449,-31,212,645,4,4,120,208,325,347,23,1526,350
1597,22,3.3.407,0,622,1,14,407,421,407,0,421,421,-87,268,701,4,4,88,208,266,347,23,1526,350
1597,23,0.2.407,1,566,0,15,407,422,401,6,422,422,0,97,614,3,6,118,15,231,325,24,1526,326
1597,23,1.3.351,0,566,0,98,351,449,351,0,449,449,-31,212,645,4,4,120,208,325,347,24,1526,326
1597,23,3.3.407,0,622,1,14,407,421,407,0,421,421,-87,268,701,4,4,88,208,266,347,24,1526,326
1597,24,0.3.422,0,638,2,96,422,518,422,0,518,518,-102,283,716,4,4,103,208,231,347,25,1526,311
1597,24,1.3.351,0,566,0,98,351,449,351,0,449,449,-31,212,645,4,4,120,208,325,347,25,1526,311
1597,24,3.3.407,1,622,1,14,407,421,407,0,421,422,-87,268,701,4,4,88,208,266,347,25,1526,311
1597,25,0.3.422,0,638,1,96,422,518,422,0,518,518,-1,269,702,4,5,103,194,231,347,26,1526,297
1597,25,1.3.421,0,622,0,98,421,519,351,70,519,519,0,268,701,4,5,120,194,325,347,26,1526,297
1597,25,3.4.421,1,622,0,74,421,495,421,0,495,495,-66,354,767,5,4,74,103,266,170,26,1526,297
1597,26,0.3.422,0,638,1,96,422,518,422,0,518,518,-1,269,768,4,5,103,194,231,347,27,1526,223
1597,26,1.3.421,1,622,0,98,421,519,351,70,519,519,0,268,767,4,5,120,194,325,347,27,1526,223
1597,27,0.3.519,0,622,0,96,519,615,422,97,615,615,0,268,767,4,6,103,96,231,347,28,1526,125
1597,27,1.4.519,1,622,0,22,519,541,519,0,541,541,-24,378,791,5,5,22,29,325,170,28,1526,125
1597,28,0.3.519,1,622,0,96,519,615,422,97,615,615,0,268,791,4,6,103,96,231,347,29,1526,103
1597,29,0.4.615,1,622,0,7,615,622,615,0,622,622,-74,452,865,5,6,7,7,231,170,30,1526,7
1598,0,0.0.0,0,551,1,3,0,3,0,0,3,3,0,0,0,1,1,176,246,176,246,1,1496,1496
1598,0,1.0.0,0,583,4,59,0,59,0,0,59,59,0,0,0,1,1,225,246,225,246,1,1496,1496
1598,0,2.0.0,0,599,5,66,0,66,0,0,66,66,0,0,0,1,1,261,246,261,246,1,1496,1496
1598,0,3.0.0,0,548,0,23,0,23,0,0,23,23,0,0,0,1,1,226,246,226,246,1,1496,1496
1598,0,4.0.0,1,557,2,48,0,48,0,0,48,48,0,0,0,1,1,366,246,366,246,1,1496,1496
1598,0,5.0.0,0,563,3,47,0,47,0,0,47,47,0,0,0,1,1,242,246,242,246,1,1496,1496
1598,1,0.0.48,1,557,0,3,48,51,0,48,51,51,0,0,0,1,2,176,198,176,246,2,1496,1448
1598,1,1.0.48,0,566,2,59,48,107,0,48,107,107,0,0,0,1,2,225,198,225,246,2,1496,1448
1598,1,2.0.48,0,557,0,66,48,114,0,48,114,114,0,0,0,1,2,261,198,261,246,2,1496,1448
1598,1,3.0.48,0,561,1,23,48,71,0,48,71,71,0,0,0,1,2,226,198,226,246,2,1496,1448
1598,1,4.1.48,0,557,0,75,48,123,48,0,123,123,-48,48,48,2,1,318,355,366,355,2,1496,1448
1598,1,5.0.48,0,566,2,47,48,95,0,48,95,95,0,0,0,1,2,242,198,242,246,2,1496,1448
1598,2,0.1.51,0,613,3,91,51,142,51,0,142,142,-51,51,51,2,1,173,355,176,355,3,1496,1445
1598,2,1.0.51,0,566,2,59,51,110,0,51,110,110,0,0,0,1,3,225,195,225,246,3,1496,1445
1598,2,2.0.51,0,557,0,66,51,117,0,51,117,117,0,0,0,1,3,261,195,261,246,3,1496,1445
1598,2,3.0.51,1,564,1,23,51,74,0,51,74,74,0,0,0,1,3,226,195,226,246,3,1496,1445
1598,2,4.1.48,0,557,0,75,48,123,48,0,123,123,-48,48,48,2,1,318,355,366,355,3,1496,1445
1598,2,5.0.51,0,566,2,47,51,98,0,51,98,98,0,0,0,1,3,242,195,242,246,3,1496,1445
1598,3,0.1.51,0,613,3,91,51,142,51,0,142,142,-51,51,51,2,1,173,355,176,355,4,1496,1422
1598,3,1.0.74,0,566,1,59,74,133,0,74,133,133,0,0,0,1,4,225,172,225,246,4,1496,1422
1598,3,2.0.74,0,564,0,66,74,140,0,74,140,140,0,0,0,1,4,261,172,261,246,4,1496,1422
1598,3,3.1.74,0,591,2,18,74,92,74,0,92,92,-74,74,74,2,1,203,355,226,355,4,1496,1422
1598,3,4.1.48,0,564,0,75,48,123,48,0,123,123,-48,48,48,2,1,318,355,366,355,4,1496,1422
1598,3,5.0.74,1,566,1,47,74,121,0,74,121,121,0,0,0,1,4,242,172,242,246,4,1496,1422
1598,4,0.1.51,0,613,2,91,51,142,51,0,142,142,-51,51,51,2,1,173,355,176,355,5,1496,1375
1598,4,1.0.121,0,566,0,59,121,180,0,121,180,180,0,0,0,1,5,225,125,225,246,5,1496,1375
1598,4,2.0.121,1,566,0,66,121,187,0,121,187,187,0,0,0,1,5,261,125,261,246,5,1496,1375
1598,4,3.1.74,0,591,1,18,74,92,74,0,92,121,-74,74,74,2,1,203,355,226,355,5,1496,1375
1598,4,4.1.48,0,566,0,75,48,123,48,0,123,123,-48,48,48,2,1,318,355,366,355,5,1496,1375
1598,4,5.1.121,0,633,3,49,121,170,121,0,170,170,-121,121,121,2,1,195,355,242,355,5,1496,1375
1598,5,0.1.51,0,613,3,91,51,142,51,0,142,187,-51,51,51,2,1,173,355,176,355,6,1496,1309
1598,5,1.0.187,1,566,0,59,187,246,0,187,246,246,0,0,0,1,6,225,59,225,246,6,1496,1309
1598,5,2.1.187,0,586,1,67,187,254,187,0,254,254,-187,187,187,2,1,195,355,261,355,6,1496,1309
1598,5,3.1.74,0,591,2,18,74,92,74,0,92,187,-74,74,74,2,1,203,355,226,355,6,1496,1309
1598,5,4.1.48,0,566,0,75,48,123,48,0,123,187,-48,48,48,2,1,318,355,366,355,6,1496,1309
1598,5,5.1.121,0,633,4,49,121,170,121,0,170,187,-121,121,121,2,1,195,355,242,355,6,1496,1309
1598,6,0.1.51,0,613,3,91,51,142,51,0,142,246,-51,51,51,2,1,173,355,176,355,7,1496,1250
1598,6,1.1.246,0,566,0,55,246,301,246,0,301,301,-246,246,246,2,1,166,355,225,355,7,1496,1250
1598,6,2.1.187,0,586,1,67,187,254,187,0,254,254,-187,187,187,2,1,195,355,261,355,7,1496,1250
1598,6,3.1.74,0,591,2,18,74,92,74,0,92,246,-74,74,74,2,1,203,355,226,355,7,1496,1250
1598,6,4.1.48,1,566,0,75,48,123,48,0,123,246,-48,48,48,2,1,318,355,366,355,7,1496,1250
1598,6,5.1.121,0,633,4,49,121,170,121,0,170,246,-121,121,121,2,1,195,355,242,355,7,1496,1250
1598,7,0.1.123,0,566,0,91,123,214,51,72,214,246,0,48,48,2,2,173,280,176,355,8,1496,1175
1598,7,1.1.246,0,566,0,55,246,301,246,0,301,301,-123,171,171,2,2,166,280,225,355,8,1496,1175
1598,7,2.1.187,0,586,2,67,187,254,187,0,254,254,-64,112,112,2,2,195,280,261,355,8,1496,1175
1598,7,3.1.123,0,584,1,18,123,141,74,49,141,246,0,48,48,2,2,203,280,226,355,8,1496,1175
1598,7,4.2.123,1,566,0,77,123,200,123,0,200,246,-123,123,171,3,1,243,294,366,294,8,1496,1175
1598,7,5.1.123,0,586,2,49,123,172,121,2,172,246,0,48,48,2,2,195,280,242,355,8,1496,1175
1598,8,0.1.123,0,566,0,91,123,214,51,72,214,246,0,48,171,2,2,173,280,176,355,9,1496,1098
1598,8,1.1.246,0,566,0,55,246,301,246,0,301,301,-123,171,294,2,2,166,280,225,355,9,1496,1098
1598,8,2.1.187,0,586,2,67,187,254,187,0,254,254,-64,112,235,2,2,195,280,261,355,9,1496,1098
1598,8,3.1.123,0,584,1,18,123,141,74,49,141,246,0,48,171,2,2,203,280,226,355,9,1496,1098
1598,8,4.3.200,1,586,2,86,200,286,200,0,286,286,-200,200,371,4,1,166,301,366,301,9,1496,1098
1598,8,5.1.123,0,586,2,49,123,172,121,2,172,246,0,48,171,2,2,195,280,242,355,9,1496,1098
1598,9,0.1.123,0,586,0,91,123,214,51,72,214,286,0,48,371,2,2,173,280,176,355,10,1496,1012
1598,9,1.1.246,0,586,0,55,246,301,246,0,301,301,-123,171,494,2,2,166,280,225,355,10,1496,1012
1598,9,2.1.187,0,586,0,67,187,254,187,0,254,286,-64,112,435,2,2,195,280,261,355,10,1496,1012
1598,9,3.1.123,0,586,0,18,123,141,74,49,141,286,0,48,371,2,2,203,280,226,355,10,1496,1012
1598,9,4.4.286,1,586,0,80,286,366,286,0,366,366,-286,286,657,5,1,80,300,366,300,10,1496,1012
1598,9,5.1.123,0,586,0,49,123,172,121,2,172,286,0,48,371,2,2,195,280,242,355,10,1496,1012
1598,10,0.1.123,0,586,0,91,123,214,51,72,214,366,0,48,657,2,2,173,280,176,355,11,1496,932
1598,10,1.1.246,0,586,0,55,246,301,246,0,301,366,-123,171,780,2,2,166,280,225,355,11,1496,932
1598,10,2.1.187,0,586,0,67,187,254,187,0,254,366,-64,112,721,2,2,195,280,261,355,11,1496,932
1598,10,3.1.123,1,586,0,18,123,141,74,49,141,366,0,48,657,2,2,203,280,226,355,11,1496,932
1598,10,5.1.123,0,586,0,49,123,172,121,2,172,366,0,48,657,2,2,195,280,242,355,11,1496,932
1598,11,0.1.141,0,586,0,91,141,232,51,90,232,366,0,48,657,2,3,173,262,176,355,12,1496,914
1598,11,1.1.246,0,586,0,55,246,301,246,0,301,366,-105,153,762,2,3,166,262,225,355,12,1496,914
1598,11,2.1.187,0,586,0,67,187,254,187,0,254,366,-46,94,703,2,3,195,262,261,355,12,1496,914
1598,11,3.2.200,1,586,0,97,200,297,141,59,297,366,0,123,657,3,2,185,217,226,294,12,1496,914
1598,11,5.1.141,0,586,0,49,141,190,121,20,190,366,0,48,657,2,3,195,262,242,355,12,1496,914
1598,12,0.1.141,0,586,0,91,141,232,51,90,232,366,0,48,657,2,3,173,262,176,355,13,1496,817
1598,12,1.1.246,0,586,0,55,246,301,246,0,301,366,-105,153,762,2,3,166,262,225,355,13,1496,817
1598,12,2.1.187,0,586,0,67,187,254,187,0,254,366,-46,94,703,2,3,195,262,261,355,13,1496,817
1598,12,3.3.297,1,589,1,72,297,369,297,0,369,369,-11,211,668,4,2,88,215,226,301,13,1496,817
1598,12,5.1.141,0,586,0,49,141,190,121,20,190,366,0,48,657,2,3,195,262,242,355,13,1496,817
1598,13,0.1.141,0,589,0,91,141,232,51,90,232,369,0,48,668,2,3,173,262,176,355,14,1496,745
1598,13,1.1.246,0,589,0,55,246,301,246,0,301,369,-105,153,773,2,3,166,262,225,355,14,1496,745
1598,13,2.1.187,0,589,0,67,187,254,187,0,254,369,-46,94,714,2,3,195,262,261,355,14,1496,745
1598,13,3.4.369,1,589,0,16,369,385,369,0,385,385,-3,289,671,5,2,16,220,226,300,14,1496,745
1598,13,5.1.141,0,589,0,49,141,190,121,20,190,369,0,48,668,2,3,195,262,242,355,14,1496,745
1598,14,0.1.141,0,589,0,91,141,232,51,90,232,385,0,48,671,2,3,173,262,176,355,15,1496,729
1598,14,1.1.246,0,589,0,55,246,301,246,0,301,385,-105,153,776,2,3,166,262,225,355,15,1496,729
1598,14,2.1.187,0,589,0,67,187,254,187,0,254,385,-46,94,717,2,3,195,262,261,355,15,1496,729
1598,14,5.1.141,1,589,0,49,141,190,121,20,190,385,0,48,671,2,3,195,262,242,355,15,1496,729
1598,15,0.1.190,0,589,0,91,190,281,51,139,281,385,0,48,671,2,4,173,213,176,355,16,1496,680
1598,15,1.1.246,0,613,1,55,246,301,246,0,301,385,-56,104,727,2,4,166,213,225,355,16,1496,680
1598,15,2.1.190,0,589,0,67,190,257,187,3,257,385,0,48,671,2,4,195,213,261,355,16,1496,680
1598,15,5.2.297,1,589,0,32,297,329,190,107,329,385,0,123,671,3,3,146,120,242,294,16,1496,680
1598,16,0.1.190,0,589,0,91,190,281,51,139,281,385,0,48,671,2,4,173,213,176,355,17,1496,648
1598,16,1.1.246,0,613,1,55,246,301,246,0,301,385,-56,104,727,2,4,166,213,225,355,17,1496,648
1598,16,2.1.190,0,589,0,67,190,257,187,3,257,385,0,48,671,2,4,195,213,261,355,17,1496,648
1598,16,5.3.369,1,661,2,88,369,457,329,40,457,457,0,211,671,4,3,114,143,242,301,17,1496,648
1598,17,0.1.190,0,661,0,91,190,281,51,139,281,457,0,48,671,2,4,173,213,176,355,18,1496,560
1598,17,1.1.246,0,661,0,55,246,301,246,0,301,457,-56,104,727,2,4,166,213,225,355,18,1496,560
1598,17,2.1.190,0,661,0,67,190,257,187,3,257,457,0,48,671,2,4,195,213,261,355,18,1496,560
1598,17,5.4.457,1,661,0,26,457,483,457,0,483,483,-72,361,743,5,3,26,204,242,300,18,1496,560
1598,18,0.1.190,1,661,0,91,190,281,51,139,281,483,0,48,743,2,4,173,213,176,355,19,1496,534
1598,18,1.1.246,0,661,0,55,246,301,246,0,301,483,-56,104,799,2,4,166,213,225,355,19,1496,534
1598,18,2.1.190,0,661,0,67,190,257,187,3,257,483,0,48,743,2,4,195,213,261,355,19,1496,534
1598,19,0.2.329,1,661,0,18,329,347,281,48,347,483,0,123,743,3,4,82,88,176,294,20,1496,443
1598,19,1.1.281,0,661,0,55,281,336,246,35,336,483,0,48,743,2,5,166,122,225,355,20,1496,443
1598,19,2.1.281,0,661,0,67,281,348,187,94,348,483,0,48,743,2,5,195,122,261,355,20,1496,443
1598,20,0.3.457,1,661,0,4,457,461,347,110,461,483,0,211,743,4,4,64,55,176,301,21,1496,425
1598,20,1.1.281,0,661,0,55,281,336,246,35,336,483,0,48,743,2,5,166,122,225,355,21,1496,425
1598,20,2.1.281,0,661,0,67,281,348,187,94,348,483,0,48,743,2,5,195,122,261,355,21,1496,425
1598,21,0.4.483,0,661,0,60,483,543,461,22,543,543,0,361,743,5,4,60,178,176,300,22,1496,421
1598,21,1.1.281,0,661,0,55,281,336,246,35,336,483,0,48,743,2,5,166,122,225,355,22,1496,421
1598,21,2.1.281,1,661,0,67,281,348,187,94,348,483,0,48,743,2,5,195,122,261,355,22,1496,421
1598,22,0.4.483,0,661,0,60,483,543,461,22,543,543,0,361,743,5,4,60,178,176,300,23,1496,354
1598,22,1.1.348,0,661,0,55,348,403,246,102,403,483,0,48,743,2,6,166,55,225,355,23,1496,354
1598,22,2.2.348,1,661,0,30,348,378,348,0,378,483,-1,124,744,3,5,128,70,261,294,23,1496,354
1598,23,0.4.483,0,661,0,60,483,543,461,22,543,543,0,361,744,5,4,60,178,176,300,24,1496,324
1598,23,1.1.348,0,661,0,55,348,403,246,102,403,483,0,48,744,2,6,166,55,225,355,24,1496,324
1598,23,2.3.461,1,661,0,11,461,472,378,83,472,483,0,211,744,4,5,98,51,261,301,24,1496,324
1598,24,0.4.483,0,661,0,60,483,543,461,22,543,543,0,361,744,5,4,60,178,176,300,25,1496,313
1598,24,1.1.348,1,661,0,55,348,403,246,102,403,483,0,48,744,2,6,166,55,225,355,25,1496,313
1598,24,2.4.483,0,661,0,87,483,570,472,11,570,570,0,361,744,5,4,87,178,261,300,25,1496,313
1598,25,0.4.483,0,661,0,60,483,543,461,22,543,543,0,361,744,5,4,60,178,176,300,26,1496,258
1598,25,1.2.403,1,661,0,40,403,443,403,0,443,483,-25,149,769,3,6,111,40,225,294,26,1496,258
1598,25,2.4.483,0,661,0,87,483,570,472,11,570,570,0,361,744,5,4,87,178,261,300,26,1496,258
1598,26,0.4.483,0,661,0,60,483,543,461,22,543,543,0,361,769,5,4,60,178,176,300,27,1496,218
1598,26,1.3.472,1,661,0,40,472,512,443,29,512,512,0,211,769,4,6,71,40,225,301,27,1496,218
1598,26,2.4.483,0,661,0,87,483,570,472,11,570,570,0,361,769,5,4,87,178,261,300,27,1496,218
1598,27,0.4.483,0,661,0,60,483,543,461,22,543,543,0,361,769,5,4,60,178,176,300,28,1496,178
1598,27,1.4.512,1,690,1,31,512,543,512,0,543,543,-29,390,798,5,4,31,178,225,300,28,1496,178
1598,27,2.4.483,0,661,0,87,483,570,472,11,570,570,0,361,769,5,4,87,178,261,300,28,1496,178
1598,28,0.4.543,1,690,0,60,543,603,461,82,603,603,0,390,798,5,5,60,147,176,300,29,1496,147
1598,28,2.4.543,0,690,0,87,543,630,472,71,630,630,0,390,798,5,5,87,147,261,300,29,1496,147
1598,29,2.4.603,1,690,0,87,603,690,472,131,690,690,0,390,798,5,6,87,87,261,300,30,1496,87
1599,0,0.0.0,0,531,2,16,0,16,0,0,16,16,0,0,0,1,1,121,260,121,260,1,1467,1467
1599,0,1.0.0,0,515,0,34,0,34,0,0,34,34,0,0,0,1,1,225,260,225,260,1,1467,1467
1599,0,2.0.0,1,527,1,12,0,12,0,0,12,12,0,0,0,1,1,286,260,286,260,1,1467,1467
1599,0,3.0.0,0,584,5,76,0,76,0,0,76,76,0,0,0,1,1,285,260,285,260,1,1467,1467
1599,0,4.0.0,0,551,3,70,0,70,0,0,70,70,0,0,0,1,1,305,260,305,260,1,1467,1467
1599,0,5.0.0,0,561,4,52,0,52,0,0,52,52,0,0,0,1,1,245,260,245,260,1,1467,1467
1599,1,0.0.12,0,529,1,16,12,28,0,12,28,28,0,0,0,1,2,121,248,121,260,2,1467,1455
1599,1,1.0.12,0,527,0,34,12,46,0,12,46,46,0,0,0,1,2,225,248,225,260,2,1467,1455
1599,1,2.1.12,1,529,1,61,12,73,12,0,73,73,-12,12,12,2,1,274,259,286,259,2,1467,1455
1599,1,3.0.12,0,529,1,76,12,88,0,12,88,88,0,0,0,1,2,285,248,285,260,2,1467,1455
1599,1,4.0.12,0,529,1,70,12,82,0,12,82,82,0,0,0,1,2,305,248,305,260,2,1467,1455
1599,1,5.0.12,0,537,2,52,12,64,0,12,64,64,0,0,0,1,2,245,248,245,260,2,1467,1455
1599,2,0.0.12,0,529,0,16,12,28,0,12,28,73,0,0,12,1,2,121,248,121,260,3,1467,1394
1599,2,1.0.12,1,529,0,34,12,46,0,12,46,73,0,0,12,1,2,225,248,225,260,3,1467,1394
1599,2,2.2.73,0,529,0,82,73,155,73,0,155,155,-73,73,85,3,1,213,362,286,362,3,1467,1394
1599,2,3.0.12,0,529,0,76,12,88,0,12,88,88,0,0,12,1,2,285,248,285,260,3,1467,1394
1599,2,4.0.12,0,529,0,70,12,82,0,12,82,82,0,0,12,1,2,305,248,305,260,3,1467,1394
1599,2,5.0.12,0,537,1,52,12,64,0,12,64,73,0,0,12,1,2,245,248,245,260,3,1467,1394
1599,3,0.0.46,0,529,0,16,46,62,0,46,62,73,0,0,12,1,3,121,214,121,260,4,1467,1360
1599,3,1.1.73,1,529,0,23,73,96,46,27,96,96,0,12,12,2,2,191,198,225,259,4,1467,1360
1599,3,2.2.73,0,529,0,82,73,155,73,0,155,155,-73,73,85,3,1,213,362,286,362,4,1467,1360
1599,3,3.0.46,0,529,0,76,46,122,0,46,122,122,0,0,12,1,3,285,214,285,260,4,1467,1360
1599,3,4.0.46,0,529,0,70,46,116,0,46,116,116,0,0,12,1,3,305,214,305,260,4,1467,1360
1599,3,5.0.46,0,537,1,52,46,98,0,46,98,98,0,0,12,1,3,245,214,245,260,4,1467,1360
1599,4,0.0.46,0,529,0,16,46,62,0,46,62,96,0,0,12,1,3,121,214,121,260,5,1467,1337
1599,4,1.2.96,0,539,2,46,96,142,96,0,142,142,-96,96,108,3,1,168,362,225,362,5,1467,1337
1599,4,2.2.73,0,529,0,82,73,155,73,0,155,155,-73,73,85,3,1,213,362,286,362,5,1467,1337
1599,4,3.0.46,0,529,0,76,46,122,0,46,122,122,0,0,12,1,3,285,214,285,260,5,1467,1337
1599,4,4.0.46,1,529,0,70,46,116,0,46,116,116,0,0,12,1,3,305,214,305,260,5,1467,1337
1599,4,5.0.46,0,537,1,52,46,98,0,46,98,98,0,0,12,1,3,245,214,245,260,5,1467,1337
1599,5,0.0.116,0,529,0,16,116,132,0,116,132,132,0,0,12,1,4,121,144,121,260,6,1467,1267
1599,5,1.2.96,0,539,2,46,96,142,96,0,142,142,-96,96,108,3,1,168,362,225,362,6,1467,1267
1599,5,2.2.73,0,529,0,82,73,155,73,0,155,155,-73,73,85,3,1,213,362,286,362,6,1467,1267
1599,5,3.0.116,0,529,0,76,116,192,0,116,192,192,0,0,12,1,4,285,144,285,260,6,1467,1267
1599,5,4.1.116,1,529,0,27,116,143,116,0,143,143,-20,32,32,2,3,235,175,305,259,6,1467,1267
1599,5,5.0.116,0,537,1,52,116,168,0,116,168,168,0,0,12,1,4,245,144,245,260,6,1467,1267
1599,6,0.0.116,0,529,0,16,116,132,0,116,132,143,0,0,32,1,4,121,144,121,260,7,1467,1240
1599,6,1.2.96,0,539,2,46,96,142,96,0,142,143,-96,96,128,3,1,168,362,225,362,7,1467,1240
1599,6,2.2.73,0,529,0,82,73,155,73,0,155,155,-73,73,105,3,1,213,362,286,362,7,1467,1240
1599,6,3.0.116,0,529,0,76,116,192,0,116,192,192,0,0,32,1,4,285,144,285,260,7,1467,1240
1599,6,4.2.143,0,540,3,78,143,221,143,0,221,221,-143,143,175,3,1,208,362,305,362,7,1467,1240
1599,6,5.0.116,1,537,1,52,116,168,0,116,168,168,0,0,32,1,4,245,144,245,260,7,1467,1240
1599,7,0.0.168,1,540,2,16,168,184,0,168,184,184,0,0,32,1,5,121,92,121,260,8,1467,1188
1599,7,1.2.96,0,539,1,46,96,142,96,0,142,168,-96,96,128,3,1,168,362,225,362,8,1467,1188
1599,7,2.2.73,0,537,0,82,73,155,73,0,155,168,-73,73,105,3,1,213,362,286,362,8,1467,1188
1599,7,3.0.168,0,537,0,76,168,244,0,168,244,244,0,0,32,1,5,285,92,285,260,8,1467,1188
1599,7,4.2.143,0,540,2,78,143,221,143,0,221,221,-143,143,175,3,1,208,362,305,362,8,1467,1188
1599,7,5.1.168,0,537,0,33,168,201,168,0,201,201,-25,57,57,2,4,193,148,245,259,8,1467,1188
1599,8,0.1.184,0,540,0,59,184,243,184,0,243,243,-41,73,73,2,4,105,148,121,259,9,1467,1172
1599,8,1.2.96,0,548,1,46,96,142,96,0,142,184,-96,96,128,3,1,168,362,225,362,9,1467,1172
1599,8,2.2.73,0,540,0,82,73,155,73,0,155,184,-73,73,105,3,1,213,362,286,362,9,1467,1172
1599,8,3.0.184,1,540,0,76,184,260,0,184,260,260,0,0,32,1,6,285,76,285,260,9,1467,1172
1599,8,4.2.143,0,549,2,78,143,221,143,0,221,221,-143,143,175,3,1,208,362,305,362,9,1467,1172
1599,8,5.1.168,0,540,0,33,168,201,168,0,201,201,-25,57,57,2,4,193,148,245,259,9,1467,1172
1599,9,0.1.184,0,540,0,59,184,243,184,0,243,260,-41,73,73,2,4,105,148,121,259,10,1467,1096
1599,9,1.2.96,0,548,1,46,96,142,96,0,142,260,-96,96,128,3,1,168,362,225,362,10,1467,1096
1599,9,2.2.73,0,540,0,82,73,155,73,0,155,260,-73,73,105,3,1,213,362,286,362,10,1467,1096
1599,9,3.1.260,0,540,0,56,260,316,260,0,316,316,-117,149,149,2,4,209,148,285,259,10,1467,1096
1599,9,4.2.143,0,549,2,78,143,221,143,0,221,260,-143,143,175,3,1,208,362,305,362,10,1467,1096
1599,9,5.1.168,1,540,0,33,168,201,168,0,201,260,-25,57,57,2,4,193,148,245,259,10,1467,1096
1599,10,0.1.201,1,540,0,59,201,260,184,17,260,260,0,57,57,2,5,105,115,121,259,11,1467,1063
1599,10,1.2.96,0,548,1,46,96,142,96,0,142,260,-96,96,153,3,1,168,362,225,362,11,1467,1063
1599,10,2.2.73,0,540,0,82,73,155,73,0,155,260,-73,73,130,3,1,213,362,286,362,11,1467,1063
1599,10,3.1.260,0,540,0,56,260,316,260,0,316,316,-59,116,116,2,5,209,115,285,259,11,1467,1063
1599,10,4.2.143,0,549,2,78,143,221,143,0,221,260,-143,143,200,3,1,208,362,305,362,11,1467,1063
1599,10,5.2.201,0,566,3,70,201,271,201,0,271,271,-201,201,258,3,1,160,362,245,362,11,1467,1063
1599,11,0.2.260,0,552,3,22,260,282,260,0,282,282,-260,260,317,3,1,46,362,121,362,12,1467,1004
1599,11,1.2.96,0,548,1,46,96,142,96,0,142,260,-96,96,153,3,1,168,362,225,362,12,1467,1004
1599,11,2.2.73,0,540,0,82,73,155,73,0,155,260,-73,73,130,3,1,213,362,286,362,12,1467,1004
1599,11,3.1.260,1,540,0,56,260,316,260,0,316,316,0,57,57,2,6,209,56,285,259,12,1467,1004
1599,11,4.2.143,0,549,2,78,143,221,143,0,221,260,-143,143,200,3,1,208,362,305,362,12,1467,1004
1599,11,5.2.201,0,566,4,70,201,271,201,0,271,271,-201,201,258,3,1,160,362,245,362,12,1467,1004
1599,12,0.2.260,0,552,3,22,260,282,260,0,282,316,-260,260,317,3,1,46,362,121,362,13,1467,948
1599,12,1.2.96,0,548,1,46,96,142,96,0,142,316,-96,96,153,3,1,168,362,225,362,13,1467,948
1599,12,2.2.73,1,540,0,82,73,155,73,0,155,316,-73,73,130,3,1,213,362,286,362,13,1467,948
1599,12,3.2.316,0,540,0,64,316,380,316,0,380,380,-316,316,373,3,1,153,362,285,362,13,1467,948
1599,12,4.2.143,0,549,2,78,143,221,143,0,221,316,-143,143,200,3,1,208,362,305,362,13,1467,948
1599,12,5.2.201,0,566,4,70,201,271,201,0,271,316,-201,201,258,3,1,160,362,245,362,13,1467,948
1599,13,0.2.260,0,552,1,22,260,282,260,0,282,316,-105,178,235,3,2,46,280,121,362,14,1467,866
1599,13,1.2.155,1,540,0,46,155,201,96,59,201,316,0,73,130,3,2,168,280,225,362,14,1467,866
1599,13,2.3.155,0,540,0,79,155,234,155,0,234,316,-155,155,285,4,1,131,357,286,357,14,1467,866
1599,13,3.2.316,0,540,0,64,316,380,316,0,380,380,-161,234,291,3,2,153,280,285,362,14,1467,866
1599,13,4.2.155,0,540,0,78,155,233,143,12,233,316,0,73,130,3,2,208,280,305,362,14,1467,866
1599,13,5.2.201,0,566,2,70,201,271,201,0,271,316,-46,119,176,3,2,160,280,245,362,14,1467,866
1599,14,0.2.260,0,584,3,22,260,282,260,0,282,316,-59,132,189,3,3,46,234,121,362,15,1467,820
1599,14,1.3.201,0,577,2,82,201,283,201,0,283,316,-201,201,331,4,1,122,357,225,357,15,1467,820
1599,14,2.3.155,0,540,0,79,155,234,155,0,234,316,-155,155,285,4,1,131,357,286,357,15,1467,820
1599,14,3.2.316,0,540,0,64,316,380,316,0,380,380,-115,188,245,3,3,153,234,285,362,15,1467,820
1599,14,4.2.201,1,540,0,78,201,279,143,58,279,316,0,73,130,3,3,208,234,305,362,15,1467,820
1599,14,5.2.201,0,566,1,70,201,271,201,0,271,316,0,73,130,3,3,160,234,245,362,15,1467,820
1599,15,0.2.279,0,540,0,22,279,301,260,19,301,316,0,73,130,3,4,46,156,121,362,16,1467,742
1599,15,1.3.201,0,577,3,82,201,283,201,0,283,316,-201,201,331,4,1,122,357,225,357,16,1467,742
1599,15,2.3.155,0,540,0,79,155,234,155,0,234,316,-155,155,285,4,1,131,357,286,357,16,1467,742
1599,15,3.2.316,0,540,0,64,316,380,316,0,380,380,-37,110,167,3,4,153,156,285,362,16,1467,742
1599,15,4.3.279,0,574,2,80,279,359,279,0,359,359,-279,279,409,4,1,130,357,305,357,16,1467,742
1599,15,5.2.279,1,546,1,70,279,349,201,78,349,349,0,73,130,3,4,160,156,245,362,16,1467,742
1599,16,0.2.349,1,557,1,22,349,371,260,89,371,371,0,73,130,3,5,46,86,121,362,17,1467,672
1599,16,1.3.201,0,579,3,82,201,283,201,0,283,349,-201,201,331,4,1,122,357,225,357,17,1467,672
1599,16,2.3.155,0,546,0,79,155,234,155,0,234,349,-155,155,285,4,1,131,357,286,357,17,1467,672
1599,16,3.2.349,0,546,0,64,349,413,316,33,413,413,0,73,130,3,5,153,86,285,362,17,1467,672
1599,16,4.3.279,0,574,2,80,279,359,279,0,359,359,-279,279,409,4,1,130,357,305,357,17,1467,672
1599,16,5.3.349,0,595,4,73,349,422,349,0,422,422,-349,349,479,4,1,90,357,245,357,17,1467,672
1599,17,0.3.371,0,586,3,11,371,382,371,0,382,382,-371,371,501,4,1,24,357,121,357,18,1467,650
1599,17,1.3.201,0,579,2,82,201,283,201,0,283,371,-201,201,331,4,1,122,357,225,357,18,1467,650
1599,17,2.3.155,0,557,0,79,155,234,155,0,234,371,-155,155,285,4,1,131,357,286,357,18,1467,650
1599,17,3.2.371,1,557,0,64,371,435,316,55,435,435,0,73,130,3,6,153,64,285,362,18,1467,650
1599,17,4.3.279,0,574,1,80,279,359,279,0,359,371,-279,279,409,4,1,130,357,305,357,18,1467,650
1599,17,5.3.349,0,597,4,73,349,422,349,0,422,422,-349,349,479,4,1,90,357,245,357,18,1467,650
1599,18,0.3.371,0,586,3,11,371,382,371,0,382,435,-371,371,501,4,1,24,357,121,357,19,1467,586
1599,18,1.3.201,0,579,2,82,201,283,201,0,283,435,-201,201,331,4,1,122,357,225,357,19,1467,586
1599,18,2.3.155,1,557,0,79,155,234,155,0,234,435,-155,155,285,4,1,131,357,286,357,19,1467,586
1599,18,3.3.435,0,557,0,32,435,467,435,0,467,467,-435,435,565,4,1,89,357,285,357,19,1467,586
1599,18,4.3.279,0,574,1,80,279,359,279,0,359,435,-279,279,409,4,1,130,357,305,357,19,1467,586
1599,18,5.3.349,0,597,4,73,349,422,349,0,422,435,-349,349,479,4,1,90,357,245,357,19,1467,586
1599,19,0.3.371,0,586,2,11,371,382,371,0,382,435,-137,292,422,4,2,24,278,121,357,20,1467,507
1599,19,1.3.234,0,557,0,82,234,316,201,33,316,435,0,155,285,4,2,122,278,225,357,20,1467,507
1599,19,2.4.234,1,557,0,52,234,286,234,0,286,435,-234,234,519,5,1,52,229,286,229,20,1467,507
1599,19,3.3.435,0,557,0,32,435,467,435,0,467,467,-201,356,486,4,2,89,278,285,357,20,1467,507
1599,19,4.3.279,0,574,1,80,279,359,279,0,359,435,-45,200,330,4,2,130,278,305,357,20,1467,507
1599,19,5.3.349,0,597,3,73,349,422,349,0,422,435,-115,270,400,4,2,90,278,245,357,20,1467,507
1599,20,0.3.371,0,586,2,11,371,382,371,0,382,435,-137,292,656,4,2,24,278,121,357,21,1467,455
1599,20,1.3.234,1,557,0,82,234,316,201,33,316,435,0,155,519,4,2,122,278,225,357,21,1467,455
1599,20,3.3.435,0,557,0,32,435,467,435,0,467,467,-201,356,720,4,2,89,278,285,357,21,1467,455
1599,20,4.3.279,0,574,1,80,279,359,279,0,359,435,-45,200,564,4,2,130,278,305,357,21,1467,455
1599,20,5.3.349,0,597,3,73,349,422,349,0,422,435,-115,270,634,4,2,90,278,245,357,21,1467,455
1599,21,0.3.371,0,586,1,11,371,382,371,0,382,435,-55,210,574,4,3,24,196,121,357,22,1467,373
1599,21,1.4.316,1,557,0,40,316,356,316,0,356,435,-30,264,549,5,2,40,177,225,229,22,1467,373
1599,21,3.3.435,0,557,0,32,435,467,435,0,467,467,-119,274,638,4,3,89,196,285,357,22,1467,373
1599,21,4.3.316,0,557,0,80,316,396,279,37,396,435,0,155,519,4,3,130,196,305,357,22,1467,373
1599,21,5.3.349,0,597,2,73,349,422,349,0,422,435,-33,188,552,4,3,90,196,245,357,22,1467,373
1599,22,0.3.371,0,586,1,11,371,382,371,0,382,435,-55,210,604,4,3,24,196,121,357,23,1467,333
1599,22,3.3.435,0,557,0,32,435,467,435,0,467,467,-119,274,668,4,3,89,196,285,357,23,1467,333
1599,22,4.3.316,1,557,0,80,316,396,279,37,396,435,0,155,549,4,3,130,196,305,357,23,1467,333
1599,22,5.3.349,0,597,2,73,349,422,349,0,422,435,-33,188,582,4,3,90,196,245,357,23,1467,333
1599,23,0.3.396,0,557,0,11,396,407,371,25,407,435,0,155,549,4,4,24,116,121,357,24,1467,253
1599,23,3.3.435,0,557,0,32,435,467,435,0,467,467,-39,194,588,4,4,89,116,285,357,24,1467,253
1599,23,4.4.396,1,557,0,50,396,446,396,0,446,446,-40,304,589,5,3,50,137,305,229,24,1467,253
1599,23,5.3.396,0,569,1,73,396,469,349,47,469,469,0,155,549,4,4,90,116,245,357,24,1467,253
1599,24,0.3.396,1,557,0,11,396,407,371,25,407,446,0,155,589,4,4,24,116,121,357,25,1467,203
1599,24,3.3.435,0,557,0,32,435,467,435,0,467,467,-39,194,628,4,4,89,116,285,357,25,1467,203
1599,24,5.3.396,0,569,1,73,396,469,349,47,469,469,0,155,589,4,4,90,116,245,357,25,1467,203
1599,25,0.4.446,1,557,0,13,446,459,407,39,459,459,0,304,589,5,4,13,87,121,229,26,1467,192
1599,25,3.3.435,0,557,0,32,435,467,435,0,467,467,-28,183,617,4,5,89,105,285,357,26,1467,192
1599,25,5.3.407,0,569,1,73,407,480,349,58,480,480,0,155,589,4,5,90,105,245,357,26,1467,192
1599,26,3.3.435,1,557,0,32,435,467,435,0,467,467,-28,183,617,4,5,89,105,285,357,27,1467,179
1599,26,5.3.407,0,569,1,73,407,480,349,58,480,480,0,155,589,4,5,90,105,245,357,27,1467,179
1599,27,3.4.467,1,557,0,57,467,524,467,0,524,524,-8,312,625,5,5,57,74,285,229,28,1467,147
1599,27,5.3.467,0,557,0,73,467,540,349,118,540,540,0,183,617,4,6,90,73,245,357,28,1467,147
1599,28,5.3.467,1,557,0,73,467,540,349,118,540,540,0,183,625,4,6,90,73,245,357,29,1467,90
1599,29,5.4.540,1,557,0,17,540,557,540,0,557,557,-16,328,641,5,6,17,17,245,229,30,1467,17
1600,0,0.0.0,0,498,0,29,0,29,0,0,29,29,0,0,0,1,1,163,274,163,274,1,1433,1433
1600,0,1.0.0,0,508,2,10,0,10,0,0,10,10,0,0,0,1,1,225,274,225,274,1,1433,1433
1600,0,2.0.0,0,553,4,58,0,58,0,0,58,58,0,0,0,1,1,213,274,213,274,1,1433,1433
1600,0,3.0.0,1,503,1,29,0,29,0,0,29,29,0,0,0,1,1,343,274,343,274,1,1433,1433
1600,0,4.0.0,0,588,5,92,0,92,0,0,92,92,0,0,0,1,1,342,274,342,274,1,1433,1433
1600,0,5.0.0,0,531,3,56,0,56,0,0,56,56,0,0,0,1,1,147,274,147,274,1,1433,1433
1600,1,0.0.29,0,503,0,29,29,58,0,29,58,58,0,0,0,1,2,163,245,163,274,2,1433,1404
1600,1,1.0.29,1,506,2,10,29,39,0,29,39,39,0,0,0,1,2,225,245,225,274,2,1433,1404
1600,1,2.0.29,0,528,3,58,29,87,0,29,87,87,0,0,0,1,2,213,245,213,274,2,1433,1404
1600,1,3.1.29,0,503,0,94,29,123,29,0,123,123,-29,29,29,2,1,314,361,343,361,2,1433,1404
1600,1,4.0.29,0,505,1,92,29,121,0,29,121,121,0,0,0,1,2,342,245,342,274,2,1433,1404
1600,1,5.0.29,0,531,4,56,29,85,0,29,85,85,0,0,0,1,2,147,245,147,274,2,1433,1404
1600,2,0.0.39,1,506,0,29,39,68,0,39,68,68,0,0,0,1,3,163,235,163,274,3,1433,1394
1600,2,1.1.39,0,563,4,91,39,130,39,0,130,130,-39,39,39,2,1,215,361,225,361,3,1433,1394
1600,2,2.0.39,0,538,2,58,39,97,0,39,97,97,0,0,0,1,3,213,235,213,274,3,1433,1394
1600,2,3.1.29,0,506,0,94,29,123,29,0,123,123,-29,29,29,2,1,314,361,343,361,3,1433,1394
1600,2,4.0.39,0,513,1,92,39,131,0,39,131,131,0,0,0,1,3,342,235,342,274,3,1433,1394
1600,2,5.0.39,0,541,3,56,39,95,0,39,95,95,0,0,0,1,3,147,235,147,274,3,1433,1394
1600,3,0.1.68,0,535,1,27,68,95,68,0,95,95,-68,68,68,2,1,134,361,163,361,4,1433,1365
1600,3,1.1.39,0,563,4,91,39,130,39,0,130,130,-39,39,39,2,1,215,361,225,361,4,1433,1365
1600,3,2.0.68,0,538,2,58,68,126,0,68,126,126,0,0,0,1,4,213,206,213,274,4,1433,1365
1600,3,3.1.29,0,506,0,94,29,123,29,0,123,123,-29,29,29,2,1,314,361,343,361,4,1433,1365
1600,3,4.0.68,1,506,0,92,68,160,0,68,160,160,0,0,0,1,4,342,206,342,274,4,1433,1365
1600,3,5.0.68,0,541,3,56,68,124,0,68,124,124,0,0,0,1,4,147,206,147,274,4,1433,1365
1600,4,0.1.68,0,535,2,27,68,95,68,0,95,160,-68,68,68,2,1,134,361,163,361,5,1433,1273
1600,4,1.1.39,0,563,3,91,39,130,39,0,130,160,-39,39,39,2,1,215,361,225,361,5,1433,1273
1600,4,2.0.160,1,528,1,58,160,218,0,160,218,218,0,0,0,1,5,213,114,213,274,5,1433,1273
1600,4,3.1.29,0,506,0,94,29,123,29,0,123,160,-29,29,29,2,1,314,361,343,361,5,1433,1273
1600,4,4.1.160,0,506,0,79,160,239,160,0,239,239,-160,160,160,2,1,250,361,342,361,5,1433,1273
1600,4,5.0.160,0,506,0,56,160,216,0,160,216,216,0,0,0,1,5,147,114,147,274,5,1433,1273
1600,5,0.1.68,0,541,1,27,68,95,68,0,95,218,-68,68,68,2,1,134,361,163,361,6,1433,1215
1600,5,1.1.39,0,571,3,91,39,130,39,0,130,218,-39,39,39,2,1,215,361,225,361,6,1433,1215
1600,5,2.1.218,0,565,2,54,218,272,218,0,272,272,-218,218,218,2,1,155,361,213,361,6,1433,1215
1600,5,3.1.29,0,528,0,94,29,123,29,0,123,218,-29,29,29,2,1,314,361,343,361,6,1433,1215
1600,5,4.1.160,0,528,0,79,160,239,160,0,239,239,-160,160,160,2,1,250,361,342,361,6,1433,1215
1600,5,5.0.218,1,528,0,56,218,274,0,218,274,274,0,0,0,1,6,147,56,147,274,6,1433,1215
1600,6,0.1.68,0,541,2,27,68,95,68,0,95,274,-68,68,68,2,1,134,361,163,361,7,1433,1159
1600,6,1.1.39,0,571,4,91,39,130,39,0,130,274,-39,39,39,2,1,215,361,225,361,7,1433,1159
1600,6,2.1.218,0,565,3,54,218,272,218,0,272,274,-218,218,218,2,1,155,361,213,361,7,1433,1159
1600,6,3.1.29,1,528,0,94,29,123,29,0,123,274,-29,29,29,2,1,314,361,343,361,7,1433,1159
1600,6,4.1.160,0,528,0,79,160,239,160,0,239,274,-160,160,160,2,1,250,361,342,361,7,1433,1159
1600,6,5.1.274,0,539,1,16,274,290,274,0,290,290,-274,274,274,2,1,91,361,147,361,7,1433,1159
1600,7,0.1.123,0,528,0,27,123,150,68,55,150,274,0,29,29,2,2,134,267,163,361,8,1433,1065
1600,7,1.1.123,0,561,2,91,123,214,39,84,214,274,0,29,29,2,2,215,267,225,361,8,1433,1065
1600,7,2.1.218,0,565,3,54,218,272,218,0,272,274,-95,124,124,2,2,155,267,213,361,8,1433,1065
1600,7,3.2.123,1,528,0,32,123,155,123,0,155,274,-123,123,152,3,1,220,230,343,230,8,1433,1065
1600,7,4.1.160,0,528,0,79,160,239,160,0,239,274,-37,66,66,2,2,250,267,342,361,8,1433,1065
1600,7,5.1.274,0,539,1,16,274,290,274,0,290,290,-151,180,180,2,2,91,267,147,361,8,1433,1065
1600,8,0.1.123,0,528,0,27,123,150,68,55,150,274,0,29,152,2,2,134,267,163,361,9,1433,1033
1600,8,1.1.123,0,561,2,91,123,214,39,84,214,274,0,29,152,2,2,215,267,225,361,9,1433,1033
1600,8,2.1.218,0,565,3,54,218,272,218,0,272,274,-95,124,247,2,2,155,267,213,361,9,1433,1033
1600,8,3.3.155,1,528,0,90,155,245,155,0,245,274,-155,155,307,4,1,188,310,343,310,9,1433,1033
1600,8,4.1.160,0,528,0,79,160,239,160,0,239,274,-37,66,189,2,2,250,267,342,361,9,1433,1033
1600,8,5.1.274,0,539,1,16,274,290,274,0,290,290,-151,180,303,2,2,91,267,147,361,9,1433,1033
1600,9,0.1.123,0,528,0,27,123,150,68,55,150,274,0,29,307,2,2,134,267,163,361,10,1433,943
1600,9,1.1.123,0,561,2,91,123,214,39,84,214,274,0,29,307,2,2,215,267,225,361,10,1433,943
1600,9,2.1.218,0,565,3,54,218,272,218,0,272,274,-95,124,402,2,2,155,267,213,361,10,1433,943
1600,9,3.4.245,1,528,0,98,245,343,245,0,343,343,-245,245,552,5,1,98,258,343,258,10,1433,943
1600,9,4.1.160,0,528,0,79,160,239,160,0,239,274,-37,66,344,2,2,250,267,342,361,10,1433,943
1600,9,5.1.274,0,539,1,16,274,290,274,0,290,290,-151,180,458,2,2,91,267,147,361,10,1433,943
1600,10,0.1.123,1,528,0,27,123,150,68,55,150,343,0,29,552,2,2,134,267,163,361,11,1433,845
1600,10,1.1.123,0,561,2,91,123,214,39,84,214,343,0,29,552,2,2,215,267,225,361,11,1433,845
1600,10,2.1.218,0,565,3,54,218,272,218,0,272,343,-95,124,647,2,2,155,267,213,361,11,1433,845
1600,10,4.1.160,0,528,0,79,160,239,160,0,239,343,-37,66,589,2,2,250,267,342,361,11,1433,845
1600,10,5.1.274,0,539,1,16,274,290,274,0,290,343,-151,180,703,2,2,91,267,147,361,11,1433,845
1600,11,0.2.155,1,528,0,25,155,180,150,5,180,343,0,123,552,3,2,107,198,163,230,12,1433,818
1600,11,1.1.150,0,561,2,91,150,241,39,111,241,343,0,29,552,2,3,215,240,225,361,12,1433,818
1600,11,2.1.218,0,592,3,54,218,272,218,0,272,343,-68,97,620,2,3,155,240,213,361,12,1433,818
1600,11,4.1.160,0,528,0,79,160,239,160,0,239,343,-10,39,562,2,3,250,240,342,361,12,1433,818
1600,11,5.1.274,0,539,1,16,274,290,274,0,290,343,-124,153,676,2,3,91,240,147,361,12,1433,818
1600,12,0.3.245,1,528,0,17,245,262,180,65,262,343,0,155,552,4,2,82,220,163,310,13,1433,793
1600,12,1.1.150,0,561,2,91,150,241,39,111,241,343,0,29,552,2,3,215,240,225,361,13,1433,793
1600,12,2.1.218,0,592,3,54,218,272,218,0,272,343,-68,97,620,2,3,155,240,213,361,13,1433,793
1600,12,4.1.160,0,528,0,79,160,239,160,0,239,343,-10,39,562,2,3,250,240,342,361,13,1433,793
1600,12,5.1.274,0,539,1,16,274,290,274,0,290,343,-124,153,676,2,3,91,240,147,361,13,1433,793
1600,13,0.4.343,1,528,0,65,343,408,262,81,408,408,0,245,552,5,2,65,160,163,258,14,1433,776
1600,13,1.1.150,0,561,2,91,150,241,39,111,241,343,0,29,552,2,3,215,240,225,361,14,1433,776
1600,13,2.1.218,0,592,3,54,218,272,218,0,272,343,-68,97,620,2,3,155,240,213,361,14,1433,776
1600,13,4.1.160,0,528,0,79,160,239,160,0,239,343,-10,39,562,2,3,250,240,342,361,14,1433,776
1600,13,5.1.274,0,539,1,16,274,290,274,0,290,343,-124,153,676,2,3,91,240,147,361,14,1433,776
1600,14,1.1.150,1,561,2,91,150,241,39,111,241,408,0,29,552,2,3,215,240,225,361,15,1433,711
1600,14,2.1.218,0,592,3,54,218,272,218,0,272,408,-68,97,620,2,3,155,240,213,361,15,1433,711
1600,14,4.1.160,0,528,0,79,160,239,160,0,239,408,-10,39,562,2,3,250,240,342,361,15,1433,711
1600,14,5.1.274,0,539,1,16,274,290,274,0,290,408,-124,153,676,2,3,91,240,147,361,15,1433,711
1600,15,1.2.241,1,561,0,51,241,292,241,0,292,408,-61,184,613,3,3,124,173,225,230,16,1433,620
1600,15,2.1.241,0,561,0,54,241,295,218,23,295,408,0,29,552,2,4,155,149,213,361,16,1433,620
1600,15,4.1.241,0,562,1,79,241,320,160,81,320,408,0,29,552,2,4,250,149,342,361,16,1433,620
1600,15,5.1.274,0,586,2,16,274,290,274,0,290,408,-33,62,585,2,4,91,149,147,361,16,1433,620
1600,16,1.3.292,1,561,0,24,292,316,292,0,316,408,-30,185,643,4,3,73,203,225,310,17,1433,569
1600,16,2.1.241,0,561,0,54,241,295,218,23,295,408,0,29,613,2,4,155,149,213,361,17,1433,569
1600,16,4.1.241,0,562,1,79,241,320,160,81,320,408,0,29,613,2,4,250,149,342,361,17,1433,569
1600,16,5.1.274,0,586,2,16,274,290,274,0,290,408,-33,62,646,2,4,91,149,147,361,17,1433,569
1600,17,1.4.408,1,561,0,49,408,457,316,92,457,457,0,245,643,5,3,49,95,225,258,18,1433,545
1600,17,2.1.241,0,561,0,54,241,295,218,23,295,408,0,29,643,2,4,155,149,213,361,18,1433,545
1600,17,4.1.241,0,562,1,79,241,320,160,81,320,408,0,29,643,2,4,250,149,342,361,18,1433,545
1600,17,5.1.274,0,586,2,16,274,290,274,0,290,408,-33,62,676,2,4,91,149,147,361,18,1433,545
1600,18,2.1.241,0,561,0,54,241,295,218,23,295,457,0,29,643,2,4,155,149,213,361,19,1433,496
1600,18,4.1.241,1,562,1,79,241,320,160,81,320,457,0,29,643,2,4,250,149,342,361,19,1433,496
1600,18,5.1.274,0,586,2,16,274,290,274,0,290,457,-33,62,676,2,4,91,149,147,361,19,1433,496
1600,19,2.1.320,1,585,1,54,320,374,218,102,374,457,0,29,643,2,5,155,70,213,361,20,1433,417
1600,19,4.2.320,0,585,1,78,320,398,320,0,398,457,-28,212,671,3,4,171,122,342,230,20,1433,417
1600,19,5.1.320,0,562,0,16,320,336,274,46,336,457,0,29,643,2,5,91,70,147,361,20,1433,417
1600,20,2.2.374,0,608,1,35,374,409,374,0,409,457,-82,266,725,3,4,101,122,213,230,21,1433,363
1600,20,4.2.320,0,585,0,78,320,398,320,0,398,457,-28,212,671,3,4,171,122,342,230,21,1433,363
1600,20,5.1.374,1,585,0,16,374,390,274,100,390,457,0,29,643,2,6,91,16,147,361,21,1433,363
1600,21,2.2.374,0,608,2,35,374,409,374,0,409,457,-82,266,725,3,4,101,122,213,230,22,1433,347
1600,21,4.2.320,1,585,0,78,320,398,320,0,398,457,-28,212,671,3,4,171,122,342,230,22,1433,347
1600,21,5.2.390,0,605,1,9,390,399,390,0,399,457,-98,282,741,3,4,75,122,147,230,22,1433,347
1600,22,2.2.398,1,585,0,35,398,433,374,24,433,457,0,212,671,3,5,101,44,213,230,23,1433,269
1600,22,4.3.398,0,585,0,73,398,471,398,0,471,471,-82,267,753,4,4,93,179,342,310,23,1433,269
1600,22,5.2.398,0,585,0,9,398,407,390,8,407,457,0,212,671,3,5,75,44,147,230,23,1433,269
1600,23,2.3.433,0,620,1,48,433,481,433,0,481,481,-117,302,788,4,4,66,179,213,310,24,1433,234
1600,23,4.3.398,0,585,0,73,398,471,398,0,471,471,-82,267,753,4,4,93,179,342,310,24,1433,234
1600,23,5.2.433,1,585,0,9,433,442,390,43,442,457,0,212,671,3,6,75,9,147,230,24,1433,234
1600,24,2.3.433,0,620,1,48,433,481,433,0,481,481,-117,302,788,4,4,66,179,213,310,25,1433,225
1600,24,4.3.398,1,585,0,73,398,471,398,0,471,471,-82,267,753,4,4,93,179,342,310,25,1433,225
1600,24,5.3.442,0,639,2,58,442,500,442,0,500,500,-126,311,797,4,4,66,179,147,310,25,1433,225
1600,25,2.3.471,0,585,0,48,471,519,433,38,519,519,0,267,753,4,5,66,106,213,310,26,1433,152
1600,25,4.4.471,1,585,0,20,471,491,471,0,491,491,-14,259,767,5,4,20,46,342,258,26,1433,152
1600,25,5.3.471,0,595,1,58,471,529,442,29,529,529,0,267,753,4,5,66,106,147,310,26,1433,152
1600,26,2.3.471,1,585,0,48,471,519,433,38,519,519,0,267,767,4,5,66,106,213,310,27,1433,132
1600,26,5.3.471,0,595,1,58,471,529,442,29,529,529,0,267,767,4,5,66,106,147,310,27,1433,132
1600,27,2.4.519,1,585,0,18,519,537,519,0,537,537,-28,287,795,5,5,18,26,213,258,28,1433,84
1600,27,5.3.519,0,585,0,58,519,577,442,77,577,577,0,267,767,4,6,66,58,147,310,28,1433,84
1600,28,5.3.519,1,585,0,58,519,577,442,77,577,577,0,267,795,4,6,66,58,147,310,29,1433,66
1600,29,5.4.577,1,585,0,8,577,585,577,0,585,585,-40,327,835,5,6,8,8,147,258,30,1433,8
1601,0,0.0.0,0,604,2,42,0,42,0,0,42,42,0,0,0,1,1,207,288,207,288,1,1700,1700
1601,0,1.0.0,0,647,5,85,0,85,0,0,85,85,0,0,0,1,1,323,288,323,288,1,1700,1700
1601,0,2.0.0,0,562,0,4,0,4,0,0,4,4,0,0,0,1,1,240,288,240,288,1,1700,1700
1601,0,3.0.0,0,644,4,82,0,82,0,0,82,82,0,0,0,1,1,303,288,303,288,1,1700,1700
1601,0,4.0.0,1,576,1,14,0,14,0,0,14,14,0,0,0,1,1,280,288,280,288,1,1700,1700
1601,0,5.0.0,0,610,3,61,0,61,0,0,61,61,0,0,0,1,1,347,288,347,288,1,1700,1700
1601,1,0.0.14,0,578,1,42,14,56,0,14,56,56,0,0,0,1,2,207,274,207,288,2,1700,1686
1601,1,1.0.14,0,578,1,85,14,99,0,14,99,99,0,0,0,1,2,323,274,323,288,2,1700,1686
1601,1,2.0.14,1,576,0,4,14,18,0,14,18,18,0,0,0,1,2,240,274,240,288,2,1700,1686
1601,1,3.0.14,0,580,2,82,14,96,0,14,96,96,0,0,0,1,2,303,274,303,288,2,1700,1686
1601,1,4.1.14,0,578,1,31,14,45,14,0,45,45,-14,14,14,2,1,266,363,280,363,2,1700,1686
1601,1,5.0.14,0,578,1,61,14,75,0,14,75,75,0,0,0,1,2,347,274,347,288,2,1700,1686
1601,2,0.0.18,0,578,1,42,18,60,0,18,60,60,0,0,0,1,3,207,270,207,288,3,1700,1682
1601,2,1.0.18,0,578,1,85,18,103,0,18,103,103,0,0,0,1,3,323,270,323,288,3,1700,1682
1601,2,2.1.18,0,576,0,48,18,66,18,0,66,66,-18,18,18,2,1,236,363,240,363,3,1700,1682
1601,2,3.0.18,0,578,1,82,18,100,0,18,100,100,0,0,0,1,3,303,270,303,288,3,1700,1682
1601,2,4.1.14,0,578,1,31,14,45,14,0,45,45,-14,14,14,2,1,266,363,280,363,3,1700,1682
1601,2,5.0.18,1,576,0,61,18,79,0,18,79,79,0,0,0,1,3,347,270,347,288,3,1700,1682
1601,3,0.0.79,1,576,0,42,79,121,0,79,121,121,0,0,0,1,4,207,209,207,288,4,1700,1621
1601,3,1.0.79,0,576,0,85,79,164,0,79,164,164,0,0,0,1,4,323,209,323,288,4,1700,1621
1601,3,2.1.18,0,576,0,48,18,66,18,0,66,79,-18,18,18,2,1,236,363,240,363,4,1700,1621
1601,3,3.0.79,0,576,0,82,79,161,0,79,161,161,0,0,0,1,4,303,209,303,288,4,1700,1621
1601,3,4.1.14,0,578,1,31,14,45,14,0,45,79,-14,14,14,2,1,266,363,280,363,4,1700,1621
1601,3,5.1.79,0,576,0,98,79,177,79,0,177,177,-79,79,79,2,1,286,363,347,363,4,1700,1621
1601,4,0.1.121,0,594,2,94,121,215,121,0,215,215,-121,121,121,2,1,165,363,207,363,5,1700,1579
1601,4,1.0.121,1,576,0,85,121,206,0,121,206,206,0,0,0,1,5,323,167,323,288,5,1700,1579
1601,4,2.1.18,0,576,0,48,18,66,18,0,66,121,-18,18,18,2,1,236,363,240,363,5,1700,1579
1601,4,3.0.121,0,578,1,82,121,203,0,121,203,203,0,0,0,1,5,303,167,303,288,5,1700,1579
1601,4,4.1.14,0,578,1,31,14,45,14,0,45,121,-14,14,14,2,1,266,363,280,363,5,1700,1579
1601,4,5.1.79,0,576,0,98,79,177,79,0,177,177,-79,79,79,2,1,286,363,347,363,5,1700,1579
1601,5,0.1.121,0,607,2,94,121,215,121,0,215,215,-121,121,121,2,1,165,363,207,363,6,1700,1494
1601,5,1.1.206,0,578,1,59,206,265,206,0,265,265,-206,206,206,2,1,238,363,323,363,6,1700,1494
1601,5,2.1.18,0,576,0,48,18,66,18,0,66,206,-18,18,18,2,1,236,363,240,363,6,1700,1494
1601,5,3.0.206,1,576,0,82,206,288,0,206,288,288,0,0,0,1,6,303,82,303,288,6,1700,1494
1601,5,4.1.14,0,578,1,31,14,45,14,0,45,206,-14,14,14,2,1,266,363,280,363,6,1700,1494
1601,5,5.1.79,0,576,0,98,79,177,79,0,177,206,-79,79,79,2,1,286,363,347,363,6,1700,1494
1601,6,0.1.121,0,607,2,94,121,215,121,0,215,288,-121,121,121,2,1,165,363,207,363,7,1700,1412
1601,6,1.1.206,0,578,1,59,206,265,206,0,265,288,-206,206,206,2,1,238,363,323,363,7,1700,1412
1601,6,2.1.18,0,576,0,48,18,66,18,0,66,288,-18,18,18,2,1,236,363,240,363,7,1700,1412
1601,6,3.1.288,0,576,0,33,288,321,288,0,321,321,-288,288,288,2,1,221,363,303,363,7,1700,1412
1601,6,4.1.14,1,578,1,31,14,45,14,0,45,288,-14,14,14,2,1,266,363,280,363,7,1700,1412
1601,6,5.1.79,0,576,0,98,79,177,79,0,177,288,-79,79,79,2,1,286,363,347,363,7,1700,1412
1601,7,0.1.121,0,607,1,94,121,215,121,0,215,288,-76,90,90,2,2,165,332,207,363,8,1700,1381
1601,7,1.1.206,0,578,0,59,206,265,206,0,265,288,-161,175,175,2,2,238,332,323,363,8,1700,1381
1601,7,2.1.45,1,578,0,48,45,93,18,27,93,288,0,14,14,2,2,236,332,240,363,8,1700,1381
1601,7,3.1.288,0,578,0,33,288,321,288,0,321,321,-243,257,257,2,2,221,332,303,363,8,1700,1381
1601,7,4.2.45,0,578,0,79,45,124,45,0,124,288,-45,45,59,3,1,235,397,280,397,8,1700,1381
1601,7,5.1.79,0,578,0,98,79,177,79,0,177,288,-34,48,48,2,2,286,332,347,363,8,1700,1381
1601,8,0.1.121,0,607,2,94,121,215,121,0,215,288,-28,42,42,2,3,165,284,207,363,9,1700,1333
1601,8,1.1.206,0,578,0,59,206,265,206,0,265,288,-113,127,127,2,3,238,284,323,363,9,1700,1333
1601,8,2.2.93,0,590,1,88,93,181,93,0,181,288,-93,93,107,3,1,188,397,240,397,9,1700,1333
1601,8,3.1.288,0,578,0,33,288,321,288,0,321,321,-195,209,209,2,3,221,284,303,363,9,1700,1333
1601,8,4.2.45,0,578,0,79,45,124,45,0,124,288,-45,45,59,3,1,235,397,280,397,9,1700,1333
1601,8,5.1.93,1,578,0,98,93,191,79,14,191,288,0,14,14,2,3,286,284,347,363,9,1700,1333
1601,9,0.1.191,0,588,1,94,191,285,121,70,285,288,0,14,14,2,4,165,186,207,363,10,1700,1235
1601,9,1.1.206,1,578,0,59,206,265,206,0,265,288,-15,29,29,2,4,238,186,323,363,10,1700,1235
1601,9,2.2.93,0,590,2,88,93,181,93,0,181,288,-93,93,107,3,1,188,397,240,397,10,1700,1235
1601,9,3.1.288,0,578,0,33,288,321,288,0,321,321,-97,111,111,2,4,221,186,303,363,10,1700,1235
1601,9,4.2.45,0,578,0,79,45,124,45,0,124,288,-45,45,59,3,1,235,397,280,397,10,1700,1235
1601,9,5.2.191,0,588,1,47,191,238,191,0,238,288,-191,191,205,3,1,188,397,347,397,10,1700,1235
1601,10,0.1.265,0,580,1,94,265,359,121,144,359,359,0,29,29,2,5,165,127,207,363,11,1700,1176
1601,10,1.2.265,0,578,0,56,265,321,265,0,321,321,-265,265,294,3,1,179,397,323,397,11,1700,1176
1601,10,2.2.93,0,590,3,88,93,181,93,0,181,288,-93,93,122,3,1,188,397,240,397,11,1700,1176
1601,10,3.1.288,1,578,0,33,288,321,288,0,321,321,-23,52,52,2,5,221,127,303,363,11,1700,1176
1601,10,4.2.45,0,578,0,79,45,124,45,0,124,288,-45,45,74,3,1,235,397,280,397,11,1700,1176
1601,10,5.2.191,0,588,2,47,191,238,191,0,238,288,-191,191,220,3,1,188,397,347,397,11,1700,1176
1601,11,0.1.321,1,578,0,94,321,415,121,200,415,415,0,52,52,2,6,165,94,207,363,12,1700,1143
1601,11,1.2.265,0,578,0,56,265,321,265,0,321,321,-265,265,317,3,1,179,397,323,397,12,1700,1143
1601,11,2.2.93,0,590,2,88,93,181,93,0,181,321,-93,93,145,3,1,188,397,240,397,12,1700,1143
1601,11,3.2.321,0,578,0,98,321,419,321,0,419,419,-321,321,373,3,1,188,397,303,397,12,1700,1143
1601,11,4.2.45,0,578,0,79,45,124,45,0,124,321,-45,45,97,3,1,235,397,280,397,12,1700,1143
1601,11,5.2.191,0,588,1,47,191,238,191,0,238,321,-191,191,243,3,1,188,397,347,397,12,1700,1143
1601,12,0.2.415,0,632,3,29,415,444,415,0,444,444,-415,415,467,3,1,71,397,207,397,13,1700,1049
1601,12,1.2.265,0,578,0,56,265,321,265,0,321,415,-265,265,317,3,1,179,397,323,397,13,1700,1049
1601,12,2.2.93,0,590,2,88,93,181,93,0,181,415,-93,93,145,3,1,188,397,240,397,13,1700,1049
1601,12,3.2.321,0,578,0,98,321,419,321,0,419,419,-321,321,373,3,1,188,397,303,397,13,1700,1049
1601,12,4.2.45,1,578,0,79,45,124,45,0,124,415,-45,45,97,3,1,235,397,280,397,13,1700,1049
1601,12,5.2.191,0,588,1,47,191,238,191,0,238,415,-191,191,243,3,1,188,397,347,397,13,1700,1049
1601,13,0.2.415,0,632,2,29,415,444,415,0,444,444,-291,336,388,3,2,71,318,207,397,14,1700,970
1601,13,1.2.265,0,578,0,56,265,321,265,0,321,415,-141,186,238,3,2,179,318,323,397,14,1700,970
1601,13,2.2.124,0,578,0,88,124,212,93,31,212,415,0,45,97,3,2,188,318,240,397,14,1700,970
1601,13,3.2.321,0,578,0,98,321,419,321,0,419,419,-197,242,294,3,2,188,318,303,397,14,1700,970
1601,13,4.3.124,1,578,0,66,124,190,124,0,190,415,-124,124,221,4,1,156,264,280,264,14,1700,970
1601,13,5.2.191,0,588,1,47,191,238,191,0,238,415,-67,112,164,3,2,188,318,347,397,14,1700,970
1601,14,0.2.415,0,632,2,29,415,444,415,0,444,444,-291,336,512,3,2,71,318,207,397,15,1700,904
1601,14,1.2.265,0,578,0,56,265,321,265,0,321,415,-141,186,362,3,2,179,318,323,397,15,1700,904
1601,14,2.2.124,0,578,0,88,124,212,93,31,212,415,0,45,221,3,2,188,318,240,397,15,1700,904
1601,14,3.2.321,0,578,0,98,321,419,321,0,419,419,-197,242,418,3,2,188,318,303,397,15,1700,904
1601,14,4.4.190,1,578,0,90,190,280,190,0,280,415,-190,190,411,5,1,90,388,280,388,15,1700,904
1601,14,5.2.191,0,588,1,47,191,238,191,0,238,415,-67,112,288,3,2,188,318,347,397,15,1700,904
1601,15,0.2.415,0,632,2,29,415,444,415,0,444,444,-291,336,702,3,2,71,318,207,397,16,1700,814
1601,15,1.2.265,0,578,0,56,265,321,265,0,321,415,-141,186,552,3,2,179,318,323,397,16,1700,814
1601,15,2.2.124,0,578,0,88,124,212,93,31,212,415,0,45,411,3,2,188,318,240,397,16,1700,814
1601,15,3.2.321,0,578,0,98,321,419,321,0,419,419,-197,242,608,3,2,188,318,303,397,16,1700,814
1601,15,5.2.191,1,588,1,47,191,238,191,0,238,415,-67,112,478,3,2,188,318,347,397,16,1700,814
1601,16,0.2.415,0,632,3,29,415,444,415,0,444,444,-177,289,655,3,3,71,271,207,397,17,1700,767
1601,16,1.2.265,0,615,1,56,265,321,265,0,321,415,-27,139,505,3,3,179,271,323,397,17,1700,767
1601,16,2.2.238,0,588,0,88,238,326,93,145,326,415,0,112,478,3,3,188,271,240,397,17,1700,767
1601,16,3.2.321,0,625,2,98,321,419,321,0,419,419,-83,195,561,3,3,188,271,303,397,17,1700,767
1601,16,5.3.238,1,588,0,43,238,281,238,0,281,415,-48,172,526,4,2,141,198,347,264,17,1700,767
1601,17,0.2.415,0,632,3,29,415,444,415,0,444,444,-177,289,703,3,3,71,271,207,397,18,1700,724
1601,17,1.2.265,0,615,1,56,265,321,265,0,321,415,-27,139,553,3,3,179,271,323,397,18,1700,724
1601,17,2.2.238,0,588,0,88,238,326,93,145,326,415,0,112,526,3,3,188,271,240,397,18,1700,724
1601,17,3.2.321,0,625,2,98,321,419,321,0,419,419,-83,195,609,3,3,188,271,303,397,18,1700,724
1601,17,5.4.281,1,588,0,98,281,379,281,0,379,415,-1,191,527,5,2,98,298,347,388,18,1700,724
1601,18,0.2.415,0,632,3,29,415,444,415,0,444,444,-177,289,704,3,3,71,271,207,397,19,1700,626
1601,18,1.2.265,0,615,1,56,265,321,265,0,321,415,-27,139,554,3,3,179,271,323,397,19,1700,626
1601,18,2.2.238,1,588,0,88,238,326,93,145,326,415,0,112,527,3,3,188,271,240,397,19,1700,626
1601,18,3.2.321,0,625,2,98,321,419,321,0,419,419,-83,195,610,3,3,188,271,303,397,19,1700,626
1601,19,0.2.415,0,632,2,29,415,444,415,0,444,444,-89,201,616,3,4,71,183,207,397,20,1700,538
1601,19,1.2.326,0,588,0,56,326,382,265,61,382,415,0,112,527,3,4,179,183,323,397,20,1700,538
1601,19,2.3.326,1,588,0,17,326,343,326,0,343,415,-45,217,572,4,3,100,155,240,264,20,1700,538
1601,19,3.2.326,0,621,1,98,326,424,321,5,424,424,0,112,527,3,4,188,183,303,397,20,1700,538
1601,20,0.2.415,0,632,2,29,415,444,415,0,444,444,-89,201,661,3,4,71,183,207,397,21,1700,521
1601,20,1.2.326,0,588,0,56,326,382,265,61,382,415,0,112,572,3,4,179,183,323,397,21,1700,521
1601,20,2.4.379,1,588,0,83,379,462,343,36,462,462,0,191,572,5,3,83,200,240,388,21,1700,521
1601,20,3.2.326,0,621,1,98,326,424,321,5,424,424,0,112,572,3,4,188,183,303,397,21,1700,521
1601,21,0.2.415,0,632,2,29,415,444,415,0,444,462,-89,201,661,3,4,71,183,207,397,22,1700,438
1601,21,1.2.326,1,588,0,56,326,382,265,61,382,462,0,112,572,3,4,179,183,323,397,22,1700,438
1601,21,3.2.326,0,621,1,98,326,424,321,5,424,462,0,112,572,3,4,188,183,303,397,22,1700,438
1601,22,0.2.415,0,632,1,29,415,444,415,0,444,462,-33,145,605,3,5,71,127,207,397,23,1700,382
1601,22,1.3.382,1,588,0,65,382,447,382,0,447,462,-39,256,611,4,4,123,138,323,264,23,1700,382
1601,22,3.2.382,0,588,0,98,382,480,321,61,480,480,0,112,572,3,5,188,127,303,397,23,1700,382
1601,23,0.2.415,0,632,1,29,415,444,415,0,444,462,-33,145,644,3,5,71,127,207,397,24,1700,317
1601,23,1.4.462,1,588,0,58,462,520,447,15,520,520,0,191,611,5,4,58,117,323,388,24,1700,317
1601,23,3.2.382,0,588,0,98,382,480,321,61,480,480,0,112,611,3,5,188,127,303,397,24,1700,317
1601,24,0.2.415,0,632,1,29,415,444,415,0,444,520,-33,145,644,3,5,71,127,207,397,25,1700,259
1601,24,3.2.382,1,588,0,98,382,480,321,61,480,520,0,112,611,3,5,188,127,303,397,25,1700,259
1601,25,0.2.480,0,588,0,29,480,509,415,65,509,520,0,112,611,3,6,71,29,207,397,26,1700,161
1601,25,3.3.480,1,588,0,49,480,529,480,0,529,529,-33,289,644,4,5,90,73,303,264,26,1700,161
1601,26,0.2.480,0,588,0,29,480,509,415,65,509,529,0,112,644,3,6,71,29,207,397,27,1700,112
1601,26,3.4.529,1,588,0,41,529,570,529,0,570,570,-9,200,653,5,5,41,59,303,388,27,1700,112
1601,27,0.2.480,1,588,0,29,480,509,415,65,509,570,0,112,653,3,6,71,29,207,397,28,1700,71
1601,28,0.3.529,1,588,0,24,529,553,509,20,553,570,0,289,653,4,6,42,24,207,264,29,1700,42
1601,29,0.4.570,1,588,0,18,570,588,553,17,588,588,0,200,653,5,6,18,18,207,388,30,1700,18
1602,0,0.0.0,0,633,1,55,0,55,0,0,55,55,0,0,0,1,1,250,304,250,304,1,1669,1669
1602,0,1.0.0,0,634,2,61,0,61,0,0,61,61,0,0,0,1,1,224,304,224,304,1,1669,1669
1602,0,2.0.0,0,634,2,50,0,50,0,0,50,50,0,0,0,1,1,266,304,266,304,1,1669,1669
1602,0,3.0.0,0,608,0,36,0,36,0,0,36,36,0,0,0,1,1,264,304,264,304,1,1669,1669
1602,0,4.0.0,1,644,3,36,0,36,0,0,36,36,0,0,0,1,1,317,304,317,304,1,1669,1669
1602,0,5.0.0,0,669,4,66,0,66,0,0,66,66,0,0,0,1,1,348,304,348,304,1,1669,1669
1602,1,0.0.36,0,669,2,55,36,91,0,36,91,91,0,0,0,1,2,250,268,250,304,2,1669,1633
1602,1,1.0.36,0,654,1,61,36,97,0,36,97,97,0,0,0,1,2,224,268,224,304,2,1669,1633
1602,1,2.0.36,0,670,3,50,36,86,0,36,86,86,0,0,0,1,2,266,268,266,304,2,1669,1633
1602,1,3.0.36,1,644,0,36,36,72,0,36,72,72,0,0,0,1,2,264,268,264,304,2,1669,1633
1602,1,4.1.36,0,654,1,82,36,118,36,0,118,118,-36,36,36,2,1,281,365,317,365,2,1669,1633
1602,1,5.0.36,0,674,4,66,36,102,0,36,102,102,0,0,0,1,2,348,268,348,304,2,1669,1633
1602,2,0.0.72,0,644,0,55,72,127,0,72,127,127,0,0,0,1,3,250,232,250,304,3,1669,1597
1602,2,1.0.72,0,662,2,61,72,133,0,72,133,133,0,0,0,1,3,224,232,224,304,3,1669,1597
1602,2,2.0.72,0,647,1,50,72,122,0,72,122,122,0,0,0,1,3,266,232,266,304,3,1669,1597
1602,2,3.1.72,0,644,0,71,72,143,72,0,143,143,-72,72,72,2,1,228,365,264,365,3,1669,1597
1602,2,4.1.36,0,669,3,82,36,118,36,0,118,118,-36,36,36,2,1,281,365,317,365,3,1669,1597
1602,2,5.0.72,1,671,4,66,72,138,0,72,138,138,0,0,0,1,3,348,232,348,304,3,1669,1597
1602,3,0.0.138,0,671,0,55,138,193,0,138,193,193,0,0,0,1,4,250,166,250,304,4,1669,1531
1602,3,1.0.138,0,671,0,61,138,199,0,138,199,199,0,0,0,1,4,224,166,224,304,4,1669,1531
1602,3,2.0.138,1,671,0,50,138,188,0,138,188,188,0,0,0,1,4,266,166,266,304,4,1669,1531
1602,3,3.1.72,0,671,0,71,72,143,72,0,143,143,-72,72,72,2,1,228,365,264,365,4,1669,1531
1602,3,4.1.36,0,674,1,82,36,118,36,0,118,138,-36,36,36,2,1,281,365,317,365,4,1669,1531
1602,3,5.1.138,0,681,2,81,138,219,138,0,219,219,-138,138,138,2,1,282,365,348,365,4,1669,1531
1602,4,0.0.188,1,671,0,55,188,243,0,188,243,243,0,0,0,1,5,250,116,250,304,5,1669,1481
1602,4,1.0.188,0,671,0,61,188,249,0,188,249,249,0,0,0,1,5,224,116,224,304,5,1669,1481
1602,4,2.1.188,0,698,3,41,188,229,188,0,229,229,-188,188,188,2,1,216,365,266,365,5,1669,1481
1602,4,3.1.72,0,671,0,71,72,143,72,0,143,188,-72,72,72,2,1,228,365,264,365,5,1669,1481
1602,4,4.1.36,0,674,1,82,36,118,36,0,118,188,-36,36,36,2,1,281,365,317,365,5,1669,1481
1602,4,5.1.138,0,688,2,81,138,219,138,0,219,219,-138,138,138,2,1,282,365,348,365,5,1669,1481
1602,5,0.1.243,0,671,0,63,243,306,243,0,306,306,-243,243,243,2,1,195,365,250,365,6,1669,1426
1602,5,1.0.243,1,671,0,61,243,304,0,243,304,304,0,0,0,1,6,224,61,224,304,6,1669,1426
1602,5,2.1.188,0,698,3,41,188,229,188,0,229,243,-188,188,188,2,1,216,365,266,365,6,1669,1426
1602,5,3.1.72,0,671,0,71,72,143,72,0,143,243,-72,72,72,2,1,228,365,264,365,6,1669,1426
1602,5,4.1.36,0,674,1,82,36,118,36,0,118,243,-36,36,36,2,1,281,365,317,365,6,1669,1426
1602,5,5.1.138,0,688,2,81,138,219,138,0,219,243,-138,138,138,2,1,282,365,348,365,6,1669,1426
1602,6,0.1.243,0,671,0,63,243,306,243,0,306,306,-243,243,243,2,1,195,365,250,365,7,1669,1365
1602,6,1.1.304,0,674,1,27,304,331,304,0,331,331,-304,304,304,2,1,163,365,224,365,7,1669,1365
1602,6,2.1.188,0,698,3,41,188,229,188,0,229,304,-188,188,188,2,1,216,365,266,365,7,1669,1365
1602,6,3.1.72,0,671,0,71,72,143,72,0,143,304,-72,72,72,2,1,228,365,264,365,7,1669,1365
1602,6,4.1.36,1,674,1,82,36,118,36,0,118,304,-36,36,36,2,1,281,365,317,365,7,1669,1365
1602,6,5.1.138,0,688,2,81,138,219,138,0,219,304,-138,138,138,2,1,282,365,348,365,7,1669,1365
1602,7,0.1.243,0,674,0,63,243,306,243,0,306,306,-125,161,161,2,2,195,283,250,365,8,1669,1283
1602,7,1.1.304,0,674,0,27,304,331,304,0,331,331,-186,222,222,2,2,163,283,224,365,8,1669,1283
1602,7,2.1.188,0,712,2,41,188,229,188,0,229,304,-70,106,106,2,2,216,283,266,365,8,1669,1283
1602,7,3.1.118,1,674,0,71,118,189,72,46,189,304,0,36,36,2,2,228,283,264,365,8,1669,1283
1602,7,4.2.118,0,674,0,80,118,198,118,0,198,304,-118,118,154,3,1,199,365,317,365,8,1669,1283
1602,7,5.1.138,0,688,1,81,138,219,138,0,219,304,-20,56,56,2,2,282,283,348,365,8,1669,1283
1602,8,0.1.243,0,674,0,63,243,306,243,0,306,306,-54,90,90,2,3,195,212,250,365,9,1669,1212
1602,8,1.1.304,0,674,0,27,304,331,304,0,331,331,-115,151,151,2,3,163,212,224,365,9,1669,1212
1602,8,2.1.189,0,674,0,41,189,230,188,1,230,304,0,36,36,2,3,216,212,266,365,9,1669,1212
1602,8,3.2.189,0,703,1,66,189,255,189,0,255,304,-189,189,225,3,1,157,365,264,365,9,1669,1212
1602,8,4.2.118,0,674,0,80,118,198,118,0,198,304,-118,118,154,3,1,199,365,317,365,9,1669,1212
1602,8,5.1.189,1,674,0,81,189,270,138,51,270,304,0,36,36,2,3,282,212,348,365,9,1669,1212
1602,9,0.1.270,0,674,0,63,270,333,243,27,333,333,0,36,36,2,4,195,131,250,365,10,1669,1131
1602,9,1.1.304,0,674,0,27,304,331,304,0,331,331,-34,70,70,2,4,163,131,224,365,10,1669,1131
1602,9,2.1.270,1,674,0,41,270,311,188,82,311,311,0,36,36,2,4,216,131,266,365,10,1669,1131
1602,9,3.2.189,0,717,1,66,189,255,189,0,255,304,-189,189,225,3,1,157,365,264,365,10,1669,1131
1602,9,4.2.118,0,674,0,80,118,198,118,0,198,304,-118,118,154,3,1,199,365,317,365,10,1669,1131
1602,9,5.2.270,0,674,0,85,270,355,270,0,355,355,-270,270,306,3,1,201,365,348,365,10,1669,1131
1602,10,0.1.311,0,674,0,63,311,374,243,68,374,374,0,36,36,2,5,195,90,250,365,11,1669,1090
1602,10,1.1.311,1,674,0,27,311,338,304,7,338,338,0,36,36,2,5,163,90,224,365,11,1669,1090
1602,10,2.2.311,0,696,1,41,311,352,311,0,352,352,-311,311,347,3,1,175,365,266,365,11,1669,1090
1602,10,3.2.189,0,717,2,66,189,255,189,0,255,311,-189,189,225,3,1,157,365,264,365,11,1669,1090
1602,10,4.2.118,0,674,0,80,118,198,118,0,198,311,-118,118,154,3,1,199,365,317,365,11,1669,1090
1602,10,5.2.270,0,674,0,85,270,355,270,0,355,355,-270,270,306,3,1,201,365,348,365,11,1669,1090
1602,11,0.1.338,1,674,0,63,338,401,243,95,401,401,0,36,36,2,6,195,63,250,365,12,1669,1063
1602,11,1.2.338,0,693,1,61,338,399,338,0,399,399,-338,338,374,3,1,136,365,224,365,12,1669,1063
1602,11,2.2.311,0,696,2,41,311,352,311,0,352,352,-311,311,347,3,1,175,365,266,365,12,1669,1063
1602,11,3.2.189,0,717,3,66,189,255,189,0,255,338,-189,189,225,3,1,157,365,264,365,12,1669,1063
1602,11,4.2.118,0,674,0,80,118,198,118,0,198,338,-118,118,154,3,1,199,365,317,365,12,1669,1063
1602,11,5.2.270,0,674,0,85,270,355,270,0,355,355,-270,270,306,3,1,201,365,348,365,12,1669,1063
1602,12,0.2.401,0,674,0,32,401,433,401,0,433,433,-401,401,437,3,1,132,365,250,365,13,1669,1000
1602,12,1.2.338,0,693,1,61,338,399,338,0,399,401,-338,338,374,3,1,136,365,224,365,13,1669,1000
1602,12,2.2.311,0,696,2,41,311,352,311,0,352,401,-311,311,347,3,1,175,365,266,365,13,1669,1000
1602,12,3.2.189,0,717,3,66,189,255,189,0,255,401,-189,189,225,3,1,157,365,264,365,13,1669,1000
1602,12,4.2.118,1,674,0,80,118,198,118,0,198,401,-118,118,154,3,1,199,365,317,365,13,1669,1000
1602,12,5.2.270,0,674,0,85,270,355,270,0,355,401,-270,270,306,3,1,201,365,348,365,13,1669,1000
1602,13,0.2.401,0,674,0,32,401,433,401,0,433,433,-203,321,357,3,2,132,285,250,365,14,1669,920
1602,13,1.2.338,0,693,1,61,338,399,338,0,399,401,-140,258,294,3,2,136,285,224,365,14,1669,920
1602,13,2.2.311,0,696,2,41,311,352,311,0,352,401,-113,231,267,3,2,175,285,266,365,14,1669,920
1602,13,3.2.198,0,674,0,66,198,264,189,9,264,401,0,118,154,3,2,157,285,264,365,14,1669,920
1602,13,4.3.198,1,674,0,59,198,257,198,0,257,401,-198,198,352,4,1,119,218,317,218,14,1669,920
1602,13,5.2.270,0,674,0,85,270,355,270,0,355,401,-72,190,226,3,2,201,285,348,365,14,1669,920
1602,14,0.2.401,0,674,0,32,401,433,401,0,433,433,-203,321,555,3,2,132,285,250,365,15,1669,861
1602,14,1.2.338,0,693,1,61,338,399,338,0,399,401,-140,258,492,3,2,136,285,224,365,15,1669,861
1602,14,2.2.311,0,696,2,41,311,352,311,0,352,401,-113,231,465,3,2,175,285,266,365,15,1669,861
1602,14,3.2.198,0,674,0,66,198,264,189,9,264,401,0,118,352,3,2,157,285,264,365,15,1669,861
1602,14,4.4.257,1,674,0,60,257,317,257,0,317,401,-257,257,609,5,1,60,417,317,417,15,1669,861
1602,14,5.2.270,0,674,0,85,270,355,270,0,355,401,-72,190,424,3,2,201,285,348,365,15,1669,861
1602,15,0.2.401,0,674,0,32,401,433,401,0,433,433,-203,321,812,3,2,132,285,250,365,16,1669,801
1602,15,1.2.338,0,693,1,61,338,399,338,0,399,401,-140,258,749,3,2,136,285,224,365,16,1669,801
1602,15,2.2.311,0,696,2,41,311,352,311,0,352,401,-113,231,722,3,2,175,285,266,365,16,1669,801
1602,15,3.2.198,1,674,0,66,198,264,189,9,264,401,0,118,609,3,2,157,285,264,365,16,1669,801
1602,15,5.2.270,0,674,0,85,270,355,270,0,355,401,-72,190,681,3,2,201,285,348,365,16,1669,801
1602,16,0.2.401,0,674,0,32,401,433,401,0,433,433,-137,255,746,3,3,132,219,250,365,17,1669,735
1602,16,1.2.338,0,693,1,61,338,399,338,0,399,401,-74,192,683,3,3,136,219,224,365,17,1669,735
1602,16,2.2.311,0,696,2,41,311,352,311,0,352,401,-47,165,656,3,3,175,219,266,365,17,1669,735
1602,16,3.3.264,1,674,0,9,264,273,264,0,273,401,-7,205,616,4,2,91,159,264,218,17,1669,735
1602,16,5.2.270,0,674,0,85,270,355,270,0,355,401,-6,124,615,3,3,201,219,348,365,17,1669,735
1602,17,0.2.401,0,674,0,32,401,433,401,0,433,433,-137,255,753,3,3,132,219,250,365,18,1669,726
1602,17,1.2.338,0,693,1,61,338,399,338,0,399,401,-74,192,690,3,3,136,219,224,365,18,1669,726
1602,17,2.2.311,0,696,2,41,311,352,311,0,352,401,-47,165,663,3,3,175,219,266,365,18,1669,726
1602,17,3.4.317,0,674,0,82,317,399,273,44,399,401,0,257,616,5,2,82,357,264,417,18,1669,726
1602,17,5.2.270,1,674,0,85,270,355,270,0,355,401,-6,124,622,3,3,201,219,348,365,18,1669,726
1602,18,0.2.401,0,674,0,32,401,433,401,0,433,433,-46,170,668,3,4,132,134,250,365,19,1669,641
1602,18,1.2.355,0,674,0,61,355,416,338,17,416,416,0,124,622,3,4,136,134,224,365,19,1669,641
1602,18,2.2.355,0,674,0,41,355,396,311,44,396,401,0,124,622,3,4,175,134,266,365,19,1669,641
1602,18,3.4.317,0,674,0,82,317,399,273,44,399,401,0,257,622,5,2,82,357,264,417,19,1669,641
1602,18,5.3.355,1,674,0,27,355,382,355,0,382,401,-82,287,704,4,3,116,150,348,218,19,1669,641
1602,19,0.2.401,0,674,0,32,401,433,401,0,433,433,-46,170,750,3,4,132,134,250,365,20,1669,614
1602,19,1.2.355,0,674,0,61,355,416,338,17,416,416,0,124,704,3,4,136,134,224,365,20,1669,614
1602,19,2.2.355,1,674,0,41,355,396,311,44,396,401,0,124,704,3,4,175,134,266,365,20,1669,614
1602,19,3.4.317,0,674,0,82,317,399,273,44,399,401,0,257,704,5,2,82,357,264,417,20,1669,614
1602,19,5.4.382,0,739,1,89,382,471,382,0,471,471,-65,322,769,5,2,89,357,348,417,20,1669,614
1602,20,0.2.401,1,674,0,32,401,433,401,0,433,433,-5,129,709,3,5,132,93,250,365,21,1669,573
1602,20,1.2.396,0,674,0,61,396,457,338,58,457,457,0,124,704,3,5,136,93,224,365,21,1669,573
1602,20,2.3.396,0,674,0,85,396,481,396,0,481,481,-14,301,718,4,4,134,123,266,218,21,1669,573
1602,20,3.4.317,0,674,0,82,317,399,273,44,399,401,0,257,704,5,2,82,357,264,417,21,1669,573
1602,20,5.4.382,0,739,1,89,382,471,382,0,471,471,-65,322,769,5,2,89,357,348,417,21,1669,573
1602,21,0.3.433,1,674,0,30,433,463,433,0,463,463,-51,338,760,4,4,100,123,250,218,22,1669,541
1602,21,1.2.433,0,674,0,61,433,494,338,95,494,494,0,129,709,3,6,136,61,224,365,22,1669,541
1602,21,2.3.396,0,674,0,85,396,481,396,0,481,481,-14,301,723,4,4,134,123,266,218,22,1669,541
1602,21,3.4.317,0,674,0,82,317,399,273,44,399,433,0,257,709,5,2,82,357,264,417,22,1669,541
1602,21,5.4.382,0,739,1,89,382,471,382,0,471,471,-65,322,774,5,2,89,357,348,417,22,1669,541
1602,22,0.4.463,0,738,1,70,463,533,463,0,533,533,-146,403,906,5,2,70,357,250,417,23,1669,511
1602,22,1.2.433,1,674,0,61,433,494,338,95,494,494,0,129,760,3,6,136,61,224,365,23,1669,511
1602,22,2.3.463,0,674,0,85,463,548,396,67,548,548,0,338,760,4,5,134,93,266,218,23,1669,511
1602,22,3.4.317,0,674,0,82,317,399,273,44,399,463,0,257,760,5,2,82,357,264,417,23,1669,511
1602,22,5.4.382,0,739,2,89,382,471,382,0,471,471,-65,322,825,5,2,89,357,348,417,23,1669,511
1602,23,0.4.463,0,738,1,70,463,533,463,0,533,533,-146,403,906,5,2,70,357,250,417,24,1669,450
1602,23,1.3.494,1,674,0,8,494,502,494,0,502,502,-31,369,791,4,5,75,93,224,218,24,1669,450
1602,23,2.3.463,0,674,0,85,463,548,396,67,548,548,0,338,760,4,5,134,93,266,218,24,1669,450
1602,23,3.4.317,0,674,0,82,317,399,273,44,399,494,0,257,760,5,2,82,357,264,417,24,1669,450
1602,23,5.4.382,0,739,2,89,382,471,382,0,471,494,-65,322,825,5,2,89,357,348,417,24,1669,450
1602,24,0.4.463,0,738,2,70,463,533,463,0,533,533,-146,403,937,5,2,70,357,250,417,25,1669,442
1602,24,1.4.502,0,688,1,67,502,569,502,0,569,569,-185,442,976,5,2,67,357,224,417,25,1669,442
1602,24,2.3.502,1,674,0,85,502,587,396,106,587,587,0,369,791,4,6,134,85,266,218,25,1669,442
1602,24,3.4.317,0,674,0,82,317,399,273,44,399,502,0,257,791,5,2,82,357,264,417,25,1669,442
1602,24,5.4.382,0,739,3,89,382,471,382,0,471,502,-65,322,856,5,2,89,357,348,417,25,1669,442
1602,25,0.4.463,0,738,3,70,463,533,463,0,533,587,-146,403,937,5,2,70,357,250,417,26,1669,357
1602,25,1.4.502,0,688,1,67,502,569,502,0,569,587,-185,442,976,5,2,67,357,224,417,26,1669,357
1602,25,2.4.587,0,703,2,49,587,636,587,0,636,636,-270,527,1061,5,2,49,357,266,417,26,1669,357
1602,25,3.4.317,1,674,0,82,317,399,273,44,399,587,0,257,791,5,2,82,357,264,417,26,1669,357
1602,25,5.4.382,0,739,4,89,382,471,382,0,471,587,-65,322,856,5,2,89,357,348,417,26,1669,357
1602,26,0.4.463,0,738,3,70,463,533,463,0,533,587,-64,321,855,5,3,70,275,250,417,27,1669,275
1602,26,1.4.502,0,688,1,67,502,569,502,0,569,587,-103,360,894,5,3,67,275,224,417,27,1669,275
1602,26,2.4.587,0,703,2,49,587,636,587,0,636,636,-188,445,979,5,3,49,275,266,417,27,1669,275
1602,26,5.4.399,1,674,0,89,399,488,382,17,488,587,0,257,791,5,3,89,275,348,417,27,1669,275
1602,27,0.4.488,1,674,0,70,488,558,463,25,558,587,0,257,791,5,4,70,186,250,417,28,1669,186
1602,27,1.4.502,0,688,1,67,502,569,502,0,569,587,-14,271,805,5,4,67,186,224,417,28,1669,186
1602,27,2.4.587,0,703,2,49,587,636,587,0,636,636,-99,356,890,5,4,49,186,266,417,28,1669,186
1602,28,1.4.558,1,674,0,67,558,625,502,56,625,625,0,257,791,5,5,67,116,224,417,29,1669,116
1602,28,2.4.587,0,703,1,49,587,636,587,0,636,636,-29,286,820,5,5,49,116,266,417,29,1669,116
1602,29,2.4.625,1,674,0,49,625,674,587,38,674,674,0,257,791,5,6,49,49,266,417,30,1669,49
1603,0,0.0.0,0,590,3,68,0,68,0,0,68,68,0,0,0,1,1,195,417,195,417,1,1542,1542
1603,0,1.0.0,1,567,1,37,0,37,0,0,37,37,0,0,0,1,1,324,417,324,417,1,1542,1542
1603,0,2.0.0,0,577,2,95,0,95,0,0,95,95,0,0,0,1,1,292,417,292,417,1,1542,1542
1603,0,3.0.0,0,592,5,89,0,89,0,0,89,89,0,0,0,1,1,223,417,223,417,1,1542,1542
1603,0,4.0.0,0,545,0,58,0,58,0,0,58,58,0,0,0,1,1,257,417,257,417,1,1542,1542
1603,0,5.0.0,0,591,4,70,0,70,0,0,70,70,0,0,0,1,1,251,417,251,417,1,1542,1542
1603,1,0.0.37,0,581,3,68,37,105,0,37,105,105,0,0,0,1,2,195,380,195,417,2,1542,1505
1603,1,1.1.37,1,567,0,94,37,131,37,0,131,131,-37,37,37,2,1,287,270,324,270,2,1542,1505
1603,1,2.0.37,0,576,1,95,37,132,0,37,132,132,0,0,0,1,2,292,380,292,417,2,1542,1505
1603,1,3.0.37,0,567,0,89,37,126,0,37,126,126,0,0,0,1,2,223,380,223,417,2,1542,1505
1603,1,4.0.37,0,567,0,58,37,95,0,37,95,95,0,0,0,1,2,257,380,257,417,2,1542,1505
1603,1,5.0.37,0,577,2,70,37,107,0,37,107,107,0,0,0,1,2,251,380,251,417,2,1542,1505
1603,2,0.0.37,0,581,3,68,37,105,0,37,105,131,0,0,37,1,2,195,380,195,417,3,1542,1411
1603,2,1.2.131,1,567,0,67,131,198,131,0,198,198,-131,131,168,3,1,193,335,324,335,3,1542,1411
1603,2,2.0.37,0,576,1,95,37,132,0,37,132,132,0,0,37,1,2,292,380,292,417,3,1542,1411
1603,2,3.0.37,0,567,0,89,37,126,0,37,126,131,0,0,37,1,2,223,380,223,417,3,1542,1411
1603,2,4.0.37,0,567,0,58,37,95,0,37,95,131,0,0,37,1,2,257,380,257,417,3,1542,1411
1603,2,5.0.37,0,577,2,70,37,107,0,37,107,131,0,0,37,1,2,251,380,251,417,3,1542,1411
1603,3,0.0.37,0,581,3,68,37,105,0,37,105,198,0,0,168,1,2,195,380,195,417,4,1542,1344
1603,3,1.3.198,1,567,0,49,198,247,198,0,247,247,-198,198,366,4,1,126,271,324,271,4,1542,1344
1603,3,2.0.37,0,576,1,95,37,132,0,37,132,198,0,0,168,1,2,292,380,292,417,4,1542,1344
1603,3,3.0.37,0,567,0,89,37,126,0,37,126,198,0,0,168,1,2,223,380,223,417,4,1542,1344
1603,3,4.0.37,0,567,0,58,37,95,0,37,95,198,0,0,168,1,2,257,380,257,417,4,1542,1344
1603,3,5.0.37,0,577,2,70,37,107,0,37,107,198,0,0,168,1,2,251,380,251,417,4,1542,1344
1603,4,0.0.37,0,581,3,68,37,105,0,37,105,247,0,0,366,1,2,195,380,195,417,5,1542,1295
1603,4,1.4.247,1,567,0,77,247,324,247,0,324,324,-247,247,613,5,1,77,249,324,249,5,1542,1295
1603,4,2.0.37,0,576,1,95,37,132,0,37,132,247,0,0,366,1,2,292,380,292,417,5,1542,1295
1603,4,3.0.37,0,567,0,89,37,126,0,37,126,247,0,0,366,1,2,223,380,223,417,5,1542,1295
1603,4,4.0.37,0,567,0,58,37,95,0,37,95,247,0,0,366,1,2,257,380,257,417,5,1542,1295
1603,4,5.0.37,0,577,2,70,37,107,0,37,107,247,0,0,366,1,2,251,380,251,417,5,1542,1295
1603,5,0.0.37,0,581,3,68,37,105,0,37,105,324,0,0,613,1,2,195,380,195,417,6,1542,1218
1603,5,2.0.37,0,576,1,95,37,132,0,37,132,324,0,0,613,1,2,292,380,292,417,6,1542,1218
1603,5,3.0.37,0,567,0,89,37,126,0,37,126,324,0,0,613,1,2,223,380,223,417,6,1542,1218
1603,5,4.0.37,1,567,0,58,37,95,0,37,95,324,0,0,613,1,2,257,380,257,417,6,1542,1218
1603,5,5.0.37,0,577,2,70,37,107,0,37,107,324,0,0,613,1,2,251,380,251,417,6,1542,1218
1603,6,0.0.95,0,581,3,68,95,163,0,95,163,324,0,0,613,1,3,195,322,195,417,7,1542,1160
1603,6,2.0.95,0,568,1,95,95,190,0,95,190,324,0,0,613,1,3,292,322,292,417,7,1542,1160
1603,6,3.0.95,0,567,0,89,95,184,0,95,184,324,0,0,613,1,3,223,322,223,417,7,1542,1160
1603,6,4.1.131,1,567,0,35,131,166,95,36,166,324,0,37,613,2,2,199,176,257,270,7,1542,1160
1603,6,5.0.95,0,578,2,70,95,165,0,95,165,324,0,0,613,1,3,251,322,251,417,7,1542,1160
1603,7,0.0.95,0,581,3,68,95,163,0,95,163,324,0,0,613,1,3,195,322,195,417,8,1542,1125
1603,7,2.0.95,0,568,1,95,95,190,0,95,190,324,0,0,613,1,3,292,322,292,417,8,1542,1125
1603,7,3.0.95,0,567,0,89,95,184,0,95,184,324,0,0,613,1,3,223,322,223,417,8,1542,1125
1603,7,4.2.198,1,567,0,81,198,279,166,32,279,324,0,131,613,3,2,164,268,257,335,8,1542,1125
1603,7,5.0.95,0,578,2,70,95,165,0,95,165,324,0,0,613,1,3,251,322,251,417,8,1542,1125
1603,8,0.0.95,0,581,3,68,95,163,0,95,163,324,0,0,613,1,3,195,322,195,417,9,1542,1044
1603,8,2.0.95,0,568,1,95,95,190,0,95,190,324,0,0,613,1,3,292,322,292,417,9,1542,1044
1603,8,3.0.95,0,567,0,89,95,184,0,95,184,324,0,0,613,1,3,223,322,223,417,9,1542,1044
1603,8,4.3.279,1,567,0,52,279,331,279,0,331,331,-32,230,645,4,2,83,222,257,271,9,1542,1044
1603,8,5.0.95,0,578,2,70,95,165,0,95,165,324,0,0,613,1,3,251,322,251,417,9,1542,1044
1603,9,0.0.95,0,581,3,68,95,163,0,95,163,331,0,0,645,1,3,195,322,195,417,10,1542,992
1603,9,2.0.95,0,568,1,95,95,190,0,95,190,331,0,0,645,1,3,292,322,292,417,10,1542,992
1603,9,3.0.95,0,567,0,89,95,184,0,95,184,331,0,0,645,1,3,223,322,223,417,10,1542,992
1603,9,4.4.331,1,567,0,31,331,362,331,0,362,362,-7,254,652,5,2,31,172,257,249,10,1542,992
1603,9,5.0.95,0,578,2,70,95,165,0,95,165,331,0,0,645,1,3,251,322,251,417,10,1542,992
1603,10,0.0.95,0,581,3,68,95,163,0,95,163,362,0,0,652,1,3,195,322,195,417,11,1542,961
1603,10,2.0.95,0,568,1,95,95,190,0,95,190,362,0,0,652,1,3,292,322,292,417,11,1542,961
1603,10,3.0.95,0,567,0,89,95,184,0,95,184,362,0,0,652,1,3,223,322,223,417,11,1542,961
1603,10,5.0.95,1,578,2,70,95,165,0,95,165,362,0,0,652,1,3,251,322,251,417,11,1542,961
1603,11,0.0.165,0,602,2,68,165,233,0,165,233,362,0,0,652,1,4,195,252,195,417,12,1542,891
1603,11,2.0.165,0,578,0,95,165,260,0,165,260,362,0,0,652,1,4,292,252,292,417,12,1542,891
1603,11,3.0.165,0,592,1,89,165,254,0,165,254,362,0,0,652,1,4,223,252,223,417,12,1542,891
1603,11,5.1.166,1,578,0,65,166,231,165,1,231,362,0,37,652,2,3,181,141,251,270,12,1542,891
1603,12,0.0.165,0,602,2,68,165,233,0,165,233,362,0,0,652,1,4,195,252,195,417,13,1542,826
1603,12,2.0.165,0,578,0,95,165,260,0,165,260,362,0,0,652,1,4,292,252,292,417,13,1542,826
1603,12,3.0.165,0,592,1,89,165,254,0,165,254,362,0,0,652,1,4,223,252,223,417,13,1542,826
1603,12,5.2.279,1,578,0,24,279,303,231,48,303,362,0,131,652,3,3,116,187,251,335,13,1542,826
1603,13,0.0.165,0,602,2,68,165,233,0,165,233,362,0,0,652,1,4,195,252,195,417,14,1542,802
1603,13,2.0.165,0,578,0,95,165,260,0,165,260,362,0,0,652,1,4,292,252,292,417,14,1542,802
1603,13,3.0.165,0,592,1,89,165,254,0,165,254,362,0,0,652,1,4,223,252,223,417,14,1542,802
1603,13,5.3.331,1,578,0,12,331,343,303,28,343,362,0,230,652,4,3,92,170,251,271,14,1542,802
1603,14,0.0.165,0,602,2,68,165,233,0,165,233,362,0,0,652,1,4,195,252,195,417,15,1542,790
1603,14,2.0.165,0,578,0,95,165,260,0,165,260,362,0,0,652,1,4,292,252,292,417,15,1542,790
1603,14,3.0.165,0,592,1,89,165,254,0,165,254,362,0,0,652,1,4,223,252,223,417,15,1542,790
1603,14,5.4.362,1,578,0,80,362,442,343,19,442,442,0,254,652,5,3,80,141,251,249,15,1542,790
1603,15,0.0.165,0,602,2,68,165,233,0,165,233,442,0,0,652,1,4,195,252,195,417,16,1542,710
1603,15,2.0.165,1,578,0,95,165,260,0,165,260,442,0,0,652,1,4,292,252,292,417,16,1542,710
1603,15,3.0.165,0,592,1,89,165,254,0,165,254,442,0,0,652,1,4,223,252,223,417,16,1542,710
1603,16,0.0.260,0,579,1,68,260,328,0,260,328,442,0,0,652,1,5,195,157,195,417,17,1542,615
1603,16,2.1.260,1,578,0,35,260,295,260,0,295,442,-29,66,681,2,4,197,76,292,270,17,1542,615
1603,16,3.0.260,0,578,0,89,260,349,0,260,349,442,0,0,652,1,5,223,157,223,417,17,1542,615
1603,17,0.0.260,0,579,1,68,260,328,0,260,328,442,0,0,681,1,5,195,157,195,417,18,1542,580
1603,17,2.2.303,1,578,0,94,303,397,295,8,397,442,0,131,681,3,4,162,163,292,335,18,1542,580
1603,17,3.0.260,0,578,0,89,260,349,0,260,349,442,0,0,681,1,5,223,157,223,417,18,1542,580
1603,18,0.0.260,0,579,1,68,260,328,0,260,328,442,0,0,681,1,5,195,157,195,417,19,1542,486
1603,18,2.3.397,1,578,0,54,397,451,397,0,451,451,-54,284,735,4,4,68,158,292,271,19,1542,486
1603,18,3.0.260,0,578,0,89,260,349,0,260,349,442,0,0,681,1,5,223,157,223,417,19,1542,486
1603,19,0.0.260,0,579,1,68,260,328,0,260,328,451,0,0,735,1,5,195,157,195,417,20,1542,432
1603,19,2.4.451,1,578,0,14,451,465,451,0,465,465,-9,263,744,5,4,14,61,292,249,20,1542,432
1603,19,3.0.260,0,578,0,89,260,349,0,260,349,451,0,0,735,1,5,223,157,223,417,20,1542,432
1603,20,0.0.260,1,579,1,68,260,328,0,260,328,465,0,0,744,1,5,195,157,195,417,21,1542,418
1603,20,3.0.260,0,578,0,89,260,349,0,260,349,465,0,0,744,1,5,223,157,223,417,21,1542,418
1603,21,0.1.328,1,579,0,31,328,359,328,0,359,465,-33,99,777,2,5,127,41,195,270,22,1542,350
1603,21,3.0.328,0,579,0,89,328,417,0,328,417,465,0,0,744,1,6,223,89,223,417,22,1542,350
1603,22,0.2.397,1,579,0,36,397,433,359,38,433,465,0,131,777,3,5,96,69,195,335,23,1542,319
1603,22,3.0.328,0,579,0,89,328,417,0,328,417,465,0,0,777,1,6,223,89,223,417,23,1542,319
1603,23,0.3.451,1,579,0,37,451,488,433,18,488,488,0,284,777,4,5,60,104,195,271,24,1542,283
1603,23,3.0.328,0,579,0,89,328,417,0,328,417,465,0,0,777,1,6,223,89,223,417,24,1542,283
1603,24,0.4.488,1,579,0,23,488,511,488,0,511,511,-23,286,800,5,5,23,47,195,249,25,1542,246
1603,24,3.0.328,0,579,0,89,328,417,0,328,417,488,0,0,777,1,6,223,89,223,417,25,1542,246
1603,25,3.0.328,1,579,0,89,328,417,0,328,417,511,0,0,800,1,6,223,89,223,417,26,1542,223
1603,26,3.1.417,1,579,0,10,417,427,417,0,427,511,-58,157,858,2,6,134,10,223,270,27,1542,134
1603,27,3.2.433,1,579,0,33,433,466,427,6,466,511,0,131,858,3,6,124,33,223,335,28,1542,124
1603,28,3.3.488,1,579,0,67,488,555,466,22,555,555,0,284,858,4,6,91,67,223,271,29,1542,91
1603,29,3.4.555,1,579,0,24,555,579,555,0,579,579,-44,330,902,5,6,24,24,223,249,30,1542,24
1604,0,0.0.0,0,665,4,81,0,81,0,0,81,81,0,0,0,1,1,338,330,338,330,1,1803,1803
1604,0,1.0.0,1,605,1,12,0,12,0,0,12,12,0,0,0,1,1,323,330,323,330,1,1803,1803
1604,0,2.0.0,0,593,0,41,0,41,0,0,41,41,0,0,0,1,1,218,330,218,330,1,1803,1803
1604,0,3.0.0,0,630,2,42,0,42,0,0,42,42,0,0,0,1,1,280,330,280,330,1,1803,1803
1604,0,4.0.0,0,672,5,79,0,79,0,0,79,79,0,0,0,1,1,292,330,292,330,1,1803,1803
1604,0,5.0.0,0,650,3,75,0,75,0,0,75,75,0,0,0,1,1,352,330,352,330,1,1803,1803
1604,1,0.0.12,0,615,2,81,12,93,0,12,93,93,0,0,0,1,2,338,318,338,330,2,1803,1791
1604,1,1.1.12,1,606,1,63,12,75,12,0,75,75,-12,12,12,2,1,311,371,323,371,2,1803,1791
1604,1,2.0.12,0,605,0,41,12,53,0,12,53,53,0,0,0,1,2,218,318,218,330,2,1803,1791
1604,1,3.0.12,0,606,1,42,12,54,0,12,54,54,0,0,0,1,2,280,318,280,330,2,1803,1791
1604,1,4.0.12,0,626,3,79,12,91,0,12,91,91,0,0,0,1,2,292,318,292,330,2,1803,1791
1604,1,5.0.12,0,615,2,75,12,87,0,12,87,87,0,0,0,1,2,352,318,352,330,2,1803,1791
1604,2,0.0.12,0,615,1,81,12,93,0,12,93,93,0,0,12,1,2,338,318,338,330,3,1803,1728
1604,2,1.2.75,0,606,0,72,75,147,75,0,147,147,-75,75,87,3,1,248,400,323,400,3,1803,1728
1604,2,2.0.12,0,606,0,41,12,53,0,12,53,75,0,0,12,1,2,218,318,218,330,3,1803,1728
1604,2,3.0.12,1,606,0,42,12,54,0,12,54,75,0,0,12,1,2,280,318,280,330,3,1803,1728
1604,2,4.0.12,0,626,2,79,12,91,0,12,91,91,0,0,12,1,2,292,318,292,330,3,1803,1728
1604,2,5.0.12,0,615,1,75,12,87,0,12,87,87,0,0,12,1,2,352,318,352,330,3,1803,1728
1604,3,0.0.54,0,615,2,81,54,135,0,54,135,135,0,0,12,1,3,338,276,338,330,4,1803,1686
1604,3,1.2.75,0,606,0,72,75,147,75,0,147,147,-75,75,87,3,1,248,400,323,400,4,1803,1686
1604,3,2.0.54,0,606,0,41,54,95,0,54,95,95,0,0,12,1,3,218,276,218,330,4,1803,1686
1604,3,3.1.75,0,610,1,48,75,123,54,21,123,123,0,12,12,2,2,238,308,280,371,4,1803,1686
1604,3,4.0.54,0,615,2,79,54,133,0,54,133,133,0,0,12,1,3,292,276,292,330,4,1803,1686
1604,3,5.0.54,1,615,2,75,54,129,0,54,129,129,0,0,12,1,3,352,276,352,330,4,1803,1686
1604,4,0.0.129,0,618,1,81,129,210,0,129,210,210,0,0,12,1,4,338,201,338,330,5,1803,1611
1604,4,1.2.75,0,615,0,72,75,147,75,0,147,147,-75,75,87,3,1,248,400,323,400,5,1803,1611
1604,4,2.0.129,1,615,0,41,129,170,0,129,170,170,0,0,12,1,4,218,201,218,330,5,1803,1611
1604,4,3.1.75,0,615,0,48,75,123,54,21,123,129,0,12,12,2,2,238,308,280,371,5,1803,1611
1604,4,4.0.129,0,622,2,79,129,208,0,129,208,208,0,0,12,1,4,292,201,292,330,5,1803,1611
1604,4,5.1.129,0,615,0,48,129,177,129,0,177,177,-54,66,66,2,2,277,308,352,371,5,1803,1611
1604,5,0.0.170,1,615,0,81,170,251,0,170,251,251,0,0,12,1,5,338,160,338,330,6,1803,1570
1604,5,1.2.75,0,615,0,72,75,147,75,0,147,170,-75,75,87,3,1,248,400,323,400,6,1803,1570
1604,5,2.1.170,0,615,0,28,170,198,170,0,198,198,-95,107,107,2,2,177,308,218,371,6,1803,1570
1604,5,3.1.75,0,615,0,48,75,123,54,21,123,170,0,12,12,2,2,238,308,280,371,6,1803,1570
1604,5,4.0.170,0,615,0,79,170,249,0,170,249,249,0,0,12,1,5,292,160,292,330,6,1803,1570
1604,5,5.1.129,0,615,0,48,129,177,129,0,177,177,-54,66,66,2,2,277,308,352,371,6,1803,1570
1604,6,0.1.251,0,615,0,98,251,349,251,0,349,349,-176,188,188,2,2,257,308,338,371,7,1803,1489
1604,6,1.2.75,0,615,0,72,75,147,75,0,147,251,-75,75,87,3,1,248,400,323,400,7,1803,1489
1604,6,2.1.170,0,615,0,28,170,198,170,0,198,251,-95,107,107,2,2,177,308,218,371,7,1803,1489
1604,6,3.1.75,0,615,0,48,75,123,54,21,123,251,0,12,12,2,2,238,308,280,371,7,1803,1489
1604,6,4.0.251,1,615,0,79,251,330,0,251,330,330,0,0,12,1,6,292,79,292,330,7,1803,1489
1604,6,5.1.129,0,615,0,48,129,177,129,0,177,251,-54,66,66,2,2,277,308,352,371,7,1803,1489
1604,7,0.1.251,0,615,0,98,251,349,251,0,349,349,-176,188,188,2,2,257,308,338,371,8,1803,1410
1604,7,1.2.75,0,615,0,72,75,147,75,0,147,330,-75,75,87,3,1,248,400,323,400,8,1803,1410
1604,7,2.1.170,0,615,0,28,170,198,170,0,198,330,-95,107,107,2,2,177,308,218,371,8,1803,1410
1604,7,3.1.75,1,615,0,48,75,123,54,21,123,330,0,12,12,2,2,238,308,280,371,8,1803,1410
1604,7,4.1.330,0,673,1,86,330,416,330,0,416,416,-255,267,267,2,2,213,308,292,371,8,1803,1410
1604,7,5.1.129,0,615,0,48,129,177,129,0,177,330,-54,66,66,2,2,277,308,352,371,8,1803,1410
1604,8,0.1.251,0,615,0,98,251,349,251,0,349,349,-128,140,140,2,3,257,260,338,371,9,1803,1362
1604,8,1.2.75,0,615,0,72,75,147,75,0,147,330,-75,75,87,3,1,248,400,323,400,9,1803,1362
1604,8,2.1.170,0,615,0,28,170,198,170,0,198,330,-47,59,59,2,3,177,260,218,371,9,1803,1362
1604,8,3.2.123,0,661,1,99,123,222,123,0,222,330,-123,123,135,3,1,190,400,280,400,9,1803,1362
1604,8,4.1.330,0,673,2,86,330,416,330,0,416,416,-207,219,219,2,3,213,260,292,371,9,1803,1362
1604,8,5.1.129,1,615,0,48,129,177,129,0,177,330,-6,18,18,2,3,277,260,352,371,9,1803,1362
1604,9,0.1.251,0,615,0,98,251,349,251,0,349,349,-74,92,92,2,4,257,212,338,371,10,1803,1314
1604,9,1.2.75,0,615,0,72,75,147,75,0,147,330,-75,75,93,3,1,248,400,323,400,10,1803,1314
1604,9,2.1.177,1,615,0,28,177,205,170,7,205,330,0,18,18,2,4,177,212,218,371,10,1803,1314
1604,9,3.2.123,0,661,2,99,123,222,123,0,222,330,-123,123,141,3,1,190,400,280,400,10,1803,1314
1604,9,4.1.330,0,673,3,86,330,416,330,0,416,416,-153,171,171,2,4,213,212,292,371,10,1803,1314
1604,9,5.2.177,0,618,1,62,177,239,177,0,239,330,-177,177,195,3,1,229,400,352,400,10,1803,1314
1604,10,0.1.251,1,615,0,98,251,349,251,0,349,349,-46,64,64,2,5,257,184,338,371,11,1803,1286
1604,10,1.2.75,0,615,0,72,75,147,75,0,147,330,-75,75,93,3,1,248,400,323,400,11,1803,1286
1604,10,2.2.205,0,620,2,47,205,252,205,0,252,330,-205,205,223,3,1,149,400,218,400,11,1803,1286
1604,10,3.2.123,0,661,3,99,123,222,123,0,222,330,-123,123,141,3,1,190,400,280,400,11,1803,1286
1604,10,4.1.330,0,673,4,86,330,416,330,0,416,416,-125,143,143,2,5,213,184,292,371,11,1803,1286
1604,10,5.2.177,0,618,1,62,177,239,177,0,239,330,-177,177,195,3,1,229,400,352,400,11,1803,1286
1604,11,0.2.349,0,618,1,39,349,388,349,0,388,388,-349,349,413,3,1,159,400,338,400,12,1803,1188
1604,11,1.2.75,0,615,0,72,75,147,75,0,147,349,-75,75,139,3,1,248,400,323,400,12,1803,1188
1604,11,2.2.205,0,620,2,47,205,252,205,0,252,349,-205,205,269,3,1,149,400,218,400,12,1803,1188
1604,11,3.2.123,0,661,3,99,123,222,123,0,222,349,-123,123,187,3,1,190,400,280,400,12,1803,1188
1604,11,4.1.349,1,615,0,86,349,435,330,19,435,435,0,64,64,2,6,213,86,292,371,12,1803,1188
1604,11,5.2.177,0,618,1,62,177,239,177,0,239,349,-177,177,241,3,1,229,400,352,400,12,1803,1188
1604,12,0.2.349,0,618,1,39,349,388,349,0,388,435,-349,349,413,3,1,159,400,338,400,13,1803,1102
1604,12,1.2.75,1,615,0,72,75,147,75,0,147,435,-75,75,139,3,1,248,400,323,400,13,1803,1102
1604,12,2.2.205,0,620,2,47,205,252,205,0,252,435,-205,205,269,3,1,149,400,218,400,13,1803,1102
1604,12,3.2.123,0,661,3,99,123,222,123,0,222,435,-123,123,187,3,1,190,400,280,400,13,1803,1102
1604,12,4.2.435,0,615,0,81,435,516,435,0,516,516,-435,435,499,3,1,127,400,292,400,13,1803,1102
1604,12,5.2.177,0,618,1,62,177,239,177,0,239,435,-177,177,241,3,1,229,400,352,400,13,1803,1102
1604,13,0.2.349,0,618,1,39,349,388,349,0,388,435,-202,277,341,3,2,159,328,338,400,14,1803,1030
1604,13,1.3.147,1,615,0,90,147,237,147,0,237,435,-147,147,286,4,1,176,324,323,324,14,1803,1030
1604,13,2.2.205,0,620,2,47,205,252,205,0,252,435,-58,133,197,3,2,149,328,218,400,14,1803,1030
1604,13,3.2.147,0,615,0,99,147,246,123,24,246,435,0,75,139,3,2,190,328,280,400,14,1803,1030
1604,13,4.2.435,0,615,0,81,435,516,435,0,516,516,-288,363,427,3,2,127,328,292,400,14,1803,1030
1604,13,5.2.177,0,618,1,62,177,239,177,0,239,435,-30,105,169,3,2,229,328,352,400,14,1803,1030
1604,14,0.2.349,0,618,1,39,349,388,349,0,388,435,-202,277,488,3,2,159,328,338,400,15,1803,940
1604,14,1.4.237,1,615,0,86,237,323,237,0,323,435,-237,237,523,5,1,86,378,323,378,15,1803,940
1604,14,2.2.205,0,620,2,47,205,252,205,0,252,435,-58,133,344,3,2,149,328,218,400,15,1803,940
1604,14,3.2.147,0,615,0,99,147,246,123,24,246,435,0,75,286,3,2,190,328,280,400,15,1803,940
1604,14,4.2.435,0,615,0,81,435,516,435,0,516,516,-288,363,574,3,2,127,328,292,400,15,1803,940
1604,14,5.2.177,0,618,1,62,177,239,177,0,239,435,-30,105,316,3,2,229,328,352,400,15,1803,940
1604,15,0.2.349,0,618,1,39,349,388,349,0,388,435,-202,277,725,3,2,159,328,338,400,16,1803,854
1604,15,2.2.205,0,620,2,47,205,252,205,0,252,435,-58,133,581,3,2,149,328,218,400,16,1803,854
1604,15,3.2.147,0,615,0,99,147,246,123,24,246,435,0,75,523,3,2,190,328,280,400,16,1803,854
1604,15,4.2.435,0,615,0,81,435,516,435,0,516,516,-288,363,811,3,2,127,328,292,400,16,1803,854
1604,15,5.2.177,1,618,1,62,177,239,177,0,239,435,-30,105,553,3,2,229,328,352,400,16,1803,854
1604,16,0.2.349,0,618,0,39,349,388,349,0,388,435,-110,215,663,3,3,159,266,338,400,17,1803,792
1604,16,2.2.239,0,618,0,47,239,286,205,34,286,435,0,105,553,3,3,149,266,218,400,17,1803,792
1604,16,3.2.239,0,627,1,99,239,338,123,116,338,435,0,105,553,3,3,190,266,280,400,17,1803,792
1604,16,4.2.435,0,618,0,81,435,516,435,0,516,516,-196,301,749,3,3,127,266,292,400,17,1803,792
1604,16,5.3.239,1,627,1,96,239,335,239,0,335,435,-2,149,555,4,2,167,234,352,324,17,1803,792
1604,17,0.2.349,0,627,0,39,349,388,349,0,388,435,-110,215,665,3,3,159,266,338,400,18,1803,696
1604,17,2.2.239,0,627,0,47,239,286,205,34,286,435,0,105,555,3,3,149,266,218,400,18,1803,696
1604,17,3.2.239,0,627,0,99,239,338,123,116,338,435,0,105,555,3,3,190,266,280,400,18,1803,696
1604,17,4.2.435,0,627,0,81,435,516,435,0,516,516,-196,301,751,3,3,127,266,292,400,18,1803,696
1604,17,5.4.335,1,627,0,71,335,406,335,0,406,435,-12,249,567,5,2,71,292,352,378,18,1803,696
1604,18,0.2.349,0,627,0,39,349,388,349,0,388,435,-110,215,677,3,3,159,266,338,400,19,1803,625
1604,18,2.2.239,0,627,0,47,239,286,205,34,286,435,0,105,567,3,3,149,266,218,400,19,1803,625
1604,18,3.2.239,1,627,0,99,239,338,123,116,338,435,0,105,567,3,3,190,266,280,400,19,1803,625
1604,18,4.2.435,0,627,0,81,435,516,435,0,516,516,-196,301,763,3,3,127,266,292,400,19,1803,625
1604,19,0.2.349,0,627,0,39,349,388,349,0,388,435,-11,116,578,3,4,159,167,338,400,20,1803,526
1604,19,2.2.338,0,627,0,47,338,385,205,133,385,435,0,105,567,3,4,149,167,218,400,20,1803,526
1604,19,3.3.338,1,627,0,26,338,364,338,0,364,435,-3,152,570,4,3,91,138,280,324,20,1803,526
1604,19,4.2.435,0,627,0,81,435,516,435,0,516,516,-97,202,664,3,4,127,167,292,400,20,1803,526
1604,20,0.2.349,0,627,0,39,349,388,349,0,388,435,-11,116,581,3,4,159,167,338,400,21,1803,500
1604,20,2.2.338,1,627,0,47,338,385,205,133,385,435,0,105,570,3,4,149,167,218,400,21,1803,500
1604,20,3.4.406,0,627,0,65,406,471,364,42,471,471,0,249,570,5,3,65,221,280,378,21,1803,500
1604,20,4.2.435,0,627,0,81,435,516,435,0,516,516,-97,202,667,3,4,127,167,292,400,21,1803,500
1604,21,0.2.385,0,627,0,39,385,424,349,36,424,435,0,105,570,3,5,159,120,338,400,22,1803,453
1604,21,2.3.385,1,627,0,23,385,408,385,0,408,435,-21,173,591,4,4,102,112,218,324,22,1803,453
1604,21,3.4.406,0,627,0,65,406,471,364,42,471,471,0,249,570,5,3,65,221,280,378,22,1803,453
1604,21,4.2.435,0,627,0,81,435,516,435,0,516,516,-50,155,620,3,5,127,120,292,400,22,1803,453
1604,22,0.2.385,1,627,0,39,385,424,349,36,424,435,0,105,591,3,5,159,120,338,400,23,1803,430
1604,22,2.4.408,0,629,1,79,408,487,408,0,487,487,-2,251,593,5,3,79,221,218,378,23,1803,430
1604,22,3.4.406,0,627,0,65,406,471,364,42,471,471,0,249,591,5,3,65,221,280,378,23,1803,430
1604,22,4.2.435,0,627,0,81,435,516,435,0,516,516,-50,155,641,3,5,127,120,292,400,23,1803,430
1604,23,0.3.424,1,627,0,44,424,468,424,0,468,468,-16,189,607,4,5,120,89,338,324,24,1803,391
1604,23,2.4.408,0,629,1,79,408,487,408,0,487,487,-2,251,593,5,3,79,221,218,378,24,1803,391
1604,23,3.4.406,0,627,0,65,406,471,364,42,471,471,0,249,591,5,3,65,221,280,378,24,1803,391
1604,23,4.2.435,0,627,0,81,435,516,435,0,516,516,-11,116,602,3,6,127,81,292,400,24,1803,391
1604,24,0.4.468,0,689,2,76,468,544,468,0,544,544,-62,311,669,5,3,76,221,338,378,25,1803,347
1604,24,2.4.408,0,629,1,79,408,487,408,0,487,487,-2,251,609,5,3,79,221,218,378,25,1803,347
1604,24,3.4.406,1,627,0,65,406,471,364,42,471,471,0,249,607,5,3,65,221,280,378,25,1803,347
1604,24,4.2.435,0,627,0,81,435,516,435,0,516,516,-11,116,618,3,6,127,81,292,400,25,1803,347
1604,25,0.4.471,1,627,0,76,471,547,468,3,547,547,0,249,607,5,4,76,156,338,378,26,1803,282
1604,25,2.4.471,0,627,0,79,471,550,408,63,550,550,0,249,607,5,4,79,156,218,378,26,1803,282
1604,25,4.2.435,0,627,0,81,435,516,435,0,516,516,-11,116,618,3,6,127,81,292,400,26,1803,282
1604,26,2.4.547,1,627,0,79,547,626,408,139,626,626,0,249,607,5,5,79,80,218,378,27,1803,206
1604,26,4.2.435,0,627,0,81,435,516,435,0,516,547,-11,116,618,3,6,127,81,292,400,27,1803,206
1604,27,4.2.435,1,627,0,81,435,516,435,0,516,626,-11,116,618,3,6,127,81,292,400,28,1803,127
1604,28,4.3.516,1,627,0,45,516,561,516,0,561,626,-48,237,666,4,6,46,45,292,324,29,1803,46
1604,29,4.4.626,1,627,0,1,626,627,561,65,627,627,0,249,666,5,6,1,1,292,378,30,1803,1
1605,0,0.0.0,0,650,1,94,0,94,0,0,94,94,0,0,0,1,1,281,445,281,445,1,1676,1676
1605,0,1.0.0,0,632,0,87,0,87,0,0,87,87,0,0,0,1,1,323,445,323,445,1,1676,1676
1605,0,2.0.0,0,632,0,87,0,87,0,0,87,87,0,0,0,1,1,246,445,246,445,1,1676,1676
1605,0,3.0.0,0,632,0,95,0,95,0,0,95,95,0,0,0,1,1,339,445,339,445,1,1676,1676
1605,0,4.0.0,1,632,0,2,0,2,0,0,2,2,0,0,0,1,1,231,445,231,445,1,1676,1676
1605,0,5.0.0,0,632,0,80,0,80,0,0,80,80,0,0,0,1,1,256,445,256,445,1,1676,1676
1605,1,0.0.2,0,647,1,94,2,96,0,2,96,96,0,0,0,1,2,281,443,281,445,2,1676,1674
1605,1,1.0.2,0,632,0,87,2,89,0,2,89,89,0,0,0,1,2,323,443,323,445,2,1676,1674
1605,1,2.0.2,0,632,0,87,2,89,0,2,89,89,0,0,0,1,2,246,443,246,445,2,1676,1674
1605,1,3.0.2,0,632,0,95,2,97,0,2,97,97,0,0,0,1,2,339,443,339,445,2,1676,1674
1605,1,4.1.2,1,632,0,39,2,41,2,0,41,41,-2,2,2,2,1,229,275,231,275,2,1676,1674
1605,1,5.0.2,0,632,0,80,2,82,0,2,82,82,0,0,0,1,2,256,443,256,445,2,1676,1674
1605,2,0.0.2,0,647,1,94,2,96,0,2,96,96,0,0,2,1,2,281,443,281,445,3,1676,1635
1605,2,1.0.2,0,632,0,87,2,89,0,2,89,89,0,0,2,1,2,323,443,323,445,3,1676,1635
1605,2,2.0.2,0,632,0,87,2,89,0,2,89,89,0,0,2,1,2,246,443,246,445,3,1676,1635
1605,2,3.0.2,0,632,0,95,2,97,0,2,97,97,0,0,2,1,2,339,443,339,445,3,1676,1635
1605,2,4.2.41,1,632,0,82,41,123,41,0,123,123,-41,41,43,3,1,190,270,231,270,3,1676,1635
1605,2,5.0.2,0,632,0,80,2,82,0,2,82,82,0,0,2,1,2,256,443,256,445,3,1676,1635
1605,3,0.0.2,0,647,1,94,2,96,0,2,96,123,0,0,43,1,2,281,443,281,445,4,1676,1553
1605,3,1.0.2,0,632,0,87,2,89,0,2,89,123,0,0,43,1,2,323,443,323,445,4,1676,1553
1605,3,2.0.2,0,632,0,87,2,89,0,2,89,123,0,0,43,1,2,246,443,246,445,4,1676,1553
1605,3,3.0.2,0,632,0,95,2,97,0,2,97,123,0,0,43,1,2,339,443,339,445,4,1676,1553
1605,3,4.3.123,1,632,0,38,123,161,123,0,161,161,-123,123,166,4,1,108,377,231,377,4,1676,1553
1605,3,5.0.2,0,632,0,80,2,82,0,2,82,123,0,0,43,1,2,256,443,256,445,4,1676,1553
1605,4,0.0.2,0,647,1,94,2,96,0,2,96,161,0,0,166,1,2,281,443,281,445,5,1676,1515
1605,4,1.0.2,0,632,0,87,2,89,0,2,89,161,0,0,166,1,2,323,443,323,445,5,1676,1515
1605,4,2.0.2,0,632,0,87,2,89,0,2,89,161,0,0,166,1,2,246,443,246,445,5,1676,1515
1605,4,3.0.2,0,632,0,95,2,97,0,2,97,161,0,0,166,1,2,339,443,339,445,5,1676,1515
1605,4,4.4.161,1,632,0,70,161,231,161,0,231,231,-161,161,327,5,1,70,309,231,309,5,1676,1515
1605,4,5.0.2,0,632,0,80,2,82,0,2,82,161,0,0,166,1,2,256,443,256,445,5,1676,1515
1605,5,0.0.2,0,647,1,94,2,96,0,2,96,231,0,0,327,1,2,281,443,281,445,6,1676,1445
1605,5,1.0.2,1,632,0,87,2,89,0,2,89,231,0,0,327,1,2,323,443,323,445,6,1676,1445
1605,5,2.0.2,0,632,0,87,2,89,0,2,89,231,0,0,327,1,2,246,443,246,445,6,1676,1445
1605,5,3.0.2,0,632,0,95,2,97,0,2,97,231,0,0,327,1,2,339,443,339,445,6,1676,1445
1605,5,5.0.2,0,632,0,80,2,82,0,2,82,231,0,0,327,1,2,256,443,256,445,6,1676,1445
1605,6,0.0.89,0,650,2,94,89,183,0,89,183,231,0,0,327,1,3,281,356,281,445,7,1676,1358
1605,6,1.1.89,1,632,0,31,89,120,89,0,120,231,-48,50,375,2,2,236,236,323,275,7,1676,1358
1605,6,2.0.89,0,633,1,87,89,176,0,89,176,231,0,0,327,1,3,246,356,246,445,7,1676,1358
1605,6,3.0.89,0,632,0,95,89,184,0,89,184,231,0,0,327,1,3,339,356,339,445,7,1676,1358
1605,6,5.0.89,0,632,0,80,89,169,0,89,169,231,0,0,327,1,3,256,356,256,445,7,1676,1358
1605,7,0.0.89,0,650,2,94,89,183,0,89,183,231,0,0,375,1,3,281,356,281,445,8,1676,1327
1605,7,1.2.123,1,632,0,77,123,200,120,3,200,231,0,41,375,3,2,205,188,323,270,8,1676,1327
1605,7,2.0.89,0,633,1,87,89,176,0,89,176,231,0,0,375,1,3,246,356,246,445,8,1676,1327
1605,7,3.0.89,0,632,0,95,89,184,0,89,184,231,0,0,375,1,3,339,356,339,445,8,1676,1327
1605,7,5.0.89,0,632,0,80,89,169,0,89,169,231,0,0,375,1,3,256,356,256,445,8,1676,1327
1605,8,0.0.89,0,650,2,94,89,183,0,89,183,231,0,0,375,1,3,281,356,281,445,9,1676,1250
1605,8,1.3.200,1,632,0,33,200,233,200,0,233,233,-39,162,414,4,2,128,339,323,377,9,1676,1250
1605,8,2.0.89,0,633,1,87,89,176,0,89,176,231,0,0,375,1,3,246,356,246,445,9,1676,1250
1605,8,3.0.89,0,632,0,95,89,184,0,89,184,231,0,0,375,1,3,339,356,339,445,9,1676,1250
1605,8,5.0.89,0,632,0,80,89,169,0,89,169,231,0,0,375,1,3,256,356,256,445,9,1676,1250
1605,9,0.0.89,0,650,2,94,89,183,0,89,183,233,0,0,414,1,3,281,356,281,445,10,1676,1217
1605,9,1.4.233,1,632,0,95,233,328,233,0,328,328,-2,163,416,5,2,95,239,323,309,10,1676,1217
1605,9,2.0.89,0,633,1,87,89,176,0,89,176,233,0,0,414,1,3,246,356,246,445,10,1676,1217
1605,9,3.0.89,0,632,0,95,89,184,0,89,184,233,0,0,414,1,3,339,356,339,445,10,1676,1217
1605,9,5.0.89,0,632,0,80,89,169,0,89,169,233,0,0,414,1,3,256,356,256,445,10,1676,1217
1605,10,0.0.89,0,650,2,94,89,183,0,89,183,328,0,0,416,1,3,281,356,281,445,11,1676,1122
1605,10,2.0.89,0,633,1,87,89,176,0,89,176,328,0,0,416,1,3,246,356,246,445,11,1676,1122
1605,10,3.0.89,1,632,0,95,89,184,0,89,184,328,0,0,416,1,3,339,356,339,445,11,1676,1122
1605,10,5.0.89,0,632,0,80,89,169,0,89,169,328,0,0,416,1,3,256,356,256,445,11,1676,1122
1605,11,0.0.184,0,672,2,94,184,278,0,184,278,328,0,0,416,1,4,281,261,281,445,12,1676,1027
1605,11,2.0.184,0,632,0,87,184,271,0,184,271,328,0,0,416,1,4,246,261,246,445,12,1676,1027
1605,11,3.1.184,1,632,0,86,184,270,184,0,270,328,-64,114,480,2,3,244,205,339,275,12,1676,1027
1605,11,5.0.184,0,637,1,80,184,264,0,184,264,328,0,0,416,1,4,256,261,256,445,12,1676,1027
1605,12,0.0.184,0,672,2,94,184,278,0,184,278,328,0,0,480,1,4,281,261,281,445,13,1676,941
1605,12,2.0.184,0,632,0,87,184,271,0,184,271,328,0,0,480,1,4,246,261,246,445,13,1676,941
1605,12,3.2.270,1,672,2,67,270,337,270,0,337,337,-70,111,550,3,3,158,111,339,270,13,1676,941
1605,12,5.0.184,0,637,1,80,184,264,0,184,264,328,0,0,480,1,4,256,261,256,445,13,1676,941
1605,13,0.0.184,0,672,0,94,184,278,0,184,278,337,0,0,550,1,4,281,261,281,445,14,1676,874
1605,13,2.0.184,0,672,0,87,184,271,0,184,271,337,0,0,550,1,4,246,261,246,445,14,1676,874
1605,13,3.3.337,0,672,0,84,337,421,337,0,421,421,-104,266,654,4,3,91,306,339,377,14,1676,874
1605,13,5.0.184,1,672,0,80,184,264,0,184,264,337,0,0,550,1,4,256,261,256,445,14,1676,874
1605,14,0.0.264,0,672,0,94,264,358,0,264,358,358,0,0,550,1,5,281,181,281,445,15,1676,794
1605,14,2.0.264,0,672,0,87,264,351,0,264,351,351,0,0,550,1,5,246,181,246,445,15,1676,794
1605,14,3.3.337,0,672,0,84,337,421,337,0,421,421,-104,266,654,4,3,91,306,339,377,15,1676,794
1605,14,5.1.270,1,672,0,31,270,301,264,6,301,337,0,114,550,2,4,176,119,256,275,15,1676,794
1605,15,0.0.264,0,672,0,94,264,358,0,264,358,358,0,0,550,1,5,281,181,281,445,16,1676,763
1605,15,2.0.264,0,672,0,87,264,351,0,264,351,351,0,0,550,1,5,246,181,246,445,16,1676,763
1605,15,3.3.337,0,672,0,84,337,421,337,0,421,421,-104,266,654,4,3,91,306,339,377,16,1676,763
1605,15,5.2.337,1,672,0,1,337,338,301,36,338,338,0,111,550,3,4,145,44,256,270,16,1676,763
1605,16,0.0.264,1,672,0,94,264,358,0,264,358,358,0,0,550,1,5,281,181,281,445,17,1676,762
1605,16,2.0.264,0,672,0,87,264,351,0,264,351,351,0,0,550,1,5,246,181,246,445,17,1676,762
1605,16,3.3.337,0,672,0,84,337,421,337,0,421,421,-104,266,654,4,3,91,306,339,377,17,1676,762
1605,16,5.3.338,0,673,1,81,338,419,338,0,419,419,-105,267,655,4,3,144,306,256,377,17,1676,762
1605,17,0.1.358,0,672,0,66,358,424,358,0,424,424,-57,171,607,2,5,187,88,281,275,18,1676,668
1605,17,2.0.358,1,672,0,87,358,445,0,358,445,445,0,0,550,1,6,246,87,246,445,18,1676,668
1605,17,3.3.337,0,672,0,84,337,421,337,0,421,421,-104,266,654,4,3,91,306,339,377,18,1676,668
1605,17,5.3.338,0,673,1,81,338,419,338,0,419,419,-105,267,655,4,3,144,306,256,377,18,1676,668
1605,18,0.1.358,1,672,0,66,358,424,358,0,424,445,-57,171,607,2,5,187,88,281,275,19,1676,581
1605,18,2.1.445,0,672,0,22,445,467,445,0,467,467,-144,258,694,2,5,159,88,246,275,19,1676,581
1605,18,3.3.337,0,672,0,84,337,421,337,0,421,445,-104,266,654,4,3,91,306,339,377,19,1676,581
1605,18,5.3.338,0,673,1,81,338,419,338,0,419,445,-105,267,655,4,3,144,306,256,377,19,1676,581
1605,19,0.2.424,1,672,0,42,424,466,424,0,466,466,-86,197,693,3,5,121,43,281,270,20,1676,515
1605,19,2.1.445,0,672,0,22,445,467,445,0,467,467,-21,192,628,2,6,159,22,246,275,20,1676,515
1605,19,3.3.337,0,672,0,84,337,421,337,0,421,445,-104,266,711,4,3,91,306,339,377,20,1676,515
1605,19,5.3.338,0,673,1,81,338,419,338,0,419,445,-105,267,712,4,3,144,306,256,377,20,1676,515
1605,20,0.3.466,0,698,2,50,466,516,466,0,516,516,-233,395,926,4,3,79,306,281,377,21,1676,473
1605,20,2.1.445,1,672,0,22,445,467,445,0,467,467,-21,192,714,2,6,159,22,246,275,21,1676,473
1605,20,3.3.337,0,672,0,84,337,421,337,0,421,466,-104,266,797,4,3,91,306,339,377,21,1676,473
1605,20,5.3.338,0,673,1,81,338,419,338,0,419,466,-105,267,798,4,3,144,306,256,377,21,1676,473
1605,21,0.3.466,0,698,2,50,466,516,466,0,516,516,-233,395,947,4,3,79,306,281,377,22,1676,451
1605,21,2.2.467,1,672,0,1,467,468,467,0,468,468,-1,198,715,3,6,137,1,246,270,22,1676,451
1605,21,3.3.337,0,672,0,84,337,421,337,0,421,467,-104,266,818,4,3,91,306,339,377,22,1676,451
1605,21,5.3.338,0,673,1,81,338,419,338,0,419,467,-105,267,819,4,3,144,306,256,377,22,1676,451
1605,22,0.3.466,0,698,2,50,466,516,466,0,516,516,-233,395,948,4,3,79,306,281,377,23,1676,450
1605,22,2.3.468,0,700,3,91,468,559,468,0,559,559,-235,397,950,4,3,136,306,246,377,23,1676,450
1605,22,3.3.337,1,672,0,84,337,421,337,0,421,468,-104,266,819,4,3,91,306,339,377,23,1676,450
1605,22,5.3.338,0,673,1,81,338,419,338,0,419,468,-105,267,820,4,3,144,306,256,377,23,1676,450
1605,23,0.3.466,0,733,2,50,466,516,466,0,516,516,-45,311,864,4,4,79,222,281,377,24,1676,366
1605,23,2.3.468,0,732,1,91,468,559,468,0,559,559,-47,313,866,4,4,136,222,246,377,24,1676,366
1605,23,3.4.421,1,672,0,7,421,428,421,0,428,468,-93,256,912,5,3,7,144,339,309,24,1676,366
1605,23,5.3.421,0,672,0,81,421,502,338,83,502,502,0,266,819,4,4,144,222,256,377,24,1676,366
1605,24,0.3.466,0,733,2,50,466,516,466,0,516,516,-45,311,957,4,4,79,222,281,377,25,1676,359
1605,24,2.3.468,0,732,1,91,468,559,468,0,559,559,-47,313,959,4,4,136,222,246,377,25,1676,359
1605,24,5.3.421,1,672,0,81,421,502,338,83,502,502,0,266,912,4,4,144,222,256,377,25,1676,359
1605,25,0.3.502,0,688,1,50,502,552,466,36,552,552,0,266,912,4,5,79,141,281,377,26,1676,278
1605,25,2.3.502,0,672,0,91,502,593,468,34,593,593,0,266,912,4,5,136,141,246,377,26,1676,278
1605,25,5.4.502,1,672,0,63,502,565,502,0,565,565,-74,330,986,5,4,63,137,256,309,26,1676,278
1605,26,0.3.502,1,688,1,50,502,552,466,36,552,565,0,266,986,4,5,79,141,281,377,27,1676,215
1605,26,2.3.502,0,672,0,91,502,593,468,34,593,593,0,266,986,4,5,136,141,246,377,27,1676,215
1605,27,0.4.565,1,688,0,29,565,594,552,13,594,594,0,330,986,5,5,29,74,281,309,28,1676,165
1605,27,2.3.552,0,688,0,91,552,643,468,84,643,643,0,266,986,4,6,136,91,246,377,28,1676,165
1605,28,2.3.552,1,688,0,91,552,643,468,84,643,643,0,266,986,4,6,136,91,246,377,29,1676,136
1605,29,2.4.643,1,688,0,45,643,688,643,0,688,688,-49,379,1035,5,6,45,45,246,309,30,1676,45
1606,0,0.0.0,1,493,0,8,0,8,0,0,8,8,0,0,0,1,1,226,261,226,261,1,1448,1448
1606,0,1.0.0,0,536,5,63,0,63,0,0,63,63,0,0,0,1,1,323,261,323,261,1,1448,1448
1606,0,2.0.0,0,511,2,33,0,33,0,0,33,33,0,0,0,1,1,173,261,173,261,1,1448,1448
1606,0,3.0.0,0,521,3,49,0,49,0,0,49,49,0,0,0,1,1,201,261,201,261,1,1448,1448
1606,0,4.0.0,0,510,1,24,0,24,0,0,24,24,0,0,0,1,1,269,261,269,261,1,1448,1448
1606,0,5.0.0,0,524,4,84,0,84,0,0,84,84,0,0,0,1,1,256,261,256,261,1,1448,1448
1606,1,0.1.8,1,493,0,34,8,42,8,0,42,42,-8,8,8,2,1,218,277,226,277,2,1448,1440
1606,1,1.0.8,0,536,4,63,8,71,0,8,71,71,0,0,0,1,2,323,253,323,261,2,1448,1440
1606,1,2.0.8,0,493,0,33,8,41,0,8,41,41,0,0,0,1,2,173,253,173,261,2,1448,1440
1606,1,3.0.8,0,512,2,49,8,57,0,8,57,57,0,0,0,1,2,201,253,201,261,2,1448,1440
1606,1,4.0.8,0,506,1,24,8,32,0,8,32,32,0,0,0,1,2,269,253,269,261,2,1448,1440
1606,1,5.0.8,0,524,3,84,8,92,0,8,92,92,0,0,0,1,2,256,253,256,261,2,1448,1440
1606,2,0.2.42,0,493,0,46,42,88,42,0,88,88,-42,42,50,3,1,184,338,226,338,3,1448,1406
1606,2,1.0.8,0,536,4,63,8,71,0,8,71,71,0,0,8,1,2,323,253,323,261,3,1448,1406
1606,2,2.0.8,0,493,0,33,8,41,0,8,41,42,0,0,8,1,2,173,253,173,261,3,1448,1406
1606,2,3.0.8,0,512,2,49,8,57,0,8,57,57,0,0,8,1,2,201,253,201,261,3,1448,1406
1606,2,4.0.8,1,506,1,24,8,32,0,8,32,42,0,0,8,1,2,269,253,269,261,3,1448,1406
1606,2,5.0.8,0,524,3,84,8,92,0,8,92,92,0,0,8,1,2,256,253,256,261,3,1448,1406
1606,3,0.2.42,0,506,0,46,42,88,42,0,88,88,-42,42,50,3,1,184,338,226,338,4,1448,1382
1606,3,1.0.32,1,506,0,63,32,95,0,32,95,95,0,0,8,1,3,323,229,323,261,4,1448,1382
1606,3,2.0.32,0,506,0,33,32,65,0,32,65,65,0,0,8,1,3,173,229,173,261,4,1448,1382
1606,3,3.0.32,0,506,0,49,32,81,0,32,81,81,0,0,8,1,3,201,229,201,261,4,1448,1382
1606,3,4.1.42,0,506,0,90,42,132,32,10,132,132,0,8,8,2,2,245,243,269,277,4,1448,1382
1606,3,5.0.32,0,521,1,84,32,116,0,32,116,116,0,0,8,1,3,256,229,256,261,4,1448,1382
1606,4,0.2.42,0,506,0,46,42,88,42,0,88,95,-42,42,50,3,1,184,338,226,338,5,1448,1319
1606,4,1.1.95,0,565,3,98,95,193,95,0,193,193,-53,61,61,2,2,260,243,323,277,5,1448,1319
1606,4,2.0.95,1,515,1,33,95,128,0,95,128,128,0,0,8,1,4,173,166,173,261,5,1448,1319
1606,4,3.0.95,0,506,0,49,95,144,0,95,144,144,0,0,8,1,4,201,166,201,261,5,1448,1319
1606,4,4.1.42,0,506,0,90,42,132,32,10,132,132,0,8,8,2,2,245,243,269,277,5,1448,1319
1606,4,5.0.95,0,532,2,84,95,179,0,95,179,179,0,0,8,1,4,256,166,256,261,5,1448,1319
1606,5,0.2.42,0,515,0,46,42,88,42,0,88,128,-42,42,50,3,1,184,338,226,338,6,1448,1286
1606,5,1.1.95,0,568,3,98,95,193,95,0,193,193,-53,61,61,2,2,260,243,323,277,6,1448,1286
1606,5,2.1.128,0,552,2,16,128,144,128,0,144,144,-86,94,94,2,2,140,243,173,277,6,1448,1286
1606,5,3.0.128,1,515,0,49,128,177,0,128,177,177,0,0,8,1,5,201,133,201,261,6,1448,1286
1606,5,4.1.42,0,515,0,90,42,132,32,10,132,132,0,8,8,2,2,245,243,269,277,6,1448,1286
1606,5,5.0.128,0,516,1,84,128,212,0,128,212,212,0,0,8,1,5,256,133,256,261,6,1448,1286
1606,6,0.2.42,0,515,0,46,42,88,42,0,88,177,-42,42,50,3,1,184,338,226,338,7,1448,1237
1606,6,1.1.95,0,568,2,98,95,193,95,0,193,193,-53,61,61,2,2,260,243,323,277,7,1448,1237
1606,6,2.1.128,0,552,1,16,128,144,128,0,144,177,-86,94,94,2,2,140,243,173,277,7,1448,1237
1606,6,3.1.177,0,515,0,25,177,202,177,0,202,202,-135,143,143,2,2,152,243,201,277,7,1448,1237
1606,6,4.1.42,0,515,0,90,42,132,32,10,132,177,0,8,8,2,2,245,243,269,277,7,1448,1237
1606,6,5.0.177,1,515,0,84,177,261,0,177,261,261,0,0,8,1,6,256,84,256,261,7,1448,1237
1606,7,0.2.42,1,515,0,46,42,88,42,0,88,261,-42,42,50,3,1,184,338,226,338,8,1448,1153
1606,7,1.1.95,0,568,3,98,95,193,95,0,193,261,-53,61,61,2,2,260,243,323,277,8,1448,1153
1606,7,2.1.128,0,552,2,16,128,144,128,0,144,261,-86,94,94,2,2,140,243,173,277,8,1448,1153
1606,7,3.1.177,0,515,0,25,177,202,177,0,202,261,-135,143,143,2,2,152,243,201,277,8,1448,1153
1606,7,4.1.42,0,515,0,90,42,132,32,10,132,261,0,8,8,2,2,245,243,269,277,8,1448,1153
1606,7,5.1.261,0,516,1,14,261,275,261,0,275,275,-219,227,227,2,2,172,243,256,277,8,1448,1153
1606,8,0.3.88,1,515,0,57,88,145,88,0,145,261,-88,88,138,4,1,138,331,226,331,9,1448,1107
1606,8,1.1.95,0,568,3,98,95,193,95,0,193,261,-53,61,103,2,2,260,243,323,277,9,1448,1107
1606,8,2.1.128,0,552,2,16,128,144,128,0,144,261,-86,94,136,2,2,140,243,173,277,9,1448,1107
1606,8,3.1.177,0,515,0,25,177,202,177,0,202,261,-135,143,185,2,2,152,243,201,277,9,1448,1107
1606,8,4.1.42,0,515,0,90,42,132,32,10,132,261,0,8,50,2,2,245,243,269,277,9,1448,1107
1606,8,5.1.261,0,516,1,14,261,275,261,0,275,275,-219,227,269,2,2,172,243,256,277,9,1448,1107
1606,9,0.4.145,1,515,0,81,145,226,145,0,226,261,-145,145,283,5,1,81,241,226,241,10,1448,1050
1606,9,1.1.95,0,568,3,98,95,193,95,0,193,261,-53,61,191,2,2,260,243,323,277,10,1448,1050
1606,9,2.1.128,0,552,2,16,128,144,128,0,144,261,-86,94,224,2,2,140,243,173,277,10,1448,1050
1606,9,3.1.177,0,515,0,25,177,202,177,0,202,261,-135,143,273,2,2,152,243,201,277,10,1448,1050
1606,9,4.1.42,0,515,0,90,42,132,32,10,132,261,0,8,138,2,2,245,243,269,277,10,1448,1050
1606,9,5.1.261,0,516,1,14,261,275,261,0,275,275,-219,227,357,2,2,172,243,256,277,10,1448,1050
1606,10,1.1.95,0,568,3,98,95,193,95,0,193,261,-53,61,336,2,2,260,243,323,277,11,1448,969
1606,10,2.1.128,0,552,2,16,128,144,128,0,144,261,-86,94,369,2,2,140,243,173,277,11,1448,969
1606,10,3.1.177,0,515,0,25,177,202,177,0,202,261,-135,143,418,2,2,152,243,201,277,11,1448,969
1606,10,4.1.42,1,515,0,90,42,132,32,10,132,261,0,8,283,2,2,245,243,269,277,11,1448,969
1606,10,5.1.261,0,516,1,14,261,275,261,0,275,275,-219,227,502,2,2,172,243,256,277,11,1448,969
1606,11,1.1.132,0,543,2,98,132,230,95,37,230,261,0,8,283,2,3,260,153,323,277,12,1448,879
1606,11,2.1.132,1,515,0,16,132,148,128,4,148,261,0,8,283,2,3,140,153,173,277,12,1448,879
1606,11,3.1.177,0,515,0,25,177,202,177,0,202,261,-45,53,328,2,3,152,153,201,277,12,1448,879
1606,11,4.2.132,0,515,0,83,132,215,132,0,215,261,-44,86,327,3,2,155,292,269,338,12,1448,879
1606,11,5.1.261,0,516,1,14,261,275,261,0,275,275,-129,137,412,2,3,172,153,256,277,12,1448,879
1606,12,1.1.148,1,516,1,98,148,246,95,53,246,261,0,8,283,2,4,260,137,323,277,13,1448,863
1606,12,2.2.148,0,519,2,53,148,201,148,0,201,261,-60,102,343,3,2,124,292,173,338,13,1448,863
1606,12,3.1.177,0,515,0,25,177,202,177,0,202,261,-29,37,312,2,4,152,137,201,277,13,1448,863
1606,12,4.2.132,0,515,0,83,132,215,132,0,215,261,-44,86,327,3,2,155,292,269,338,13,1448,863
1606,12,5.1.261,0,516,1,14,261,275,261,0,275,275,-113,121,396,2,4,172,137,256,277,13,1448,863
1606,13,1.2.246,0,583,2,83,246,329,246,0,329,329,-158,200,441,3,2,162,292,323,338,14,1448,765
1606,13,2.2.148,0,519,1,53,148,201,148,0,201,261,-60,102,343,3,2,124,292,173,338,14,1448,765
1606,13,3.1.246,1,516,0,25,246,271,177,69,271,271,0,8,283,2,5,152,39,201,277,14,1448,765
1606,13,4.2.132,0,516,0,83,132,215,132,0,215,261,-44,86,327,3,2,155,292,269,338,14,1448,765
1606,13,5.1.261,0,516,0,14,261,275,261,0,275,275,-15,23,298,2,5,172,39,256,277,14,1448,765
1606,14,1.2.246,0,583,2,83,246,329,246,0,329,329,-158,200,441,3,2,162,292,323,338,15,1448,740
1606,14,2.2.148,0,519,1,53,148,201,148,0,201,271,-60,102,343,3,2,124,292,173,338,15,1448,740
1606,14,3.2.271,0,516,0,34,271,305,271,0,305,305,-183,225,466,3,2,127,292,201,338,15,1448,740
1606,14,4.2.132,0,516,0,83,132,215,132,0,215,271,-44,86,327,3,2,155,292,269,338,15,1448,740
1606,14,5.1.271,1,516,0,14,271,285,261,10,285,285,0,8,283,2,6,172,14,256,277,15,1448,740
1606,15,1.2.246,0,583,3,83,246,329,246,0,329,329,-158,200,441,3,2,162,292,323,338,16,1448,726
1606,15,2.2.148,0,519,1,53,148,201,148,0,201,285,-60,102,343,3,2,124,292,173,338,16,1448,726
1606,15,3.2.271,0,516,0,34,271,305,271,0,305,305,-183,225,466,3,2,127,292,201,338,16,1448,726
1606,15,4.2.132,1,516,0,83,132,215,132,0,215,285,-44,86,327,3,2,155,292,269,338,16,1448,726
1606,15,5.2.285,0,520,2,39,285,324,285,0,324,324,-197,239,480,3,2,158,292,256,338,16,1448,726
1606,16,1.2.246,0,583,2,83,246,329,246,0,329,329,-31,117,358,3,3,162,209,323,338,17,1448,643
1606,16,2.2.215,0,516,0,53,215,268,148,67,268,285,0,86,327,3,3,124,209,173,338,17,1448,643
1606,16,3.2.271,0,516,0,34,271,305,271,0,305,305,-56,142,383,3,3,127,209,201,338,17,1448,643
1606,16,4.3.215,1,516,0,31,215,246,215,0,246,285,-70,158,397,4,2,72,274,269,331,17,1448,643
1606,16,5.2.285,0,520,1,39,285,324,285,0,324,324,-70,156,397,3,3,158,209,256,338,17,1448,643
1606,17,1.2.246,0,583,2,83,246,329,246,0,329,329,-31,117,428,3,3,162,209,323,338,18,1448,612
1606,17,2.2.215,0,516,0,53,215,268,148,67,268,285,0,86,397,3,3,124,209,173,338,18,1448,612
1606,17,3.2.271,0,516,0,34,271,305,271,0,305,305,-56,142,453,3,3,127,209,201,338,18,1448,612
1606,17,4.4.246,1,516,0,41,246,287,246,0,287,287,-20,165,417,5,2,41,160,269,241,18,1448,612
1606,17,5.2.285,0,520,1,39,285,324,285,0,324,324,-70,156,467,3,3,158,209,256,338,18,1448,612
1606,18,1.2.246,0,583,2,83,246,329,246,0,329,329,-31,117,448,3,3,162,209,323,338,19,1448,571
1606,18,2.2.215,1,516,0,53,215,268,148,67,268,287,0,86,417,3,3,124,209,173,338,19,1448,571
1606,18,3.2.271,0,516,0,34,271,305,271,0,305,305,-56,142,473,3,3,127,209,201,338,19,1448,571
1606,18,5.2.285,0,520,1,39,285,324,285,0,324,324,-70,156,487,3,3,158,209,256,338,19,1448,571
1606,19,1.2.268,0,573,2,83,268,351,246,22,351,351,0,86,417,3,4,162,156,323,338,20,1448,518
1606,19,2.3.268,0,516,0,60,268,328,268,0,328,328,-22,180,439,4,3,71,243,173,331,20,1448,518
1606,19,3.2.271,1,516,0,34,271,305,271,0,305,305,-3,89,420,3,4,127,156,201,338,20,1448,518
1606,19,5.2.285,0,520,1,39,285,324,285,0,324,324,-17,103,434,3,4,158,156,256,338,20,1448,518
1606,20,1.2.305,0,571,2,83,305,388,246,59,388,388,0,89,420,3,5,162,122,323,338,21,1448,484
1606,20,2.3.268,0,516,0,60,268,328,268,0,328,328,-22,180,442,4,3,71,243,173,331,21,1448,484
1606,20,3.3.305,0,553,1,44,305,349,305,0,349,349,-59,217,479,4,3,93,243,201,331,21,1448,484
1606,20,5.2.305,1,516,0,39,305,344,285,20,344,344,0,89,420,3,5,158,122,256,338,21,1448,484
1606,21,1.2.344,1,516,0,83,344,427,246,98,427,427,0,89,420,3,6,162,83,323,338,22,1448,445
1606,21,2.3.268,0,516,0,60,268,328,268,0,328,344,-22,180,442,4,3,71,243,173,331,22,1448,445
1606,21,3.3.305,0,553,2,44,305,349,305,0,349,349,-59,217,479,4,3,93,243,201,331,22,1448,445
1606,21,5.3.344,0,532,1,65,344,409,344,0,409,409,-98,256,518,4,3,119,243,256,331,22,1448,445
1606,22,1.3.427,0,572,3,74,427,501,427,0,501,501,-181,339,601,4,3,79,243,323,331,23,1448,362
1606,22,2.3.268,0,516,0,60,268,328,268,0,328,427,-22,180,442,4,3,71,243,173,331,23,1448,362
1606,22,3.3.305,1,553,2,44,305,349,305,0,349,427,-59,217,479,4,3,93,243,201,331,23,1448,362
1606,22,5.3.344,0,532,1,65,344,409,344,0,409,427,-98,256,518,4,3,119,243,256,331,23,1448,362
1606,23,1.3.427,0,572,1,74,427,501,427,0,501,501,-78,295,557,4,4,79,199,323,331,24,1448,318
1606,23,2.3.349,0,553,0,60,349,409,268,81,409,427,0,217,479,4,4,71,199,173,331,24,1448,318
1606,23,3.4.349,1,553,0,49,349,398,349,0,398,427,-62,227,541,5,3,49,119,201,241,24,1448,318
1606,23,5.3.349,0,553,0,65,349,414,344,5,414,427,0,217,479,4,4,119,199,256,331,24,1448,318
1606,24,1.3.427,0,572,1,74,427,501,427,0,501,501,-78,295,619,4,4,79,199,323,331,25,1448,269
1606,24,2.3.349,1,553,0,60,349,409,268,81,409,427,0,217,541,4,4,71,199,173,331,25,1448,269
1606,24,5.3.349,0,553,0,65,349,414,344,5,414,427,0,217,541,4,4,119,199,256,331,25,1448,269
1606,25,1.3.427,0,620,1,74,427,501,427,0,501,501,-18,235,559,4,5,79,139,323,331,26,1448,209
1606,25,2.4.409,1,553,0,11,409,420,409,0,420,427,-11,238,552,5,4,11,70,173,241,26,1448,209
1606,25,5.3.409,0,553,0,65,409,474,344,65,474,474,0,217,541,4,5,119,139,256,331,26,1448,209
1606,26,1.3.427,0,620,1,74,427,501,427,0,501,501,-18,235,570,4,5,79,139,323,331,27,1448,198
1606,26,5.3.409,1,553,0,65,409,474,344,65,474,474,0,217,552,4,5,119,139,256,331,27,1448,198
1606,27,1.3.474,0,553,0,74,474,548,427,47,548,548,0,217,552,4,6,79,74,323,331,28,1448,133
1606,27,5.4.474,1,553,0,54,474,528,474,0,528,528,-54,292,606,5,5,54,59,256,241,28,1448,133
1606,28,1.3.474,1,553,0,74,474,548,427,47,548,548,0,217,606,4,6,79,74,323,331,29,1448,79
1606,29,1.4.548,1,553,0,5,548,553,548,0,553,553,-20,312,626,5,6,5,5,323,241,30,1448,5
1607,0,0.0.0,0,463,1,21,0,21,0,0,21,21,0,0,0,1,1,170,277,170,277,1,1320,1320
1607,0,1.0.0,0,481,3,39,0,39,0,0,39,39,0,0,0,1,1,223,277,223,277,1,1320,1320
1607,0,2.0.0,0,525,5,79,0,79,0,0,79,79,0,0,0,1,1,199,277,199,277,1,1320,1320
1607,0,3.0.0,1,462,0,3,0,3,0,0,3,3,0,0,0,1,1,161,277,161,277,1,1320,1320
1607,0,4.0.0,0,467,2,46,0,46,0,0,46,46,0,0,0,1,1,209,277,209,277,1,1320,1320
1607,0,5.0.0,0,510,4,89,0,89,0,0,89,89,0,0,0,1,1,358,277,358,277,1,1320,1320
1607,1,0.0.3,0,462,0,21,3,24,0,3,24,24,0,0,0,1,2,170,274,170,277,2,1320,1317
1607,1,1.0.3,0,462,0,39,3,42,0,3,42,42,0,0,0,1,2,223,274,223,277,2,1320,1317
1607,1,2.0.3,0,525,3,79,3,82,0,3,82,82,0,0,0,1,2,199,274,199,277,2,1320,1317
1607,1,3.1.3,1,462,0,63,3,66,3,0,66,66,-3,3,3,2,1,158,281,161,281,2,1320,1317
1607,1,4.0.3,0,467,1,46,3,49,0,3,49,49,0,0,0,1,2,209,274,209,277,2,1320,1317
1607,1,5.0.3,0,499,2,89,3,92,0,3,92,92,0,0,0,1,2,358,274,358,277,2,1320,1317
1607,2,0.0.3,0,462,0,21,3,24,0,3,24,66,0,0,3,1,2,170,274,170,277,3,1320,1254
1607,2,1.0.3,0,462,0,39,3,42,0,3,42,66,0,0,3,1,2,223,274,223,277,3,1320,1254
1607,2,2.0.3,0,525,3,79,3,82,0,3,82,82,0,0,3,1,2,199,274,199,277,3,1320,1254
1607,2,3.2.66,1,462,0,2,66,68,66,0,68,68,-66,66,69,3,1,95,307,161,307,3,1320,1254
1607,2,4.0.3,0,467,1,46,3,49,0,3,49,66,0,0,3,1,2,209,274,209,277,3,1320,1254
1607,2,5.0.3,0,499,2,89,3,92,0,3,92,92,0,0,3,1,2,358,274,358,277,3,1320,1254
1607,3,0.0.3,0,462,0,21,3,24,0,3,24,68,0,0,69,1,2,170,274,170,277,4,1320,1252
1607,3,1.0.3,0,462,0,39,3,42,0,3,42,68,0,0,69,1,2,223,274,223,277,4,1320,1252
1607,3,2.0.3,0,525,3,79,3,82,0,3,82,82,0,0,69,1,2,199,274,199,277,4,1320,1252
1607,3,3.3.68,1,462,0,3,68,71,68,0,71,71,-68,68,137,4,1,93,186,161,186,4,1320,1252
1607,3,4.0.3,0,467,1,46,3,49,0,3,49,68,0,0,69,1,2,209,274,209,277,4,1320,1252
1607,3,5.0.3,0,499,2,89,3,92,0,3,92,92,0,0,69,1,2,358,274,358,277,4,1320,1252
1607,4,0.0.3,0,462,0,21,3,24,0,3,24,71,0,0,137,1,2,170,274,170,277,5,1320,1249
1607,4,1.0.3,0,462,0,39,3,42,0,3,42,71,0,0,137,1,2,223,274,223,277,5,1320,1249
1607,4,2.0.3,0,525,3,79,3,82,0,3,82,82,0,0,137,1,2,199,274,199,277,5,1320,1249
1607,4,3.4.71,1,462,0,90,71,161,71,0,161,161,-71,71,208,5,1,90,269,161,269,5,1320,1249
1607,4,4.0.3,0,467,1,46,3,49,0,3,49,71,0,0,137,1,2,209,274,209,277,5,1320,1249
1607,4,5.0.3,0,499,2,89,3,92,0,3,92,92,0,0,137,1,2,358,274,358,277,5,1320,1249
1607,5,0.0.3,0,462,0,21,3,24,0,3,24,161,0,0,208,1,2,170,274,170,277,6,1320,1159
1607,5,1.0.3,0,462,0,39,3,42,0,3,42,161,0,0,208,1,2,223,274,223,277,6,1320,1159
1607,5,2.0.3,0,525,3,79,3,82,0,3,82,161,0,0,208,1,2,199,274,199,277,6,1320,1159
1607,5,4.0.3,0,467,1,46,3,49,0,3,49,161,0,0,208,1,2,209,274,209,277,6,1320,1159
1607,5,5.0.3,1,499,2,89,3,92,0,3,92,161,0,0,208,1,2,358,274,358,277,6,1320,1159
1607,6,0.0.92,0,499,0,21,92,113,0,92,113,161,0,0,208,1,3,170,185,170,277,7,1320,1070
1607,6,1.0.92,1,524,2,39,92,131,0,92,131,161,0,0,208,1,3,223,185,223,277,7,1320,1070
1607,6,2.0.92,0,524,2,79,92,171,0,92,171,171,0,0,208,1,3,199,185,199,277,7,1320,1070
1607,6,4.0.92,0,513,1,46,92,138,0,92,138,161,0,0,208,1,3,209,185,209,277,7,1320,1070
1607,6,5.1.92,0,524,2,97,92,189,92,0,189,189,-26,29,234,2,2,269,218,358,281,7,1320,1070
1607,7,0.0.131,1,524,0,21,131,152,0,131,152,161,0,0,208,1,4,170,146,170,277,8,1320,1031
1607,7,1.1.131,0,538,1,66,131,197,131,0,197,197,-65,68,273,2,2,184,218,223,281,8,1320,1031
1607,7,2.0.131,0,524,0,79,131,210,0,131,210,210,0,0,208,1,4,199,146,199,277,8,1320,1031
1607,7,4.0.131,0,524,0,46,131,177,0,131,177,177,0,0,208,1,4,209,146,209,277,8,1320,1031
1607,7,5.1.92,0,524,0,97,92,189,92,0,189,189,-26,29,234,2,2,269,218,358,281,8,1320,1031
1607,8,0.1.152,0,531,1,3,152,155,152,0,155,161,-86,89,294,2,2,149,218,170,281,9,1320,1010
1607,8,1.1.131,0,538,2,66,131,197,131,0,197,197,-65,68,273,2,2,184,218,223,281,9,1320,1010
1607,8,2.0.152,0,524,0,79,152,231,0,152,231,231,0,0,208,1,5,199,125,199,277,9,1320,1010
1607,8,4.0.152,1,524,0,46,152,198,0,152,198,198,0,0,208,1,5,209,125,209,277,9,1320,1010
1607,8,5.1.92,0,524,0,97,92,189,92,0,189,189,-26,29,234,2,2,269,218,358,281,9,1320,1010
1607,9,0.1.152,0,531,1,3,152,155,152,0,155,198,-86,89,294,2,2,149,218,170,281,10,1320,964
1607,9,1.1.131,0,539,2,66,131,197,131,0,197,198,-65,68,273,2,2,184,218,223,281,10,1320,964
1607,9,2.0.198,1,524,0,79,198,277,0,198,277,277,0,0,208,1,6,199,79,199,277,10,1320,964
1607,9,4.1.198,0,524,0,43,198,241,198,0,241,241,-132,135,340,2,2,163,218,209,281,10,1320,964
1607,9,5.1.92,0,524,0,97,92,189,92,0,189,198,-26,29,234,2,2,269,218,358,281,10,1320,964
1607,10,0.1.152,0,531,1,3,152,155,152,0,155,277,-86,89,294,2,2,149,218,170,281,11,1320,885
1607,10,1.1.131,0,539,2,66,131,197,131,0,197,277,-65,68,273,2,2,184,218,223,281,11,1320,885
1607,10,2.1.277,0,524,0,9,277,286,277,0,286,286,-211,214,419,2,2,120,218,199,281,11,1320,885
1607,10,4.1.198,0,524,0,43,198,241,198,0,241,277,-132,135,340,2,2,163,218,209,281,11,1320,885
1607,10,5.1.92,1,524,0,97,92,189,92,0,189,277,-26,29,234,2,2,269,218,358,281,11,1320,885
1607,11,0.1.189,1,524,0,3,189,192,152,37,192,277,0,29,234,2,3,149,121,170,281,12,1320,788
1607,11,1.1.189,0,524,0,66,189,255,131,58,255,277,0,29,234,2,3,184,121,223,281,12,1320,788
1607,11,2.1.277,0,524,0,9,277,286,277,0,286,286,-88,117,322,2,3,120,121,199,281,12,1320,788
1607,11,4.1.198,0,524,0,43,198,241,198,0,241,277,-9,38,243,2,3,163,121,209,281,12,1320,788
1607,11,5.2.189,0,524,0,77,189,266,189,0,266,277,-121,187,355,3,2,172,305,358,307,12,1320,788
1607,12,0.2.192,0,527,1,49,192,241,192,0,241,277,-124,190,358,3,2,146,305,170,307,13,1320,785
1607,12,1.1.192,1,524,0,66,192,258,131,61,258,277,0,29,234,2,4,184,118,223,281,13,1320,785
1607,12,2.1.277,0,524,0,9,277,286,277,0,286,286,-85,114,319,2,4,120,118,199,281,13,1320,785
1607,12,4.1.198,0,524,0,43,198,241,198,0,241,277,-6,35,240,2,4,163,118,209,281,13,1320,785
1607,12,5.2.189,0,524,0,77,189,266,189,0,266,277,-121,187,355,3,2,172,305,358,307,13,1320,785
1607,13,0.2.192,0,527,1,49,192,241,192,0,241,277,-124,190,358,3,2,146,305,170,307,14,1320,719
1607,13,1.2.258,0,550,3,88,258,346,258,0,346,346,-190,256,424,3,2,118,305,223,307,14,1320,719
1607,13,2.1.277,0,530,2,9,277,286,277,0,286,286,-19,48,253,2,5,120,52,199,281,14,1320,719
1607,13,4.1.258,1,524,0,43,258,301,198,60,301,301,0,29,234,2,5,163,52,209,281,14,1320,719
1607,13,5.2.189,0,524,0,77,189,266,189,0,266,277,-121,187,355,3,2,172,305,358,307,14,1320,719
1607,14,0.2.192,0,527,1,49,192,241,192,0,241,301,-124,190,358,3,2,146,305,170,307,15,1320,676
1607,14,1.2.258,0,550,2,88,258,346,258,0,346,346,-190,256,424,3,2,118,305,223,307,15,1320,676
1607,14,2.1.301,1,524,0,9,301,310,277,24,310,310,0,29,234,2,6,120,9,199,281,15,1320,676
1607,14,4.2.301,0,559,3,84,301,385,301,0,385,385,-233,299,467,3,2,120,305,209,307,15,1320,676
1607,14,5.2.189,0,524,0,77,189,266,189,0,266,301,-121,187,355,3,2,172,305,358,307,15,1320,676
1607,15,0.2.192,0,527,1,49,192,241,192,0,241,310,-124,190,358,3,2,146,305,170,307,16,1320,667
1607,15,1.2.258,0,550,2,88,258,346,258,0,346,346,-190,256,424,3,2,118,305,223,307,16,1320,667
1607,15,2.2.310,0,568,4,7,310,317,310,0,317,317,-242,308,476,3,2,111,305,199,307,16,1320,667
1607,15,4.2.301,0,559,3,84,301,385,301,0,385,385,-233,299,467,3,2,120,305,209,307,16,1320,667
1607,15,5.2.189,1,524,0,77,189,266,189,0,266,310,-121,187,355,3,2,172,305,358,307,16,1320,667
1607,16,0.2.266,0,524,0,49,266,315,192,74,315,315,0,187,355,3,3,146,228,170,307,17,1320,590
1607,16,1.2.266,0,530,1,88,266,354,258,8,354,354,0,187,355,3,3,118,228,223,307,17,1320,590
1607,16,2.2.310,0,568,3,7,310,317,310,0,317,317,-44,231,399,3,3,111,228,199,307,17,1320,590
1607,16,4.2.301,0,559,2,84,301,385,301,0,385,385,-35,222,390,3,3,120,228,209,307,17,1320,590
1607,16,5.3.266,1,524,0,50,266,316,266,0,316,316,-195,263,550,4,2,95,183,358,186,17,1320,590
1607,17,0.2.266,0,524,0,49,266,315,192,74,315,316,0,187,550,3,3,146,228,170,307,18,1320,540
1607,17,1.2.266,0,530,1,88,266,354,258,8,354,354,0,187,550,3,3,118,228,223,307,18,1320,540
1607,17,2.2.310,0,568,3,7,310,317,310,0,317,317,-44,231,594,3,3,111,228,199,307,18,1320,540
1607,17,4.2.301,0,559,2,84,301,385,301,0,385,385,-35,222,585,3,3,120,228,209,307,18,1320,540
1607,17,5.4.316,1,524,0,45,316,361,316,0,361,361,-155,226,705,5,2,45,179,358,269,18,1320,540
1607,18,0.2.266,1,524,0,49,266,315,192,74,315,361,0,187,705,3,3,146,228,170,307,19,1320,495
1607,18,1.2.266,0,530,1,88,266,354,258,8,354,361,0,187,705,3,3,118,228,223,307,19,1320,495
1607,18,2.2.310,0,568,3,7,310,317,310,0,317,361,-44,231,749,3,3,111,228,199,307,19,1320,495
1607,18,4.2.301,0,559,2,84,301,385,301,0,385,385,-35,222,740,3,3,120,228,209,307,19,1320,495
1607,19,0.3.316,1,524,0,63,316,379,315,1,379,379,0,263,705,4,3,97,133,170,186,20,1320,446
1607,19,1.2.315,0,534,1,88,315,403,258,57,403,403,0,187,705,3,4,118,179,223,307,20,1320,446
1607,19,2.2.315,0,524,0,7,315,322,310,5,322,361,0,187,705,3,4,111,179,199,307,20,1320,446
1607,19,4.2.315,0,535,2,84,315,399,301,14,399,399,0,187,705,3,4,120,179,209,307,20,1320,446
1607,20,0.4.379,1,524,0,34,379,413,379,0,413,413,-18,244,723,5,3,34,134,170,269,21,1320,383
1607,20,1.2.315,0,534,1,88,315,403,258,57,403,403,0,187,705,3,4,118,179,223,307,21,1320,383
1607,20,2.2.315,0,524,0,7,315,322,310,5,322,379,0,187,705,3,4,111,179,199,307,21,1320,383
1607,20,4.2.315,0,535,2,84,315,399,301,14,399,399,0,187,705,3,4,120,179,209,307,21,1320,383
1607,21,1.2.315,0,534,1,88,315,403,258,57,403,413,0,187,723,3,4,118,179,223,307,22,1320,349
1607,21,2.2.315,1,524,0,7,315,322,310,5,322,413,0,187,723,3,4,111,179,199,307,22,1320,349
1607,21,4.2.315,0,535,2,84,315,399,301,14,399,413,0,187,723,3,4,120,179,209,307,22,1320,349
1607,22,1.2.322,0,530,1,88,322,410,258,64,410,413,0,187,723,3,5,118,172,223,307,23,1320,342
1607,22,2.3.379,1,524,0,29,379,408,322,57,408,413,0,263,723,4,4,104,70,199,186,23,1320,342
1607,22,4.2.322,0,524,0,84,322,406,301,21,406,413,0,187,723,3,5,120,172,209,307,23,1320,342
1607,23,1.2.322,0,530,1,88,322,410,258,64,410,413,0,187,723,3,5,118,172,223,307,24,1320,313
1607,23,2.4.413,1,524,0,75,413,488,408,5,488,488,0,244,723,5,4,75,100,199,269,24,1320,313
1607,23,4.2.322,0,524,0,84,322,406,301,21,406,413,0,187,723,3,5,120,172,209,307,24,1320,313
1607,24,1.2.322,1,530,1,88,322,410,258,64,410,488,0,187,723,3,5,118,172,223,307,25,1320,238
1607,24,4.2.322,0,524,0,84,322,406,301,21,406,488,0,187,723,3,5,120,172,209,307,25,1320,238
1607,25,1.3.410,1,530,0,16,410,426,410,0,426,488,-2,265,725,4,5,30,41,223,186,26,1320,150
1607,25,4.2.410,0,530,0,84,410,494,301,109,494,494,0,187,723,3,6,120,84,209,307,26,1320,150
1607,26,1.4.488,1,530,0,14,488,502,426,62,502,502,0,244,725,5,5,14,25,223,269,27,1320,134
1607,26,4.2.410,0,530,0,84,410,494,301,109,494,494,0,187,725,3,6,120,84,209,307,27,1320,134
1607,27,4.2.410,1,530,0,84,410,494,301,109,494,502,0,187,725,3,6,120,84,209,307,28,1320,120
1607,28,4.3.494,1,530,0,25,494,519,494,0,519,519,-68,333,793,4,6,36,25,209,186,29,1320,36
1607,29,4.4.519,1,530,0,11,519,530,519,0,530,530,-17,261,810,5,6,11,11,209,269,30,1320,11
1608,0,0.0.0,1,546,1,34,0,34,0,0,34,34,0,0,0,1,1,313,290,313,290,1,1585,1585
1608,0,1.0.0,0,551,2,15,0,15,0,0,15,15,0,0,0,1,1,224,290,224,290,1,1585,1585
1608,0,2.0.0,0,536,0,25,0,25,0,0,25,25,0,0,0,1,1,225,290,225,290,1,1585,1585
1608,0,3.0.0,0,564,3,55,0,55,0,0,55,55,0,0,0,1,1,218,290,218,290,1,1585,1585
1608,0,4.0.0,0,584,4,67,0,67,0,0,67,67,0,0,0,1,1,344,290,344,290,1,1585,1585
1608,0,5.0.0,0,630,5,94,0,94,0,0,94,94,0,0,0,1,1,261,290,261,290,1,1585,1585
1608,1,0.1.34,0,562,2,70,34,104,34,0,104,104,-34,34,34,2,1,279,284,313,284,2,1585,1551
1608,1,1.0.34,1,561,1,15,34,49,0,34,49,49,0,0,0,1,2,224,256,224,290,2,1585,1551
1608,1,2.0.34,0,546,0,25,34,59,0,34,59,59,0,0,0,1,2,225,256,225,290,2,1585,1551
1608,1,3.0.34,0,564,3,55,34,89,0,34,89,89,0,0,0,1,2,218,256,218,290,2,1585,1551
1608,1,4.0.34,0,565,4,67,34,101,0,34,101,101,0,0,0,1,2,344,256,344,290,2,1585,1551
1608,1,5.0.34,0,590,5,94,34,128,0,34,128,128,0,0,0,1,2,261,256,261,290,2,1585,1551
1608,2,0.1.34,0,564,1,70,34,104,34,0,104,104,-34,34,34,2,1,279,284,313,284,3,1585,1536
1608,2,1.1.49,0,571,3,35,49,84,49,0,84,84,-49,49,49,2,1,209,284,224,284,3,1585,1536
1608,2,2.0.49,1,561,0,25,49,74,0,49,74,74,0,0,0,1,3,225,241,225,290,3,1585,1536
1608,2,3.0.49,0,564,1,55,49,104,0,49,104,104,0,0,0,1,3,218,241,218,290,3,1585,1536
1608,2,4.0.49,0,566,2,67,49,116,0,49,116,116,0,0,0,1,3,344,241,344,290,3,1585,1536
1608,2,5.0.49,0,590,4,94,49,143,0,49,143,143,0,0,0,1,3,261,241,261,290,3,1585,1536
1608,3,0.1.34,0,564,1,70,34,104,34,0,104,104,-34,34,34,2,1,279,284,313,284,4,1585,1511
1608,3,1.1.49,0,571,3,35,49,84,49,0,84,84,-49,49,49,2,1,209,284,224,284,4,1585,1511
1608,3,2.1.74,0,561,0,3,74,77,74,0,77,77,-74,74,74,2,1,200,284,225,284,4,1585,1511
1608,3,3.0.74,0,561,0,55,74,129,0,74,129,129,0,0,0,1,4,218,216,218,290,4,1585,1511
1608,3,4.0.74,1,561,0,67,74,141,0,74,141,141,0,0,0,1,4,344,216,344,290,4,1585,1511
1608,3,5.0.74,0,570,2,94,74,168,0,74,168,168,0,0,0,1,4,261,216,261,290,4,1585,1511
1608,4,0.1.34,0,566,1,70,34,104,34,0,104,141,-34,34,34,2,1,279,284,313,284,5,1585,1444
1608,4,1.1.49,0,571,2,35,49,84,49,0,84,141,-49,49,49,2,1,209,284,224,284,5,1585,1444
1608,4,2.1.74,0,561,0,3,74,77,74,0,77,141,-74,74,74,2,1,200,284,225,284,5,1585,1444
1608,4,3.0.141,1,561,0,55,141,196,0,141,196,196,0,0,0,1,5,218,149,218,290,5,1585,1444
1608,4,4.1.141,0,577,3,94,141,235,141,0,235,235,-141,141,141,2,1,277,284,344,284,5,1585,1444
1608,4,5.0.141,0,561,0,94,141,235,0,141,235,235,0,0,0,1,5,261,149,261,290,5,1585,1444
1608,5,0.1.34,0,566,1,70,34,104,34,0,104,196,-34,34,34,2,1,279,284,313,284,6,1585,1389
1608,5,1.1.49,0,571,2,35,49,84,49,0,84,196,-49,49,49,2,1,209,284,224,284,6,1585,1389
1608,5,2.1.74,0,561,0,3,74,77,74,0,77,196,-74,74,74,2,1,200,284,225,284,6,1585,1389
1608,5,3.1.196,0,561,0,2,196,198,196,0,198,198,-196,196,196,2,1,163,284,218,284,6,1585,1389
1608,5,4.1.141,0,577,3,94,141,235,141,0,235,235,-141,141,141,2,1,277,284,344,284,6,1585,1389
1608,5,5.0.196,1,561,0,94,196,290,0,196,290,290,0,0,0,1,6,261,94,261,290,6,1585,1389
1608,6,0.1.34,0,566,1,70,34,104,34,0,104,290,-34,34,34,2,1,279,284,313,284,7,1585,1295
1608,6,1.1.49,0,571,2,35,49,84,49,0,84,290,-49,49,49,2,1,209,284,224,284,7,1585,1295
1608,6,2.1.74,1,561,0,3,74,77,74,0,77,290,-74,74,74,2,1,200,284,225,284,7,1585,1295
1608,6,3.1.196,0,561,0,2,196,198,196,0,198,290,-196,196,196,2,1,163,284,218,284,7,1585,1295
1608,6,4.1.141,0,577,3,94,141,235,141,0,235,290,-141,141,141,2,1,277,284,344,284,7,1585,1295
1608,6,5.1.290,0,561,0,80,290,370,290,0,370,370,-290,290,290,2,1,167,284,261,284,7,1585,1295
1608,7,0.1.77,1,561,0,70,77,147,34,43,147,290,0,74,74,2,2,279,281,313,284,8,1585,1292
1608,7,1.1.77,0,577,1,35,77,112,49,28,112,290,0,74,74,2,2,209,281,224,284,8,1585,1292
1608,7,2.2.77,0,561,0,59,77,136,77,0,136,290,-77,77,151,3,1,197,373,225,373,8,1585,1292
1608,7,3.1.196,0,561,0,2,196,198,196,0,198,290,-119,193,193,2,2,163,281,218,284,8,1585,1292
1608,7,4.1.141,0,596,2,94,141,235,141,0,235,290,-64,138,138,2,2,277,281,344,284,8,1585,1292
1608,7,5.1.290,0,561,0,80,290,370,290,0,370,370,-213,287,287,2,2,167,281,261,284,8,1585,1292
1608,8,0.2.147,0,561,0,53,147,200,147,0,200,290,-147,147,221,3,1,209,373,313,373,9,1585,1222
1608,8,1.1.147,1,561,0,35,147,182,49,98,182,290,0,74,74,2,3,209,211,224,284,9,1585,1222
1608,8,2.2.77,0,561,0,59,77,136,77,0,136,290,-77,77,151,3,1,197,373,225,373,9,1585,1222
1608,8,3.1.196,0,561,0,2,196,198,196,0,198,290,-49,123,123,2,3,163,211,218,284,9,1585,1222
1608,8,4.1.147,0,583,1,94,147,241,141,6,241,290,0,74,74,2,3,277,211,344,284,9,1585,1222
1608,8,5.1.290,0,561,0,80,290,370,290,0,370,370,-143,217,217,2,3,167,211,261,284,9,1585,1222
1608,9,0.2.147,0,561,0,53,147,200,147,0,200,290,-147,147,221,3,1,209,373,313,373,10,1585,1187
1608,9,1.2.182,0,627,1,93,182,275,182,0,275,290,-182,182,256,3,1,174,373,224,373,10,1585,1187
1608,9,2.2.77,0,561,0,59,77,136,77,0,136,290,-77,77,151,3,1,197,373,225,373,10,1585,1187
1608,9,3.1.196,1,561,0,2,196,198,196,0,198,290,-14,88,88,2,4,163,176,218,284,10,1585,1187
1608,9,4.1.182,0,561,0,94,182,276,141,41,276,290,0,74,74,2,4,277,176,344,284,10,1585,1187
1608,9,5.1.290,0,561,0,80,290,370,290,0,370,370,-108,182,182,2,4,167,176,261,284,10,1585,1187
1608,10,0.2.147,0,561,0,53,147,200,147,0,200,290,-147,147,235,3,1,209,373,313,373,11,1585,1185
1608,10,1.2.182,0,633,2,93,182,275,182,0,275,290,-182,182,270,3,1,174,373,224,373,11,1585,1185
1608,10,2.2.77,0,561,0,59,77,136,77,0,136,290,-77,77,165,3,1,197,373,225,373,11,1585,1185
1608,10,3.2.198,0,623,1,68,198,266,198,0,266,290,-198,198,286,3,1,161,373,218,373,11,1585,1185
1608,10,4.1.198,1,561,0,94,198,292,141,57,292,292,0,88,88,2,5,277,174,344,284,11,1585,1185
1608,10,5.1.290,0,647,3,80,290,370,290,0,370,370,-92,180,180,2,5,167,174,261,284,11,1585,1185
1608,11,0.2.147,0,561,0,53,147,200,147,0,200,292,-147,147,235,3,1,209,373,313,373,12,1585,1091
1608,11,1.2.182,0,633,3,93,182,275,182,0,275,292,-182,182,270,3,1,174,373,224,373,12,1585,1091
1608,11,2.2.77,0,561,0,59,77,136,77,0,136,292,-77,77,165,3,1,197,373,225,373,12,1585,1091
1608,11,3.2.198,0,623,2,68,198,266,198,0,266,292,-198,198,286,3,1,161,373,218,373,12,1585,1091
1608,11,4.2.292,0,566,1,84,292,376,292,0,376,376,-292,292,380,3,1,183,373,344,373,12,1585,1091
1608,11,5.1.292,1,561,0,80,292,372,290,2,372,372,0,88,88,2,6,167,80,261,284,12,1585,1091
1608,12,0.2.147,0,561,0,53,147,200,147,0,200,372,-147,147,235,3,1,209,373,313,373,13,1585,1011
1608,12,1.2.182,0,633,4,93,182,275,182,0,275,372,-182,182,270,3,1,174,373,224,373,13,1585,1011
1608,12,2.2.77,1,561,0,59,77,136,77,0,136,372,-77,77,165,3,1,197,373,225,373,13,1585,1011
1608,12,3.2.198,0,623,3,68,198,266,198,0,266,372,-198,198,286,3,1,161,373,218,373,13,1585,1011
1608,12,4.2.292,0,566,1,84,292,376,292,0,376,376,-292,292,380,3,1,183,373,344,373,13,1585,1011
1608,12,5.2.372,0,574,2,16,372,388,372,0,388,388,-372,372,460,3,1,87,373,261,373,13,1585,1011
1608,13,0.2.147,0,561,0,53,147,200,147,0,200,372,-11,88,176,3,2,209,314,313,373,14,1585,952
1608,13,1.2.182,0,633,4,93,182,275,182,0,275,372,-46,123,211,3,2,174,314,224,373,14,1585,952
1608,13,2.3.136,1,561,0,97,136,233,136,0,233,372,-136,136,301,4,1,138,339,225,339,14,1585,952
1608,13,3.2.198,0,623,3,68,198,266,198,0,266,372,-62,139,227,3,2,161,314,218,373,14,1585,952
1608,13,4.2.292,0,566,1,84,292,376,292,0,376,376,-156,233,321,3,2,183,314,344,373,14,1585,952
1608,13,5.2.372,0,574,2,16,372,388,372,0,388,388,-236,313,401,3,2,87,314,261,373,14,1585,952
1608,14,0.2.147,0,561,0,53,147,200,147,0,200,372,-11,88,312,3,2,209,314,313,373,15,1585,855
1608,14,1.2.182,0,633,4,93,182,275,182,0,275,372,-46,123,347,3,2,174,314,224,373,15,1585,855
1608,14,2.4.233,1,561,0,41,233,274,233,0,274,372,-233,233,534,5,1,41,299,225,299,15,1585,855
1608,14,3.2.198,0,623,3,68,198,266,198,0,266,372,-62,139,363,3,2,161,314,218,373,15,1585,855
1608,14,4.2.292,0,566,1,84,292,376,292,0,376,376,-156,233,457,3,2,183,314,344,373,15,1585,855
1608,14,5.2.372,0,574,2,16,372,388,372,0,388,388,-236,313,537,3,2,87,314,261,373,15,1585,855
1608,15,0.2.147,1,561,0,53,147,200,147,0,200,372,-11,88,545,3,2,209,314,313,373,16,1585,814
1608,15,1.2.182,0,633,4,93,182,275,182,0,275,372,-46,123,580,3,2,174,314,224,373,16,1585,814
1608,15,3.2.198,0,623,3,68,198,266,198,0,266,372,-62,139,596,3,2,161,314,218,373,16,1585,814
1608,15,4.2.292,0,566,1,84,292,376,292,0,376,376,-156,233,690,3,2,183,314,344,373,16,1585,814
1608,15,5.2.372,0,574,2,16,372,388,372,0,388,388,-236,313,770,3,2,87,314,261,373,16,1585,814
1608,16,0.3.233,1,561,0,70,233,303,200,33,303,372,0,136,545,4,2,156,242,313,339,17,1585,761
1608,16,1.2.200,0,561,0,93,200,293,182,18,293,372,0,88,545,3,3,174,261,224,373,17,1585,761
1608,16,3.2.200,0,566,1,68,200,268,198,2,268,372,0,88,545,3,3,161,261,218,373,17,1585,761
1608,16,4.2.292,0,566,1,84,292,376,292,0,376,376,-92,180,637,3,3,183,261,344,373,17,1585,761
1608,16,5.2.372,0,574,2,16,372,388,372,0,388,388,-172,260,717,3,3,87,261,261,373,17,1585,761
1608,17,0.4.303,1,561,0,86,303,389,303,0,389,389,-29,262,574,5,2,86,258,313,299,18,1585,691
1608,17,1.2.200,0,561,0,93,200,293,182,18,293,372,0,88,545,3,3,174,261,224,373,18,1585,691
1608,17,3.2.200,0,566,1,68,200,268,198,2,268,372,0,88,545,3,3,161,261,218,373,18,1585,691
1608,17,4.2.292,0,566,1,84,292,376,292,0,376,376,-92,180,637,3,3,183,261,344,373,18,1585,691
1608,17,5.2.372,0,574,2,16,372,388,372,0,388,388,-172,260,717,3,3,87,261,261,373,18,1585,691
1608,18,1.2.200,0,561,0,93,200,293,182,18,293,389,0,88,574,3,3,174,261,224,373,19,1585,605
1608,18,3.2.200,1,566,1,68,200,268,198,2,268,389,0,88,574,3,3,161,261,218,373,19,1585,605
1608,18,4.2.292,0,566,1,84,292,376,292,0,376,389,-92,180,666,3,3,183,261,344,373,19,1585,605
1608,18,5.2.372,0,574,2,16,372,388,372,0,388,389,-172,260,746,3,3,87,261,261,373,19,1585,605
1608,19,1.2.268,0,574,1,93,268,361,182,86,361,389,0,88,574,3,4,174,193,224,373,20,1585,537
1608,19,3.3.303,1,566,0,61,303,364,268,35,364,389,0,136,574,4,3,93,172,218,339,20,1585,537
1608,19,4.2.292,0,566,0,84,292,376,292,0,376,389,-24,112,598,3,4,183,193,344,373,20,1585,537
1608,19,5.2.372,0,574,1,16,372,388,372,0,388,389,-104,192,678,3,4,87,193,261,373,20,1585,537
1608,20,1.2.268,0,574,1,93,268,361,182,86,361,389,0,88,574,3,4,174,193,224,373,21,1585,476
1608,20,3.4.389,1,566,0,32,389,421,364,25,421,421,0,262,574,5,3,32,172,218,299,21,1585,476
1608,20,4.2.292,0,566,0,84,292,376,292,0,376,389,-24,112,598,3,4,183,193,344,373,21,1585,476
1608,20,5.2.372,0,574,1,16,372,388,372,0,388,389,-104,192,678,3,4,87,193,261,373,21,1585,476
1608,21,1.2.268,1,574,1,93,268,361,182,86,361,421,0,88,574,3,4,174,193,224,373,22,1585,444
1608,21,4.2.292,0,566,0,84,292,376,292,0,376,421,-24,112,598,3,4,183,193,344,373,22,1585,444
1608,21,5.2.372,0,574,1,16,372,388,372,0,388,421,-104,192,678,3,4,87,193,261,373,22,1585,444
1608,22,1.3.364,1,574,0,58,364,422,361,3,422,422,0,136,574,4,4,81,111,224,339,23,1585,351
1608,22,4.2.361,0,580,1,84,361,445,292,69,445,445,0,88,574,3,5,183,100,344,373,23,1585,351
1608,22,5.2.372,0,574,0,16,372,388,372,0,388,421,-11,99,585,3,5,87,100,261,373,23,1585,351
1608,23,1.4.422,1,574,0,23,422,445,422,0,445,445,-1,263,575,5,4,23,140,224,299,24,1585,293
1608,23,4.2.361,0,580,1,84,361,445,292,69,445,445,0,88,574,3,5,183,100,344,373,24,1585,293
1608,23,5.2.372,0,574,0,16,372,388,372,0,388,422,-11,99,585,3,5,87,100,261,373,24,1585,293
1608,24,4.2.361,1,580,1,84,361,445,292,69,445,445,0,88,575,3,5,183,100,344,373,25,1585,270
1608,24,5.2.372,0,574,0,16,372,388,372,0,388,445,-11,99,586,3,5,87,100,261,373,25,1585,270
1608,25,4.3.445,1,580,0,18,445,463,445,0,463,463,-23,159,598,4,5,99,53,344,339,26,1585,186
1608,25,5.2.445,0,580,0,16,445,461,372,73,461,461,0,88,575,3,6,87,16,261,373,26,1585,186
1608,26,4.4.463,0,580,0,81,463,544,463,0,544,544,-18,281,616,5,5,81,117,344,299,27,1585,168
1608,26,5.2.445,1,580,0,16,445,461,372,73,461,463,0,88,598,3,6,87,16,261,373,27,1585,168
1608,27,4.4.463,0,580,0,81,463,544,463,0,544,544,-18,281,616,5,5,81,117,344,299,28,1585,152
1608,27,5.3.463,1,580,0,35,463,498,461,2,498,498,0,159,598,4,6,71,35,261,339,28,1585,152
1608,28,4.4.463,1,580,0,81,463,544,463,0,544,544,-18,281,616,5,5,81,117,344,299,29,1585,117
1608,28,5.4.498,0,615,1,36,498,534,498,0,534,534,-53,316,651,5,5,36,117,261,299,29,1585,117
1608,29,5.4.544,1,580,0,36,544,580,498,46,580,580,0,281,616,5,6,36,36,261,299,30,1585,36
1609,0,0.0.0,0,565,0,47,0,47,0,0,47,47,0,0,0,1,1,257,402,257,402,1,1551,1551
1609,0,1.0.0,0,565,0,89,0,89,0,0,89,89,0,0,0,1,1,322,402,322,402,1,1551,1551
1609,0,2.0.0,0,568,1,70,0,70,0,0,70,70,0,0,0,1,1,250,402,250,402,1,1551,1551
1609,0,3.0.0,1,565,0,9,0,9,0,0,9,9,0,0,0,1,1,179,402,179,402,1,1551,1551
1609,0,4.0.0,0,565,0,89,0,89,0,0,89,89,0,0,0,1,1,282,402,282,402,1,1551,1551
1609,0,5.0.0,0,582,2,98,0,98,0,0,98,98,0,0,0,1,1,261,402,261,402,1,1551,1551
1609,1,0.0.9,0,565,0,47,9,56,0,9,56,56,0,0,0,1,2,257,393,257,402,2,1551,1542
1609,1,1.0.9,0,565,0,89,9,98,0,9,98,98,0,0,0,1,2,322,393,322,402,2,1551,1542
1609,1,2.0.9,0,568,1,70,9,79,0,9,79,79,0,0,0,1,2,250,393,250,402,2,1551,1542
1609,1,3.1.9,1,565,0,40,9,49,9,0,49,49,-9,9,9,2,1,170,285,179,285,2,1551,1542
1609,1,4.0.9,0,565,0,89,9,98,0,9,98,98,0,0,0,1,2,282,393,282,402,2,1551,1542
1609,1,5.0.9,0,582,2,98,9,107,0,9,107,107,0,0,0,1,2,261,393,261,402,2,1551,1542
1609,2,0.0.9,0,565,0,47,9,56,0,9,56,56,0,0,9,1,2,257,393,257,402,3,1551,1502
1609,2,1.0.9,0,565,0,89,9,98,0,9,98,98,0,0,9,1,2,322,393,322,402,3,1551,1502
1609,2,2.0.9,0,568,1,70,9,79,0,9,79,79,0,0,9,1,2,250,393,250,402,3,1551,1502
1609,2,3.2.49,1,565,0,36,49,85,49,0,85,85,-49,49,58,3,1,130,341,179,341,3,1551,1502
1609,2,4.0.9,0,565,0,89,9,98,0,9,98,98,0,0,9,1,2,282,393,282,402,3,1551,1502
1609,2,5.0.9,0,582,2,98,9,107,0,9,107,107,0,0,9,1,2,261,393,261,402,3,1551,1502
1609,3,0.0.9,0,565,0,47,9,56,0,9,56,85,0,0,58,1,2,257,393,257,402,4,1551,1466
1609,3,1.0.9,0,565,0,89,9,98,0,9,98,98,0,0,58,1,2,322,393,322,402,4,1551,1466
1609,3,2.0.9,0,568,1,70,9,79,0,9,79,85,0,0,58,1,2,250,393,250,402,4,1551,1466
1609,3,3.3.85,1,565,0,21,85,106,85,0,106,106,-85,85,143,4,1,94,294,179,294,4,1551,1466
1609,3,4.0.9,0,565,0,89,9,98,0,9,98,98,0,0,58,1,2,282,393,282,402,4,1551,1466
1609,3,5.0.9,0,582,2,98,9,107,0,9,107,107,0,0,58,1,2,261,393,261,402,4,1551,1466
1609,4,0.0.9,0,565,0,47,9,56,0,9,56,106,0,0,143,1,2,257,393,257,402,5,1551,1445
1609,4,1.0.9,0,565,0,89,9,98,0,9,98,106,0,0,143,1,2,322,393,322,402,5,1551,1445
1609,4,2.0.9,0,568,1,70,9,79,0,9,79,106,0,0,143,1,2,250,393,250,402,5,1551,1445
1609,4,3.4.106,1,565,0,73,106,179,106,0,179,179,-106,106,249,5,1,73,229,179,229,5,1551,1445
1609,4,4.0.9,0,565,0,89,9,98,0,9,98,106,0,0,143,1,2,282,393,282,402,5,1551,1445
1609,4,5.0.9,0,582,2,98,9,107,0,9,107,107,0,0,143,1,2,261,393,261,402,5,1551,1445
1609,5,0.0.9,1,565,0,47,9,56,0,9,56,179,0,0,249,1,2,257,393,257,402,6,1551,1372
1609,5,1.0.9,0,565,0,89,9,98,0,9,98,179,0,0,249,1,2,322,393,322,402,6,1551,1372
1609,5,2.0.9,0,568,1,70,9,79,0,9,79,179,0,0,249,1,2,250,393,250,402,6,1551,1372
1609,5,4.0.9,0,565,0,89,9,98,0,9,98,179,0,0,249,1,2,282,393,282,402,6,1551,1372
1609,5,5.0.9,0,582,2,98,9,107,0,9,107,179,0,0,249,1,2,261,393,261,402,6,1551,1372
1609,6,0.1.56,1,565,0,38,56,94,56,0,94,179,-7,16,256,2,2,210,245,257,285,7,1551,1325
1609,6,1.0.56,0,565,0,89,56,145,0,56,145,179,0,0,249,1,3,322,346,322,402,7,1551,1325
1609,6,2.0.56,0,565,0,70,56,126,0,56,126,179,0,0,249,1,3,250,346,250,402,7,1551,1325
1609,6,4.0.56,0,565,0,89,56,145,0,56,145,179,0,0,249,1,3,282,346,282,402,7,1551,1325
1609,6,5.0.56,0,582,1,98,56,154,0,56,154,179,0,0,249,1,3,261,346,261,402,7,1551,1325
1609,7,0.2.94,1,565,0,56,94,150,94,0,150,179,-9,58,265,3,2,172,305,257,341,8,1551,1287
1609,7,1.0.56,0,565,0,89,56,145,0,56,145,179,0,0,256,1,3,322,346,322,402,8,1551,1287
1609,7,2.0.56,0,565,0,70,56,126,0,56,126,179,0,0,256,1,3,250,346,250,402,8,1551,1287
1609,7,4.0.56,0,565,0,89,56,145,0,56,145,179,0,0,256,1,3,282,346,282,402,8,1551,1287
1609,7,5.0.56,0,582,1,98,56,154,0,56,154,179,0,0,256,1,3,261,346,261,402,8,1551,1287
1609,8,0.3.150,1,565,0,77,150,227,150,0,227,227,-44,129,309,4,2,116,273,257,294,9,1551,1231
1609,8,1.0.56,0,565,0,89,56,145,0,56,145,179,0,0,265,1,3,322,346,322,402,9,1551,1231
1609,8,2.0.56,0,565,0,70,56,126,0,56,126,179,0,0,265,1,3,250,346,250,402,9,1551,1231
1609,8,4.0.56,0,565,0,89,56,145,0,56,145,179,0,0,265,1,3,282,346,282,402,9,1551,1231
1609,8,5.0.56,0,582,1,98,56,154,0,56,154,179,0,0,265,1,3,261,346,261,402,9,1551,1231
1609,9,0.4.227,1,565,0,39,227,266,227,0,266,266,-48,154,357,5,2,39,156,257,229,10,1551,1154
1609,9,1.0.56,0,565,0,89,56,145,0,56,145,227,0,0,309,1,3,322,346,322,402,10,1551,1154
1609,9,2.0.56,0,565,0,70,56,126,0,56,126,227,0,0,309,1,3,250,346,250,402,10,1551,1154
1609,9,4.0.56,0,565,0,89,56,145,0,56,145,227,0,0,309,1,3,282,346,282,402,10,1551,1154
1609,9,5.0.56,0,582,1,98,56,154,0,56,154,227,0,0,309,1,3,261,346,261,402,10,1551,1154
1609,10,1.0.56,1,565,0,89,56,145,0,56,145,266,0,0,357,1,3,322,346,322,402,11,1551,1115
1609,10,2.0.56,0,565,0,70,56,126,0,56,126,266,0,0,357,1,3,250,346,250,402,11,1551,1115
1609,10,4.0.56,0,565,0,89,56,145,0,56,145,266,0,0,357,1,3,282,346,282,402,11,1551,1115
1609,10,5.0.56,0,582,1,98,56,154,0,56,154,266,0,0,357,1,3,261,346,261,402,11,1551,1115
1609,11,1.1.145,1,565,0,3,145,148,145,0,148,266,-51,67,408,2,3,233,207,322,285,12,1551,1026
1609,11,2.0.145,0,565,0,70,145,215,0,145,215,266,0,0,357,1,4,250,257,250,402,12,1551,1026
1609,11,4.0.145,0,565,0,89,145,234,0,145,234,266,0,0,357,1,4,282,257,282,402,12,1551,1026
1609,11,5.0.145,0,582,1,98,145,243,0,145,243,266,0,0,357,1,4,261,257,261,402,12,1551,1026
1609,12,1.2.150,1,565,0,99,150,249,148,2,249,266,0,58,408,3,3,230,249,322,341,13,1551,1023
1609,12,2.0.145,0,565,0,70,145,215,0,145,215,266,0,0,408,1,4,250,257,250,402,13,1551,1023
1609,12,4.0.145,0,565,0,89,145,234,0,145,234,266,0,0,408,1,4,282,257,282,402,13,1551,1023
1609,12,5.0.145,0,582,1,98,145,243,0,145,243,266,0,0,408,1,4,261,257,261,402,13,1551,1023
1609,13,1.3.249,1,565,0,99,249,348,249,0,348,348,-22,151,430,4,3,131,196,322,294,14,1551,924
1609,13,2.0.145,0,565,0,70,145,215,0,145,215,266,0,0,408,1,4,250,257,250,402,14,1551,924
1609,13,4.0.145,0,565,0,89,145,234,0,145,234,266,0,0,408,1,4,282,257,282,402,14,1551,924
1609,13,5.0.145,0,582,1,98,145,243,0,145,243,266,0,0,408,1,4,261,257,261,402,14,1551,924
1609,14,1.4.348,1,565,0,32,348,380,348,0,380,380,-82,236,512,5,3,32,117,322,229,15,1551,825
1609,14,2.0.145,0,565,0,70,145,215,0,145,215,348,0,0,430,1,4,250,257,250,402,15,1551,825
1609,14,4.0.145,0,565,0,89,145,234,0,145,234,348,0,0,430,1,4,282,257,282,402,15,1551,825
1609,14,5.0.145,0,582,1,98,145,243,0,145,243,348,0,0,430,1,4,261,257,261,402,15,1551,825
1609,15,2.0.145,1,565,0,70,145,215,0,145,215,380,0,0,512,1,4,250,257,250,402,16,1551,793
1609,15,4.0.145,0,565,0,89,145,234,0,145,234,380,0,0,512,1,4,282,257,282,402,16,1551,793
1609,15,5.0.145,0,582,1,98,145,243,0,145,243,380,0,0,512,1,4,261,257,261,402,16,1551,793
1609,16,2.1.215,0,565,0,95,215,310,215,0,310,380,-67,134,579,2,4,180,204,250,285,17,1551,723
1609,16,4.0.215,1,565,0,89,215,304,0,215,304,380,0,0,512,1,5,282,187,282,402,17,1551,723
1609,16,5.0.215,0,595,1,98,215,313,0,215,313,380,0,0,512,1,5,261,187,261,402,17,1551,723
1609,17,2.1.215,0,565,0,95,215,310,215,0,310,380,-67,134,579,2,4,180,204,250,285,18,1551,634
1609,17,4.1.304,0,608,1,46,304,350,304,0,350,380,-156,223,668,2,4,193,204,282,285,18,1551,634
1609,17,5.0.304,1,565,0,98,304,402,0,304,402,402,0,0,512,1,6,261,98,261,402,18,1551,634
1609,18,2.1.215,1,565,0,95,215,310,215,0,310,402,-67,134,579,2,4,180,204,250,285,19,1551,536
1609,18,4.1.304,0,608,1,46,304,350,304,0,350,402,-156,223,668,2,4,193,204,282,285,19,1551,536
1609,18,5.1.402,0,565,0,63,402,465,402,0,465,465,-254,321,766,2,4,163,204,261,285,19,1551,536
1609,19,2.2.310,1,565,0,12,310,322,310,0,322,402,-61,119,640,3,4,85,150,250,341,20,1551,441
1609,19,4.1.310,0,565,0,46,310,356,304,6,356,402,0,134,579,2,5,193,109,282,285,20,1551,441
1609,19,5.1.402,0,565,0,63,402,465,402,0,465,465,-92,226,671,2,5,163,109,261,285,20,1551,441
1609,20,2.3.348,1,565,0,66,348,414,322,26,414,414,0,151,640,4,4,73,97,250,294,21,1551,429
1609,20,4.1.310,0,565,0,46,310,356,304,6,356,402,0,134,640,2,5,193,109,282,285,21,1551,429
1609,20,5.1.402,0,565,0,63,402,465,402,0,465,465,-92,226,732,2,5,163,109,261,285,21,1551,429
1609,21,2.4.414,1,565,0,7,414,421,414,0,421,421,-34,270,674,5,4,7,85,250,229,22,1551,363
1609,21,4.1.310,0,565,0,46,310,356,304,6,356,414,0,134,640,2,5,193,109,282,285,22,1551,363
1609,21,5.1.402,0,565,0,63,402,465,402,0,465,465,-92,226,732,2,5,163,109,261,285,22,1551,363
1609,22,4.1.310,1,565,0,46,310,356,304,6,356,421,0,134,674,2,5,193,109,282,285,23,1551,356
1609,22,5.1.402,0,565,0,63,402,465,402,0,465,465,-92,226,766,2,5,163,109,261,285,23,1551,356
1609,23,4.2.356,1,565,0,85,356,441,356,0,441,441,-34,153,708,3,5,147,138,282,341,24,1551,310
1609,23,5.1.402,0,565,0,63,402,465,402,0,465,465,-46,180,720,2,6,163,63,261,285,24,1551,310
1609,24,4.3.441,1,565,0,11,441,452,441,0,452,452,-27,178,735,4,5,62,31,282,294,25,1551,225
1609,24,5.1.402,0,565,0,63,402,465,402,0,465,465,-46,180,754,2,6,163,63,261,285,25,1551,225
1609,25,4.4.452,1,565,0,51,452,503,452,0,503,503,-31,301,766,5,5,51,78,282,229,26,1551,214
1609,25,5.1.402,0,565,0,63,402,465,402,0,465,465,-46,180,781,2,6,163,63,261,285,26,1551,214
1609,26,5.1.402,1,565,0,63,402,465,402,0,465,503,-46,180,812,2,6,163,63,261,285,27,1551,163
1609,27,5.2.465,1,565,0,53,465,518,465,0,518,518,-24,177,836,3,6,100,53,261,341,28,1551,100
1609,28,5.3.518,1,565,0,20,518,538,518,0,538,538,-66,244,902,4,6,47,20,261,294,29,1551,47
1609,29,5.4.538,1,565,0,27,538,565,538,0,565,565,-35,336,937,5,6,27,27,261,229,30,1551,27
1610,0,0.0.0,0,544,3,60,0,60,0,0,60,60,0,0,0,1,1,300,220,300,220,1,1421,1421
1610,0,1.0.0,0,559,5,65,0,65,0,0,65,65,0,0,0,1,1,222,220,222,220,1,1421,1421
1610,0,2.0.0,1,507,1,17,0,17,0,0,17,17,0,0,0,1,1,277,220,277,220,1,1421,1421
1610,0,3.0.0,0,552,4,62,0,62,0,0,62,62,0,0,0,1,1,236,220,236,220,1,1421,1421
1610,0,4.0.0,0,510,2,12,0,12,0,0,12,12,0,0,0,1,1,222,220,222,220,1,1421,1421
1610,0,5.0.0,0,498,0,4,0,4,0,0,4,4,0,0,0,1,1,164,220,164,220,1,1421,1421
1610,1,0.0.17,0,507,0,60,17,77,0,17,77,77,0,0,0,1,2,300,203,300,220,2,1421,1404
1610,1,1.0.17,0,510,1,65,17,82,0,17,82,82,0,0,0,1,2,222,203,222,220,2,1421,1404
1610,1,2.1.17,0,507,0,89,17,106,17,0,106,106,-17,17,17,2,1,260,387,277,387,2,1421,1404
1610,1,3.0.17,0,507,0,62,17,79,0,17,79,79,0,0,0,1,2,236,203,236,220,2,1421,1404
1610,1,4.0.17,1,507,0,12,17,29,0,17,29,29,0,0,0,1,2,222,203,222,220,2,1421,1404
1610,1,5.0.17,0,507,0,4,17,21,0,17,21,21,0,0,0,1,2,164,203,164,220,2,1421,1404
1610,2,0.0.29,0,507,0,60,29,89,0,29,89,89,0,0,0,1,3,300,191,300,220,3,1421,1392
1610,2,1.0.29,0,515,2,65,29,94,0,29,94,94,0,0,0,1,3,222,191,222,220,3,1421,1392
1610,2,2.1.17,0,507,0,89,17,106,17,0,106,106,-17,17,17,2,1,260,387,277,387,3,1421,1392
1610,2,3.0.29,0,509,1,62,29,91,0,29,91,91,0,0,0,1,3,236,191,236,220,3,1421,1392
1610,2,4.1.29,0,534,3,98,29,127,29,0,127,127,-29,29,29,2,1,210,387,222,387,3,1421,1392
1610,2,5.0.29,1,507,0,4,29,33,0,29,33,33,0,0,0,1,3,164,191,164,220,3,1421,1392
1610,3,0.0.33,1,507,0,60,33,93,0,33,93,93,0,0,0,1,4,300,187,300,220,4,1421,1388
1610,3,1.0.33,0,515,2,65,33,98,0,33,98,98,0,0,0,1,4,222,187,222,220,4,1421,1388
1610,3,2.1.17,0,507,0,89,17,106,17,0,106,106,-17,17,17,2,1,260,387,277,387,4,1421,1388
1610,3,3.0.33,0,509,1,62,33,95,0,33,95,95,0,0,0,1,4,236,187,236,220,4,1421,1388
1610,3,4.1.29,0,534,4,98,29,127,29,0,127,127,-29,29,29,2,1,210,387,222,387,4,1421,1388
1610,3,5.1.33,0,527,3,47,33,80,33,0,80,80,-33,33,33,2,1,160,387,164,387,4,1421,1388
1610,4,0.1.93,0,536,4,6,93,99,93,0,99,99,-93,93,93,2,1,240,387,300,387,5,1421,1328
1610,4,1.0.93,0,510,1,65,93,158,0,93,158,158,0,0,0,1,5,222,127,222,220,5,1421,1328
1610,4,2.1.17,0,507,0,89,17,106,17,0,106,106,-17,17,17,2,1,260,387,277,387,5,1421,1328
1610,4,3.0.93,1,507,0,62,93,155,0,93,155,155,0,0,0,1,5,236,127,236,220,5,1421,1328
1610,4,4.1.29,0,534,3,98,29,127,29,0,127,127,-29,29,29,2,1,210,387,222,387,5,1421,1328
1610,4,5.1.33,0,527,2,47,33,80,33,0,80,93,-33,33,33,2,1,160,387,164,387,5,1421,1328
1610,5,0.1.93,0,536,2,6,93,99,93,0,99,155,-93,93,93,2,1,240,387,300,387,6,1421,1266
1610,5,1.0.155,1,507,0,65,155,220,0,155,220,220,0,0,0,1,6,222,65,222,220,6,1421,1266
1610,5,2.1.17,0,507,0,89,17,106,17,0,106,155,-17,17,17,2,1,260,387,277,387,6,1421,1266
1610,5,3.1.155,0,550,3,77,155,232,155,0,232,232,-155,155,155,2,1,174,387,236,387,6,1421,1266
1610,5,4.1.29,0,534,1,98,29,127,29,0,127,155,-29,29,29,2,1,210,387,222,387,6,1421,1266
1610,5,5.1.33,0,536,2,47,33,80,33,0,80,155,-33,33,33,2,1,160,387,164,387,6,1421,1266
1610,6,0.1.93,1,536,3,6,93,99,93,0,99,220,-93,93,93,2,1,240,387,300,387,7,1421,1201
1610,6,1.1.220,0,526,1,70,220,290,220,0,290,290,-220,220,220,2,1,157,387,222,387,7,1421,1201
1610,6,2.1.17,0,507,0,89,17,106,17,0,106,220,-17,17,17,2,1,260,387,277,387,7,1421,1201
1610,6,3.1.155,0,550,4,77,155,232,155,0,232,232,-155,155,155,2,1,174,387,236,387,7,1421,1201
1610,6,4.1.29,0,534,2,98,29,127,29,0,127,220,-29,29,29,2,1,210,387,222,387,7,1421,1201
1610,6,5.1.33,0,536,3,47,33,80,33,0,80,220,-33,33,33,2,1,160,387,164,387,7,1421,1201
1610,7,0.2.99,1,536,0,59,99,158,99,0,158,220,-99,99,192,3,1,234,309,300,309,8,1421,1195
1610,7,1.1.220,0,572,2,70,220,290,220,0,290,290,-121,214,214,2,2,157,381,222,387,8,1421,1195
1610,7,2.1.99,0,536,0,89,99,188,17,82,188,220,0,93,93,2,2,260,381,277,387,8,1421,1195
1610,7,3.1.155,0,592,3,77,155,232,155,0,232,232,-56,149,149,2,2,174,381,236,387,8,1421,1195
1610,7,4.1.99,0,545,1,98,99,197,29,70,197,220,0,93,93,2,2,210,381,222,387,8,1421,1195
1610,7,5.1.33,0,536,0,47,33,80,33,0,99,220,47,46,46,2,2,160,381,164,387,8,1421,1195
1610,8,0.3.158,1,536,0,83,158,241,158,0,241,241,-158,158,350,4,1,175,246,300,246,9,1421,1136
1610,8,1.1.220,0,572,2,70,220,290,220,0,290,290,-121,214,313,2,2,157,381,222,387,9,1421,1136
1610,8,2.1.99,0,536,0,89,99,188,17,82,188,220,0,93,192,2,2,260,381,277,387,9,1421,1136
1610,8,3.1.155,0,592,3,77,155,232,155,0,232,232,-56,149,248,2,2,174,381,236,387,9,1421,1136
1610,8,4.1.99,0,545,1,98,99,197,29,70,197,220,0,93,192,2,2,210,381,222,387,9,1421,1136
1610,8,5.1.33,0,536,0,47,33,80,33,0,99,220,47,46,145,2,2,160,381,164,387,9,1421,1136
1610,9,0.4.241,1,536,0,92,241,333,241,0,333,333,-241,241,591,5,1,92,259,300,259,10,1421,1053
1610,9,1.1.220,0,572,2,70,220,290,220,0,290,290,-121,214,471,2,2,157,381,222,387,10,1421,1053
1610,9,2.1.99,0,536,0,89,99,188,17,82,188,241,0,93,350,2,2,260,381,277,387,10,1421,1053
1610,9,3.1.155,0,592,3,77,155,232,155,0,232,241,-56,149,406,2,2,174,381,236,387,10,1421,1053
1610,9,4.1.99,0,545,1,98,99,197,29,70,197,241,0,93,350,2,2,210,381,222,387,10,1421,1053
1610,9,5.1.33,0,536,0,47,33,80,33,0,99,241,47,46,303,2,2,160,381,164,387,10,1421,1053
1610,10,1.1.220,0,572,2,70,220,290,220,0,290,333,-121,214,712,2,2,157,381,222,387,11,1421,961
1610,10,2.1.99,0,536,0,89,99,188,17,82,188,333,0,93,591,2,2,260,381,277,387,11,1421,961
1610,10,3.1.155,0,592,3,77,155,232,155,0,232,333,-56,149,647,2,2,174,381,236,387,11,1421,961
1610,10,4.1.99,0,545,1,98,99,197,29,70,197,333,0,93,591,2,2,210,381,222,387,11,1421,961
1610,10,5.1.33,1,536,0,47,33,80,33,0,99,333,47,46,544,2,2,160,381,164,387,11,1421,961
1610,11,1.1.220,0,572,2,70,220,290,220,0,290,333,-121,167,665,2,3,157,334,222,387,12,1421,914
1610,11,2.1.99,0,536,0,89,99,188,17,82,188,333,0,46,544,2,3,260,334,277,387,12,1421,914
1610,11,3.1.155,0,592,3,77,155,232,155,0,232,333,-56,102,600,2,3,174,334,236,387,12,1421,914
1610,11,4.1.99,0,545,1,98,99,197,29,70,197,333,0,46,544,2,3,210,334,222,387,12,1421,914
1610,11,5.2.158,1,536,0,91,158,249,80,78,249,333,0,99,544,3,2,113,250,164,309,12,1421,914
1610,12,1.1.220,0,572,2,70,220,290,220,0,290,333,-121,167,665,2,3,157,334,222,387,13,1421,823
1610,12,2.1.99,0,536,0,89,99,188,17,82,188,333,0,46,544,2,3,260,334,277,387,13,1421,823
1610,12,3.1.155,0,592,3,77,155,232,155,0,232,333,-56,102,600,2,3,174,334,236,387,13,1421,823
1610,12,4.1.99,0,545,1,98,99,197,29,70,197,333,0,46,544,2,3,210,334,222,387,13,1421,823
1610,12,5.3.249,1,536,0,4,249,253,249,0,253,333,-8,166,552,4,2,22,163,164,246,13,1421,823
1610,13,1.1.220,0,572,2,70,220,290,220,0,290,333,-121,167,673,2,3,157,334,222,387,14,1421,819
1610,13,2.1.99,0,536,0,89,99,188,17,82,188,333,0,46,552,2,3,260,334,277,387,14,1421,819
1610,13,3.1.155,0,592,3,77,155,232,155,0,232,333,-56,102,608,2,3,174,334,236,387,14,1421,819
1610,13,4.1.99,0,545,1,98,99,197,29,70,197,333,0,46,552,2,3,210,334,222,387,14,1421,819
1610,13,5.4.333,1,536,0,18,333,351,253,80,351,351,0,241,552,5,2,18,167,164,259,14,1421,819
1610,14,1.1.220,0,572,2,70,220,290,220,0,290,351,-121,167,673,2,3,157,334,222,387,15,1421,801
1610,14,2.1.99,1,536,0,89,99,188,17,82,188,351,0,46,552,2,3,260,334,277,387,15,1421,801
1610,14,3.1.155,0,592,3,77,155,232,155,0,232,351,-56,102,608,2,3,174,334,236,387,15,1421,801
1610,14,4.1.99,0,545,1,98,99,197,29,70,197,351,0,46,552,2,3,210,334,222,387,15,1421,801
1610,15,1.1.220,0,572,2,70,220,290,220,0,290,351,-32,78,584,2,4,157,245,222,387,16,1421,712
1610,15,2.2.249,1,536,0,65,249,314,188,61,314,351,0,99,552,3,3,171,159,277,309,16,1421,712
1610,15,3.1.188,0,536,0,77,188,265,155,33,265,351,0,46,552,2,4,174,245,236,387,16,1421,712
1610,15,4.1.188,0,539,1,98,188,286,29,159,286,351,0,46,552,2,4,210,245,222,387,16,1421,712
1610,16,1.1.220,0,572,2,70,220,290,220,0,290,351,-32,78,584,2,4,157,245,222,387,17,1421,647
1610,16,2.3.314,1,536,0,35,314,349,314,0,349,351,-61,227,613,4,3,106,159,277,246,17,1421,647
1610,16,3.1.188,0,536,0,77,188,265,155,33,265,351,0,46,552,2,4,174,245,236,387,17,1421,647
1610,16,4.1.188,0,539,1,98,188,286,29,159,286,351,0,46,552,2,4,210,245,222,387,17,1421,647
1610,17,1.1.220,0,572,2,70,220,290,220,0,290,351,-32,78,645,2,4,157,245,222,387,18,1421,612
1610,17,2.4.351,1,536,0,71,351,422,349,2,422,422,0,241,613,5,3,71,149,277,259,18,1421,612
1610,17,3.1.188,0,536,0,77,188,265,155,33,265,351,0,46,613,2,4,174,245,236,387,18,1421,612
1610,17,4.1.188,0,539,1,98,188,286,29,159,286,351,0,46,613,2,4,210,245,222,387,18,1421,612
1610,18,1.1.220,0,572,2,70,220,290,220,0,290,422,-32,78,645,2,4,157,245,222,387,19,1421,541
1610,18,3.1.188,0,536,0,77,188,265,155,33,265,422,0,46,613,2,4,174,245,236,387,19,1421,541
1610,18,4.1.188,1,539,1,98,188,286,29,159,286,422,0,46,613,2,4,210,245,222,387,19,1421,541
1610,19,1.1.286,0,540,1,70,286,356,220,66,356,422,0,46,613,2,5,157,147,222,387,20,1421,443
1610,19,3.1.286,0,539,0,77,286,363,155,131,363,422,0,46,613,2,5,174,147,236,387,20,1421,443
1610,19,4.2.314,1,540,1,86,314,400,286,28,400,422,0,99,613,3,4,112,94,222,309,20,1421,443
1610,20,1.1.286,0,540,0,70,286,356,220,66,356,422,0,46,613,2,5,157,147,222,387,21,1421,357
1610,20,3.1.286,0,565,1,77,286,363,155,131,363,422,0,46,613,2,5,174,147,236,387,21,1421,357
1610,20,4.3.400,1,540,0,4,400,404,400,0,404,422,-51,278,664,4,4,26,124,222,246,21,1421,357
1610,21,1.1.286,0,540,0,70,286,356,220,66,356,422,0,46,664,2,5,157,147,222,387,22,1421,353
1610,21,3.1.286,0,565,1,77,286,363,155,131,363,422,0,46,664,2,5,174,147,236,387,22,1421,353
1610,21,4.4.422,1,540,0,22,422,444,404,18,444,444,0,241,664,5,4,22,78,222,259,22,1421,353
1610,22,1.1.286,0,540,0,70,286,356,220,66,356,444,0,46,664,2,5,157,147,222,387,23,1421,331
1610,22,3.1.286,1,565,1,77,286,363,155,131,363,444,0,46,664,2,5,174,147,236,387,23,1421,331
1610,23,1.1.363,0,565,0,70,363,433,220,143,433,444,0,46,664,2,6,157,70,222,387,24,1421,254
1610,23,3.2.400,1,565,0,3,400,403,363,37,403,444,0,99,664,3,5,97,8,236,309,24,1421,254
1610,24,1.1.363,1,565,0,70,363,433,220,143,433,444,0,46,664,2,6,157,70,222,387,25,1421,251
1610,24,3.3.404,0,565,0,79,404,483,403,1,483,483,0,278,664,4,5,94,120,236,246,25,1421,251
1610,25,1.2.433,1,565,0,5,433,438,433,0,438,444,-30,129,694,3,6,87,5,222,309,26,1421,181
1610,25,3.3.404,0,565,0,79,404,483,403,1,483,483,0,278,664,4,5,94,120,236,246,26,1421,181
1610,26,1.3.438,1,573,1,41,438,479,438,0,479,479,-34,312,728,4,5,82,120,222,246,27,1421,176
1610,26,3.3.404,0,565,0,79,404,483,403,1,483,483,0,278,694,4,5,94,120,236,246,27,1421,176
1610,27,1.4.479,1,573,0,41,479,520,479,0,520,520,-35,276,763,5,5,41,56,222,259,28,1421,135
1610,27,3.3.479,0,573,0,79,479,558,403,76,558,558,0,312,728,4,6,94,79,236,246,28,1421,135
1610,28,3.3.479,1,573,0,79,479,558,403,76,558,558,0,312,763,4,6,94,79,236,246,29,1421,94
1610,29,3.4.558,1,573,0,15,558,573,558,0,573,573,-38,314,801,5,6,15,15,236,259,30,1421,15
1611,0,0.0.0,0,586,5,73,0,73,0,0,73,73,0,0,0,1,1,344,233,344,233,1,1488,1488
1611,0,1.0.0,0,536,2,41,0,41,0,0,41,41,0,0,0,1,1,222,233,222,233,1,1488,1488
1611,0,2.0.0,0,575,4,62,0,62,0,0,62,62,0,0,0,1,1,203,233,203,233,1,1488,1488
1611,0,3.0.0,0,519,1,16,0,16,0,0,16,16,0,0,0,1,1,197,233,197,233,1,1488,1488
1611,0,4.0.0,1,543,3,33,0,33,0,0,33,33,0,0,0,1,1,357,233,357,233,1,1488,1488
1611,0,5.0.0,0,513,0,8,0,8,0,0,8,8,0,0,0,1,1,165,233,165,233,1,1488,1488
1611,1,0.0.33,0,578,3,73,33,106,0,33,106,106,0,0,0,1,2,344,200,344,233,2,1488,1455
1611,1,1.0.33,0,553,2,41,33,74,0,33,74,74,0,0,0,1,2,222,200,222,233,2,1488,1455
1611,1,2.0.33,0,578,3,62,33,95,0,33,95,95,0,0,0,1,2,203,200,203,233,2,1488,1455
1611,1,3.0.33,1,543,0,16,33,49,0,33,49,49,0,0,0,1,2,197,200,197,233,2,1488,1455
1611,1,4.1.33,0,553,2,50,33,83,33,0,83,83,-33,33,33,2,1,324,289,357,289,2,1488,1455
1611,1,5.0.33,0,546,1,8,33,41,0,33,41,41,0,0,0,1,2,165,200,165,233,2,1488,1455
1611,2,0.0.49,0,578,3,73,49,122,0,49,122,122,0,0,0,1,3,344,184,344,233,3,1488,1439
1611,2,1.0.49,0,543,0,41,49,90,0,49,90,90,0,0,0,1,3,222,184,222,233,3,1488,1439
1611,2,2.0.49,0,574,2,62,49,111,0,49,111,111,0,0,0,1,3,203,184,203,233,3,1488,1439
1611,2,3.1.49,0,543,0,16,49,65,49,0,65,65,-49,49,49,2,1,181,289,197,289,3,1488,1439
1611,2,4.1.33,0,560,1,50,33,83,33,0,83,83,-33,33,33,2,1,324,289,357,289,3,1488,1439
1611,2,5.0.49,1,543,0,8,49,57,0,49,57,57,0,0,0,1,3,165,184,165,233,3,1488,1439
1611,3,0.0.57,1,578,3,73,57,130,0,57,130,130,0,0,0,1,4,344,176,344,233,4,1488,1431
1611,3,1.0.57,0,543,0,41,57,98,0,57,98,98,0,0,0,1,4,222,176,222,233,4,1488,1431
1611,3,2.0.57,0,562,1,62,57,119,0,57,119,119,0,0,0,1,4,203,176,203,233,4,1488,1431
1611,3,3.1.49,0,543,0,16,49,65,49,0,65,65,-49,49,49,2,1,181,289,197,289,4,1488,1431
1611,3,4.1.33,0,568,2,50,33,83,33,0,83,83,-33,33,33,2,1,324,289,357,289,4,1488,1431
1611,3,5.1.57,0,562,1,30,57,87,57,0,87,87,-57,57,57,2,1,157,289,165,289,4,1488,1431
1611,4,0.1.130,0,578,0,73,130,203,130,0,203,203,-130,130,130,2,1,271,289,344,289,5,1488,1358
1611,4,1.0.130,1,578,0,41,130,171,0,130,171,171,0,0,0,1,5,222,103,222,233,5,1488,1358
1611,4,2.0.130,0,578,0,62,130,192,0,130,192,192,0,0,0,1,5,203,103,203,233,5,1488,1358
1611,4,3.1.49,0,580,1,16,49,65,49,0,65,130,-49,49,49,2,1,181,289,197,289,5,1488,1358
1611,4,4.1.33,0,578,0,50,33,83,33,0,83,130,-33,33,33,2,1,324,289,357,289,5,1488,1358
1611,4,5.1.57,0,586,2,30,57,87,57,0,87,130,-57,57,57,2,1,157,289,165,289,5,1488,1358
1611,5,0.1.130,0,578,0,73,130,203,130,0,203,203,-130,130,130,2,1,271,289,344,289,6,1488,1317
1611,5,1.1.171,0,578,0,38,171,209,171,0,209,209,-171,171,171,2,1,181,289,222,289,6,1488,1317
1611,5,2.0.171,1,578,0,62,171,233,0,171,233,233,0,0,0,1,6,203,62,203,233,6,1488,1317
1611,5,3.1.49,0,580,1,16,49,65,49,0,65,171,-49,49,49,2,1,181,289,197,289,6,1488,1317
1611,5,4.1.33,0,578,0,50,33,83,33,0,83,171,-33,33,33,2,1,324,289,357,289,6,1488,1317
1611,5,5.1.57,0,586,2,30,57,87,57,0,87,171,-57,57,57,2,1,157,289,165,289,6,1488,1317
1611,6,0.1.130,0,578,0,73,130,203,130,0,203,233,-130,130,130,2,1,271,289,344,289,7,1488,1255
1611,6,1.1.171,0,578,0,38,171,209,171,0,209,233,-171,171,171,2,1,181,289,222,289,7,1488,1255
1611,6,2.1.233,0,578,0,82,233,315,233,0,315,315,-233,233,233,2,1,141,289,203,289,7,1488,1255
1611,6,3.1.49,0,580,1,16,49,65,49,0,65,233,-49,49,49,2,1,181,289,197,289,7,1488,1255
1611,6,4.1.33,1,578,0,50,33,83,33,0,83,233,-33,33,33,2,1,324,289,357,289,7,1488,1255
1611,6,5.1.57,0,586,2,30,57,87,57,0,87,233,-57,57,57,2,1,157,289,165,289,7,1488,1255
1611,7,0.1.130,0,578,0,73,130,203,130,0,203,233,-47,80,80,2,2,271,239,344,289,8,1488,1205
1611,7,1.1.171,0,578,0,38,171,209,171,0,209,233,-88,121,121,2,2,181,239,222,289,8,1488,1205
1611,7,2.1.233,0,578,0,82,233,315,233,0,315,315,-150,183,183,2,2,141,239,203,289,8,1488,1205
1611,7,3.1.83,0,578,0,16,83,99,49,34,99,233,0,33,33,2,2,181,239,197,289,8,1488,1205
1611,7,4.2.83,1,578,0,87,83,170,83,0,170,233,-83,83,116,3,1,274,278,357,278,8,1488,1205
1611,7,5.1.83,0,578,0,30,83,113,57,26,113,233,0,33,33,2,2,157,239,165,289,8,1488,1205
1611,8,0.1.130,0,578,0,73,130,203,130,0,203,233,-47,80,163,2,2,271,239,344,289,9,1488,1118
1611,8,1.1.171,0,578,0,38,171,209,171,0,209,233,-88,121,204,2,2,181,239,222,289,9,1488,1118
1611,8,2.1.233,0,578,0,82,233,315,233,0,315,315,-150,183,266,2,2,141,239,203,289,9,1488,1118
1611,8,3.1.83,1,578,0,16,83,99,49,34,99,233,0,33,116,2,2,181,239,197,289,9,1488,1118
1611,8,4.3.170,0,578,0,96,170,266,170,0,266,266,-170,170,286,4,1,187,399,357,399,9,1488,1118
1611,8,5.1.83,0,578,0,30,83,113,57,26,113,233,0,33,116,2,2,157,239,165,289,9,1488,1118
1611,9,0.1.130,0,578,0,73,130,203,130,0,203,233,-31,64,147,2,3,271,223,344,289,10,1488,1102
1611,9,1.1.171,0,578,0,38,171,209,171,0,209,233,-72,105,188,2,3,181,223,222,289,10,1488,1102
1611,9,2.1.233,0,578,0,82,233,315,233,0,315,315,-134,167,250,2,3,141,223,203,289,10,1488,1102
1611,9,3.2.170,1,578,0,70,170,240,99,71,240,240,0,83,116,3,2,165,191,197,278,10,1488,1102
1611,9,4.3.170,0,578,0,96,170,266,170,0,266,266,-170,170,286,4,1,187,399,357,399,10,1488,1102
1611,9,5.1.99,0,578,0,30,99,129,57,42,129,233,0,33,116,2,3,157,223,165,289,10,1488,1102
1611,10,0.1.130,0,578,0,73,130,203,130,0,203,240,-31,64,147,2,3,271,223,344,289,11,1488,1032
1611,10,1.1.171,0,578,0,38,171,209,171,0,209,240,-72,105,188,2,3,181,223,222,289,11,1488,1032
1611,10,2.1.233,0,578,0,82,233,315,233,0,315,315,-134,167,250,2,3,141,223,203,289,11,1488,1032
1611,10,3.3.240,0,648,1,38,240,278,240,0,278,278,-240,240,356,4,1,95,399,197,399,11,1488,1032
1611,10,4.3.170,0,578,0,96,170,266,170,0,266,266,-170,170,286,4,1,187,399,357,399,11,1488,1032
1611,10,5.1.99,1,578,0,30,99,129,57,42,129,240,0,33,116,2,3,157,223,165,289,11,1488,1032
1611,11,0.1.130,0,578,0,73,130,203,130,0,203,240,-1,34,117,2,4,271,193,344,289,12,1488,1002
1611,11,1.1.171,0,578,0,38,171,209,171,0,209,240,-42,75,158,2,4,181,193,222,289,12,1488,1002
1611,11,2.1.233,0,578,0,82,233,315,233,0,315,315,-104,137,220,2,4,141,193,203,289,12,1488,1002
1611,11,3.3.240,0,648,1,38,240,278,240,0,278,278,-240,240,356,4,1,95,399,197,399,12,1488,1002
1611,11,4.3.170,0,578,0,96,170,266,170,0,266,266,-170,170,286,4,1,187,399,357,399,12,1488,1002
1611,11,5.2.240,1,578,0,30,240,270,129,111,270,270,0,83,116,3,3,127,121,165,278,12,1488,1002
1611,12,0.1.130,1,578,0,73,130,203,130,0,203,270,-1,34,117,2,4,271,193,344,289,13,1488,972
1611,12,1.1.171,0,578,0,38,171,209,171,0,209,270,-42,75,158,2,4,181,193,222,289,13,1488,972
1611,12,2.1.233,0,607,1,82,233,315,233,0,315,315,-104,137,220,2,4,141,193,203,289,13,1488,972
1611,12,3.3.240,0,648,3,38,240,278,240,0,278,278,-240,240,356,4,1,95,399,197,399,13,1488,972
1611,12,4.3.170,0,578,0,96,170,266,170,0,266,270,-170,170,286,4,1,187,399,357,399,13,1488,972
1611,12,5.3.270,0,618,2,88,270,358,270,0,358,358,-270,270,386,4,1,97,399,165,399,13,1488,972
1611,13,0.2.270,1,607,1,63,270,333,203,67,333,333,0,83,117,3,4,198,91,344,278,14,1488,899
1611,13,1.1.203,0,578,0,38,203,241,171,32,241,270,0,34,117,2,5,181,120,222,289,14,1488,899
1611,13,2.1.233,0,607,1,82,233,315,233,0,315,315,-30,64,147,2,5,141,120,203,289,14,1488,899
1611,13,3.3.240,0,648,3,38,240,278,240,0,278,278,-240,240,357,4,1,95,399,197,399,14,1488,899
1611,13,4.3.170,0,578,0,96,170,266,170,0,266,270,-170,170,287,4,1,187,399,357,399,14,1488,899
1611,13,5.3.270,0,618,2,88,270,358,270,0,358,358,-270,270,387,4,1,97,399,165,399,14,1488,899
1611,14,0.3.333,0,607,0,90,333,423,333,0,423,423,-333,333,450,4,1,135,399,344,399,15,1488,836
1611,14,1.1.203,1,607,0,38,203,241,171,32,241,333,0,34,117,2,5,181,120,222,289,15,1488,836
1611,14,2.1.233,0,607,0,82,233,315,233,0,315,333,-30,64,147,2,5,141,120,203,289,15,1488,836
1611,14,3.3.240,0,648,2,38,240,278,240,0,278,333,-240,240,357,4,1,95,399,197,399,15,1488,836
1611,14,4.3.170,0,607,0,96,170,266,170,0,266,333,-170,170,287,4,1,187,399,357,399,15,1488,836
1611,14,5.3.270,0,618,1,88,270,358,270,0,358,358,-270,270,387,4,1,97,399,165,399,15,1488,836
1611,15,0.3.333,0,607,0,90,333,423,333,0,423,423,-333,333,450,4,1,135,399,344,399,16,1488,798
1611,15,1.2.333,1,607,0,10,333,343,241,92,343,343,0,83,117,3,5,143,28,222,278,16,1488,798
1611,15,2.1.241,0,607,0,82,241,323,233,8,323,333,0,34,117,2,6,141,82,203,289,16,1488,798
1611,15,3.3.240,0,648,2,38,240,278,240,0,278,333,-240,240,357,4,1,95,399,197,399,16,1488,798
1611,15,4.3.170,0,607,0,96,170,266,170,0,266,333,-170,170,287,4,1,187,399,357,399,16,1488,798
1611,15,5.3.270,0,618,1,88,270,358,270,0,358,358,-270,270,387,4,1,97,399,165,399,16,1488,798
1611,16,0.3.333,0,607,0,90,333,423,333,0,423,423,-333,333,450,4,1,135,399,344,399,17,1488,788
1611,16,1.3.343,0,617,1,83,343,426,343,0,426,426,-343,343,460,4,1,133,399,222,399,17,1488,788
1611,16,2.1.241,1,607,0,82,241,323,233,8,323,343,0,34,117,2,6,141,82,203,289,17,1488,788
1611,16,3.3.240,0,648,3,38,240,278,240,0,278,343,-240,240,357,4,1,95,399,197,399,17,1488,788
1611,16,4.3.170,0,607,0,96,170,266,170,0,266,343,-170,170,287,4,1,187,399,357,399,17,1488,788
1611,16,5.3.270,0,618,2,88,270,358,270,0,358,358,-270,270,387,4,1,97,399,165,399,17,1488,788
1611,17,0.3.333,0,607,0,90,333,423,333,0,423,423,-333,333,450,4,1,135,399,344,399,18,1488,706
1611,17,1.3.343,0,617,1,83,343,426,343,0,426,426,-343,343,460,4,1,133,399,222,399,18,1488,706
1611,17,2.2.343,1,607,0,18,343,361,323,20,361,361,0,83,117,3,6,59,18,203,278,18,1488,706
1611,17,3.3.240,0,648,3,38,240,278,240,0,278,343,-240,240,357,4,1,95,399,197,399,18,1488,706
1611,17,4.3.170,0,607,0,96,170,266,170,0,266,343,-170,170,287,4,1,187,399,357,399,18,1488,706
1611,17,5.3.270,0,618,2,88,270,358,270,0,358,358,-270,270,387,4,1,97,399,165,399,18,1488,706
1611,18,0.3.333,0,607,0,90,333,423,333,0,423,423,-333,333,450,4,1,135,399,344,399,19,1488,688
1611,18,1.3.343,0,617,1,83,343,426,343,0,426,426,-343,343,460,4,1,133,399,222,399,19,1488,688
1611,18,2.3.361,0,621,3,4,361,365,361,0,365,365,-361,361,478,4,1,41,399,203,399,19,1488,688
1611,18,3.3.240,0,648,4,38,240,278,240,0,278,361,-240,240,357,4,1,95,399,197,399,19,1488,688
1611,18,4.3.170,1,607,0,96,170,266,170,0,266,361,-170,170,287,4,1,187,399,357,399,19,1488,688
1611,18,5.3.270,0,618,2,88,270,358,270,0,358,361,-270,270,387,4,1,97,399,165,399,19,1488,688
1611,19,0.3.333,0,607,0,90,333,423,333,0,423,423,-67,237,354,4,2,135,303,344,399,20,1488,592
1611,19,1.3.343,0,617,1,83,343,426,343,0,426,426,-77,247,364,4,2,133,303,222,399,20,1488,592
1611,19,2.3.361,0,621,3,4,361,365,361,0,365,365,-95,265,382,4,2,41,303,203,399,20,1488,592
1611,19,3.3.266,0,607,0,38,266,304,240,26,304,361,0,170,287,4,2,95,303,197,399,20,1488,592
1611,19,4.4.266,1,607,0,91,266,357,266,0,357,361,-266,266,553,5,1,91,289,357,289,20,1488,592
1611,19,5.3.270,0,618,2,88,270,358,270,0,358,361,-4,174,291,4,2,97,303,165,399,20,1488,592
1611,20,0.3.333,0,607,0,90,333,423,333,0,423,423,-67,237,620,4,2,135,303,344,399,21,1488,501
1611,20,1.3.343,0,617,1,83,343,426,343,0,426,426,-77,247,630,4,2,133,303,222,399,21,1488,501
1611,20,2.3.361,0,621,3,4,361,365,361,0,365,365,-95,265,648,4,2,41,303,203,399,21,1488,501
1611,20,3.3.266,1,607,0,38,266,304,240,26,304,361,0,170,553,4,2,95,303,197,399,21,1488,501
1611,20,5.3.270,0,618,2,88,270,358,270,0,358,361,-4,174,557,4,2,97,303,165,399,21,1488,501
1611,21,0.3.333,0,607,0,90,333,423,333,0,423,423,-29,199,582,4,3,135,265,344,399,22,1488,463
1611,21,1.3.343,0,617,2,83,343,426,343,0,426,426,-39,209,592,4,3,133,265,222,399,22,1488,463
1611,21,2.3.361,0,635,3,4,361,365,361,0,365,365,-57,227,610,4,3,41,265,203,399,22,1488,463
1611,21,3.4.357,1,607,0,57,357,414,304,53,414,414,0,266,553,5,2,57,198,197,289,22,1488,463
1611,21,5.3.304,0,614,1,88,304,392,270,34,392,392,0,170,553,4,3,97,265,165,399,22,1488,463
1611,22,0.3.333,0,607,0,90,333,423,333,0,423,423,-29,199,582,4,3,135,265,344,399,23,1488,406
1611,22,1.3.343,0,617,2,83,343,426,343,0,426,426,-39,209,592,4,3,133,265,222,399,23,1488,406
1611,22,2.3.361,1,635,3,4,361,365,361,0,365,414,-57,227,610,4,3,41,265,203,399,23,1488,406
1611,22,5.3.304,0,614,1,88,304,392,270,34,392,414,0,170,553,4,3,97,265,165,399,23,1488,406
1611,23,0.3.365,0,635,0,90,365,455,333,32,455,455,0,227,610,4,4,135,261,344,399,24,1488,402
1611,23,1.3.365,0,635,0,83,365,448,343,22,448,448,0,227,610,4,4,133,261,222,399,24,1488,402
1611,23,2.4.414,1,635,0,37,414,451,365,49,451,451,0,266,610,5,3,37,141,203,289,24,1488,402
1611,23,5.3.365,0,671,1,88,365,453,270,95,453,453,0,227,610,4,4,97,261,165,399,24,1488,402
1611,24,0.3.365,1,635,0,90,365,455,333,32,455,455,0,227,610,4,4,135,261,344,399,25,1488,365
1611,24,1.3.365,0,635,0,83,365,448,343,22,448,451,0,227,610,4,4,133,261,222,399,25,1488,365
1611,24,5.3.365,0,671,1,88,365,453,270,95,453,453,0,227,610,4,4,97,261,165,399,25,1488,365
1611,25,0.4.455,1,635,0,45,455,500,455,0,500,500,-4,270,614,5,4,45,104,344,289,26,1488,275
1611,25,1.3.455,0,635,0,83,455,538,343,112,538,538,0,227,610,4,5,133,171,222,399,26,1488,275
1611,25,5.3.455,0,676,1,88,455,543,270,185,543,543,0,227,610,4,5,97,171,165,399,26,1488,275
1611,26,1.3.455,0,635,0,83,455,538,343,112,538,538,0,227,614,4,5,133,171,222,399,27,1488,230
1611,26,5.3.455,1,676,1,88,455,543,270,185,543,543,0,227,614,4,5,97,171,165,399,27,1488,230
1611,27,1.3.543,0,676,0,83,543,626,343,200,626,626,0,227,614,4,6,133,83,222,399,28,1488,142
1611,27,5.4.543,1,676,0,9,543,552,543,0,552,552,-43,313,657,5,5,9,59,165,289,28,1488,142
1611,28,1.3.543,1,676,0,83,543,626,343,200,626,626,0,227,657,4,6,133,83,222,399,29,1488,133
1611,29,1.4.626,1,676,0,50,626,676,626,0,676,676,-74,387,731,5,6,50,50,222,289,30,1488,50
1612,0,0.0.0,0,629,4,87,0,87,0,0,87,87,0,0,0,1,1,389,249,389,249,1,1658,1658
1612,0,1.0.0,0,554,0,17,0,17,0,0,17,17,0,0,0,1,1,123,249,123,249,1,1658,1658
1612,0,2.0.0,0,563,1,9,0,9,0,0,9,9,0,0,0,1,1,231,249,231,249,1,1658,1658
1612,0,3.0.0,0,610,3,68,0,68,0,0,68,68,0,0,0,1,1,354,249,354,249,1,1658,1658
1612,0,4.0.0,0,609,2,55,0,55,0,0,55,55,0,0,0,1,1,295,249,295,249,1,1658,1658
1612,0,5.0.0,1,554,0,13,0,13,0,0,13,13,0,0,0,1,1,266,249,266,249,1,1658,1658
1612,1,0.0.13,0,588,4,87,13,100,0,13,100,100,0,0,0,1,2,389,236,389,249,2,1658,1645
1612,1,1.0.13,0,554,0,17,13,30,0,13,30,30,0,0,0,1,2,123,236,123,249,2,1658,1645
1612,1,2.0.13,0,563,1,9,13,22,0,13,22,22,0,0,0,1,2,231,236,231,249,2,1658,1645
1612,1,3.0.13,0,576,2,68,13,81,0,13,81,81,0,0,0,1,2,354,236,354,249,2,1658,1645
1612,1,4.0.13,0,584,3,55,13,68,0,13,68,68,0,0,0,1,2,295,236,295,249,2,1658,1645
1612,1,5.1.13,1,554,0,13,13,26,13,0,26,26,-13,13,13,2,1,253,195,266,195,2,1658,1645
1612,2,0.0.13,0,588,5,87,13,100,0,13,100,100,0,0,13,1,2,389,236,389,249,3,1658,1632
1612,2,1.0.13,0,554,0,17,13,30,0,13,30,30,0,0,13,1,2,123,236,123,249,3,1658,1632
1612,2,2.0.13,1,563,1,9,13,22,0,13,22,26,0,0,13,1,2,231,236,231,249,3,1658,1632
1612,2,3.0.13,0,576,3,68,13,81,0,13,81,81,0,0,13,1,2,354,236,354,249,3,1658,1632
1612,2,4.0.13,0,584,4,55,13,68,0,13,68,68,0,0,13,1,2,295,236,295,249,3,1658,1632
1612,2,5.2.26,0,565,2,68,26,94,26,0,94,94,-26,26,39,3,1,240,344,266,344,3,1658,1632
1612,3,0.0.22,0,597,5,87,22,109,0,22,109,109,0,0,13,1,3,389,227,389,249,4,1658,1623
1612,3,1.0.22,0,563,0,17,22,39,0,22,39,39,0,0,13,1,3,123,227,123,249,4,1658,1623
1612,3,2.1.26,1,580,2,76,26,102,22,4,102,102,0,13,13,2,2,222,182,231,195,4,1658,1623
1612,3,3.0.22,0,584,3,68,22,90,0,22,90,90,0,0,13,1,3,354,227,354,249,4,1658,1623
1612,3,4.0.22,0,587,4,55,22,77,0,22,77,77,0,0,13,1,3,295,227,295,249,4,1658,1623
1612,3,5.2.26,0,565,1,68,26,94,26,0,94,94,-26,26,39,3,1,240,344,266,344,4,1658,1623
1612,4,0.0.22,0,597,3,87,22,109,0,22,109,109,0,0,13,1,3,389,227,389,249,5,1658,1547
1612,4,1.0.22,0,580,0,17,22,39,0,22,39,102,0,0,13,1,3,123,227,123,249,5,1658,1547
1612,4,2.2.102,0,584,1,71,102,173,102,0,173,173,-102,102,115,3,1,146,344,231,344,5,1658,1547
1612,4,3.0.22,1,584,1,68,22,90,0,22,90,102,0,0,13,1,3,354,227,354,249,5,1658,1547
1612,4,4.0.22,0,595,2,55,22,77,0,22,77,102,0,0,13,1,3,295,227,295,249,5,1658,1547
1612,4,5.2.26,0,580,0,68,26,94,26,0,94,102,-26,26,39,3,1,240,344,266,344,5,1658,1547
1612,5,0.0.90,0,599,1,87,90,177,0,90,177,177,0,0,13,1,4,389,159,389,249,6,1658,1479
1612,5,1.0.90,0,584,0,17,90,107,0,90,107,107,0,0,13,1,4,123,159,123,249,6,1658,1479
1612,5,2.2.102,0,584,0,71,102,173,102,0,173,173,-102,102,115,3,1,146,344,231,344,6,1658,1479
1612,5,3.1.102,1,584,0,54,102,156,90,12,156,156,0,13,13,2,3,286,106,354,195,6,1658,1479
1612,5,4.0.90,0,604,2,55,90,145,0,90,145,145,0,0,13,1,4,295,159,295,249,6,1658,1479
1612,5,5.2.26,0,584,0,68,26,94,26,0,94,102,-26,26,39,3,1,240,344,266,344,6,1658,1479
1612,6,0.0.90,1,599,2,87,90,177,0,90,177,177,0,0,13,1,4,389,159,389,249,7,1658,1425
1612,6,1.0.90,0,584,0,17,90,107,0,90,107,156,0,0,13,1,4,123,159,123,249,7,1658,1425
1612,6,2.2.102,0,584,0,71,102,173,102,0,173,173,-102,102,115,3,1,146,344,231,344,7,1658,1425
1612,6,3.2.156,0,591,1,37,156,193,156,0,193,193,-156,156,169,3,1,232,344,354,344,7,1658,1425
1612,6,4.0.90,0,604,3,55,90,145,0,90,145,156,0,0,13,1,4,295,159,295,249,7,1658,1425
1612,6,5.2.26,0,584,0,68,26,94,26,0,94,156,-26,26,39,3,1,240,344,266,344,7,1658,1425
1612,7,0.1.177,1,608,1,42,177,219,177,0,219,219,-21,34,34,2,4,302,52,389,195,8,1658,1338
1612,7,1.0.177,0,599,0,17,177,194,0,177,194,194,0,0,13,1,5,123,72,123,249,8,1658,1338
1612,7,2.2.102,0,608,1,71,102,173,102,0,173,177,-102,102,115,3,1,146,344,231,344,8,1658,1338
1612,7,3.2.156,0,599,0,37,156,193,156,0,193,193,-156,156,169,3,1,232,344,354,344,8,1658,1338
1612,7,4.0.177,0,608,1,55,177,232,0,177,232,232,0,0,13,1,5,295,72,295,249,8,1658,1338
1612,7,5.2.26,0,599,0,68,26,94,26,0,94,177,-26,26,39,3,1,240,344,266,344,8,1658,1338
1612,8,0.2.219,0,608,0,66,219,285,219,0,285,285,-219,219,253,3,1,260,344,389,344,9,1658,1296
1612,8,1.0.177,0,608,0,17,177,194,0,177,194,219,0,0,34,1,5,123,72,123,249,9,1658,1296
1612,8,2.2.102,0,623,1,71,102,173,102,0,173,219,-102,102,136,3,1,146,344,231,344,9,1658,1296
1612,8,3.2.156,0,608,0,37,156,193,156,0,193,219,-156,156,190,3,1,232,344,354,344,9,1658,1296
1612,8,4.0.177,1,608,0,55,177,232,0,177,232,232,0,0,34,1,5,295,72,295,249,9,1658,1296
1612,8,5.2.26,0,608,0,68,26,94,26,0,94,219,-26,26,60,3,1,240,344,266,344,9,1658,1296
1612,9,0.2.219,0,608,0,66,219,285,219,0,285,285,-219,219,253,3,1,260,344,389,344,10,1658,1241
1612,9,1.0.232,0,608,0,17,232,249,0,232,249,249,0,0,34,1,6,123,17,123,249,10,1658,1241
1612,9,2.2.102,0,625,1,71,102,173,102,0,173,232,-102,102,136,3,1,146,344,231,344,10,1658,1241
1612,9,3.2.156,0,608,0,37,156,193,156,0,193,232,-156,156,190,3,1,232,344,354,344,10,1658,1241
1612,9,4.1.232,1,608,0,3,232,235,232,0,235,235,-13,47,47,2,5,240,10,295,195,10,1658,1241
1612,9,5.2.26,0,608,0,68,26,94,26,0,94,232,-26,26,60,3,1,240,344,266,344,10,1658,1241
1612,10,0.2.219,0,608,0,66,219,285,219,0,285,285,-219,219,266,3,1,260,344,389,344,11,1658,1238
1612,10,1.0.232,1,608,0,17,232,249,0,232,249,249,0,0,47,1,6,123,17,123,249,11,1658,1238
1612,10,2.2.102,0,625,1,71,102,173,102,0,173,235,-102,102,149,3,1,146,344,231,344,11,1658,1238
1612,10,3.2.156,0,608,0,37,156,193,156,0,193,235,-156,156,203,3,1,232,344,354,344,11,1658,1238
1612,10,4.2.235,0,633,2,87,235,322,235,0,322,322,-235,235,282,3,1,237,344,295,344,11,1658,1238
1612,10,5.2.26,0,608,0,68,26,94,26,0,94,235,-26,26,73,3,1,240,344,266,344,11,1658,1238
1612,11,0.2.219,0,608,0,66,219,285,219,0,285,285,-219,219,266,3,1,260,344,389,344,12,1658,1221
1612,11,1.1.249,1,608,0,7,249,256,249,0,256,256,-14,61,61,2,6,106,7,123,195,12,1658,1221
1612,11,2.2.102,0,625,1,71,102,173,102,0,173,249,-102,102,149,3,1,146,344,231,344,12,1658,1221
1612,11,3.2.156,0,608,0,37,156,193,156,0,193,249,-156,156,203,3,1,232,344,354,344,12,1658,1221
1612,11,4.2.235,0,633,2,87,235,322,235,0,322,322,-235,235,282,3,1,237,344,295,344,12,1658,1221
1612,11,5.2.26,0,608,0,68,26,94,26,0,94,249,-26,26,73,3,1,240,344,266,344,12,1658,1221
1612,12,0.2.219,0,608,0,66,219,285,219,0,285,285,-219,219,280,3,1,260,344,389,344,13,1658,1214
1612,12,1.2.256,0,608,0,15,256,271,256,0,271,271,-256,256,317,3,1,99,344,123,344,13,1658,1214
1612,12,2.2.102,0,625,1,71,102,173,102,0,173,256,-102,102,163,3,1,146,344,231,344,13,1658,1214
1612,12,3.2.156,0,608,0,37,156,193,156,0,193,256,-156,156,217,3,1,232,344,354,344,13,1658,1214
1612,12,4.2.235,0,633,2,87,235,322,235,0,322,322,-235,235,296,3,1,237,344,295,344,13,1658,1214
1612,12,5.2.26,1,608,0,68,26,94,26,0,94,256,-26,26,87,3,1,240,344,266,344,13,1658,1214
1612,13,0.2.219,0,608,0,66,219,285,219,0,285,285,-125,151,212,3,2,260,276,389,344,14,1658,1146
1612,13,1.2.256,0,608,0,15,256,271,256,0,271,271,-162,188,249,3,2,99,276,123,344,14,1658,1146
1612,13,2.2.102,0,625,1,71,102,173,102,0,173,256,-8,34,95,3,2,146,276,231,344,14,1658,1146
1612,13,3.2.156,1,608,0,37,156,193,156,0,193,256,-62,88,149,3,2,232,276,354,344,14,1658,1146
1612,13,4.2.235,0,633,2,87,235,322,235,0,322,322,-141,167,228,3,2,237,276,295,344,14,1658,1146
1612,13,5.3.94,0,608,0,73,94,167,94,0,167,256,-94,94,181,4,1,172,453,266,453,14,1658,1146
1612,14,0.2.219,0,608,0,66,219,285,219,0,285,285,-26,114,175,3,3,260,239,389,344,15,1658,1109
1612,14,1.2.256,0,608,0,15,256,271,256,0,271,271,-63,151,212,3,3,99,239,123,344,15,1658,1109
1612,14,2.2.193,1,608,0,71,193,264,102,91,264,264,0,88,149,3,3,146,239,231,344,15,1658,1109
1612,14,3.3.193,0,608,0,97,193,290,193,0,290,290,-193,193,342,4,1,195,453,354,453,15,1658,1109
1612,14,4.2.235,0,633,1,87,235,322,235,0,322,322,-42,130,191,3,3,237,239,295,344,15,1658,1109
1612,14,5.3.94,0,608,0,73,94,167,94,0,167,256,-94,94,243,4,1,172,453,266,453,15,1658,1109
1612,15,0.2.264,1,631,1,66,264,330,219,45,330,330,0,88,149,3,4,260,168,389,344,16,1658,1038
1612,15,1.2.264,0,608,0,15,264,279,256,8,279,279,0,88,149,3,4,99,168,123,344,16,1658,1038
1612,15,2.3.264,0,714,3,72,264,336,264,0,336,336,-264,264,413,4,1,75,453,231,453,16,1658,1038
1612,15,3.3.193,0,608,0,97,193,290,193,0,290,290,-193,193,342,4,1,195,453,354,453,16,1658,1038
1612,15,4.2.264,0,662,2,87,264,351,235,29,351,351,0,88,149,3,4,237,168,295,344,16,1658,1038
1612,15,5.3.94,0,608,0,73,94,167,94,0,167,264,-94,94,243,4,1,172,453,266,453,16,1658,1038
1612,16,0.3.330,0,647,1,97,330,427,330,0,427,427,-330,330,479,4,1,194,453,389,453,17,1658,972
1612,16,1.2.330,1,631,0,15,330,345,256,74,345,345,0,88,149,3,5,99,102,123,344,17,1658,972
1612,16,2.3.264,0,723,2,72,264,336,264,0,336,336,-264,264,413,4,1,75,453,231,453,17,1658,972
1612,16,3.3.193,0,631,0,97,193,290,193,0,290,330,-193,193,342,4,1,195,453,354,453,17,1658,972
1612,16,4.2.330,0,647,1,87,330,417,235,95,417,417,0,88,149,3,5,237,102,295,344,17,1658,972
1612,16,5.3.94,0,631,0,73,94,167,94,0,167,330,-94,94,243,4,1,172,453,266,453,17,1658,972
1612,17,0.3.330,0,647,1,97,330,427,330,0,427,427,-330,330,479,4,1,194,453,389,453,18,1658,957
1612,17,1.3.345,0,631,0,25,345,370,345,0,370,370,-345,345,494,4,1,84,453,123,453,18,1658,957
1612,17,2.3.264,0,723,2,72,264,336,264,0,336,345,-264,264,413,4,1,75,453,231,453,18,1658,957
1612,17,3.3.193,0,631,0,97,193,290,193,0,290,345,-193,193,342,4,1,195,453,354,453,18,1658,957
1612,17,4.2.345,1,631,0,87,345,432,235,110,432,432,0,88,149,3,6,237,87,295,344,18,1658,957
1612,17,5.3.94,0,631,0,73,94,167,94,0,167,345,-94,94,243,4,1,172,453,266,453,18,1658,957
1612,18,0.3.330,0,647,1,97,330,427,330,0,427,432,-330,330,479,4,1,194,453,389,453,19,1658,870
1612,18,1.3.345,0,631,0,25,345,370,345,0,370,432,-345,345,494,4,1,84,453,123,453,19,1658,870
1612,18,2.3.264,0,723,2,72,264,336,264,0,336,432,-264,264,413,4,1,75,453,231,453,19,1658,870
1612,18,3.3.193,0,631,0,97,193,290,193,0,290,432,-193,193,342,4,1,195,453,354,453,19,1658,870
1612,18,4.3.432,0,647,1,89,432,521,432,0,521,521,-432,432,581,4,1,150,453,295,453,19,1658,870
1612,18,5.3.94,1,631,0,73,94,167,94,0,167,432,-94,94,243,4,1,172,453,266,453,19,1658,870
1612,19,0.3.330,0,647,1,97,330,427,330,0,427,432,-163,257,406,4,2,194,380,389,453,20,1658,797
1612,19,1.3.345,0,631,0,25,345,370,345,0,370,432,-178,272,421,4,2,84,380,123,453,20,1658,797
1612,19,2.3.264,0,723,2,72,264,336,264,0,336,432,-97,191,340,4,2,75,380,231,453,20,1658,797
1612,19,3.3.193,0,631,0,97,193,290,193,0,290,432,-26,120,269,4,2,195,380,354,453,20,1658,797
1612,19,4.3.432,0,647,1,89,432,521,432,0,521,521,-265,359,508,4,2,150,380,295,453,20,1658,797
1612,19,5.4.167,1,631,0,99,167,266,167,0,266,432,-167,167,410,5,1,99,417,266,417,20,1658,797
1612,20,0.3.330,0,647,1,97,330,427,330,0,427,432,-163,257,573,4,2,194,380,389,453,21,1658,698
1612,20,1.3.345,0,631,0,25,345,370,345,0,370,432,-178,272,588,4,2,84,380,123,453,21,1658,698
1612,20,2.3.264,0,723,2,72,264,336,264,0,336,432,-97,191,507,4,2,75,380,231,453,21,1658,698
1612,20,3.3.193,1,631,0,97,193,290,193,0,290,432,-26,120,436,4,2,195,380,354,453,21,1658,698
1612,20,4.3.432,0,647,1,89,432,521,432,0,521,521,-265,359,675,4,2,150,380,295,453,21,1658,698
1612,21,0.3.330,0,647,2,97,330,427,330,0,427,432,-40,160,476,4,3,194,283,389,453,22,1658,601
1612,21,1.3.345,0,631,0,25,345,370,345,0,370,432,-55,175,491,4,3,84,283,123,453,22,1658,601
1612,21,2.3.290,0,642,1,72,290,362,264,26,362,432,0,120,436,4,3,75,283,231,453,22,1658,601
1612,21,3.4.290,1,631,0,98,290,388,290,0,388,432,-24,191,460,5,2,98,318,354,417,22,1658,601
1612,21,4.3.432,0,647,2,89,432,521,432,0,521,521,-142,262,578,4,3,150,283,295,453,22,1658,601
1612,22,0.3.330,0,647,2,97,330,427,330,0,427,432,-40,160,500,4,3,194,283,389,453,23,1658,503
1612,22,1.3.345,0,631,0,25,345,370,345,0,370,432,-55,175,515,4,3,84,283,123,453,23,1658,503
1612,22,2.3.290,1,642,1,72,290,362,264,26,362,432,0,120,460,4,3,75,283,231,453,23,1658,503
1612,22,4.3.432,0,647,2,89,432,521,432,0,521,521,-142,262,602,4,3,150,283,295,453,23,1658,503
1612,23,0.3.362,0,676,1,97,362,459,330,32,459,459,0,120,460,4,4,194,211,389,453,24,1658,431
1612,23,1.3.362,0,642,0,25,362,387,345,17,387,432,0,120,460,4,4,84,211,123,453,24,1658,431
1612,23,2.4.388,1,642,0,3,388,391,362,26,391,432,0,191,460,5,3,3,220,231,417,24,1658,431
1612,23,4.3.432,0,715,2,89,432,521,432,0,521,521,-70,190,530,4,4,150,211,295,453,24,1658,431
1612,24,0.3.362,1,676,1,97,362,459,330,32,459,459,0,120,460,4,4,194,211,389,453,25,1658,428
1612,24,1.3.362,0,642,0,25,362,387,345,17,387,432,0,120,460,4,4,84,211,123,453,25,1658,428
1612,24,4.3.432,0,715,2,89,432,521,432,0,521,521,-70,190,530,4,4,150,211,295,453,25,1658,428
1612,25,0.4.459,0,676,0,97,459,556,459,0,556,556,-68,259,528,5,4,97,217,389,417,26,1658,331
1612,25,1.3.459,1,676,0,25,459,484,345,114,484,484,0,120,460,4,5,84,114,123,453,26,1658,331
1612,25,4.3.459,0,676,0,89,459,548,432,27,548,548,0,120,460,4,5,150,114,295,453,26,1658,331
1612,26,0.4.459,0,676,0,97,459,556,459,0,556,556,-68,259,528,5,4,97,217,389,417,27,1658,306
1612,26,1.4.484,0,701,1,59,484,543,484,0,543,543,-93,284,553,5,4,59,217,123,417,27,1658,306
1612,26,4.3.484,1,676,0,89,484,573,432,52,573,573,0,120,460,4,6,150,89,295,453,27,1658,306
1612,27,0.4.459,1,676,0,97,459,556,459,0,556,573,-68,259,528,5,4,97,217,389,417,28,1658,217
1612,27,1.4.484,0,701,2,59,484,543,484,0,543,573,-93,284,553,5,4,59,217,123,417,28,1658,217
1612,27,4.4.573,0,693,1,61,573,634,573,0,634,634,-182,373,642,5,4,61,217,295,417,28,1658,217
1612,28,1.4.556,1,676,0,59,556,615,484,72,615,615,0,259,528,5,5,59,120,123,417,29,1658,120
1612,28,4.4.573,0,693,1,61,573,634,573,0,634,634,-17,276,545,5,5,61,120,295,417,29,1658,120
1612,29,4.4.615,1,676,0,61,615,676,573,42,676,676,0,259,528,5,6,61,61,295,417,30,1658,61
1613,0,0.0.0,0,556,0,1,0,1,0,0,1,1,0,0,0,1,1,135,264,135,264,1,1529,1529
1613,0,1.0.0,0,622,5,92,0,92,0,0,92,92,0,0,0,1,1,322,264,322,264,1,1529,1529
1613,0,2.0.0,0,605,3,54,0,54,0,0,54,54,0,0,0,1,1,256,264,256,264,1,1529,1529
1613,0,3.0.0,0,578,2,22,0,22,0,0,22,22,0,0,0,1,1,214,264,214,264,1,1529,1529
1613,0,4.0.0,0,611,4,77,0,77,0,0,77,77,0,0,0,1,1,333,264,333,264,1,1529,1529
1613,0,5.0.0,1,566,1,18,0,18,0,0,18,18,0,0,0,1,1,269,264,269,264,1,1529,1529
1613,1,0.0.18,0,566,0,1,18,19,0,18,19,19,0,0,0,1,2,135,246,135,264,2,1529,1511
1613,1,1.0.18,0,570,1,92,18,110,0,18,110,110,0,0,0,1,2,322,246,322,264,2,1529,1511
1613,1,2.0.18,0,586,3,54,18,72,0,18,72,72,0,0,0,1,2,256,246,256,264,2,1529,1511
1613,1,3.0.18,1,581,2,22,18,40,0,18,40,40,0,0,0,1,2,214,246,214,264,2,1529,1511
1613,1,4.0.18,0,581,2,77,18,95,0,18,95,95,0,0,0,1,2,333,246,333,264,2,1529,1511
1613,1,5.1.18,0,570,1,95,18,113,18,0,113,113,-18,18,18,2,1,251,394,269,394,2,1529,1511
1613,2,0.0.40,1,581,0,1,40,41,0,40,41,41,0,0,0,1,3,135,224,135,264,3,1529,1489
1613,2,1.0.40,0,590,2,92,40,132,0,40,132,132,0,0,0,1,3,322,224,322,264,3,1529,1489
1613,2,2.0.40,0,586,1,54,40,94,0,40,94,94,0,0,0,1,3,256,224,256,264,3,1529,1489
1613,2,3.1.40,0,621,3,92,40,132,40,0,132,132,-40,40,40,2,1,192,394,214,394,3,1529,1489
1613,2,4.0.40,0,586,1,77,40,117,0,40,117,117,0,0,0,1,3,333,224,333,264,3,1529,1489
1613,2,5.1.18,0,581,0,95,18,113,18,0,113,113,-18,18,18,2,1,251,394,269,394,3,1529,1489
1613,3,0.1.41,0,588,3,10,41,51,41,0,51,51,-41,41,41,2,1,134,394,135,394,4,1529,1488
1613,3,1.0.41,0,583,1,92,41,133,0,41,133,133,0,0,0,1,4,322,223,322,264,4,1529,1488
1613,3,2.0.41,0,586,2,54,41,95,0,41,95,95,0,0,0,1,4,256,223,256,264,4,1529,1488
1613,3,3.1.40,0,621,4,92,40,132,40,0,132,132,-40,40,40,2,1,192,394,214,394,4,1529,1488
1613,3,4.0.41,1,581,0,77,41,118,0,41,118,118,0,0,0,1,4,333,223,333,264,4,1529,1488
1613,3,5.1.18,0,581,0,95,18,113,18,0,113,113,-18,18,18,2,1,251,394,269,394,4,1529,1488
1613,4,0.1.41,0,588,1,10,41,51,41,0,51,118,-41,41,41,2,1,134,394,135,394,5,1529,1411
1613,4,1.0.118,0,595,2,92,118,210,0,118,210,210,0,0,0,1,5,322,146,322,264,5,1529,1411
1613,4,2.0.118,1,581,0,54,118,172,0,118,172,172,0,0,0,1,5,256,146,256,264,5,1529,1411
1613,4,3.1.40,0,625,4,92,40,132,40,0,132,132,-40,40,40,2,1,192,394,214,394,5,1529,1411
1613,4,4.1.118,0,598,3,54,118,172,118,0,172,172,-118,118,118,2,1,256,394,333,394,5,1529,1411
1613,4,5.1.18,0,581,0,95,18,113,18,0,113,118,-18,18,18,2,1,251,394,269,394,5,1529,1411
1613,5,0.1.41,0,588,1,10,41,51,41,0,51,172,-41,41,41,2,1,134,394,135,394,6,1529,1357
1613,5,1.0.172,1,581,0,92,172,264,0,172,264,264,0,0,0,1,6,322,92,322,264,6,1529,1357
1613,5,2.1.172,0,598,2,69,172,241,172,0,241,241,-172,172,172,2,1,202,394,256,394,6,1529,1357
1613,5,3.1.40,0,625,3,92,40,132,40,0,132,172,-40,40,40,2,1,192,394,214,394,6,1529,1357
1613,5,4.1.118,0,598,2,54,118,172,118,0,172,172,-118,118,118,2,1,256,394,333,394,6,1529,1357
1613,5,5.1.18,0,581,0,95,18,113,18,0,113,172,-18,18,18,2,1,251,394,269,394,6,1529,1357
1613,6,0.1.41,1,588,1,10,41,51,41,0,51,264,-41,41,41,2,1,134,394,135,394,7,1529,1265
1613,6,1.1.264,0,581,0,74,264,338,264,0,338,338,-264,264,264,2,1,230,394,322,394,7,1529,1265
1613,6,2.1.172,0,598,2,69,172,241,172,0,241,264,-172,172,172,2,1,202,394,256,394,7,1529,1265
1613,6,3.1.40,0,625,3,92,40,132,40,0,132,264,-40,40,40,2,1,192,394,214,394,7,1529,1265
1613,6,4.1.118,0,598,2,54,118,172,118,0,172,264,-118,118,118,2,1,256,394,333,394,7,1529,1265
1613,6,5.1.18,0,581,0,95,18,113,18,0,113,264,-18,18,18,2,1,251,394,269,394,7,1529,1265
1613,7,0.2.51,1,588,0,70,51,121,51,0,121,264,-51,51,92,3,1,124,214,135,214,8,1529,1255
1613,7,1.1.264,0,613,1,74,264,338,264,0,338,338,-213,254,254,2,2,230,384,322,394,8,1529,1255
1613,7,2.1.172,0,640,4,69,172,241,172,0,241,264,-121,162,162,2,2,202,384,256,394,8,1529,1255
1613,7,3.1.51,0,617,2,92,51,143,40,11,143,264,0,41,41,2,2,192,384,214,394,8,1529,1255
1613,7,4.1.118,0,632,3,54,118,172,118,0,172,264,-67,108,108,2,2,256,384,333,394,8,1529,1255
1613,7,5.1.51,0,588,0,95,51,146,18,33,146,264,0,41,41,2,2,251,384,269,394,8,1529,1255
1613,8,0.3.121,1,588,0,4,121,125,121,0,125,264,-121,121,213,4,1,54,307,135,307,9,1529,1185
1613,8,1.1.264,0,613,1,74,264,338,264,0,338,338,-213,254,305,2,2,230,384,322,394,9,1529,1185
1613,8,2.1.172,0,640,4,69,172,241,172,0,241,264,-121,162,213,2,2,202,384,256,394,9,1529,1185
1613,8,3.1.51,0,617,2,92,51,143,40,11,143,264,0,41,92,2,2,192,384,214,394,9,1529,1185
1613,8,4.1.118,0,632,3,54,118,172,118,0,172,264,-67,108,159,2,2,256,384,333,394,9,1529,1185
1613,8,5.1.51,0,588,0,95,51,146,18,33,146,264,0,41,92,2,2,251,384,269,394,9,1529,1185
1613,9,0.4.125,1,588,0,50,125,175,125,0,175,264,-125,125,338,5,1,50,350,135,350,10,1529,1181
1613,9,1.1.264,0,613,1,74,264,338,264,0,338,338,-213,254,426,2,2,230,384,322,394,10,1529,1181
1613,9,2.1.172,0,640,4,69,172,241,172,0,241,264,-121,162,334,2,2,202,384,256,394,10,1529,1181
1613,9,3.1.51,0,617,2,92,51,143,40,11,143,264,0,41,213,2,2,192,384,214,394,10,1529,1181
1613,9,4.1.118,0,632,3,54,118,172,118,0,172,264,-67,108,280,2,2,256,384,333,394,10,1529,1181
1613,9,5.1.51,0,588,0,95,51,146,18,33,146,264,0,41,213,2,2,251,384,269,394,10,1529,1181
1613,10,1.1.264,0,613,1,74,264,338,264,0,338,338,-213,254,551,2,2,230,384,322,394,11,1529,1131
1613,10,2.1.172,0,640,4,69,172,241,172,0,241,264,-121,162,459,2,2,202,384,256,394,11,1529,1131
1613,10,3.1.51,0,617,2,92,51,143,40,11,143,264,0,41,338,2,2,192,384,214,394,11,1529,1131
1613,10,4.1.118,0,632,3,54,118,172,118,0,172,264,-67,108,405,2,2,256,384,333,394,11,1529,1131
1613,10,5.1.51,1,588,0,95,51,146,18,33,146,264,0,41,338,2,2,251,384,269,394,11,1529,1131
1613,11,1.1.264,0,613,1,74,264,338,264,0,338,338,-118,159,456,2,3,230,289,322,394,12,1529,1036
1613,11,2.1.172,0,640,3,69,172,241,172,0,241,264,-26,67,364,2,3,202,289,256,394,12,1529,1036
1613,11,3.1.146,0,636,2,92,146,238,40,106,238,264,0,41,338,2,3,192,289,214,394,12,1529,1036
1613,11,4.1.146,0,588,0,54,146,200,118,28,200,264,0,41,338,2,3,256,289,333,394,12,1529,1036
1613,11,5.2.146,1,588,0,7,146,153,146,0,153,264,-25,76,363,3,2,156,144,269,214,12,1529,1036
1613,12,1.1.264,0,613,1,74,264,338,264,0,338,338,-118,159,481,2,3,230,289,322,394,13,1529,1029
1613,12,2.1.172,0,640,3,69,172,241,172,0,241,264,-26,67,389,2,3,202,289,256,394,13,1529,1029
1613,12,3.1.146,0,636,2,92,146,238,40,106,238,264,0,41,363,2,3,192,289,214,394,13,1529,1029
1613,12,4.1.146,0,588,0,54,146,200,118,28,200,264,0,41,363,2,3,256,289,333,394,13,1529,1029
1613,12,5.3.153,1,588,0,58,153,211,153,0,211,264,-28,149,391,4,2,149,303,269,307,13,1529,1029
1613,13,1.1.264,0,613,1,74,264,338,264,0,338,338,-118,159,509,2,3,230,289,322,394,14,1529,971
1613,13,2.1.172,0,640,3,69,172,241,172,0,241,264,-26,67,417,2,3,202,289,256,394,14,1529,971
1613,13,3.1.146,0,636,2,92,146,238,40,106,238,264,0,41,391,2,3,192,289,214,394,14,1529,971
1613,13,4.1.146,0,588,0,54,146,200,118,28,200,264,0,41,391,2,3,256,289,333,394,14,1529,971
1613,13,5.4.211,1,588,0,91,211,302,211,0,302,302,-36,161,427,5,2,91,300,269,350,14,1529,971
1613,14,1.1.264,0,613,1,74,264,338,264,0,338,338,-118,159,545,2,3,230,289,322,394,15,1529,880
1613,14,2.1.172,0,640,3,69,172,241,172,0,241,302,-26,67,453,2,3,202,289,256,394,15,1529,880
1613,14,3.1.146,0,636,2,92,146,238,40,106,238,302,0,41,427,2,3,192,289,214,394,15,1529,880
1613,14,4.1.146,1,588,0,54,146,200,118,28,200,302,0,41,427,2,3,256,289,333,394,15,1529,880
1613,15,1.1.264,0,613,2,74,264,338,264,0,338,338,-64,105,491,2,4,230,235,322,394,16,1529,826
1613,15,2.1.200,0,588,0,69,200,269,172,28,269,302,0,41,427,2,4,202,235,256,394,16,1529,826
1613,15,3.1.200,0,604,1,92,200,292,40,160,292,302,0,41,427,2,4,192,235,214,394,16,1529,826
1613,15,4.2.200,1,588,0,88,200,288,200,0,288,302,-47,123,474,3,3,202,137,333,214,16,1529,826
1613,16,1.1.264,0,613,2,74,264,338,264,0,338,338,-64,105,538,2,4,230,235,322,394,17,1529,738
1613,16,2.1.200,0,588,0,69,200,269,172,28,269,302,0,41,474,2,4,202,235,256,394,17,1529,738
1613,16,3.1.200,0,604,1,92,200,292,40,160,292,302,0,41,474,2,4,192,235,214,394,17,1529,738
1613,16,4.3.288,1,588,0,82,288,370,288,0,370,370,-77,226,551,4,3,114,245,333,307,17,1529,738
1613,17,1.1.264,0,613,2,74,264,338,264,0,338,370,-64,105,615,2,4,230,235,322,394,18,1529,656
1613,17,2.1.200,0,588,0,69,200,269,172,28,269,370,0,41,551,2,4,202,235,256,394,18,1529,656
1613,17,3.1.200,0,604,1,92,200,292,40,160,292,370,0,41,551,2,4,192,235,214,394,18,1529,656
1613,17,4.4.370,1,588,0,32,370,402,370,0,402,402,-68,229,619,5,3,32,209,333,350,18,1529,656
1613,18,1.1.264,0,613,2,74,264,338,264,0,338,402,-64,105,683,2,4,230,235,322,394,19,1529,624
1613,18,2.1.200,0,588,0,69,200,269,172,28,269,402,0,41,619,2,4,202,235,256,394,19,1529,624
1613,18,3.1.200,1,604,1,92,200,292,40,160,292,402,0,41,619,2,4,192,235,214,394,19,1529,624
1613,19,1.1.292,0,629,1,74,292,366,264,28,366,402,0,41,619,2,5,230,143,322,394,20,1529,532
1613,19,2.1.292,0,604,0,69,292,361,172,120,361,402,0,41,619,2,5,202,143,256,394,20,1529,532
1613,19,3.2.292,1,604,0,4,292,296,292,0,296,402,-4,127,623,3,4,100,49,214,214,20,1529,532
1613,20,1.1.292,0,629,1,74,292,366,264,28,366,402,0,41,623,2,5,230,143,322,394,21,1529,528
1613,20,2.1.292,0,604,0,69,292,361,172,120,361,402,0,41,623,2,5,202,143,256,394,21,1529,528
1613,20,3.3.370,1,604,0,56,370,426,296,74,426,426,0,226,623,4,4,96,163,214,307,21,1529,528
1613,21,1.1.292,0,629,1,74,292,366,264,28,366,426,0,41,623,2,5,230,143,322,394,22,1529,472
1613,21,2.1.292,0,604,0,69,292,361,172,120,361,426,0,41,623,2,5,202,143,256,394,22,1529,472
1613,21,3.4.426,1,604,0,40,426,466,426,0,466,466,-24,253,647,5,4,40,177,214,350,22,1529,472
1613,22,1.1.292,0,629,1,74,292,366,264,28,366,466,0,41,647,2,5,230,143,322,394,23,1529,432
1613,22,2.1.292,1,604,0,69,292,361,172,120,361,466,0,41,647,2,5,202,143,256,394,23,1529,432
1613,23,1.1.361,0,604,0,74,361,435,264,97,435,466,0,41,647,2,6,230,74,322,394,24,1529,363
1613,23,2.2.361,1,604,0,24,361,385,361,0,385,466,-65,192,712,3,5,133,45,256,214,24,1529,363
1613,24,1.1.361,0,604,0,74,361,435,264,97,435,466,0,41,712,2,6,230,74,322,394,25,1529,339
1613,24,2.3.426,1,604,0,41,426,467,385,41,467,467,0,226,712,4,5,109,107,256,307,25,1529,339
1613,25,1.1.361,0,604,0,74,361,435,264,97,435,467,0,41,712,2,6,230,74,322,394,26,1529,298
1613,25,2.4.467,1,604,0,68,467,535,467,0,535,535,-1,254,713,5,5,68,137,256,350,26,1529,298
1613,26,1.1.361,1,604,0,74,361,435,264,97,435,535,0,41,713,2,6,230,74,322,394,27,1529,230
1613,27,1.2.435,1,604,0,21,435,456,435,0,456,535,-50,242,763,3,6,156,21,322,214,28,1529,156
1613,28,1.3.467,1,604,0,66,467,533,456,11,533,535,0,226,763,4,6,135,66,322,307,29,1529,135
1613,29,1.4.535,1,604,0,69,535,604,533,2,604,604,0,254,763,5,6,69,69,322,350,30,1529,69
1614,0,0.0.0,0,549,1,14,0,14,0,0,14,14,0,0,0,1,1,178,375,178,375,1,1496,1496
1614,0,1.0.0,0,575,4,67,0,67,0,0,67,67,0,0,0,1,1,222,375,222,375,1,1496,1496
1614,0,2.0.0,0,567,3,99,0,99,0,0,99,99,0,0,0,1,1,282,375,282,375,1,1496,1496
1614,0,3.0.0,0,545,0,75,0,75,0,0,75,75,0,0,0,1,1,273,375,273,375,1,1496,1496
1614,0,4.0.0,0,563,2,98,0,98,0,0,98,98,0,0,0,1,1,270,375,270,375,1,1496,1496
1614,0,5.0.0,1,545,0,22,0,22,0,0,22,22,0,0,0,1,1,271,375,271,375,1,1496,1496
1614,1,0.0.22,0,558,1,14,22,36,0,22,36,36,0,0,0,1,2,178,353,178,375,2,1496,1474
1614,1,1.0.22,0,558,1,67,22,89,0,22,89,89,0,0,0,1,2,222,353,222,375,2,1496,1474
1614,1,2.0.22,0,545,0,99,22,121,0,22,121,121,0,0,0,1,2,282,353,282,375,2,1496,1474
1614,1,3.0.22,0,545,0,75,22,97,0,22,97,97,0,0,0,1,2,273,353,273,375,2,1496,1474
1614,1,4.0.22,0,558,1,98,22,120,0,22,120,120,0,0,0,1,2,270,353,270,375,2,1496,1474
1614,1,5.1.22,1,545,0,79,22,101,22,0,101,101,-22,22,22,2,1,249,298,271,298,2,1496,1474
1614,2,0.0.22,0,558,1,14,22,36,0,22,36,101,0,0,22,1,2,178,353,178,375,3,1496,1395
1614,2,1.0.22,0,558,1,67,22,89,0,22,89,101,0,0,22,1,2,222,353,222,375,3,1496,1395
1614,2,2.0.22,0,545,0,99,22,121,0,22,121,121,0,0,22,1,2,282,353,282,375,3,1496,1395
1614,2,3.0.22,0,545,0,75,22,97,0,22,97,101,0,0,22,1,2,273,353,273,375,3,1496,1395
1614,2,4.0.22,0,558,1,98,22,120,0,22,120,120,0,0,22,1,2,270,353,270,375,3,1496,1395
1614,2,5.2.101,1,545,0,45,101,146,101,0,146,146,-101,101,123,3,1,170,381,271,381,3,1496,1395
1614,3,0.0.22,0,558,1,14,22,36,0,22,36,146,0,0,123,1,2,178,353,178,375,4,1496,1350
1614,3,1.0.22,0,558,1,67,22,89,0,22,89,146,0,0,123,1,2,222,353,222,375,4,1496,1350
1614,3,2.0.22,0,545,0,99,22,121,0,22,121,146,0,0,123,1,2,282,353,282,375,4,1496,1350
1614,3,3.0.22,0,545,0,75,22,97,0,22,97,146,0,0,123,1,2,273,353,273,375,4,1496,1350
1614,3,4.0.22,0,558,1,98,22,120,0,22,120,146,0,0,123,1,2,270,353,270,375,4,1496,1350
1614,3,5.3.146,1,545,0,43,146,189,146,0,189,189,-146,146,269,4,1,125,163,271,163,4,1496,1350
1614,4,0.0.22,0,558,1,14,22,36,0,22,36,189,0,0,269,1,2,178,353,178,375,5,1496,1307
1614,4,1.0.22,0,558,1,67,22,89,0,22,89,189,0,0,269,1,2,222,353,222,375,5,1496,1307
1614,4,2.0.22,0,545,0,99,22,121,0,22,121,189,0,0,269,1,2,282,353,282,375,5,1496,1307
1614,4,3.0.22,0,545,0,75,22,97,0,22,97,189,0,0,269,1,2,273,353,273,375,5,1496,1307
1614,4,4.0.22,0,558,1,98,22,120,0,22,120,189,0,0,269,1,2,270,353,270,375,5,1496,1307
1614,4,5.4.189,1,545,0,82,189,271,189,0,271,271,-189,189,458,5,1,82,279,271,279,5,1496,1307
1614,5,0.0.22,1,558,1,14,22,36,0,22,36,271,0,0,458,1,2,178,353,178,375,6,1496,1225
1614,5,1.0.22,0,558,1,67,22,89,0,22,89,271,0,0,458,1,2,222,353,222,375,6,1496,1225
1614,5,2.0.22,0,545,0,99,22,121,0,22,121,271,0,0,458,1,2,282,353,282,375,6,1496,1225
1614,5,3.0.22,0,545,0,75,22,97,0,22,97,271,0,0,458,1,2,273,353,273,375,6,1496,1225
1614,5,4.0.22,0,558,1,98,22,120,0,22,120,271,0,0,458,1,2,270,353,270,375,6,1496,1225
1614,6,0.1.101,1,558,0,77,101,178,36,65,178,271,0,22,458,2,2,164,219,178,298,7,1496,1211
1614,6,1.0.36,0,558,0,67,36,103,0,36,103,271,0,0,458,1,3,222,339,222,375,7,1496,1211
1614,6,2.0.36,0,559,1,99,36,135,0,36,135,271,0,0,458,1,3,282,339,282,375,7,1496,1211
1614,6,3.0.36,0,558,0,75,36,111,0,36,111,271,0,0,458,1,3,273,339,273,375,7,1496,1211
1614,6,4.0.36,0,558,0,98,36,134,0,36,134,271,0,0,458,1,3,270,339,270,375,7,1496,1211
1614,7,0.2.178,0,558,0,73,178,251,178,0,251,271,-32,133,490,3,2,87,336,178,381,8,1496,1134
1614,7,1.0.36,0,558,0,67,36,103,0,36,103,271,0,0,458,1,3,222,339,222,375,8,1496,1134
1614,7,2.0.36,0,570,1,99,36,135,0,36,135,271,0,0,458,1,3,282,339,282,375,8,1496,1134
1614,7,3.0.36,1,558,0,75,36,111,0,36,111,271,0,0,458,1,3,273,339,273,375,8,1496,1134
1614,7,4.0.36,0,558,0,98,36,134,0,36,134,271,0,0,458,1,3,270,339,270,375,8,1496,1134
1614,8,0.2.178,0,558,0,73,178,251,178,0,251,271,-32,133,490,3,2,87,336,178,381,9,1496,1059
1614,8,1.0.111,0,558,0,67,111,178,0,111,178,271,0,0,458,1,4,222,264,222,375,9,1496,1059
1614,8,2.0.111,0,561,1,99,111,210,0,111,210,271,0,0,458,1,4,282,264,282,375,9,1496,1059
1614,8,3.1.178,1,558,0,31,178,209,111,67,209,271,0,22,458,2,3,198,142,273,298,9,1496,1059
1614,8,4.0.111,0,558,0,98,111,209,0,111,209,271,0,0,458,1,4,270,264,270,375,9,1496,1059
1614,9,0.2.178,0,558,0,73,178,251,178,0,251,271,-32,133,490,3,2,87,336,178,381,10,1496,1028
1614,9,1.0.111,1,558,0,67,111,178,0,111,178,271,0,0,458,1,4,222,264,222,375,10,1496,1028
1614,9,2.0.111,0,561,1,99,111,210,0,111,210,271,0,0,458,1,4,282,264,282,375,10,1496,1028
1614,9,3.2.209,0,561,1,71,209,280,209,0,280,280,-63,164,521,3,2,167,336,273,381,10,1496,1028
1614,9,4.0.111,0,558,0,98,111,209,0,111,209,271,0,0,458,1,4,270,264,270,375,10,1496,1028
1614,10,0.2.178,0,558,0,73,178,251,178,0,251,271,-32,133,490,3,2,87,336,178,381,11,1496,961
1614,10,1.1.209,1,558,0,42,209,251,178,31,251,271,0,22,458,2,4,155,111,222,298,11,1496,961
1614,10,2.0.178,0,590,2,99,178,277,0,178,277,277,0,0,458,1,5,282,197,282,375,11,1496,961
1614,10,3.2.209,0,588,1,71,209,280,209,0,280,280,-63,164,521,3,2,167,336,273,381,11,1496,961
1614,10,4.0.178,0,558,0,98,178,276,0,178,276,276,0,0,458,1,5,270,197,270,375,11,1496,961
1614,11,0.2.178,0,558,0,73,178,251,178,0,251,271,-32,133,490,3,2,87,336,178,381,12,1496,919
1614,11,1.2.251,0,558,0,26,251,277,251,0,277,277,-105,206,563,3,2,113,336,222,381,12,1496,919
1614,11,2.0.178,1,590,2,99,178,277,0,178,277,277,0,0,458,1,5,282,197,282,375,12,1496,919
1614,11,3.2.209,0,588,1,71,209,280,209,0,280,280,-63,164,521,3,2,167,336,273,381,12,1496,919
1614,11,4.0.178,0,558,0,98,178,276,0,178,276,276,0,0,458,1,5,270,197,270,375,12,1496,919
1614,12,0.2.178,0,590,0,73,178,251,178,0,251,277,-32,133,490,3,2,87,336,178,381,13,1496,820
1614,12,1.2.251,0,590,0,26,251,277,251,0,277,277,-105,206,563,3,2,113,336,222,381,13,1496,820
1614,12,2.1.277,1,590,0,63,277,340,277,0,340,340,-26,48,484,2,5,183,69,282,298,13,1496,820
1614,12,3.2.209,0,590,0,71,209,280,209,0,280,280,-63,164,521,3,2,167,336,273,381,13,1496,820
1614,12,4.0.277,0,590,0,98,277,375,0,277,375,375,0,0,458,1,6,270,98,270,375,13,1496,820
1614,13,0.2.178,0,590,0,73,178,251,178,0,251,340,-32,133,516,3,2,87,336,178,381,14,1496,757
1614,13,1.2.251,0,590,0,26,251,277,251,0,277,340,-105,206,589,3,2,113,336,222,381,14,1496,757
1614,13,2.2.340,0,595,1,77,340,417,340,0,417,417,-194,295,678,3,2,120,336,282,381,14,1496,757
1614,13,3.2.209,0,590,0,71,209,280,209,0,280,340,-63,164,547,3,2,167,336,273,381,14,1496,757
1614,13,4.0.277,1,590,0,98,277,375,0,277,375,375,0,0,484,1,6,270,98,270,375,14,1496,757
1614,14,0.2.178,0,590,0,73,178,251,178,0,251,375,-32,133,516,3,2,87,336,178,381,15,1496,659
1614,14,1.2.251,0,590,0,26,251,277,251,0,277,375,-105,206,589,3,2,113,336,222,381,15,1496,659
1614,14,2.2.340,0,595,1,77,340,417,340,0,417,417,-194,295,678,3,2,120,336,282,381,15,1496,659
1614,14,3.2.209,0,590,0,71,209,280,209,0,280,375,-63,164,547,3,2,167,336,273,381,15,1496,659
1614,14,4.1.375,1,590,0,6,375,381,375,0,381,381,-35,83,519,2,6,172,6,270,298,15,1496,659
1614,15,0.2.178,0,590,0,73,178,251,178,0,251,381,-32,133,551,3,2,87,336,178,381,16,1496,653
1614,15,1.2.251,0,590,0,26,251,277,251,0,277,381,-105,206,624,3,2,113,336,222,381,16,1496,653
1614,15,2.2.340,0,595,1,77,340,417,340,0,417,417,-194,295,713,3,2,120,336,282,381,16,1496,653
1614,15,3.2.209,1,590,0,71,209,280,209,0,280,381,-63,164,582,3,2,167,336,273,381,16,1496,653
1614,15,4.2.381,0,590,0,89,381,470,381,0,470,470,-235,336,754,3,2,166,336,270,381,16,1496,653
1614,16,0.2.280,0,590,0,73,280,353,178,102,353,381,0,164,582,3,3,87,265,178,381,17,1496,582
1614,16,1.2.280,0,590,0,26,280,306,251,29,306,381,0,164,582,3,3,113,265,222,381,17,1496,582
1614,16,2.2.340,0,595,1,77,340,417,340,0,417,417,-60,224,642,3,3,120,265,282,381,17,1496,582
1614,16,3.3.280,1,590,0,15,280,295,280,0,295,381,-91,237,673,4,2,96,120,273,163,17,1496,582
1614,16,4.2.381,0,590,0,89,381,470,381,0,470,470,-101,265,683,3,3,166,265,270,381,17,1496,582
1614,17,0.2.280,0,590,0,73,280,353,178,102,353,381,0,164,673,3,3,87,265,178,381,18,1496,567
1614,17,1.2.280,0,590,0,26,280,306,251,29,306,381,0,164,673,3,3,113,265,222,381,18,1496,567
1614,17,2.2.340,0,595,1,77,340,417,340,0,417,417,-60,224,733,3,3,120,265,282,381,18,1496,567
1614,17,3.4.295,1,590,0,81,295,376,295,0,376,381,-24,213,697,5,2,81,197,273,279,18,1496,567
1614,17,4.2.381,0,590,0,89,381,470,381,0,470,470,-101,265,774,3,3,166,265,270,381,18,1496,567
1614,18,0.2.280,0,590,0,73,280,353,178,102,353,381,0,164,697,3,3,87,265,178,381,19,1496,486
1614,18,1.2.280,1,590,0,26,280,306,251,29,306,381,0,164,697,3,3,113,265,222,381,19,1496,486
1614,18,2.2.340,0,595,1,77,340,417,340,0,417,417,-60,224,757,3,3,120,265,282,381,19,1496,486
1614,18,4.2.381,0,590,0,89,381,470,381,0,470,470,-101,265,798,3,3,166,265,270,381,19,1496,486
1614,19,0.2.306,0,590,0,73,306,379,178,128,379,381,0,164,697,3,4,87,239,178,381,20,1496,460
1614,19,1.3.306,1,590,0,9,306,315,306,0,315,381,-11,248,708,4,3,87,105,222,163,20,1496,460
1614,19,2.2.340,0,595,1,77,340,417,340,0,417,417,-34,198,731,3,4,120,239,282,381,20,1496,460
1614,19,4.2.381,0,590,0,89,381,470,381,0,470,470,-75,239,772,3,4,166,239,270,381,20,1496,460
1614,20,0.2.306,0,590,0,73,306,379,178,128,379,381,0,164,708,3,4,87,239,178,381,21,1496,451
1614,20,1.4.376,1,590,0,78,376,454,315,61,454,454,0,213,708,5,3,78,116,222,279,21,1496,451
1614,20,2.2.340,0,595,1,77,340,417,340,0,417,417,-34,198,742,3,4,120,239,282,381,21,1496,451
1614,20,4.2.381,0,590,0,89,381,470,381,0,470,470,-75,239,783,3,4,166,239,270,381,21,1496,451
1614,21,0.2.306,1,590,0,73,306,379,178,128,379,454,0,164,708,3,4,87,239,178,381,22,1496,373
1614,21,2.2.340,0,595,1,77,340,417,340,0,417,454,-34,198,742,3,4,120,239,282,381,22,1496,373
1614,21,4.2.381,0,590,0,89,381,470,381,0,470,470,-75,239,783,3,4,166,239,270,381,22,1496,373
1614,22,0.3.379,1,590,0,11,379,390,379,0,390,454,-64,312,772,4,4,14,96,178,163,23,1496,300
1614,22,2.2.379,0,622,1,77,379,456,340,39,456,456,0,164,708,3,5,120,166,282,381,23,1496,300
1614,22,4.2.381,0,590,0,89,381,470,381,0,470,470,-2,166,710,3,5,166,166,270,381,23,1496,300
1614,23,0.4.454,1,590,0,3,454,457,390,64,457,457,0,213,772,5,4,3,38,178,279,24,1496,289
1614,23,2.2.379,0,622,1,77,379,456,340,39,456,456,0,164,772,3,5,120,166,282,381,24,1496,289
1614,23,4.2.381,0,590,0,89,381,470,381,0,470,470,-2,166,774,3,5,166,166,270,381,24,1496,289
1614,24,2.2.379,1,622,1,77,379,456,340,39,456,457,0,164,772,3,5,120,166,282,381,25,1496,286
1614,24,4.2.381,0,590,0,89,381,470,381,0,470,470,-2,166,774,3,5,166,166,270,381,25,1496,286
1614,25,2.3.456,1,622,0,10,456,466,456,0,466,466,-66,378,838,4,5,43,85,282,163,26,1496,209
1614,25,4.2.456,0,622,0,89,456,545,381,75,545,545,0,164,772,3,6,166,89,270,381,26,1496,209
1614,26,2.4.466,1,622,0,33,466,499,466,0,499,499,-9,222,847,5,5,33,35,282,279,27,1496,199
1614,26,4.2.456,0,622,0,89,456,545,381,75,545,545,0,164,838,3,6,166,89,270,381,27,1496,199
1614,27,4.2.456,1,622,0,89,456,545,381,75,545,545,0,164,847,3,6,166,89,270,381,28,1496,166
1614,28,4.3.545,1,622,0,75,545,620,545,0,620,620,-79,457,926,4,6,77,75,270,163,29,1496,77
1614,29,4.4.620,1,622,0,2,620,622,620,0,622,622,-121,343,1047,5,6,2,2,270,279,30,1496,2
1615,0,0.0.0,0,571,1,27,0,27,0,0,27,27,0,0,0,1,1,221,192,221,192,1,1563,1563
1615,0,1.0.0,0,566,0,43,0,43,0,0,43,43,0,0,0,1,1,221,192,221,192,1,1563,1563
1615,0,2.0.0,0,594,4,46,0,46,0,0,46,46,0,0,0,1,1,308,192,308,192,1,1563,1563
1615,0,3.0.0,0,594,4,28,0,28,0,0,28,28,0,0,0,1,1,232,192,232,192,1,1563,1563
1615,0,4.0.0,1,587,3,21,0,21,0,0,21,21,0,0,0,1,1,309,192,309,192,1,1563,1563
1615,0,5.0.0,0,581,2,27,0,27,0,0,27,27,0,0,0,1,1,272,192,272,192,1,1563,1563
1615,1,0.0.21,0,592,1,27,21,48,0,21,48,48,0,0,0,1,2,221,171,221,192,2,1563,1542
1615,1,1.0.21,0,587,0,43,21,64,0,21,64,64,0,0,0,1,2,221,171,221,192,2,1563,1542
1615,1,2.0.21,0,609,3,46,21,67,0,21,67,67,0,0,0,1,2,308,171,308,192,2,1563,1542
1615,1,3.0.21,0,612,4,28,21,49,0,21,49,49,0,0,0,1,2,232,171,232,192,2,1563,1542
1615,1,4.1.21,0,587,0,58,21,79,21,0,79,79,-21,21,21,2,1,288,300,309,300,2,1563,1542
1615,1,5.0.21,1,602,2,27,21,48,0,21,48,48,0,0,0,1,2,272,171,272,192,2,1563,1542
1615,2,0.0.48,0,617,2,27,48,75,0,48,75,75,0,0,0,1,3,221,144,221,192,3,1563,1515
1615,2,1.0.48,0,602,0,43,48,91,0,48,91,91,0,0,0,1,3,221,144,221,192,3,1563,1515
1615,2,2.0.48,1,628,4,46,48,94,0,48,94,94,0,0,0,1,3,308,144,308,192,3,1563,1515
1615,2,3.0.48,0,618,3,28,48,76,0,48,76,76,0,0,0,1,3,232,144,232,192,3,1563,1515
1615,2,4.1.21,0,602,0,58,21,79,21,0,79,79,-21,21,21,2,1,288,300,309,300,3,1563,1515
1615,2,5.1.48,0,609,1,62,48,110,48,0,110,110,-48,48,48,2,1,245,300,272,300,3,1563,1515
1615,3,0.0.94,0,628,0,27,94,121,0,94,121,121,0,0,0,1,4,221,98,221,192,4,1563,1469
1615,3,1.0.94,0,628,0,43,94,137,0,94,137,137,0,0,0,1,4,221,98,221,192,4,1563,1469
1615,3,2.1.94,0,645,2,56,94,150,94,0,150,150,-94,94,94,2,1,262,300,308,300,4,1563,1469
1615,3,3.0.94,1,628,0,28,94,122,0,94,122,122,0,0,0,1,4,232,98,232,192,4,1563,1469
1615,3,4.1.21,0,636,1,58,21,79,21,0,79,94,-21,21,21,2,1,288,300,309,300,4,1563,1469
1615,3,5.1.48,0,628,0,62,48,110,48,0,110,110,-48,48,48,2,1,245,300,272,300,4,1563,1469
1615,4,0.0.122,1,628,0,27,122,149,0,122,149,149,0,0,0,1,5,221,70,221,192,5,1563,1441
1615,4,1.0.122,0,628,0,43,122,165,0,122,165,165,0,0,0,1,5,221,70,221,192,5,1563,1441
1615,4,2.1.94,0,645,1,56,94,150,94,0,150,150,-94,94,94,2,1,262,300,308,300,5,1563,1441
1615,4,3.1.122,0,628,0,69,122,191,122,0,191,191,-122,122,122,2,1,204,300,232,300,5,1563,1441
1615,4,4.1.21,0,645,1,58,21,79,21,0,79,122,-21,21,21,2,1,288,300,309,300,5,1563,1441
1615,4,5.1.48,0,628,0,62,48,110,48,0,110,122,-48,48,48,2,1,245,300,272,300,5,1563,1441
1615,5,0.1.149,0,628,0,45,149,194,149,0,194,194,-149,149,149,2,1,194,300,221,300,6,1563,1414
1615,5,1.0.149,1,628,0,43,149,192,0,149,192,192,0,0,0,1,6,221,43,221,192,6,1563,1414
1615,5,2.1.94,0,645,1,56,94,150,94,0,150,150,-94,94,94,2,1,262,300,308,300,6,1563,1414
1615,5,3.1.122,0,628,0,69,122,191,122,0,191,191,-122,122,122,2,1,204,300,232,300,6,1563,1414
1615,5,4.1.21,0,645,1,58,21,79,21,0,79,149,-21,21,21,2,1,288,300,309,300,6,1563,1414
1615,5,5.1.48,0,628,0,62,48,110,48,0,110,149,-48,48,48,2,1,245,300,272,300,6,1563,1414
1615,6,0.1.149,0,628,0,45,149,194,149,0,194,194,-149,149,149,2,1,194,300,221,300,7,1563,1371
1615,6,1.1.192,0,628,0,10,192,202,192,0,202,202,-192,192,192,2,1,178,300,221,300,7,1563,1371
1615,6,2.1.94,0,645,1,56,94,150,94,0,150,192,-94,94,94,2,1,262,300,308,300,7,1563,1371
1615,6,3.1.122,0,628,0,69,122,191,122,0,191,192,-122,122,122,2,1,204,300,232,300,7,1563,1371
1615,6,4.1.21,1,645,1,58,21,79,21,0,79,192,-21,21,21,2,1,288,300,309,300,7,1563,1371
1615,6,5.1.48,0,628,0,62,48,110,48,0,110,192,-48,48,48,2,1,245,300,272,300,7,1563,1371
1615,7,0.1.149,0,645,0,45,149,194,149,0,194,194,-70,91,91,2,2,194,242,221,300,8,1563,1313
1615,7,1.1.192,0,645,0,10,192,202,192,0,202,202,-113,134,134,2,2,178,242,221,300,8,1563,1313
1615,7,2.1.94,0,645,0,56,94,150,94,0,150,192,-15,36,36,2,2,262,242,308,300,8,1563,1313
1615,7,3.1.122,0,645,0,69,122,191,122,0,191,192,-43,64,64,2,2,204,242,232,300,8,1563,1313
1615,7,4.2.79,0,645,0,90,79,169,79,0,169,192,-79,79,100,3,1,230,349,309,349,8,1563,1313
1615,7,5.1.79,1,645,0,62,79,141,48,31,141,192,0,21,21,2,2,245,242,272,300,8,1563,1313
1615,8,0.1.149,0,645,0,45,149,194,149,0,194,194,-8,29,29,2,3,194,180,221,300,9,1563,1251
1615,8,1.1.192,0,645,0,10,192,202,192,0,202,202,-51,72,72,2,3,178,180,221,300,9,1563,1251
1615,8,2.1.141,1,645,0,56,141,197,94,47,197,197,0,21,21,2,3,262,180,308,300,9,1563,1251
1615,8,3.1.141,0,645,0,69,141,210,122,19,210,210,0,21,21,2,3,204,180,232,300,9,1563,1251
1615,8,4.2.79,0,645,0,90,79,169,79,0,169,192,-79,79,100,3,1,230,349,309,349,9,1563,1251
1615,8,5.2.141,0,659,1,83,141,224,141,0,224,224,-141,141,162,3,1,183,349,272,349,9,1563,1251
1615,9,0.1.197,0,645,0,45,197,242,149,48,242,242,0,21,21,2,4,194,124,221,300,10,1563,1195
1615,9,1.1.197,1,645,0,10,197,207,192,5,207,207,0,21,21,2,4,178,124,221,300,10,1563,1195
1615,9,2.2.197,0,645,0,30,197,227,197,0,227,227,-197,197,218,3,1,206,349,308,349,10,1563,1195
1615,9,3.1.197,0,645,0,69,197,266,122,75,266,266,0,21,21,2,4,204,124,232,300,10,1563,1195
1615,9,4.2.79,0,645,0,90,79,169,79,0,169,197,-79,79,100,3,1,230,349,309,349,10,1563,1195
1615,9,5.2.141,0,659,1,83,141,224,141,0,224,224,-141,141,162,3,1,183,349,272,349,10,1563,1195
1615,10,0.1.207,1,645,0,45,207,252,149,58,252,252,0,21,21,2,5,194,114,221,300,11,1563,1185
1615,10,1.2.207,0,645,0,31,207,238,207,0,238,238,-207,207,228,3,1,168,349,221,349,11,1563,1185
1615,10,2.2.197,0,645,0,30,197,227,197,0,227,227,-197,197,218,3,1,206,349,308,349,11,1563,1185
1615,10,3.1.207,0,645,0,69,207,276,122,85,276,276,0,21,21,2,5,204,114,232,300,11,1563,1185
1615,10,4.2.79,0,645,0,90,79,169,79,0,169,207,-79,79,100,3,1,230,349,309,349,11,1563,1185
1615,10,5.2.141,0,659,1,83,141,224,141,0,224,224,-141,141,162,3,1,183,349,272,349,11,1563,1185
1615,11,0.2.252,0,645,0,77,252,329,252,0,329,329,-252,252,273,3,1,149,349,221,349,12,1563,1140
1615,11,1.2.207,0,645,0,31,207,238,207,0,238,252,-207,207,228,3,1,168,349,221,349,12,1563,1140
1615,11,2.2.197,0,645,0,30,197,227,197,0,227,252,-197,197,218,3,1,206,349,308,349,12,1563,1140
1615,11,3.1.252,1,645,0,69,252,321,122,130,321,321,0,21,21,2,6,204,69,232,300,12,1563,1140
1615,11,4.2.79,0,645,0,90,79,169,79,0,169,252,-79,79,100,3,1,230,349,309,349,12,1563,1140
1615,11,5.2.141,0,659,1,83,141,224,141,0,224,252,-141,141,162,3,1,183,349,272,349,12,1563,1140
1615,12,0.2.252,0,645,0,77,252,329,252,0,329,329,-252,252,273,3,1,149,349,221,349,13,1563,1071
1615,12,1.2.207,0,645,0,31,207,238,207,0,238,321,-207,207,228,3,1,168,349,221,349,13,1563,1071
1615,12,2.2.197,0,645,0,30,197,227,197,0,227,321,-197,197,218,3,1,206,349,308,349,13,1563,1071
1615,12,3.2.321,0,645,0,38,321,359,321,0,359,359,-321,321,342,3,1,135,349,232,349,13,1563,1071
1615,12,4.2.79,1,645,0,90,79,169,79,0,169,321,-79,79,100,3,1,230,349,309,349,13,1563,1071
1615,12,5.2.141,0,659,1,83,141,224,141,0,224,321,-141,141,162,3,1,183,349,272,349,13,1563,1071
1615,13,0.2.252,0,645,0,77,252,329,252,0,329,329,-83,162,183,3,2,149,259,221,349,14,1563,981
1615,13,1.2.207,0,645,0,31,207,238,207,0,238,321,-38,117,138,3,2,168,259,221,349,14,1563,981
1615,13,2.2.197,0,645,0,30,197,227,197,0,227,321,-28,107,128,3,2,206,259,308,349,14,1563,981
1615,13,3.2.321,0,645,0,38,321,359,321,0,359,359,-152,231,252,3,2,135,259,232,349,14,1563,981
1615,13,4.3.169,1,645,0,68,169,237,169,0,237,321,-169,169,269,4,1,140,314,309,314,14,1563,981
1615,13,5.2.169,0,645,0,83,169,252,141,28,252,321,0,79,100,3,2,183,259,272,349,14,1563,981
1615,14,0.2.252,0,645,0,77,252,329,252,0,329,329,-83,162,352,3,2,149,259,221,349,15,1563,913
1615,14,1.2.207,0,645,0,31,207,238,207,0,238,321,-38,117,307,3,2,168,259,221,349,15,1563,913
1615,14,2.2.197,1,645,0,30,197,227,197,0,227,321,-28,107,297,3,2,206,259,308,349,15,1563,913
1615,14,3.2.321,0,645,0,38,321,359,321,0,359,359,-152,231,421,3,2,135,259,232,349,15,1563,913
1615,14,4.4.237,0,645,0,72,237,309,237,0,309,321,-237,237,506,5,1,72,408,309,408,15,1563,913
1615,14,5.2.169,0,645,0,83,169,252,141,28,252,321,0,79,269,3,2,183,259,272,349,15,1563,913
1615,15,0.2.252,0,651,1,77,252,329,252,0,329,329,-25,132,322,3,3,149,229,221,349,16,1563,883
1615,15,1.2.227,0,645,0,31,227,258,207,20,258,321,0,107,297,3,3,168,229,221,349,16,1563,883
1615,15,2.3.237,1,651,1,78,237,315,227,10,315,321,0,169,297,4,2,176,246,308,314,16,1563,883
1615,15,3.2.321,0,645,0,38,321,359,321,0,359,359,-94,201,391,3,3,135,229,232,349,16,1563,883
1615,15,4.4.237,0,645,0,72,237,309,237,0,309,321,-237,237,534,5,1,72,408,309,408,16,1563,883
1615,15,5.2.227,0,651,1,83,227,310,141,86,310,321,0,107,297,3,3,183,229,272,349,16,1563,883
1615,16,0.2.252,0,651,0,77,252,329,252,0,329,329,-25,132,322,3,3,149,229,221,349,17,1563,805
1615,16,1.2.227,1,651,0,31,227,258,207,20,258,321,0,107,297,3,3,168,229,221,349,17,1563,805
1615,16,2.4.315,0,651,0,98,315,413,315,0,413,413,-315,315,612,5,1,98,408,308,408,17,1563,805
1615,16,3.2.321,0,651,0,38,321,359,321,0,359,359,-94,201,391,3,3,135,229,232,349,17,1563,805
1615,16,4.4.237,0,651,0,72,237,309,237,0,309,321,-237,237,534,5,1,72,408,309,408,17,1563,805
1615,16,5.2.227,0,651,0,83,227,310,141,86,310,321,0,107,297,3,3,183,229,272,349,17,1563,805
1615,17,0.2.258,0,651,0,77,258,335,252,6,335,335,0,107,297,3,4,149,198,221,349,18,1563,774
1615,17,1.3.315,1,651,0,50,315,365,258,57,365,365,0,169,297,4,3,137,168,221,314,18,1563,774
1615,17,2.4.315,0,651,0,98,315,413,315,0,413,413,-315,315,612,5,1,98,408,308,408,18,1563,774
1615,17,3.2.321,0,651,0,38,321,359,321,0,359,359,-63,170,360,3,4,135,198,232,349,18,1563,774
1615,17,4.4.237,0,651,0,72,237,309,237,0,309,321,-237,237,534,5,1,72,408,309,408,18,1563,774
1615,17,5.2.258,0,651,0,83,258,341,141,117,341,341,0,107,297,3,4,183,198,272,349,18,1563,774
1615,18,0.2.258,0,651,0,77,258,335,252,6,335,365,0,107,297,3,4,149,198,221,349,19,1563,724
1615,18,1.4.365,0,701,1,87,365,452,365,0,452,452,-365,365,662,5,1,87,408,221,408,19,1563,724
1615,18,2.4.315,0,651,0,98,315,413,315,0,413,413,-315,315,612,5,1,98,408,308,408,19,1563,724
1615,18,3.2.321,0,651,0,38,321,359,321,0,359,365,-63,170,360,3,4,135,198,232,349,19,1563,724
1615,18,4.4.237,0,651,0,72,237,309,237,0,309,365,-237,237,534,5,1,72,408,309,408,19,1563,724
1615,18,5.2.258,1,651,0,83,258,341,141,117,341,365,0,107,297,3,4,183,198,272,349,19,1563,724
1615,19,0.2.341,0,651,0,77,341,418,252,89,418,418,0,107,297,3,5,149,115,221,349,20,1563,641
1615,19,1.4.365,0,701,1,87,365,452,365,0,452,452,-365,365,662,5,1,87,408,221,408,20,1563,641
1615,19,2.4.315,0,651,0,98,315,413,315,0,413,413,-315,315,612,5,1,98,408,308,408,20,1563,641
1615,19,3.2.341,0,651,0,38,341,379,321,20,379,379,0,107,297,3,5,135,115,232,349,20,1563,641
1615,19,4.4.237,0,651,0,72,237,309,237,0,309,365,-237,237,534,5,1,72,408,309,408,20,1563,641
1615,19,5.3.365,1,651,0,27,365,392,341,24,392,392,0,169,297,4,4,100,118,272,314,20,1563,641
1615,20,0.2.341,0,651,0,77,341,418,252,89,418,418,0,107,297,3,5,149,115,221,349,21,1563,614
1615,20,1.4.365,0,701,1,87,365,452,365,0,452,452,-365,365,662,5,1,87,408,221,408,21,1563,614
1615,20,2.4.315,0,651,0,98,315,413,315,0,413,413,-315,315,612,5,1,98,408,308,408,21,1563,614
1615,20,3.2.341,1,651,0,38,341,379,321,20,379,392,0,107,297,3,5,135,115,232,349,21,1563,614
1615,20,4.4.237,0,651,0,72,237,309,237,0,309,392,-237,237,534,5,1,72,408,309,408,21,1563,614
1615,20,5.4.392,0,728,2,73,392,465,392,0,465,465,-392,392,689,5,1,73,408,272,408,21,1563,614
1615,21,0.2.379,1,651,0,77,379,456,252,127,456,456,0,107,297,3,6,149,77,221,349,22,1563,576
1615,21,1.4.365,0,701,1,87,365,452,365,0,452,452,-365,365,662,5,1,87,408,221,408,22,1563,576
1615,21,2.4.315,0,651,0,98,315,413,315,0,413,413,-315,315,612,5,1,98,408,308,408,22,1563,576
1615,21,3.3.392,0,651,0,74,392,466,379,13,466,466,0,169,297,4,5,97,91,232,314,22,1563,576
1615,21,4.4.237,0,651,0,72,237,309,237,0,309,392,-237,237,534,5,1,72,408,309,408,22,1563,576
1615,21,5.4.392,0,728,2,73,392,465,392,0,465,465,-392,392,689,5,1,73,408,272,408,22,1563,576
1615,22,0.3.456,0,651,0,17,456,473,456,0,473,473,-64,233,361,4,5,72,91,221,314,23,1563,499
1615,22,1.4.365,0,701,1,87,365,452,365,0,452,456,-365,365,662,5,1,87,408,221,408,23,1563,499
1615,22,2.4.315,0,651,0,98,315,413,315,0,413,456,-315,315,612,5,1,98,408,308,408,23,1563,499
1615,22,3.3.392,1,651,0,74,392,466,379,13,466,466,0,169,297,4,5,97,91,232,314,23,1563,499
1615,22,4.4.237,0,651,0,72,237,309,237,0,309,456,-237,237,534,5,1,72,408,309,408,23,1563,499
1615,22,5.4.392,0,728,2,73,392,465,392,0,465,465,-392,392,689,5,1,73,408,272,408,23,1563,499
1615,23,0.3.466,1,651,0,17,466,483,456,10,483,483,0,169,297,4,6,72,17,221,314,24,1563,425
1615,23,1.4.365,0,701,1,87,365,452,365,0,452,466,-365,365,662,5,1,87,408,221,408,24,1563,425
1615,23,2.4.315,0,651,0,98,315,413,315,0,413,466,-315,315,612,5,1,98,408,308,408,24,1563,425
1615,23,3.4.466,0,704,2,23,466,489,466,0,489,489,-466,466,763,5,1,23,408,232,408,24,1563,425
1615,23,4.4.237,0,651,0,72,237,309,237,0,309,466,-237,237,534,5,1,72,408,309,408,24,1563,425
1615,23,5.4.392,0,728,3,73,392,465,392,0,465,466,-392,392,689,5,1,73,408,272,408,24,1563,425
1615,24,0.4.483,0,721,3,55,483,538,483,0,538,538,-483,483,780,5,1,55,408,221,408,25,1563,408
1615,24,1.4.365,0,701,1,87,365,452,365,0,452,483,-365,365,662,5,1,87,408,221,408,25,1563,408
1615,24,2.4.315,0,651,0,98,315,413,315,0,413,483,-315,315,612,5,1,98,408,308,408,25,1563,408
1615,24,3.4.466,0,704,2,23,466,489,466,0,489,489,-466,466,763,5,1,23,408,232,408,25,1563,408
1615,24,4.4.237,1,651,0,72,237,309,237,0,309,483,-237,237,534,5,1,72,408,309,408,25,1563,408
1615,24,5.4.392,0,728,4,73,392,465,392,0,465,483,-392,392,689,5,1,73,408,272,408,25,1563,408
1615,25,0.4.483,0,721,3,55,483,538,483,0,538,538,-174,411,708,5,2,55,336,221,408,26,1563,336
1615,25,1.4.365,0,701,1,87,365,452,365,0,452,483,-56,293,590,5,2,87,336,221,408,26,1563,336
1615,25,2.4.315,1,651,0,98,315,413,315,0,413,483,-6,243,540,5,2,98,336,308,408,26,1563,336
1615,25,3.4.466,0,704,2,23,466,489,466,0,489,489,-157,394,691,5,2,23,336,232,408,26,1563,336
1615,25,5.4.392,0,728,4,73,392,465,392,0,465,483,-83,320,617,5,2,73,336,272,408,26,1563,336
1615,26,0.4.483,0,721,2,55,483,538,483,0,538,538,-70,313,610,5,3,55,238,221,408,27,1563,238
1615,26,1.4.413,0,651,0,87,413,500,365,48,500,500,0,243,540,5,3,87,238,221,408,27,1563,238
1615,26,3.4.466,0,704,1,23,466,489,466,0,489,489,-53,296,593,5,3,23,238,232,408,27,1563,238
1615,26,5.4.413,1,651,0,73,413,486,392,21,486,486,0,243,540,5,3,73,238,272,408,27,1563,238
1615,27,0.4.486,0,651,0,55,486,541,483,3,541,541,0,243,540,5,4,55,165,221,408,28,1563,165
1615,27,1.4.486,0,651,0,87,486,573,365,121,573,573,0,243,540,5,4,87,165,221,408,28,1563,165
1615,27,3.4.486,1,651,0,23,486,509,466,20,509,509,0,243,540,5,4,23,165,232,408,28,1563,165
1615,28,0.4.509,0,651,0,55,509,564,483,26,564,564,0,243,540,5,5,55,142,221,408,29,1563,142
1615,28,1.4.509,1,651,0,87,509,596,365,144,596,596,0,243,540,5,5,87,142,221,408,29,1563,142
1615,29,0.4.596,1,651,0,55,596,651,483,113,651,651,0,243,540,5,6,55,55,221,408,30,1563,55
1616,0,0.0.0,0,550,2,40,0,40,0,0,40,40,0,0,0,1,1,166,306,166,306,1,1437,1437
1616,0,1.0.0,1,519,0,19,0,19,0,0,19,19,0,0,0,1,1,321,306,321,306,1,1437,1437
1616,0,2.0.0,0,586,4,91,0,91,0,0,91,91,0,0,0,1,1,335,306,335,306,1,1437,1437
1616,0,3.0.0,0,559,3,81,0,81,0,0,81,81,0,0,0,1,1,192,306,192,306,1,1437,1437
1616,0,4.0.0,0,529,1,43,0,43,0,0,43,43,0,0,0,1,1,248,306,248,306,1,1437,1437
1616,0,5.0.0,0,519,0,32,0,32,0,0,32,32,0,0,0,1,1,175,306,175,306,1,1437,1437
1616,1,0.0.19,0,542,2,40,19,59,0,19,59,59,0,0,0,1,2,166,287,166,306,2,1437,1418
1616,1,1.1.19,1,519,0,78,19,97,19,0,97,97,-19,19,19,2,1,302,204,321,204,2,1437,1418
1616,1,2.0.19,0,564,3,91,19,110,0,19,110,110,0,0,0,1,2,335,287,335,306,2,1437,1418
1616,1,3.0.19,0,519,0,81,19,100,0,19,100,100,0,0,0,1,2,192,287,192,306,2,1437,1418
1616,1,4.0.19,0,524,1,43,19,62,0,19,62,62,0,0,0,1,2,248,287,248,306,2,1437,1418
1616,1,5.0.19,0,519,0,32,19,51,0,19,51,51,0,0,0,1,2,175,287,175,306,2,1437,1418
1616,2,0.0.19,0,542,2,40,19,59,0,19,59,97,0,0,19,1,2,166,287,166,306,3,1437,1340
1616,2,1.2.97,1,519,0,37,97,134,97,0,134,134,-97,97,116,3,1,224,319,321,319,3,1437,1340
1616,2,2.0.19,0,564,3,91,19,110,0,19,110,110,0,0,19,1,2,335,287,335,306,3,1437,1340
1616,2,3.0.19,0,519,0,81,19,100,0,19,100,100,0,0,19,1,2,192,287,192,306,3,1437,1340
1616,2,4.0.19,0,524,1,43,19,62,0,19,62,97,0,0,19,1,2,248,287,248,306,3,1437,1340
1616,2,5.0.19,0,519,0,32,19,51,0,19,51,97,0,0,19,1,2,175,287,175,306,3,1437,1340
1616,3,0.0.19,0,542,2,40,19,59,0,19,59,134,0,0,116,1,2,166,287,166,306,4,1437,1303
1616,3,1.3.134,1,564,3,91,134,225,134,0,225,225,-134,134,250,4,1,187,269,321,269,4,1437,1303
1616,3,2.0.19,0,564,3,91,19,110,0,19,110,134,0,0,116,1,2,335,287,335,306,4,1437,1303
1616,3,3.0.19,0,519,0,81,19,100,0,19,100,134,0,0,116,1,2,192,287,192,306,4,1437,1303
1616,3,4.0.19,0,524,1,43,19,62,0,19,62,134,0,0,116,1,2,248,287,248,306,4,1437,1303
1616,3,5.0.19,0,519,0,32,19,51,0,19,51,134,0,0,116,1,2,175,287,175,306,4,1437,1303
1616,4,0.0.19,0,564,0,40,19,59,0,19,59,225,0,0,250,1,2,166,287,166,306,5,1437,1212
1616,4,1.4.225,1,564,0,96,225,321,225,0,321,321,-225,225,475,5,1,96,339,321,339,5,1437,1212
1616,4,2.0.19,0,564,0,91,19,110,0,19,110,225,0,0,250,1,2,335,287,335,306,5,1437,1212
1616,4,3.0.19,0,564,0,81,19,100,0,19,100,225,0,0,250,1,2,192,287,192,306,5,1437,1212
1616,4,4.0.19,0,564,0,43,19,62,0,19,62,225,0,0,250,1,2,248,287,248,306,5,1437,1212
1616,4,5.0.19,0,564,0,32,19,51,0,19,51,225,0,0,250,1,2,175,287,175,306,5,1437,1212
1616,5,0.0.19,0,564,0,40,19,59,0,19,59,321,0,0,475,1,2,166,287,166,306,6,1437,1116
1616,5,2.0.19,0,564,0,91,19,110,0,19,110,321,0,0,475,1,2,335,287,335,306,6,1437,1116
1616,5,3.0.19,0,564,0,81,19,100,0,19,100,321,0,0,475,1,2,192,287,192,306,6,1437,1116
1616,5,4.0.19,1,564,0,43,19,62,0,19,62,321,0,0,475,1,2,248,287,248,306,6,1437,1116
1616,5,5.0.19,0,564,0,32,19,51,0,19,51,321,0,0,475,1,2,175,287,175,306,6,1437,1116
1616,6,0.0.62,0,564,0,40,62,102,0,62,102,321,0,0,475,1,3,166,244,166,306,7,1437,1073
1616,6,2.0.62,0,564,0,91,62,153,0,62,153,321,0,0,475,1,3,335,244,335,306,7,1437,1073
1616,6,3.0.62,0,564,0,81,62,143,0,62,143,321,0,0,475,1,3,192,244,192,306,7,1437,1073
1616,6,4.1.97,1,564,0,10,97,107,62,35,107,321,0,19,475,2,2,205,126,248,204,7,1437,1073
1616,6,5.0.62,0,564,0,32,62,94,0,62,94,321,0,0,475,1,3,175,244,175,306,7,1437,1073
1616,7,0.0.62,0,564,0,40,62,102,0,62,102,321,0,0,475,1,3,166,244,166,306,8,1437,1063
1616,7,2.0.62,0,564,0,91,62,153,0,62,153,321,0,0,475,1,3,335,244,335,306,8,1437,1063
1616,7,3.0.62,0,564,0,81,62,143,0,62,143,321,0,0,475,1,3,192,244,192,306,8,1437,1063
1616,7,4.2.134,1,564,0,91,134,225,107,27,225,321,0,97,475,3,2,195,282,248,319,8,1437,1063
1616,7,5.0.62,0,564,0,32,62,94,0,62,94,321,0,0,475,1,3,175,244,175,306,8,1437,1063
1616,8,0.0.62,0,564,0,40,62,102,0,62,102,321,0,0,475,1,3,166,244,166,306,9,1437,972
1616,8,2.0.62,0,564,0,91,62,153,0,62,153,321,0,0,475,1,3,335,244,335,306,9,1437,972
1616,8,3.0.62,0,564,0,81,62,143,0,62,143,321,0,0,475,1,3,192,244,192,306,9,1437,972
1616,8,4.3.225,1,564,0,62,225,287,225,0,287,321,0,134,475,4,2,104,178,248,269,9,1437,972
1616,8,5.0.62,0,564,0,32,62,94,0,62,94,321,0,0,475,1,3,175,244,175,306,9,1437,972
1616,9,0.0.62,0,564,0,40,62,102,0,62,102,321,0,0,475,1,3,166,244,166,306,10,1437,910
1616,9,2.0.62,0,564,0,91,62,153,0,62,153,321,0,0,475,1,3,335,244,335,306,10,1437,910
1616,9,3.0.62,0,564,0,81,62,143,0,62,143,321,0,0,475,1,3,192,244,192,306,10,1437,910
1616,9,4.4.321,1,564,0,42,321,363,287,34,363,363,0,225,475,5,2,42,243,248,339,10,1437,910
1616,9,5.0.62,0,564,0,32,62,94,0,62,94,321,0,0,475,1,3,175,244,175,306,10,1437,910
1616,10,0.0.62,0,564,0,40,62,102,0,62,102,363,0,0,475,1,3,166,244,166,306,11,1437,868
1616,10,2.0.62,1,564,0,91,62,153,0,62,153,363,0,0,475,1,3,335,244,335,306,11,1437,868
1616,10,3.0.62,0,564,0,81,62,143,0,62,143,363,0,0,475,1,3,192,244,192,306,11,1437,868
1616,10,5.0.62,0,564,0,32,62,94,0,62,94,363,0,0,475,1,3,175,244,175,306,11,1437,868
1616,11,0.0.153,0,564,0,40,153,193,0,153,193,363,0,0,475,1,4,166,153,166,306,12,1437,777
1616,11,2.1.153,1,564,0,50,153,203,153,0,203,363,-46,65,521,2,3,244,116,335,204,12,1437,777
1616,11,3.0.153,0,564,0,81,153,234,0,153,234,363,0,0,475,1,4,192,153,192,306,12,1437,777
1616,11,5.0.153,0,564,0,32,153,185,0,153,185,363,0,0,475,1,4,175,153,175,306,12,1437,777
1616,12,0.0.153,0,564,0,40,153,193,0,153,193,363,0,0,521,1,4,166,153,166,306,13,1437,727
1616,12,2.2.225,0,564,0,83,225,308,203,22,308,363,0,97,521,3,3,194,191,335,319,13,1437,727
1616,12,3.0.153,0,564,0,81,153,234,0,153,234,363,0,0,521,1,4,192,153,192,306,13,1437,727
1616,12,5.0.153,1,564,0,32,153,185,0,153,185,363,0,0,521,1,4,175,153,175,306,13,1437,727
1616,13,0.0.185,0,564,0,40,185,225,0,185,225,363,0,0,521,1,5,166,121,166,306,14,1437,695
1616,13,2.2.225,0,564,0,83,225,308,203,22,308,363,0,97,521,3,3,194,191,335,319,14,1437,695
1616,13,3.0.185,0,564,0,81,185,266,0,185,266,363,0,0,521,1,5,192,121,192,306,14,1437,695
1616,13,5.1.203,1,564,0,45,203,248,185,18,248,363,0,65,521,2,4,143,66,175,204,14,1437,695
1616,14,0.0.185,1,564,0,40,185,225,0,185,225,363,0,0,521,1,5,166,121,166,306,15,1437,650
1616,14,2.2.225,0,564,0,83,225,308,203,22,308,363,0,97,521,3,3,194,191,335,319,15,1437,650
1616,14,3.0.185,0,564,0,81,185,266,0,185,266,363,0,0,521,1,5,192,121,192,306,15,1437,650
1616,14,5.2.248,0,564,0,22,248,270,248,0,270,363,-23,120,544,3,3,98,191,175,319,15,1437,650
1616,15,0.1.248,1,564,0,13,248,261,225,23,261,363,0,65,521,2,5,126,21,166,204,16,1437,610
1616,15,2.2.225,0,564,0,83,225,308,203,22,308,363,0,97,521,3,3,194,191,335,319,16,1437,610
1616,15,3.0.225,0,564,0,81,225,306,0,225,306,363,0,0,521,1,6,192,81,192,306,16,1437,610
1616,15,5.2.248,0,564,0,22,248,270,248,0,270,363,-23,120,544,3,3,98,191,175,319,16,1437,610
1616,16,0.2.261,0,569,1,80,261,341,261,0,341,363,-36,133,557,3,3,113,191,166,319,17,1437,597
1616,16,2.2.225,0,564,0,83,225,308,203,22,308,363,0,97,521,3,3,194,191,335,319,17,1437,597
1616,16,3.0.225,1,564,0,81,225,306,0,225,306,363,0,0,521,1,6,192,81,192,306,17,1437,597
1616,16,5.2.248,0,564,0,22,248,270,248,0,270,363,-23,120,544,3,3,98,191,175,319,17,1437,597
1616,17,0.2.261,0,569,1,80,261,341,261,0,341,363,-36,133,557,3,3,113,191,166,319,18,1437,516
1616,17,2.2.225,0,564,0,83,225,308,203,22,308,363,0,97,521,3,3,194,191,335,319,18,1437,516
1616,17,3.1.306,1,564,0,8,306,314,306,0,314,363,-45,110,566,2,6,111,8,192,204,18,1437,516
1616,17,5.2.248,0,564,0,22,248,270,248,0,270,363,-23,120,544,3,3,98,191,175,319,18,1437,516
1616,18,0.2.261,0,569,1,80,261,341,261,0,341,363,-36,133,602,3,3,113,191,166,319,19,1437,508
1616,18,2.2.225,1,564,0,83,225,308,203,22,308,363,0,97,566,3,3,194,191,335,319,19,1437,508
1616,18,3.2.314,0,564,0,6,314,320,314,0,320,363,-89,186,655,3,3,103,191,192,319,19,1437,508
1616,18,5.2.248,0,564,0,22,248,270,248,0,270,363,-23,120,589,3,3,98,191,175,319,19,1437,508
1616,19,0.2.308,0,564,0,80,308,388,261,47,388,388,0,97,566,3,4,113,108,166,319,20,1437,425
1616,19,2.3.308,1,564,0,47,308,355,308,0,355,363,-21,155,587,4,3,111,116,335,269,20,1437,425
1616,19,3.2.314,0,564,0,6,314,320,314,0,320,363,-6,103,572,3,4,103,108,192,319,20,1437,425
1616,19,5.2.308,0,564,0,22,308,330,248,60,330,363,0,97,566,3,4,98,108,175,319,20,1437,425
1616,20,0.2.308,0,564,0,80,308,388,261,47,388,388,0,97,587,3,4,113,108,166,319,21,1437,378
1616,20,2.4.363,0,564,0,64,363,427,355,8,427,427,0,225,587,5,3,64,201,335,339,21,1437,378
1616,20,3.2.314,0,564,0,6,314,320,314,0,320,363,-6,103,593,3,4,103,108,192,319,21,1437,378
1616,20,5.2.308,1,564,0,22,308,330,248,60,330,363,0,97,587,3,4,98,108,175,319,21,1437,378
1616,21,0.2.330,0,564,0,80,330,410,261,69,410,410,0,97,587,3,5,113,86,166,319,22,1437,356
1616,21,2.4.363,0,564,0,64,363,427,355,8,427,427,0,225,587,5,3,64,201,335,339,22,1437,356
1616,21,3.2.330,0,564,0,6,330,336,314,16,336,363,0,97,587,3,5,103,86,192,319,22,1437,356
1616,21,5.3.355,1,564,0,12,355,367,330,25,367,367,0,155,587,4,4,76,69,175,269,22,1437,356
1616,22,0.2.330,0,564,0,80,330,410,261,69,410,410,0,97,587,3,5,113,86,166,319,23,1437,344
1616,22,2.4.363,0,564,0,64,363,427,355,8,427,427,0,225,587,5,3,64,201,335,339,23,1437,344
1616,22,3.2.330,1,564,0,6,330,336,314,16,336,367,0,97,587,3,5,103,86,192,319,23,1437,344
1616,22,5.4.367,0,568,1,64,367,431,367,0,431,431,-4,229,591,5,3,64,201,175,339,23,1437,344
1616,23,0.2.336,0,564,0,80,336,416,261,75,416,416,0,97,587,3,6,113,80,166,319,24,1437,338
1616,23,2.4.363,0,564,0,64,363,427,355,8,427,427,0,225,587,5,3,64,201,335,339,24,1437,338
1616,23,3.3.367,1,564,0,33,367,400,336,31,400,400,0,155,587,4,5,97,57,192,269,24,1437,338
1616,23,5.4.367,0,568,1,64,367,431,367,0,431,431,-4,229,591,5,3,64,201,175,339,24,1437,338
1616,24,0.2.336,0,564,0,80,336,416,261,75,416,416,0,97,587,3,6,113,80,166,319,25,1437,305
1616,24,2.4.363,1,564,0,64,363,427,355,8,427,427,0,225,587,5,3,64,201,335,339,25,1437,305
1616,24,3.4.400,0,601,2,64,400,464,400,0,464,464,-37,262,624,5,3,64,201,192,339,25,1437,305
1616,24,5.4.367,0,568,1,64,367,431,367,0,431,431,-4,229,591,5,3,64,201,175,339,25,1437,305
1616,25,0.2.336,1,564,0,80,336,416,261,75,416,427,0,97,587,3,6,113,80,166,319,26,1437,241
1616,25,3.4.427,0,564,0,64,427,491,400,27,491,491,0,225,587,5,4,64,137,192,339,26,1437,241
1616,25,5.4.427,0,564,0,64,427,491,367,60,491,491,0,225,587,5,4,64,137,175,339,26,1437,241
1616,26,0.3.416,1,564,0,24,416,440,416,0,440,440,-16,171,603,4,6,33,24,166,269,27,1437,161
1616,26,3.4.427,0,564,0,64,427,491,400,27,491,491,0,225,587,5,4,64,137,192,339,27,1437,161
1616,26,5.4.427,0,564,0,64,427,491,367,60,491,491,0,225,587,5,4,64,137,175,339,27,1437,161
1616,27,0.4.440,1,577,1,9,440,449,440,0,449,449,-13,238,616,5,4,9,137,166,339,28,1437,137
1616,27,3.4.427,0,564,0,64,427,491,400,27,491,491,0,225,603,5,4,64,137,192,339,28,1437,137
1616,27,5.4.427,0,564,0,64,427,491,367,60,491,491,0,225,603,5,4,64,137,175,339,28,1437,137
1616,28,3.4.449,0,577,0,64,449,513,400,49,513,513,0,238,616,5,5,64,128,192,339,29,1437,128
1616,28,5.4.449,1,577,0,64,449,513,367,82,513,513,0,238,616,5,5,64,128,175,339,29,1437,128
1616,29,3.4.513,1,577,0,64,513,577,400,113,577,577,0,238,616,5,6,64,64,192,339,30,1437,64
1617,0,0.0.0,0,543,3,53,0,53,0,0,53,53,0,0,0,1,1,309,320,309,320,1,1504,1504
1617,0,1.0.0,0,589,5,94,0,94,0,0,94,94,0,0,0,1,1,222,320,222,320,1,1504,1504
1617,0,2.0.0,0,518,2,38,0,38,0,0,38,38,0,0,0,1,1,163,320,163,320,1,1504,1504
1617,0,3.0.0,0,505,1,35,0,35,0,0,35,35,0,0,0,1,1,251,320,251,320,1,1504,1504
1617,0,4.0.0,0,561,4,64,0,64,0,0,64,64,0,0,0,1,1,284,320,284,320,1,1504,1504
1617,0,5.0.0,1,497,0,36,0,36,0,0,36,36,0,0,0,1,1,275,320,275,320,1,1504,1504
1617,1,0.0.36,0,534,2,53,36,89,0,36,89,89,0,0,0,1,2,309,284,309,320,2,1504,1468
1617,1,1.0.36,0,578,4,94,36,130,0,36,130,130,0,0,0,1,2,222,284,222,320,2,1504,1468
1617,1,2.0.36,0,507,1,38,36,74,0,36,74,74,0,0,0,1,2,163,284,163,320,2,1504,1468
1617,1,3.0.36,0,497,0,35,36,71,0,36,71,71,0,0,0,1,2,251,284,251,320,2,1504,1468
1617,1,4.0.36,0,542,3,64,36,100,0,36,100,100,0,0,0,1,2,284,284,284,320,2,1504,1468
1617,1,5.1.36,1,497,0,28,36,64,36,0,64,64,-36,36,36,2,1,239,306,275,306,2,1504,1468
1617,2,0.0.36,0,534,2,53,36,89,0,36,89,89,0,0,36,1,2,309,284,309,320,3,1504,1440
1617,2,1.0.36,0,578,4,94,36,130,0,36,130,130,0,0,36,1,2,222,284,222,320,3,1504,1440
1617,2,2.0.36,0,507,1,38,36,74,0,36,74,74,0,0,36,1,2,163,284,163,320,3,1504,1440
1617,2,3.0.36,0,497,0,35,36,71,0,36,71,71,0,0,36,1,2,251,284,251,320,3,1504,1440
1617,2,4.0.36,0,542,3,64,36,100,0,36,100,100,0,0,36,1,2,284,284,284,320,3,1504,1440
1617,2,5.2.64,1,497,0,60,64,124,64,0,124,124,-64,64,100,3,1,211,384,275,384,3,1504,1440
1617,3,0.0.36,0,534,2,53,36,89,0,36,89,124,0,0,100,1,2,309,284,309,320,4,1504,1380
1617,3,1.0.36,0,578,4,94,36,130,0,36,130,130,0,0,100,1,2,222,284,222,320,4,1504,1380
1617,3,2.0.36,0,507,1,38,36,74,0,36,74,124,0,0,100,1,2,163,284,163,320,4,1504,1380
1617,3,3.0.36,0,497,0,35,36,71,0,36,71,124,0,0,100,1,2,251,284,251,320,4,1504,1380
1617,3,4.0.36,0,542,3,64,36,100,0,36,100,124,0,0,100,1,2,284,284,284,320,4,1504,1380
1617,3,5.3.124,1,497,0,96,124,220,124,0,220,220,-124,124,224,4,1,151,323,275,323,4,1504,1380
1617,4,0.0.36,0,534,2,53,36,89,0,36,89,220,0,0,224,1,2,309,284,309,320,5,1504,1284
1617,4,1.0.36,0,578,4,94,36,130,0,36,130,220,0,0,224,1,2,222,284,222,320,5,1504,1284
1617,4,2.0.36,0,507,1,38,36,74,0,36,74,220,0,0,224,1,2,163,284,163,320,5,1504,1284
1617,4,3.0.36,0,497,0,35,36,71,0,36,71,220,0,0,224,1,2,251,284,251,320,5,1504,1284
1617,4,4.0.36,0,542,3,64,36,100,0,36,100,220,0,0,224,1,2,284,284,284,320,5,1504,1284
1617,4,5.4.220,1,497,0,55,220,275,220,0,275,275,-220,220,444,5,1,55,171,275,171,5,1504,1284
1617,5,0.0.36,1,534,2,53,36,89,0,36,89,275,0,0,444,1,2,309,284,309,320,6,1504,1229
1617,5,1.0.36,0,578,4,94,36,130,0,36,130,275,0,0,444,1,2,222,284,222,320,6,1504,1229
1617,5,2.0.36,0,507,1,38,36,74,0,36,74,275,0,0,444,1,2,163,284,163,320,6,1504,1229
1617,5,3.0.36,0,497,0,35,36,71,0,36,71,275,0,0,444,1,2,251,284,251,320,6,1504,1229
1617,5,4.0.36,0,542,3,64,36,100,0,36,100,275,0,0,444,1,2,284,284,284,320,6,1504,1229
1617,6,0.1.89,0,534,0,81,89,170,89,0,170,275,-25,61,469,2,2,256,278,309,306,7,1504,1176
1617,6,1.0.89,0,553,1,94,89,183,0,89,183,275,0,0,444,1,3,222,231,222,320,7,1504,1176
1617,6,2.0.89,0,534,0,38,89,127,0,89,127,275,0,0,444,1,3,163,231,163,320,7,1504,1176
1617,6,3.0.89,1,534,0,35,89,124,0,89,124,275,0,0,444,1,3,251,231,251,320,7,1504,1176
1617,6,4.0.89,0,534,0,64,89,153,0,89,153,275,0,0,444,1,3,284,231,284,320,7,1504,1176
1617,7,0.1.89,0,534,0,81,89,170,89,0,170,275,-25,61,469,2,2,256,278,309,306,8,1504,1141
1617,7,1.0.124,0,553,2,94,124,218,0,124,218,275,0,0,444,1,4,222,196,222,320,8,1504,1141
1617,7,2.0.124,0,534,0,38,124,162,0,124,162,275,0,0,444,1,4,163,196,163,320,8,1504,1141
1617,7,3.1.124,0,543,1,46,124,170,124,0,170,275,-60,96,504,2,2,216,278,251,306,8,1504,1141
1617,7,4.0.124,1,534,0,64,124,188,0,124,188,275,0,0,444,1,4,284,196,284,320,8,1504,1141
1617,8,0.1.89,0,534,0,81,89,170,89,0,170,275,-25,61,469,2,2,256,278,309,306,9,1504,1077
1617,8,1.0.188,0,534,0,94,188,282,0,188,282,282,0,0,444,1,5,222,132,222,320,9,1504,1077
1617,8,2.0.188,1,534,0,38,188,226,0,188,226,275,0,0,444,1,5,163,132,163,320,9,1504,1077
1617,8,3.1.124,0,543,1,46,124,170,124,0,170,275,-60,96,504,2,2,216,278,251,306,9,1504,1077
1617,8,4.1.188,0,552,2,62,188,250,188,0,250,275,-124,160,568,2,2,220,278,284,306,9,1504,1077
1617,9,0.1.89,0,534,0,81,89,170,89,0,170,275,-25,61,469,2,2,256,278,309,306,10,1504,1039
1617,9,1.0.226,1,534,0,94,226,320,0,226,320,320,0,0,444,1,6,222,94,222,320,10,1504,1039
1617,9,2.1.226,0,540,1,43,226,269,226,0,269,275,-162,198,606,2,2,125,278,163,306,10,1504,1039
1617,9,3.1.124,0,543,2,46,124,170,124,0,170,275,-60,96,504,2,2,216,278,251,306,10,1504,1039
1617,9,4.1.188,0,552,3,62,188,250,188,0,250,275,-124,160,568,2,2,220,278,284,306,10,1504,1039
1617,10,0.1.89,1,534,0,81,89,170,89,0,170,320,-25,61,469,2,2,256,278,309,306,11,1504,945
1617,10,1.1.320,0,534,0,46,320,366,320,0,366,366,-256,292,700,2,2,128,278,222,306,11,1504,945
1617,10,2.1.226,0,540,1,43,226,269,226,0,269,320,-162,198,606,2,2,125,278,163,306,11,1504,945
1617,10,3.1.124,0,543,2,46,124,170,124,0,170,320,-60,96,504,2,2,216,278,251,306,11,1504,945
1617,10,4.1.188,0,552,3,62,188,250,188,0,250,320,-124,160,568,2,2,220,278,284,306,11,1504,945
1617,11,0.2.170,0,534,0,83,170,253,170,0,253,320,-46,110,515,3,2,175,324,309,384,12,1504,864
1617,11,1.1.320,0,534,0,46,320,366,320,0,366,366,-150,211,619,2,3,128,197,222,306,12,1504,864
1617,11,2.1.226,0,540,1,43,226,269,226,0,269,320,-56,117,525,2,3,125,197,163,306,12,1504,864
1617,11,3.1.170,1,534,0,46,170,216,124,46,216,320,0,61,469,2,3,216,197,251,306,12,1504,864
1617,11,4.1.188,0,563,2,62,188,250,188,0,250,320,-18,79,487,2,3,220,197,284,306,12,1504,864
1617,12,0.2.170,0,534,0,83,170,253,170,0,253,320,-46,110,515,3,2,175,324,309,384,13,1504,818
1617,12,1.1.320,0,534,0,46,320,366,320,0,366,366,-104,165,573,2,4,128,151,222,306,13,1504,818
1617,12,2.1.226,0,540,1,43,226,269,226,0,269,320,-10,71,479,2,4,125,151,163,306,13,1504,818
1617,12,3.2.216,0,580,2,72,216,288,216,0,288,320,-92,156,561,3,2,170,324,251,384,13,1504,818
1617,12,4.1.216,1,534,0,62,216,278,188,28,278,320,0,61,469,2,4,220,151,284,306,13,1504,818
1617,13,0.2.170,0,534,0,83,170,253,170,0,253,320,-46,110,515,3,2,175,324,309,384,14,1504,756
1617,13,1.1.320,0,534,0,46,320,366,320,0,366,366,-42,103,511,2,5,128,89,222,306,14,1504,756
1617,13,2.1.278,1,534,0,43,278,321,226,52,321,321,0,61,469,2,5,125,89,163,306,14,1504,756
1617,13,3.2.216,0,580,1,72,216,288,216,0,288,320,-92,156,561,3,2,170,324,251,384,14,1504,756
1617,13,4.2.278,0,588,2,91,278,369,278,0,369,369,-154,218,623,3,2,158,324,284,384,14,1504,756
1617,14,0.2.170,0,534,0,83,170,253,170,0,253,321,-46,110,515,3,2,175,324,309,384,15,1504,713
1617,14,1.1.321,1,534,0,46,321,367,320,1,367,367,0,61,469,2,6,128,46,222,306,15,1504,713
1617,14,2.2.321,0,615,3,36,321,357,321,0,357,357,-197,261,666,3,2,82,324,163,384,15,1504,713
1617,14,3.2.216,0,580,1,72,216,288,216,0,288,321,-92,156,561,3,2,170,324,251,384,15,1504,713
1617,14,4.2.278,0,588,2,91,278,369,278,0,369,369,-154,218,623,3,2,158,324,284,384,15,1504,713
1617,15,0.2.170,1,534,0,83,170,253,170,0,253,367,-46,110,515,3,2,175,324,309,384,16,1504,667
1617,15,1.2.367,0,567,1,42,367,409,367,0,409,409,-243,307,712,3,2,82,324,222,384,16,1504,667
1617,15,2.2.321,0,615,4,36,321,357,321,0,357,367,-197,261,666,3,2,82,324,163,384,16,1504,667
1617,15,3.2.216,0,580,2,72,216,288,216,0,288,367,-92,156,561,3,2,170,324,251,384,16,1504,667
1617,15,4.2.278,0,588,3,91,278,369,278,0,369,369,-154,218,623,3,2,158,324,284,384,16,1504,667
1617,16,0.3.253,1,534,0,31,253,284,253,0,284,367,-33,157,548,4,2,92,227,309,323,17,1504,584
1617,16,1.2.367,0,567,1,42,367,409,367,0,409,409,-114,224,629,3,3,82,241,222,384,17,1504,584
1617,16,2.2.321,0,615,3,36,321,357,321,0,357,367,-68,178,583,3,3,82,241,163,384,17,1504,584
1617,16,3.2.253,0,534,0,72,253,325,216,37,325,367,0,110,515,3,3,170,241,251,384,17,1504,584
1617,16,4.2.278,0,588,2,91,278,369,278,0,369,369,-25,135,540,3,3,158,241,284,384,17,1504,584
1617,17,0.4.284,1,534,0,61,284,345,284,0,345,367,-9,229,557,5,2,61,116,309,171,18,1504,553
1617,17,1.2.367,0,567,1,42,367,409,367,0,409,409,-114,224,662,3,3,82,241,222,384,18,1504,553
1617,17,2.2.321,0,615,3,36,321,357,321,0,357,367,-68,178,616,3,3,82,241,163,384,18,1504,553
1617,17,3.2.253,0,534,0,72,253,325,216,37,325,367,0,110,548,3,3,170,241,251,384,18,1504,553
1617,17,4.2.278,0,588,2,91,278,369,278,0,369,369,-25,135,573,3,3,158,241,284,384,18,1504,553
1617,18,1.2.367,0,567,1,42,367,409,367,0,409,409,-114,224,671,3,3,82,241,222,384,19,1504,492
1617,18,2.2.321,0,615,3,36,321,357,321,0,357,367,-68,178,625,3,3,82,241,163,384,19,1504,492
1617,18,3.2.253,1,534,0,72,253,325,216,37,325,367,0,110,557,3,3,170,241,251,384,19,1504,492
1617,18,4.2.278,0,588,2,91,278,369,278,0,369,369,-25,135,582,3,3,158,241,284,384,19,1504,492
1617,19,1.2.367,0,567,2,42,367,409,367,0,409,409,-42,152,599,3,4,82,169,222,384,20,1504,420
1617,19,2.2.325,0,547,1,36,325,361,321,4,361,367,0,110,557,3,4,82,169,163,384,20,1504,420
1617,19,3.3.325,1,534,0,91,325,416,325,0,416,416,-41,198,598,4,3,98,196,251,323,20,1504,420
1617,19,4.2.325,0,534,0,91,325,416,278,47,416,416,0,110,557,3,4,158,169,284,384,20,1504,420
1617,20,1.2.367,0,567,2,42,367,409,367,0,409,416,-42,152,640,3,4,82,169,222,384,21,1504,329
1617,20,2.2.325,0,547,1,36,325,361,321,4,361,416,0,110,598,3,4,82,169,163,384,21,1504,329
1617,20,3.4.416,1,534,0,7,416,423,416,0,423,423,-71,300,669,5,3,7,55,251,171,21,1504,329
1617,20,4.2.325,0,534,0,91,325,416,278,47,416,416,0,110,598,3,4,158,169,284,384,21,1504,329
1617,21,1.2.367,0,567,2,42,367,409,367,0,409,423,-42,152,711,3,4,82,169,222,384,22,1504,322
1617,21,2.2.325,0,547,1,36,325,361,321,4,361,423,0,110,669,3,4,82,169,163,384,22,1504,322
1617,21,4.2.325,1,534,0,91,325,416,278,47,416,423,0,110,669,3,4,158,169,284,384,22,1504,322
1617,22,1.2.416,0,550,1,42,416,458,367,49,458,458,0,110,669,3,5,82,78,222,384,23,1504,231
1617,22,2.2.416,0,534,0,36,416,452,321,95,452,452,0,110,669,3,5,82,78,163,384,23,1504,231
1617,22,4.3.416,1,534,0,55,416,471,416,0,471,471,0,198,669,4,4,67,105,284,323,23,1504,231
1617,23,1.2.416,0,550,1,42,416,458,367,49,458,471,0,110,669,3,5,82,78,222,384,24,1504,176
1617,23,2.2.416,0,534,0,36,416,452,321,95,452,471,0,110,669,3,5,82,78,163,384,24,1504,176
1617,23,4.4.471,1,534,0,12,471,483,471,0,483,483,-48,348,717,5,4,12,48,284,171,24,1504,176
1617,24,1.2.416,0,550,1,42,416,458,367,49,458,483,0,110,717,3,5,82,78,222,384,25,1504,164
1617,24,2.2.416,1,534,0,36,416,452,321,95,452,483,0,110,717,3,5,82,78,163,384,25,1504,164
1617,25,1.2.452,0,534,0,42,452,494,367,85,494,494,0,110,717,3,6,82,42,222,384,26,1504,128
1617,25,2.3.471,1,534,0,16,471,487,452,19,487,487,0,198,717,4,5,46,50,163,323,26,1504,128
1617,26,1.2.452,0,534,0,42,452,494,367,85,494,494,0,110,717,3,6,82,42,222,384,27,1504,112
1617,26,2.4.487,1,534,0,30,487,517,487,0,517,517,-4,352,721,5,5,30,36,163,171,27,1504,112
1617,27,1.2.452,1,534,0,42,452,494,367,85,494,517,0,110,721,3,6,82,42,222,384,28,1504,82
1617,28,1.3.494,1,534,0,34,494,528,494,0,528,528,-7,205,728,4,6,40,34,222,323,29,1504,40
1617,29,1.4.528,1,534,0,6,528,534,528,0,534,534,-11,363,739,5,6,6,6,222,171,30,1504,6
1618,0,0.0.0,0,665,5,66,0,66,0,0,66,66,0,0,0,1,1,253,434,253,434,1,1770,1770
1618,0,1.0.0,0,641,3,70,0,70,0,0,70,70,0,0,0,1,1,221,434,221,434,1,1770,1770
1618,0,2.0.0,0,623,1,83,0,83,0,0,83,83,0,0,0,1,1,386,434,386,434,1,1770,1770
1618,0,3.0.0,0,659,4,88,0,88,0,0,88,88,0,0,0,1,1,310,434,310,434,1,1770,1770
1618,0,4.0.0,0,637,2,86,0,86,0,0,86,86,0,0,0,1,1,322,434,322,434,1,1770,1770
1618,0,5.0.0,1,621,0,41,0,41,0,0,41,41,0,0,0,1,1,278,434,278,434,1,1770,1770
1618,1,0.0.41,0,654,3,66,41,107,0,41,107,107,0,0,0,1,2,253,393,253,434,2,1770,1729
1618,1,1.0.41,0,641,2,70,41,111,0,41,111,111,0,0,0,1,2,221,393,221,434,2,1770,1729
1618,1,2.0.41,0,621,0,83,41,124,0,41,124,124,0,0,0,1,2,386,393,386,434,2,1770,1729
1618,1,3.0.41,0,630,1,88,41,129,0,41,129,129,0,0,0,1,2,310,393,310,434,2,1770,1729
1618,1,4.0.41,0,621,0,86,41,127,0,41,127,127,0,0,0,1,2,322,393,322,434,2,1770,1729
1618,1,5.1.41,1,621,0,12,41,53,41,0,53,53,-41,41,41,2,1,237,210,278,210,2,1770,1729
1618,2,0.0.41,0,654,3,66,41,107,0,41,107,107,0,0,41,1,2,253,393,253,434,3,1770,1717
1618,2,1.0.41,0,641,2,70,41,111,0,41,111,111,0,0,41,1,2,221,393,221,434,3,1770,1717
1618,2,2.0.41,0,621,0,83,41,124,0,41,124,124,0,0,41,1,2,386,393,386,434,3,1770,1717
1618,2,3.0.41,0,630,1,88,41,129,0,41,129,129,0,0,41,1,2,310,393,310,434,3,1770,1717
1618,2,4.0.41,0,621,0,86,41,127,0,41,127,127,0,0,41,1,2,322,393,322,434,3,1770,1717
1618,2,5.2.53,1,621,0,98,53,151,53,0,151,151,-53,53,94,3,1,225,452,278,452,3,1770,1717
1618,3,0.0.41,0,654,3,66,41,107,0,41,107,151,0,0,94,1,2,253,393,253,434,4,1770,1619
1618,3,1.0.41,0,641,2,70,41,111,0,41,111,151,0,0,94,1,2,221,393,221,434,4,1770,1619
1618,3,2.0.41,0,621,0,83,41,124,0,41,124,151,0,0,94,1,2,386,393,386,434,4,1770,1619
1618,3,3.0.41,0,630,1,88,41,129,0,41,129,151,0,0,94,1,2,310,393,310,434,4,1770,1619
1618,3,4.0.41,0,621,0,86,41,127,0,41,127,151,0,0,94,1,2,322,393,322,434,4,1770,1619
1618,3,5.3.151,1,621,0,81,151,232,151,0,232,232,-151,151,245,4,1,127,375,278,375,4,1770,1619
1618,4,0.0.41,0,654,3,66,41,107,0,41,107,232,0,0,245,1,2,253,393,253,434,5,1770,1538
1618,4,1.0.41,0,641,2,70,41,111,0,41,111,232,0,0,245,1,2,221,393,221,434,5,1770,1538
1618,4,2.0.41,0,621,0,83,41,124,0,41,124,232,0,0,245,1,2,386,393,386,434,5,1770,1538
1618,4,3.0.41,0,630,1,88,41,129,0,41,129,232,0,0,245,1,2,310,393,310,434,5,1770,1538
1618,4,4.0.41,0,621,0,86,41,127,0,41,127,232,0,0,245,1,2,322,393,322,434,5,1770,1538
1618,4,5.4.232,1,621,0,46,232,278,232,0,278,278,-232,232,477,5,1,46,299,278,299,5,1770,1538
1618,5,0.0.41,0,654,3,66,41,107,0,41,107,278,0,0,477,1,2,253,393,253,434,6,1770,1492
1618,5,1.0.41,0,641,2,70,41,111,0,41,111,278,0,0,477,1,2,221,393,221,434,6,1770,1492
1618,5,2.0.41,1,621,0,83,41,124,0,41,124,278,0,0,477,1,2,386,393,386,434,6,1770,1492
1618,5,3.0.41,0,630,1,88,41,129,0,41,129,278,0,0,477,1,2,310,393,310,434,6,1770,1492
1618,5,4.0.41,0,621,0,86,41,127,0,41,127,278,0,0,477,1,2,322,393,322,434,6,1770,1492
1618,6,0.0.124,0,628,1,66,124,190,0,124,190,278,0,0,477,1,3,253,310,253,434,7,1770,1409
1618,6,1.0.124,0,639,2,70,124,194,0,124,194,278,0,0,477,1,3,221,310,221,434,7,1770,1409
1618,6,2.1.124,1,621,0,37,124,161,124,0,161,278,-71,112,548,2,2,303,198,386,210,7,1770,1409
1618,6,3.0.124,0,621,0,88,124,212,0,124,212,278,0,0,477,1,3,310,310,310,434,7,1770,1409
1618,6,4.0.124,0,621,0,86,124,210,0,124,210,278,0,0,477,1,3,322,310,322,434,7,1770,1409
1618,7,0.0.124,0,628,1,66,124,190,0,124,190,278,0,0,548,1,3,253,310,253,434,8,1770,1372
1618,7,1.0.124,0,639,2,70,124,194,0,124,194,278,0,0,548,1,3,221,310,221,434,8,1770,1372
1618,7,2.2.161,1,621,0,88,161,249,161,0,249,278,-10,63,558,3,2,266,354,386,452,8,1770,1372
1618,7,3.0.124,0,621,0,88,124,212,0,124,212,278,0,0,548,1,3,310,310,310,434,8,1770,1372
1618,7,4.0.124,0,621,0,86,124,210,0,124,210,278,0,0,548,1,3,322,310,322,434,8,1770,1372
1618,8,0.0.124,0,628,1,66,124,190,0,124,190,278,0,0,558,1,3,253,310,253,434,9,1770,1284
1618,8,1.0.124,0,639,2,70,124,194,0,124,194,278,0,0,558,1,3,221,310,221,434,9,1770,1284
1618,8,2.3.249,1,621,0,84,249,333,249,0,333,333,-17,168,575,4,2,178,294,386,375,9,1770,1284
1618,8,3.0.124,0,621,0,88,124,212,0,124,212,278,0,0,558,1,3,310,310,310,434,9,1770,1284
1618,8,4.0.124,0,621,0,86,124,210,0,124,210,278,0,0,558,1,3,322,310,322,434,9,1770,1284
1618,9,0.0.124,0,628,1,66,124,190,0,124,190,333,0,0,575,1,3,253,310,253,434,10,1770,1200
1618,9,1.0.124,0,639,2,70,124,194,0,124,194,333,0,0,575,1,3,221,310,221,434,10,1770,1200
1618,9,2.4.333,1,621,0,94,333,427,333,0,427,427,-55,287,630,5,2,94,253,386,299,10,1770,1200
1618,9,3.0.124,0,621,0,88,124,212,0,124,212,333,0,0,575,1,3,310,310,310,434,10,1770,1200
1618,9,4.0.124,0,621,0,86,124,210,0,124,210,333,0,0,575,1,3,322,310,322,434,10,1770,1200
1618,10,0.0.124,0,628,1,66,124,190,0,124,190,427,0,0,630,1,3,253,310,253,434,11,1770,1106
1618,10,1.0.124,0,639,2,70,124,194,0,124,194,427,0,0,630,1,3,221,310,221,434,11,1770,1106
1618,10,3.0.124,0,621,0,88,124,212,0,124,212,427,0,0,630,1,3,310,310,310,434,11,1770,1106
1618,10,4.0.124,1,621,0,86,124,210,0,124,210,427,0,0,630,1,3,322,310,322,434,11,1770,1106
1618,11,0.0.210,0,628,1,66,210,276,0,210,276,427,0,0,630,1,4,253,224,253,434,12,1770,1020
1618,11,1.0.210,0,639,2,70,210,280,0,210,280,427,0,0,630,1,4,221,224,221,434,12,1770,1020
1618,11,3.0.210,0,621,0,88,210,298,0,210,298,427,0,0,630,1,4,310,224,310,434,12,1770,1020
1618,11,4.1.210,1,621,0,14,210,224,210,0,224,427,-49,161,679,2,3,236,161,322,210,12,1770,1020
1618,12,0.0.210,0,628,1,66,210,276,0,210,276,427,0,0,679,1,4,253,224,253,434,13,1770,1006
1618,12,1.0.210,0,639,2,70,210,280,0,210,280,427,0,0,679,1,4,221,224,221,434,13,1770,1006
1618,12,3.0.210,1,621,0,88,210,298,0,210,298,427,0,0,679,1,4,310,224,310,434,13,1770,1006
1618,12,4.2.249,0,621,0,92,249,341,224,25,341,427,0,63,679,3,3,222,266,322,452,13,1770,1006
1618,13,0.0.298,1,633,1,66,298,364,0,298,364,427,0,0,679,1,5,253,136,253,434,14,1770,918
1618,13,1.0.298,0,621,0,70,298,368,0,298,368,427,0,0,679,1,5,221,136,221,434,14,1770,918
1618,13,3.1.298,0,621,0,84,298,382,298,0,382,427,-74,235,753,2,4,222,147,310,210,14,1770,918
1618,13,4.2.249,0,621,0,92,249,341,224,25,341,427,0,63,679,3,3,222,266,322,452,14,1770,918
1618,14,0.1.364,0,680,1,49,364,413,364,0,413,427,-140,301,819,2,4,187,147,253,210,15,1770,852
1618,14,1.0.364,1,633,0,70,364,434,0,364,434,434,0,0,679,1,6,221,70,221,434,15,1770,852
1618,14,3.1.298,0,633,0,84,298,382,298,0,382,427,-74,235,753,2,4,222,147,310,210,15,1770,852
1618,14,4.2.249,0,633,0,92,249,341,224,25,341,427,0,63,679,3,3,222,266,322,452,15,1770,852
1618,15,0.1.364,0,680,1,49,364,413,364,0,413,434,-140,301,819,2,4,187,147,253,210,16,1770,782
1618,15,1.1.434,0,633,0,14,434,448,434,0,448,448,-210,371,889,2,4,151,147,221,210,16,1770,782
1618,15,3.1.298,1,633,0,84,298,382,298,0,382,434,-74,235,753,2,4,222,147,310,210,16,1770,782
1618,15,4.2.249,0,633,0,92,249,341,224,25,341,434,0,63,679,3,3,222,266,322,452,16,1770,782
1618,16,0.1.382,1,633,0,49,382,431,364,18,431,434,0,235,753,2,5,187,63,253,210,17,1770,698
1618,16,1.1.434,0,633,0,14,434,448,434,0,448,448,-52,287,805,2,5,151,63,221,210,17,1770,698
1618,16,3.2.382,0,633,0,40,382,422,382,0,422,434,-133,196,886,3,3,138,266,310,452,17,1770,698
1618,16,4.2.249,0,633,0,92,249,341,224,25,341,434,0,63,753,3,3,222,266,322,452,17,1770,698
1618,17,0.2.431,0,655,1,87,431,518,431,0,518,518,-182,245,935,3,3,138,266,253,452,18,1770,649
1618,17,1.1.434,1,633,0,14,434,448,434,0,448,448,-3,238,756,2,6,151,14,221,210,18,1770,649
1618,17,3.2.382,0,633,0,40,382,422,382,0,422,434,-133,196,886,3,3,138,266,310,452,18,1770,649
1618,17,4.2.249,0,633,0,92,249,341,224,25,341,434,0,63,753,3,3,222,266,322,452,18,1770,649
1618,18,0.2.431,0,655,1,87,431,518,431,0,518,518,-182,245,938,3,3,138,266,253,452,19,1770,635
1618,18,1.2.448,0,633,0,47,448,495,448,0,495,495,-199,262,955,3,3,137,266,221,452,19,1770,635
1618,18,3.2.382,0,633,0,40,382,422,382,0,422,448,-133,196,889,3,3,138,266,310,452,19,1770,635
1618,18,4.2.249,1,633,0,92,249,341,224,25,341,448,0,63,756,3,3,222,266,322,452,19,1770,635
1618,19,0.2.431,0,655,1,87,431,518,431,0,518,518,-90,153,846,3,4,138,174,253,452,20,1770,543
1618,19,1.2.448,0,633,0,47,448,495,448,0,495,495,-107,170,863,3,4,137,174,221,452,20,1770,543
1618,19,3.2.382,0,633,0,40,382,422,382,0,422,448,-41,104,797,3,4,138,174,310,452,20,1770,543
1618,19,4.3.341,1,633,0,48,341,389,341,0,389,448,-8,176,764,4,3,130,210,322,375,20,1770,543
1618,20,0.2.431,0,655,1,87,431,518,431,0,518,518,-90,153,854,3,4,138,174,253,452,21,1770,495
1618,20,1.2.448,0,633,0,47,448,495,448,0,495,495,-107,170,871,3,4,137,174,221,452,21,1770,495
1618,20,3.2.382,0,633,0,40,382,422,382,0,422,448,-41,104,805,3,4,138,174,310,452,21,1770,495
1618,20,4.4.427,1,633,0,82,427,509,389,38,509,509,0,287,764,5,3,82,159,322,299,21,1770,495
1618,21,0.2.431,0,655,1,87,431,518,431,0,518,518,-90,153,854,3,4,138,174,253,452,22,1770,413
1618,21,1.2.448,0,633,0,47,448,495,448,0,495,509,-107,170,871,3,4,137,174,221,452,22,1770,413
1618,21,3.2.382,1,633,0,40,382,422,382,0,422,509,-41,104,805,3,4,138,174,310,452,22,1770,413
1618,22,0.2.431,0,655,1,87,431,518,431,0,518,518,-9,113,814,3,5,138,134,253,452,23,1770,373
1618,22,1.2.448,0,633,0,47,448,495,448,0,495,509,-26,130,831,3,5,137,134,221,452,23,1770,373
1618,22,3.3.422,1,633,0,50,422,472,422,0,472,509,-33,209,838,4,4,98,162,310,375,23,1770,373
1618,23,0.2.431,0,655,1,87,431,518,431,0,518,518,-9,113,847,3,5,138,134,253,452,24,1770,323
1618,23,1.2.448,0,633,0,47,448,495,448,0,495,509,-26,130,864,3,5,137,134,221,452,24,1770,323
1618,23,3.4.509,1,633,0,48,509,557,472,37,557,557,0,287,838,5,4,48,77,310,299,24,1770,323
1618,24,0.2.431,0,655,1,87,431,518,431,0,518,557,-9,113,847,3,5,138,134,253,452,25,1770,275
1618,24,1.2.448,1,633,0,47,448,495,448,0,495,557,-26,130,864,3,5,137,134,221,452,25,1770,275
1618,25,0.2.495,0,633,0,87,495,582,431,64,582,582,0,130,864,3,6,138,87,253,452,26,1770,228
1618,25,1.3.495,1,633,0,75,495,570,495,0,570,570,-23,232,887,4,5,90,112,221,375,26,1770,228
1618,26,0.2.495,0,633,0,87,495,582,431,64,582,582,0,130,887,3,6,138,87,253,452,27,1770,153
1618,26,1.4.570,1,633,0,15,570,585,570,0,585,585,-13,300,900,5,5,15,29,221,299,27,1770,153
1618,27,0.2.495,1,633,0,87,495,582,431,64,582,585,0,130,900,3,6,138,87,253,452,28,1770,138
1618,28,0.3.582,1,633,0,37,582,619,582,0,619,619,-12,244,912,4,6,51,37,253,375,29,1770,51
1618,29,0.4.619,1,633,0,14,619,633,619,0,633,633,-34,334,946,5,6,14,14,253,299,30,1770,14
1619,0,0.0.0,0,531,3,79,0,79,0,0,79,79,0,0,0,1,1,296,250,296,250,1,1440,1440
1619,0,1.0.0,0,546,4,45,0,45,0,0,45,45,0,0,0,1,1,219,250,219,250,1,1440,1440
1619,0,2.0.0,0,501,0,30,0,30,0,0,30,30,0,0,0,1,1,215,250,215,250,1,1440,1440
1619,0,3.0.0,0,517,1,41,0,41,0,0,41,41,0,0,0,1,1,170,250,170,250,1,1440,1440
1619,0,4.0.0,1,501,0,9,0,9,0,0,9,9,0,0,0,1,1,261,250,261,250,1,1440,1440
1619,0,5.0.0,0,526,2,46,0,46,0,0,46,46,0,0,0,1,1,279,250,279,250,1,1440,1440
1619,1,0.0.9,0,513,2,79,9,88,0,9,88,88,0,0,0,1,2,296,241,296,250,2,1440,1431
1619,1,1.0.9,0,513,2,45,9,54,0,9,54,54,0,0,0,1,2,219,241,219,250,2,1440,1431
1619,1,2.0.9,0,506,1,30,9,39,0,9,39,39,0,0,0,1,2,215,241,215,250,2,1440,1431
1619,1,3.0.9,0,501,0,41,9,50,0,9,50,50,0,0,0,1,2,170,241,170,250,2,1440,1431
1619,1,4.1.9,0,501,0,66,9,75,9,0,75,75,-9,9,9,2,1,252,311,261,311,2,1440,1431
1619,1,5.0.9,1,513,2,46,9,55,0,9,55,55,0,0,0,1,2,279,241,279,250,2,1440,1431
1619,2,0.0.55,0,537,2,79,55,134,0,55,134,134,0,0,0,1,3,296,195,296,250,3,1440,1385
1619,2,1.0.55,0,535,1,45,55,100,0,55,100,100,0,0,0,1,3,219,195,219,250,3,1440,1385
1619,2,2.0.55,1,513,0,30,55,85,0,55,85,85,0,0,0,1,3,215,195,215,250,3,1440,1385
1619,2,3.0.55,0,513,0,41,55,96,0,55,96,96,0,0,0,1,3,170,195,170,250,3,1440,1385
1619,2,4.1.9,0,513,0,66,9,75,9,0,75,75,-9,9,9,2,1,252,311,261,311,3,1440,1385
1619,2,5.1.55,0,535,1,94,55,149,55,0,149,149,-55,55,55,2,1,233,311,279,311,3,1440,1385
1619,3,0.0.85,0,537,1,79,85,164,0,85,164,164,0,0,0,1,4,296,165,296,250,4,1440,1355
1619,3,1.0.85,1,537,1,45,85,130,0,85,130,130,0,0,0,1,4,219,165,219,250,4,1440,1355
1619,3,2.1.85,0,513,0,30,85,115,85,0,115,115,-85,85,85,2,1,185,311,215,311,4,1440,1355
1619,3,3.0.85,0,513,0,41,85,126,0,85,126,126,0,0,0,1,4,170,165,170,250,4,1440,1355
1619,3,4.1.9,0,513,0,66,9,75,9,0,75,85,-9,9,9,2,1,252,311,261,311,4,1440,1355
1619,3,5.1.55,0,544,2,94,55,149,55,0,149,149,-55,55,55,2,1,233,311,279,311,4,1440,1355
1619,4,0.0.130,1,539,1,79,130,209,0,130,209,209,0,0,0,1,5,296,120,296,250,5,1440,1310
1619,4,1.1.130,0,537,0,81,130,211,130,0,211,211,-130,130,130,2,1,174,311,219,311,5,1440,1310
1619,4,2.1.85,0,537,0,30,85,115,85,0,115,130,-85,85,85,2,1,185,311,215,311,5,1440,1310
1619,4,3.0.130,0,537,0,41,130,171,0,130,171,171,0,0,0,1,5,170,120,170,250,5,1440,1310
1619,4,4.1.9,0,537,0,66,9,75,9,0,75,130,-9,9,9,2,1,252,311,261,311,5,1440,1310
1619,4,5.1.55,0,567,2,94,55,149,55,0,149,149,-55,55,55,2,1,233,311,279,311,5,1440,1310
1619,5,0.1.209,0,539,0,17,209,226,209,0,226,226,-209,209,209,2,1,217,311,296,311,6,1440,1231
1619,5,1.1.130,0,539,0,81,130,211,130,0,211,211,-130,130,130,2,1,174,311,219,311,6,1440,1231
1619,5,2.1.85,0,539,0,30,85,115,85,0,115,209,-85,85,85,2,1,185,311,215,311,6,1440,1231
1619,5,3.0.209,1,539,0,41,209,250,0,209,250,250,0,0,0,1,6,170,41,170,250,6,1440,1231
1619,5,4.1.9,0,539,0,66,9,75,9,0,75,209,-9,9,9,2,1,252,311,261,311,6,1440,1231
1619,5,5.1.55,0,581,1,94,55,149,55,0,149,209,-55,55,55,2,1,233,311,279,311,6,1440,1231
1619,6,0.1.209,0,539,0,17,209,226,209,0,226,250,-209,209,209,2,1,217,311,296,311,7,1440,1190
1619,6,1.1.130,0,539,0,81,130,211,130,0,211,250,-130,130,130,2,1,174,311,219,311,7,1440,1190
1619,6,2.1.85,0,539,0,30,85,115,85,0,115,250,-85,85,85,2,1,185,311,215,311,7,1440,1190
1619,6,3.1.250,0,539,0,23,250,273,250,0,273,273,-250,250,250,2,1,129,311,170,311,7,1440,1190
1619,6,4.1.9,1,539,0,66,9,75,9,0,75,250,-9,9,9,2,1,252,311,261,311,7,1440,1190
1619,6,5.1.55,0,581,1,94,55,149,55,0,149,250,-55,55,55,2,1,233,311,279,311,7,1440,1190
1619,7,0.1.209,0,539,0,17,209,226,209,0,226,250,-134,143,143,2,2,217,245,296,311,8,1440,1124
1619,7,1.1.130,0,539,0,81,130,211,130,0,211,250,-55,64,64,2,2,174,245,219,311,8,1440,1124
1619,7,2.1.85,1,539,0,30,85,115,85,0,115,250,-10,19,19,2,2,185,245,215,311,8,1440,1124
1619,7,3.1.250,0,539,0,23,250,273,250,0,273,273,-175,184,184,2,2,129,245,170,311,8,1440,1124
1619,7,4.2.75,0,539,0,93,75,168,75,0,168,250,-75,75,84,3,1,186,321,261,321,8,1440,1124
1619,7,5.1.75,0,550,1,94,75,169,55,20,169,250,0,9,9,2,2,233,245,279,311,8,1440,1124
1619,8,0.1.209,0,539,0,17,209,226,209,0,226,250,-94,113,113,2,3,217,215,296,311,9,1440,1094
1619,8,1.1.130,0,539,0,81,130,211,130,0,211,250,-15,34,34,2,3,174,215,219,311,9,1440,1094
1619,8,2.2.115,0,558,1,42,115,157,115,0,157,250,-115,115,134,3,1,155,321,215,321,9,1440,1094
1619,8,3.1.250,0,539,0,23,250,273,250,0,273,273,-135,154,154,2,3,129,215,170,311,9,1440,1094
1619,8,4.2.75,0,539,0,93,75,168,75,0,168,250,-75,75,94,3,1,186,321,261,321,9,1440,1094
1619,8,5.1.115,1,539,0,94,115,209,55,60,209,250,0,19,19,2,3,233,215,279,311,9,1440,1094
1619,9,0.1.209,1,539,0,17,209,226,209,0,226,250,0,19,19,2,4,217,121,296,311,10,1440,1000
1619,9,1.1.209,0,549,1,81,209,290,130,79,290,290,0,19,19,2,4,174,121,219,311,10,1440,1000
1619,9,2.2.115,0,558,2,42,115,157,115,0,157,250,-115,115,134,3,1,155,321,215,321,10,1440,1000
1619,9,3.1.250,0,539,0,23,250,273,250,0,273,273,-41,60,60,2,4,129,121,170,311,10,1440,1000
1619,9,4.2.75,0,539,0,93,75,168,75,0,168,250,-75,75,94,3,1,186,321,261,321,10,1440,1000
1619,9,5.2.209,0,566,3,37,209,246,209,0,246,250,-209,209,228,3,1,139,321,279,321,10,1440,1000
1619,10,0.2.226,0,549,2,90,226,316,226,0,316,316,-226,226,245,3,1,200,321,296,321,11,1440,983
1619,10,1.1.226,1,544,1,81,226,307,130,96,307,307,0,19,19,2,5,174,104,219,311,11,1440,983
1619,10,2.2.115,0,558,3,42,115,157,115,0,157,250,-115,115,134,3,1,155,321,215,321,11,1440,983
1619,10,3.1.250,0,539,0,23,250,273,250,0,273,273,-24,43,43,2,5,129,104,170,311,11,1440,983
1619,10,4.2.75,0,539,0,93,75,168,75,0,168,250,-75,75,94,3,1,186,321,261,321,11,1440,983
1619,10,5.2.209,0,566,4,37,209,246,209,0,246,250,-209,209,228,3,1,139,321,279,321,11,1440,983
1619,11,0.2.226,0,563,1,90,226,316,226,0,316,316,-226,226,245,3,1,200,321,296,321,12,1440,902
1619,11,1.2.307,0,566,2,52,307,359,307,0,359,359,-307,307,326,3,1,93,321,219,321,12,1440,902
1619,11,2.2.115,0,563,1,42,115,157,115,0,157,307,-115,115,134,3,1,155,321,215,321,12,1440,902
1619,11,3.1.307,1,544,0,23,307,330,250,57,330,330,0,19,19,2,6,129,23,170,311,12,1440,902
1619,11,4.2.75,0,544,0,93,75,168,75,0,168,307,-75,75,94,3,1,186,321,261,321,12,1440,902
1619,11,5.2.209,0,584,3,37,209,246,209,0,246,307,-209,209,228,3,1,139,321,279,321,12,1440,902
1619,12,0.2.226,0,563,2,90,226,316,226,0,316,330,-226,226,245,3,1,200,321,296,321,13,1440,879
1619,12,1.2.307,0,566,3,52,307,359,307,0,359,359,-307,307,326,3,1,93,321,219,321,13,1440,879
1619,12,2.2.115,1,563,2,42,115,157,115,0,157,330,-115,115,134,3,1,155,321,215,321,13,1440,879
1619,12,3.2.330,0,561,1,7,330,337,330,0,337,337,-330,330,349,3,1,106,321,170,321,13,1440,879
1619,12,4.2.75,0,544,0,93,75,168,75,0,168,330,-75,75,94,3,1,186,321,261,321,13,1440,879
1619,12,5.2.209,0,584,4,37,209,246,209,0,246,330,-209,209,228,3,1,139,321,279,321,13,1440,879
1619,13,0.2.226,0,615,3,90,226,316,226,0,316,330,-69,184,203,3,2,200,279,296,321,14,1440,837
1619,13,1.2.307,0,572,1,52,307,359,307,0,359,359,-150,265,284,3,2,93,279,219,321,14,1440,837
1619,13,2.3.157,1,563,0,53,157,210,157,0,210,330,-157,157,291,4,1,113,230,215,230,14,1440,837
1619,13,3.2.330,0,563,0,7,330,337,330,0,337,337,-173,288,307,3,2,106,279,170,321,14,1440,837
1619,13,4.2.157,0,563,0,93,157,250,75,82,250,330,0,115,134,3,2,186,279,261,321,14,1440,837
1619,13,5.2.209,0,584,2,37,209,246,209,0,246,330,-52,167,186,3,2,139,279,279,321,14,1440,837
1619,14,0.2.226,0,615,3,90,226,316,226,0,316,330,-69,184,360,3,2,200,279,296,321,15,1440,784
1619,14,1.2.307,0,572,1,52,307,359,307,0,359,359,-150,265,441,3,2,93,279,219,321,15,1440,784
1619,14,2.4.210,1,563,0,60,210,270,210,0,270,330,-210,210,501,5,1,60,328,215,328,15,1440,784
1619,14,3.2.330,0,563,0,7,330,337,330,0,337,337,-173,288,464,3,2,106,279,170,321,15,1440,784
1619,14,4.2.157,0,563,0,93,157,250,75,82,250,330,0,115,291,3,2,186,279,261,321,15,1440,784
1619,14,5.2.209,0,584,2,37,209,246,209,0,246,330,-52,167,343,3,2,139,279,279,321,15,1440,784
1619,15,0.2.226,0,615,3,90,226,316,226,0,316,330,-69,184,570,3,2,200,279,296,321,16,1440,724
1619,15,1.2.307,0,572,1,52,307,359,307,0,359,359,-150,265,651,3,2,93,279,219,321,16,1440,724
1619,15,3.2.330,0,563,0,7,330,337,330,0,337,337,-173,288,674,3,2,106,279,170,321,16,1440,724
1619,15,4.2.157,1,563,0,93,157,250,75,82,250,330,0,115,501,3,2,186,279,261,321,16,1440,724
1619,15,5.2.209,0,584,2,37,209,246,209,0,246,330,-52,167,553,3,2,139,279,279,321,16,1440,724
1619,16,0.2.250,0,573,2,90,250,340,226,24,340,340,0,115,501,3,3,200,186,296,321,17,1440,631
1619,16,1.2.307,0,572,1,52,307,359,307,0,359,359,-57,172,558,3,3,93,186,219,321,17,1440,631
1619,16,3.2.330,0,563,0,7,330,337,330,0,337,337,-80,195,581,3,3,106,186,170,321,17,1440,631
1619,16,4.3.250,1,563,0,41,250,291,250,0,291,330,-40,197,541,4,2,93,177,261,230,17,1440,631
1619,16,5.2.250,0,563,0,37,250,287,209,41,287,330,0,115,501,3,3,139,186,279,321,17,1440,631
1619,17,0.2.250,0,573,2,90,250,340,226,24,340,340,0,115,541,3,3,200,186,296,321,18,1440,590
1619,17,1.2.307,0,572,1,52,307,359,307,0,359,359,-57,172,598,3,3,93,186,219,321,18,1440,590
1619,17,3.2.330,0,563,0,7,330,337,330,0,337,337,-80,195,621,3,3,106,186,170,321,18,1440,590
1619,17,4.4.291,1,563,0,52,291,343,291,0,343,343,-21,231,562,5,2,52,268,261,328,18,1440,590
1619,17,5.2.250,0,563,0,37,250,287,209,41,287,330,0,115,541,3,3,139,186,279,321,18,1440,590
1619,18,0.2.250,0,573,2,90,250,340,226,24,340,343,0,115,562,3,3,200,186,296,321,19,1440,538
1619,18,1.2.307,0,572,1,52,307,359,307,0,359,359,-57,172,619,3,3,93,186,219,321,19,1440,538
1619,18,3.2.330,0,563,0,7,330,337,330,0,337,343,-80,195,642,3,3,106,186,170,321,19,1440,538
1619,18,5.2.250,1,563,0,37,250,287,209,41,287,343,0,115,562,3,3,139,186,279,321,19,1440,538
1619,19,0.2.287,0,573,2,90,287,377,226,61,377,377,0,115,562,3,4,200,149,296,321,20,1440,501
1619,19,1.2.307,0,572,1,52,307,359,307,0,359,359,-20,135,582,3,4,93,149,219,321,20,1440,501
1619,19,3.2.330,0,563,0,7,330,337,330,0,337,343,-43,158,605,3,4,106,149,170,321,20,1440,501
1619,19,5.3.291,1,572,1,65,291,356,287,4,356,356,0,197,562,4,3,102,136,279,230,20,1440,501
1619,20,0.2.287,0,573,1,90,287,377,226,61,377,377,0,115,562,3,4,200,149,296,321,21,1440,436
1619,20,1.2.307,0,572,0,52,307,359,307,0,359,359,-20,135,582,3,4,93,149,219,321,21,1440,436
1619,20,3.2.330,0,572,0,7,330,337,330,0,337,356,-43,158,605,3,4,106,149,170,321,21,1440,436
1619,20,5.4.356,1,572,0,37,356,393,356,0,393,393,-13,244,575,5,3,37,216,279,328,21,1440,436
1619,21,0.2.287,1,573,1,90,287,377,226,61,377,393,0,115,575,3,4,200,149,296,321,22,1440,399
1619,21,1.2.307,0,572,0,52,307,359,307,0,359,393,-20,135,595,3,4,93,149,219,321,22,1440,399
1619,21,3.2.330,0,572,0,7,330,337,330,0,337,393,-43,158,618,3,4,106,149,170,321,22,1440,399
1619,22,0.3.377,1,600,1,44,377,421,377,0,421,421,-21,218,596,4,4,110,71,296,230,23,1440,309
1619,22,1.2.377,0,600,1,52,377,429,307,70,429,429,0,115,575,3,5,93,59,219,321,23,1440,309
1619,22,3.2.377,0,573,0,7,377,384,330,47,384,393,0,115,575,3,5,106,59,170,321,23,1440,309
1619,23,0.4.421,0,600,0,66,421,487,421,0,487,487,-28,272,624,5,4,66,179,296,328,24,1440,265
1619,23,1.2.377,0,600,0,52,377,429,307,70,429,429,0,115,596,3,5,93,59,219,321,24,1440,265
1619,23,3.2.377,1,600,0,7,377,384,330,47,384,421,0,115,596,3,5,106,59,170,321,24,1440,265
1619,24,0.4.421,0,600,0,66,421,487,421,0,487,487,-28,272,624,5,4,66,179,296,328,25,1440,258
1619,24,1.2.384,0,600,0,52,384,436,307,77,436,436,0,115,596,3,6,93,52,219,321,25,1440,258
1619,24,3.3.421,1,600,0,10,421,431,384,37,431,431,0,218,596,4,5,99,27,170,230,25,1440,258
1619,25,0.4.421,0,600,0,66,421,487,421,0,487,487,-28,272,624,5,4,66,179,296,328,26,1440,248
1619,25,1.2.384,1,600,0,52,384,436,307,77,436,436,0,115,596,3,6,93,52,219,321,26,1440,248
1619,25,3.4.431,0,610,1,89,431,520,431,0,520,520,-38,282,634,5,4,89,179,170,328,26,1440,248
1619,26,0.4.421,0,600,0,66,421,487,421,0,487,487,-28,272,624,5,4,66,179,296,328,27,1440,196
1619,26,1.3.436,1,600,0,17,436,453,436,0,453,453,-5,223,601,4,6,41,17,219,230,27,1440,196
1619,26,3.4.431,0,610,1,89,431,520,431,0,520,520,-38,282,634,5,4,89,179,170,328,27,1440,196
1619,27,0.4.421,1,600,0,66,421,487,421,0,487,487,-28,272,629,5,4,66,179,296,328,28,1440,179
1619,27,1.4.453,0,632,2,24,453,477,453,0,477,477,-60,304,661,5,4,24,179,219,328,28,1440,179
1619,27,3.4.431,0,610,1,89,431,520,431,0,520,520,-38,282,639,5,4,89,179,170,328,28,1440,179
1619,28,1.4.487,1,600,0,24,487,511,453,34,511,511,0,272,629,5,5,24,113,219,328,29,1440,113
1619,28,3.4.487,0,600,0,89,487,576,431,56,576,576,0,272,629,5,5,89,113,170,328,29,1440,113
1619,29,3.4.511,1,600,0,89,511,600,431,80,600,600,0,272,629,5,6,89,89,170,328,30,1440,89
1620,0,0.0.0,0,677,4,92,0,92,0,0,92,92,0,0,0,1,1,339,362,339,362,1,1608,1608
1620,0,1.0.0,1,606,1,21,0,21,0,0,21,21,0,0,0,1,1,221,362,221,362,1,1608,1608
1620,0,2.0.0,0,645,3,75,0,75,0,0,75,75,0,0,0,1,1,241,362,241,362,1,1608,1608
1620,0,3.0.0,0,679,5,94,0,94,0,0,94,94,0,0,0,1,1,328,362,328,362,1,1608,1608
1620,0,4.0.0,0,587,0,30,0,30,0,0,30,30,0,0,0,1,1,199,362,199,362,1,1608,1608
1620,0,5.0.0,0,635,2,50,0,50,0,0,50,50,0,0,0,1,1,280,362,280,362,1,1608,1608
1620,1,0.0.21,0,640,3,92,21,113,0,21,113,113,0,0,0,1,2,339,341,339,362,2,1608,1587
1620,1,1.1.21,1,608,1,50,21,71,21,0,71,71,-21,21,21,2,1,200,314,221,314,2,1608,1587
1620,1,2.0.21,0,629,2,75,21,96,0,21,96,96,0,0,0,1,2,241,341,241,362,2,1608,1587
1620,1,3.0.21,0,642,4,94,21,115,0,21,115,115,0,0,0,1,2,328,341,328,362,2,1608,1587
1620,1,4.0.21,0,606,0,30,21,51,0,21,51,51,0,0,0,1,2,199,341,199,362,2,1608,1587
1620,1,5.0.21,0,608,1,50,21,71,0,21,71,71,0,0,0,1,2,280,341,280,362,2,1608,1587
1620,2,0.0.21,0,640,2,92,21,113,0,21,113,113,0,0,21,1,2,339,341,339,362,3,1608,1537
1620,2,1.2.71,0,608,0,58,71,129,71,0,129,129,-71,71,92,3,1,150,489,221,489,3,1608,1537
1620,2,2.0.21,0,629,1,75,21,96,0,21,96,96,0,0,21,1,2,241,341,241,362,3,1608,1537
1620,2,3.0.21,0,642,3,94,21,115,0,21,115,115,0,0,21,1,2,328,341,328,362,3,1608,1537
1620,2,4.0.21,0,608,0,30,21,51,0,21,51,71,0,0,21,1,2,199,341,199,362,3,1608,1537
1620,2,5.0.21,1,608,0,50,21,71,0,21,71,71,0,0,21,1,2,280,341,280,362,3,1608,1537
1620,3,0.0.71,0,627,1,92,71,163,0,71,163,163,0,0,21,1,3,339,291,339,362,4,1608,1487
1620,3,1.2.71,0,608,0,58,71,129,71,0,129,129,-71,71,92,3,1,150,489,221,489,4,1608,1487
1620,3,2.0.71,0,641,2,75,71,146,0,71,146,146,0,0,21,1,3,241,291,241,362,4,1608,1487
1620,3,3.0.71,0,627,1,94,71,165,0,71,165,165,0,0,21,1,3,328,291,328,362,4,1608,1487
1620,3,4.0.71,0,608,0,30,71,101,0,71,101,101,0,0,21,1,3,199,291,199,362,4,1608,1487
1620,3,5.1.71,1,627,1,77,71,148,71,0,148,148,0,21,21,2,2,230,264,280,314,4,1608,1487
1620,4,0.0.71,0,627,0,92,71,163,0,71,163,163,0,0,21,1,3,339,291,339,362,5,1608,1410
1620,4,1.2.71,0,627,0,58,71,129,71,0,129,148,-71,71,92,3,1,150,489,221,489,5,1608,1410
1620,4,2.0.71,0,641,1,75,71,146,0,71,146,148,0,0,21,1,3,241,291,241,362,5,1608,1410
1620,4,3.0.71,0,627,0,94,71,165,0,71,165,165,0,0,21,1,3,328,291,328,362,5,1608,1410
1620,4,4.0.71,1,627,0,30,71,101,0,71,101,148,0,0,21,1,3,199,291,199,362,5,1608,1410
1620,4,5.2.148,0,627,0,75,148,223,148,0,223,223,-148,148,169,3,1,153,489,280,489,5,1608,1410
1620,5,0.0.101,0,627,0,92,101,193,0,101,193,193,0,0,21,1,4,339,261,339,362,6,1608,1380
1620,5,1.2.71,0,627,0,58,71,129,71,0,129,148,-71,71,92,3,1,150,489,221,489,6,1608,1380
1620,5,2.0.101,0,648,1,75,101,176,0,101,176,176,0,0,21,1,4,241,261,241,362,6,1608,1380
1620,5,3.0.101,0,627,0,94,101,195,0,101,195,195,0,0,21,1,4,328,261,328,362,6,1608,1380
1620,5,4.1.148,1,627,0,18,148,166,101,47,166,166,0,21,21,2,3,169,187,199,314,6,1608,1380
1620,5,5.2.148,0,627,0,75,148,223,148,0,223,223,-148,148,169,3,1,153,489,280,489,6,1608,1380
1620,6,0.0.101,1,627,0,92,101,193,0,101,193,193,0,0,21,1,4,339,261,339,362,7,1608,1362
1620,6,1.2.71,0,627,0,58,71,129,71,0,129,166,-71,71,92,3,1,150,489,221,489,7,1608,1362
1620,6,2.0.101,0,648,2,75,101,176,0,101,176,176,0,0,21,1,4,241,261,241,362,7,1608,1362
1620,6,3.0.101,0,627,0,94,101,195,0,101,195,195,0,0,21,1,4,328,261,328,362,7,1608,1362
1620,6,4.2.166,0,645,1,94,166,260,166,0,260,260,-166,166,187,3,1,151,489,199,489,7,1608,1362
1620,6,5.2.148,0,627,0,75,148,223,148,0,223,223,-148,148,169,3,1,153,489,280,489,7,1608,1362
1620,7,0.1.193,0,627,0,84,193,277,193,0,277,277,-27,48,48,2,4,247,169,339,314,8,1608,1270
1620,7,1.2.71,0,627,0,58,71,129,71,0,129,193,-71,71,92,3,1,150,489,221,489,8,1608,1270
1620,7,2.0.193,0,639,1,75,193,268,0,193,268,268,0,0,21,1,5,241,169,241,362,8,1608,1270
1620,7,3.0.193,1,627,0,94,193,287,0,193,287,287,0,0,21,1,5,328,169,328,362,8,1608,1270
1620,7,4.2.166,0,645,2,94,166,260,166,0,260,260,-166,166,187,3,1,151,489,199,489,8,1608,1270
1620,7,5.2.148,0,627,0,75,148,223,148,0,223,223,-148,148,169,3,1,153,489,280,489,8,1608,1270
1620,8,0.1.193,0,627,0,84,193,277,193,0,277,287,-27,48,48,2,4,247,169,339,314,9,1608,1176
1620,8,1.2.71,0,627,0,58,71,129,71,0,129,287,-71,71,92,3,1,150,489,221,489,9,1608,1176
1620,8,2.0.287,1,627,0,75,287,362,0,287,362,362,0,0,21,1,6,241,75,241,362,9,1608,1176
1620,8,3.1.287,0,627,0,61,287,348,287,0,348,348,-121,142,142,2,4,234,169,328,314,9,1608,1176
1620,8,4.2.166,0,645,1,94,166,260,166,0,260,287,-166,166,187,3,1,151,489,199,489,9,1608,1176
1620,8,5.2.148,0,627,0,75,148,223,148,0,223,287,-148,148,169,3,1,153,489,280,489,9,1608,1176
1620,9,0.1.193,1,627,0,84,193,277,193,0,277,362,-27,48,48,2,4,247,169,339,314,10,1608,1101
1620,9,1.2.71,0,627,0,58,71,129,71,0,129,362,-71,71,92,3,1,150,489,221,489,10,1608,1101
1620,9,2.1.362,0,627,0,24,362,386,362,0,386,386,-196,217,217,2,4,166,169,241,314,10,1608,1101
1620,9,3.1.287,0,627,0,61,287,348,287,0,348,362,-121,142,142,2,4,234,169,328,314,10,1608,1101
1620,9,4.2.166,0,645,1,94,166,260,166,0,260,362,-166,166,187,3,1,151,489,199,489,10,1608,1101
1620,9,5.2.148,0,627,0,75,148,223,148,0,223,362,-148,148,169,3,1,153,489,280,489,10,1608,1101
1620,10,0.2.277,0,662,2,94,277,371,277,0,371,371,-277,277,325,3,1,163,489,339,489,11,1608,1017
1620,10,1.2.71,0,627,0,58,71,129,71,0,129,362,-71,71,119,3,1,150,489,221,489,11,1608,1017
1620,10,2.1.362,0,627,0,24,362,386,362,0,386,386,-85,133,133,2,5,166,85,241,314,11,1608,1017
1620,10,3.1.287,1,627,0,61,287,348,287,0,348,362,-10,58,58,2,5,234,85,328,314,11,1608,1017
1620,10,4.2.166,0,645,1,94,166,260,166,0,260,362,-166,166,214,3,1,151,489,199,489,11,1608,1017
1620,10,5.2.148,0,627,0,75,148,223,148,0,223,362,-148,148,196,3,1,153,489,280,489,11,1608,1017
1620,11,0.2.277,0,662,3,94,277,371,277,0,371,371,-277,277,335,3,1,163,489,339,489,12,1608,956
1620,11,1.2.71,0,627,0,58,71,129,71,0,129,362,-71,71,129,3,1,150,489,221,489,12,1608,956
1620,11,2.1.362,1,627,0,24,362,386,362,0,386,386,-14,72,72,2,6,166,24,241,314,12,1608,956
1620,11,3.2.348,0,658,2,74,348,422,348,0,422,422,-348,348,406,3,1,173,489,328,489,12,1608,956
1620,11,4.2.166,0,645,1,94,166,260,166,0,260,362,-166,166,224,3,1,151,489,199,489,12,1608,956
1620,11,5.2.148,0,627,0,75,148,223,148,0,223,362,-148,148,206,3,1,153,489,280,489,12,1608,956
1620,12,0.2.277,0,662,3,94,277,371,277,0,371,386,-277,277,349,3,1,163,489,339,489,13,1608,932
1620,12,1.2.71,1,627,0,58,71,129,71,0,129,386,-71,71,143,3,1,150,489,221,489,13,1608,932
1620,12,2.2.386,0,705,4,94,386,480,386,0,480,480,-386,386,458,3,1,142,489,241,489,13,1608,932
1620,12,3.2.348,0,658,2,74,348,422,348,0,422,422,-348,348,420,3,1,173,489,328,489,13,1608,932
1620,12,4.2.166,0,645,1,94,166,260,166,0,260,386,-166,166,238,3,1,151,489,199,489,13,1608,932
1620,12,5.2.148,0,627,0,75,148,223,148,0,223,386,-148,148,220,3,1,153,489,280,489,13,1608,932
1620,13,0.2.277,0,662,3,94,277,371,277,0,371,386,-148,219,291,3,2,163,431,339,489,14,1608,874
1620,13,1.3.129,1,627,0,59,129,188,129,0,188,386,-129,129,272,4,1,92,283,221,283,14,1608,874
1620,13,2.2.386,0,705,4,94,386,480,386,0,480,480,-257,328,400,3,2,142,431,241,489,14,1608,874
1620,13,3.2.348,0,658,2,74,348,422,348,0,422,422,-219,290,362,3,2,173,431,328,489,14,1608,874
1620,13,4.2.166,0,645,1,94,166,260,166,0,260,386,-37,108,180,3,2,151,431,199,489,14,1608,874
1620,13,5.2.148,0,627,0,75,148,223,148,0,223,386,-19,90,162,3,2,153,431,280,489,14,1608,874
1620,14,0.2.277,0,662,3,94,277,371,277,0,371,386,-148,219,420,3,2,163,431,339,489,15,1608,815
1620,14,1.4.188,1,627,0,33,188,221,188,0,221,386,-188,188,460,5,1,33,160,221,160,15,1608,815
1620,14,2.2.386,0,705,4,94,386,480,386,0,480,480,-257,328,529,3,2,142,431,241,489,15,1608,815
1620,14,3.2.348,0,658,2,74,348,422,348,0,422,422,-219,290,491,3,2,173,431,328,489,15,1608,815
1620,14,4.2.166,0,645,1,94,166,260,166,0,260,386,-37,108,309,3,2,151,431,199,489,15,1608,815
1620,14,5.2.148,0,627,0,75,148,223,148,0,223,386,-19,90,291,3,2,153,431,280,489,15,1608,815
1620,15,0.2.277,0,662,3,94,277,371,277,0,371,386,-148,219,608,3,2,163,431,339,489,16,1608,782
1620,15,2.2.386,0,705,4,94,386,480,386,0,480,480,-257,328,717,3,2,142,431,241,489,16,1608,782
1620,15,3.2.348,0,658,2,74,348,422,348,0,422,422,-219,290,679,3,2,173,431,328,489,16,1608,782
1620,15,4.2.166,0,645,1,94,166,260,166,0,260,386,-37,108,497,3,2,151,431,199,489,16,1608,782
1620,15,5.2.148,1,627,0,75,148,223,148,0,223,386,-19,90,479,3,2,153,431,280,489,16,1608,782
1620,16,0.2.277,0,681,2,94,277,371,277,0,371,386,-54,144,533,3,3,163,356,339,489,17,1608,707
1620,16,2.2.386,0,705,3,94,386,480,386,0,480,480,-163,253,642,3,3,142,356,241,489,17,1608,707
1620,16,3.2.348,0,658,1,74,348,422,348,0,422,422,-125,215,604,3,3,173,356,328,489,17,1608,707
1620,16,4.2.223,0,627,0,94,223,317,166,57,317,386,0,90,479,3,3,151,356,199,489,17,1608,707
1620,16,5.3.223,1,627,0,50,223,273,223,0,273,386,-35,164,514,4,2,78,224,280,283,17,1608,707
1620,17,0.2.277,0,681,2,94,277,371,277,0,371,386,-54,144,568,3,3,163,356,339,489,18,1608,657
1620,17,2.2.386,0,705,3,94,386,480,386,0,480,480,-163,253,677,3,3,142,356,241,489,18,1608,657
1620,17,3.2.348,0,658,1,74,348,422,348,0,422,422,-125,215,639,3,3,173,356,328,489,18,1608,657
1620,17,4.2.223,0,627,0,94,223,317,166,57,317,386,0,90,514,3,3,151,356,199,489,18,1608,657
1620,17,5.4.273,1,627,0,28,273,301,273,0,301,386,-52,240,566,5,2,28,127,280,160,18,1608,657
1620,18,0.2.277,0,681,2,94,277,371,277,0,371,386,-54,144,620,3,3,163,356,339,489,19,1608,629
1620,18,2.2.386,0,705,3,94,386,480,386,0,480,480,-163,253,729,3,3,142,356,241,489,19,1608,629
1620,18,3.2.348,0,658,1,74,348,422,348,0,422,422,-125,215,691,3,3,173,356,328,489,19,1608,629
1620,18,4.2.223,1,627,0,94,223,317,166,57,317,386,0,90,566,3,3,151,356,199,489,19,1608,629
1620,19,0.2.317,0,627,0,94,317,411,277,40,411,411,0,90,566,3,4,163,262,339,489,20,1608,535
1620,19,2.2.386,0,717,2,94,386,480,386,0,480,480,-69,159,635,3,4,142,262,241,489,20,1608,535
1620,19,3.2.348,0,658,1,74,348,422,348,0,422,422,-31,121,597,3,4,173,262,328,489,20,1608,535
1620,19,4.3.317,1,627,0,34,317,351,317,0,351,386,-44,208,610,4,3,57,174,199,283,20,1608,535
1620,20,0.2.317,0,627,0,94,317,411,277,40,411,411,0,90,610,3,4,163,262,339,489,21,1608,501
1620,20,2.2.386,0,717,2,94,386,480,386,0,480,480,-69,159,679,3,4,142,262,241,489,21,1608,501
1620,20,3.2.348,0,658,1,74,348,422,348,0,422,422,-31,121,641,3,4,173,262,328,489,21,1608,501
1620,20,4.4.351,1,627,0,23,351,374,351,0,374,386,-50,290,660,5,3,23,99,199,160,21,1608,501
1620,21,0.2.317,1,627,0,94,317,411,277,40,411,411,0,90,660,3,4,163,262,339,489,22,1608,478
1620,21,2.2.386,0,717,2,94,386,480,386,0,480,480,-69,159,729,3,4,142,262,241,489,22,1608,478
1620,21,3.2.348,0,658,1,74,348,422,348,0,422,422,-31,121,691,3,4,173,262,328,489,22,1608,478
1620,22,0.3.411,1,627,0,50,411,461,411,0,461,461,-60,268,720,4,4,69,140,339,283,23,1608,384
1620,22,2.2.411,0,678,1,94,411,505,386,25,505,505,0,90,660,3,5,142,168,241,489,23,1608,384
1620,22,3.2.411,0,627,0,74,411,485,348,63,485,485,0,90,660,3,5,173,168,328,489,23,1608,384
1620,23,0.4.461,1,627,0,19,461,480,461,0,480,480,-87,377,807,5,4,19,76,339,160,24,1608,334
1620,23,2.2.411,0,678,1,94,411,505,386,25,505,505,0,90,720,3,5,142,168,241,489,24,1608,334
1620,23,3.2.411,0,627,0,74,411,485,348,63,485,485,0,90,720,3,5,173,168,328,489,24,1608,334
1620,24,2.2.411,0,678,1,94,411,505,386,25,505,505,0,90,807,3,5,142,168,241,489,25,1608,315
1620,24,3.2.411,1,627,0,74,411,485,348,63,485,485,0,90,807,3,5,173,168,328,489,25,1608,315
1620,25,2.2.485,0,627,0,94,485,579,386,99,579,579,0,90,807,3,6,142,94,241,489,26,1608,241
1620,25,3.3.485,1,627,0,68,485,553,485,0,553,553,-24,292,831,4,5,99,90,328,283,26,1608,241
1620,26,2.2.485,0,627,0,94,485,579,386,99,579,579,0,90,831,3,6,142,94,241,489,27,1608,173
1620,26,3.4.553,1,627,0,31,553,584,553,0,584,584,-73,450,904,5,5,31,57,328,160,27,1608,173
1620,27,2.2.485,1,627,0,94,485,579,386,99,579,584,0,90,904,3,6,142,94,241,489,28,1608,142
1620,28,2.3.579,1,627,0,22,579,601,579,0,601,601,-26,318,930,4,6,48,22,241,283,29,1608,48
1620,29,2.4.601,1,627,0,26,601,627,601,0,627,627,-17,467,947,5,6,26,26,241,160,30,1608,26
1621,0,0.0.0,1,571,1,6,0,6,0,0,6,6,0,0,0,1,1,284,278,284,278,1,1577,1577
1621,0,1.0.0,0,661,5,96,0,96,0,0,96,96,0,0,0,1,1,220,278,220,278,1,1577,1577
1621,0,2.0.0,0,565,0,21,0,21,0,0,21,21,0,0,0,1,1,268,278,268,278,1,1577,1577
1621,0,3.0.0,0,613,2,48,0,48,0,0,48,48,0,0,0,1,1,287,278,287,278,1,1577,1577
1621,0,4.0.0,0,617,3,52,0,52,0,0,52,52,0,0,0,1,1,334,278,334,278,1,1577,1577
1621,0,5.0.0,0,620,4,55,0,55,0,0,55,55,0,0,0,1,1,184,278,184,278,1,1577,1577
1621,1,0.1.6,0,601,1,53,6,59,6,0,59,59,-6,6,6,2,1,278,317,284,317,2,1577,1571
1621,1,1.0.6,0,619,3,96,6,102,0,6,102,102,0,0,0,1,2,220,272,220,278,2,1577,1571
1621,1,2.0.6,1,571,0,21,6,27,0,6,27,27,0,0,0,1,2,268,272,268,278,2,1577,1571
1621,1,3.0.6,0,601,1,48,6,54,0,6,54,54,0,0,0,1,2,287,272,287,278,2,1577,1571
1621,1,4.0.6,0,601,1,52,6,58,0,6,58,58,0,0,0,1,2,334,272,334,278,2,1577,1571
1621,1,5.0.6,0,608,2,55,6,61,0,6,61,61,0,0,0,1,2,184,272,184,278,2,1577,1571
1621,2,0.1.6,0,601,1,53,6,59,6,0,59,59,-6,6,6,2,1,278,317,284,317,3,1577,1550
1621,2,1.0.27,0,571,0,96,27,123,0,27,123,123,0,0,0,1,3,220,251,220,278,3,1577,1550
1621,2,2.1.27,0,571,0,18,27,45,27,0,45,45,-27,27,27,2,1,247,317,268,317,3,1577,1550
1621,2,3.0.27,0,571,0,48,27,75,0,27,75,75,0,0,0,1,3,287,251,287,278,3,1577,1550
1621,2,4.0.27,1,571,0,52,27,79,0,27,79,79,0,0,0,1,3,334,251,334,278,3,1577,1550
1621,2,5.0.27,0,571,0,55,27,82,0,27,82,82,0,0,0,1,3,184,251,184,278,3,1577,1550
1621,3,0.1.6,0,601,2,53,6,59,6,0,59,79,-6,6,6,2,1,278,317,284,317,4,1577,1498
1621,3,1.0.79,0,571,0,96,79,175,0,79,175,175,0,0,0,1,4,220,199,220,278,4,1577,1498
1621,3,2.1.27,0,571,0,18,27,45,27,0,45,79,-27,27,27,2,1,247,317,268,317,4,1577,1498
1621,3,3.0.79,1,571,0,48,79,127,0,79,127,127,0,0,0,1,4,287,199,287,278,4,1577,1498
1621,3,4.1.79,0,587,1,69,79,148,79,0,148,148,-79,79,79,2,1,282,317,334,317,4,1577,1498
1621,3,5.0.79,0,571,0,55,79,134,0,79,134,134,0,0,0,1,4,184,199,184,278,4,1577,1498
1621,4,0.1.6,0,601,2,53,6,59,6,0,59,127,-6,6,6,2,1,278,317,284,317,5,1577,1450
1621,4,1.0.127,0,571,0,96,127,223,0,127,223,223,0,0,0,1,5,220,151,220,278,5,1577,1450
1621,4,2.1.27,0,571,0,18,27,45,27,0,45,127,-27,27,27,2,1,247,317,268,317,5,1577,1450
1621,4,3.1.127,0,571,0,99,127,226,127,0,226,226,-127,127,127,2,1,239,317,287,317,5,1577,1450
1621,4,4.1.79,0,587,1,69,79,148,79,0,148,148,-79,79,79,2,1,282,317,334,317,5,1577,1450
1621,4,5.0.127,1,571,0,55,127,182,0,127,182,182,0,0,0,1,5,184,151,184,278,5,1577,1450
1621,5,0.1.6,0,601,2,53,6,59,6,0,59,182,-6,6,6,2,1,278,317,284,317,6,1577,1395
1621,5,1.0.182,1,571,0,96,182,278,0,182,278,278,0,0,0,1,6,220,96,220,278,6,1577,1395
1621,5,2.1.27,0,571,0,18,27,45,27,0,45,182,-27,27,27,2,1,247,317,268,317,6,1577,1395
1621,5,3.1.127,0,571,0,99,127,226,127,0,226,226,-127,127,127,2,1,239,317,287,317,6,1577,1395
1621,5,4.1.79,0,587,1,69,79,148,79,0,148,182,-79,79,79,2,1,282,317,334,317,6,1577,1395
1621,5,5.1.182,0,571,0,60,182,242,182,0,242,242,-182,182,182,2,1,129,317,184,317,6,1577,1395
1621,6,0.1.6,0,601,2,53,6,59,6,0,59,278,-6,6,6,2,1,278,317,284,317,7,1577,1299
1621,6,1.1.278,0,571,0,18,278,296,278,0,296,296,-278,278,278,2,1,124,317,220,317,7,1577,1299
1621,6,2.1.27,1,571,0,18,27,45,27,0,45,278,-27,27,27,2,1,247,317,268,317,7,1577,1299
1621,6,3.1.127,0,571,0,99,127,226,127,0,226,278,-127,127,127,2,1,239,317,287,317,7,1577,1299
1621,6,4.1.79,0,587,1,69,79,148,79,0,148,278,-79,79,79,2,1,282,317,334,317,7,1577,1299
1621,6,5.1.182,0,571,0,60,182,242,182,0,242,278,-182,182,182,2,1,129,317,184,317,7,1577,1299
1621,7,0.1.45,1,571,0,53,45,98,6,39,98,278,0,27,27,2,2,278,299,284,317,8,1577,1281
1621,7,1.1.278,0,571,0,18,278,296,278,0,296,296,-233,260,260,2,2,124,299,220,317,8,1577,1281
1621,7,2.2.45,0,571,0,48,45,93,45,0,93,278,-45,45,72,3,1,229,357,268,357,8,1577,1281
1621,7,3.1.127,0,571,0,99,127,226,127,0,226,278,-82,109,109,2,2,239,299,287,317,8,1577,1281
1621,7,4.1.79,0,587,1,69,79,148,79,0,148,278,-34,61,61,2,2,282,299,334,317,8,1577,1281
1621,7,5.1.182,0,571,0,60,182,242,182,0,242,278,-137,164,164,2,2,129,299,184,317,8,1577,1281
1621,8,0.2.98,0,571,0,97,98,195,98,0,195,278,-98,98,125,3,1,225,357,284,357,9,1577,1228
1621,8,1.1.278,0,571,0,18,278,296,278,0,296,296,-180,207,207,2,3,124,246,220,317,9,1577,1228
1621,8,2.2.45,0,571,0,48,45,93,45,0,93,278,-45,45,72,3,1,229,357,268,357,9,1577,1228
1621,8,3.1.127,0,571,0,99,127,226,127,0,226,278,-29,56,56,2,3,239,246,287,317,9,1577,1228
1621,8,4.1.98,1,571,0,69,98,167,79,19,167,278,0,27,27,2,3,282,246,334,317,9,1577,1228
1621,8,5.1.182,0,571,0,60,182,242,182,0,242,278,-84,111,111,2,3,129,246,184,317,9,1577,1228
1621,9,0.2.98,0,571,0,97,98,195,98,0,195,278,-98,98,125,3,1,225,357,284,357,10,1577,1159
1621,9,1.1.278,0,571,0,18,278,296,278,0,296,296,-111,138,138,2,4,124,177,220,317,10,1577,1159
1621,9,2.2.45,1,571,0,48,45,93,45,0,93,278,-45,45,72,3,1,229,357,268,357,10,1577,1159
1621,9,3.1.167,0,571,0,99,167,266,127,40,266,278,0,27,27,2,4,239,177,287,317,10,1577,1159
1621,9,4.2.167,0,594,1,94,167,261,167,0,261,278,-167,167,194,3,1,213,357,334,357,10,1577,1159
1621,9,5.1.182,0,571,0,60,182,242,182,0,242,278,-15,42,42,2,4,129,177,184,317,10,1577,1159
1621,10,0.2.98,0,571,0,97,98,195,98,0,195,278,-5,50,77,3,2,225,309,284,357,11,1577,1111
1621,10,1.1.278,0,571,0,18,278,296,278,0,296,296,-111,138,183,2,4,124,177,220,317,11,1577,1111
1621,10,2.3.93,1,571,0,90,93,183,93,0,183,278,-93,93,165,4,1,181,237,268,237,11,1577,1111
1621,10,3.1.167,0,571,0,99,167,266,127,40,266,278,0,27,72,2,4,239,177,287,317,11,1577,1111
1621,10,4.2.167,0,594,1,94,167,261,167,0,261,278,-74,119,146,3,2,213,309,334,357,11,1577,1111
1621,10,5.1.182,0,571,0,60,182,242,182,0,242,278,-15,42,87,2,4,129,177,184,317,11,1577,1111
1621,11,0.2.98,0,571,0,97,98,195,98,0,195,278,-5,50,170,3,2,225,309,284,357,12,1577,1021
1621,11,1.1.278,0,571,0,18,278,296,278,0,296,296,-111,138,276,2,4,124,177,220,317,12,1577,1021
1621,11,2.4.183,0,571,0,91,183,274,183,0,274,278,-183,183,348,5,1,91,388,268,388,12,1577,1021
1621,11,3.1.167,1,571,0,99,167,266,127,40,266,278,0,27,165,2,4,239,177,287,317,12,1577,1021
1621,11,4.2.167,0,594,1,94,167,261,167,0,261,278,-74,119,239,3,2,213,309,334,357,12,1577,1021
1621,11,5.1.182,0,571,0,60,182,242,182,0,242,278,-15,42,180,2,4,129,177,184,317,12,1577,1021
1621,12,0.2.98,0,571,0,97,98,195,98,0,195,278,-5,50,170,3,2,225,309,284,357,13,1577,922
1621,12,1.1.278,1,571,0,18,278,296,278,0,296,296,-12,39,177,2,5,124,78,220,317,13,1577,922
1621,12,2.4.183,0,571,0,91,183,274,183,0,274,278,-183,183,348,5,1,91,388,268,388,13,1577,922
1621,12,3.2.266,0,582,1,41,266,307,266,0,307,307,-173,218,338,3,2,140,309,287,357,13,1577,922
1621,12,4.2.167,0,594,2,94,167,261,167,0,261,278,-74,119,239,3,2,213,309,334,357,13,1577,922
1621,12,5.1.266,0,571,0,60,266,326,182,84,326,326,0,27,165,2,5,129,78,184,317,13,1577,922
1621,13,0.2.98,0,571,0,97,98,195,98,0,195,296,-5,50,182,3,2,225,309,284,357,14,1577,904
1621,13,1.2.296,0,571,0,63,296,359,296,0,359,359,-203,248,380,3,2,106,309,220,357,14,1577,904
1621,13,2.4.183,0,571,0,91,183,274,183,0,274,296,-183,183,360,5,1,91,388,268,388,14,1577,904
1621,13,3.2.266,0,582,1,41,266,307,266,0,307,307,-173,218,350,3,2,140,309,287,357,14,1577,904
1621,13,4.2.167,0,594,2,94,167,261,167,0,261,296,-74,119,251,3,2,213,309,334,357,14,1577,904
1621,13,5.1.296,1,571,0,60,296,356,182,114,356,356,0,39,177,2,6,129,60,184,317,14,1577,904
1621,14,0.2.98,0,571,0,97,98,195,98,0,195,356,-5,50,182,3,2,225,309,284,357,15,1577,844
1621,14,1.2.296,0,571,0,63,296,359,296,0,359,359,-203,248,380,3,2,106,309,220,357,15,1577,844
1621,14,2.4.183,1,571,0,91,183,274,183,0,274,356,-183,183,360,5,1,91,388,268,388,15,1577,844
1621,14,3.2.266,0,582,1,41,266,307,266,0,307,356,-173,218,350,3,2,140,309,287,357,15,1577,844
1621,14,4.2.167,0,594,2,94,167,261,167,0,261,356,-74,119,251,3,2,213,309,334,357,15,1577,844
1621,14,5.2.356,0,571,0,14,356,370,356,0,370,370,-263,308,440,3,2,69,309,184,357,15,1577,844
1621,15,0.2.98,1,571,0,97,98,195,98,0,195,356,-5,50,365,3,2,225,309,284,357,16,1577,753
1621,15,1.2.296,0,571,0,63,296,359,296,0,359,359,-203,248,563,3,2,106,309,220,357,16,1577,753
1621,15,3.2.266,0,582,1,41,266,307,266,0,307,356,-173,218,533,3,2,140,309,287,357,16,1577,753
1621,15,4.2.167,0,594,2,94,167,261,167,0,261,356,-74,119,434,3,2,213,309,334,357,16,1577,753
1621,15,5.2.356,0,571,0,14,356,370,356,0,370,370,-263,308,623,3,2,69,309,184,357,16,1577,753
1621,16,0.3.195,1,571,0,57,195,252,195,0,252,356,-12,105,377,4,2,128,147,284,237,17,1577,656
1621,16,1.2.296,0,571,0,63,296,359,296,0,359,359,-101,151,466,3,3,106,212,220,357,17,1577,656
1621,16,3.2.266,0,582,1,41,266,307,266,0,307,356,-71,121,436,3,3,140,212,287,357,17,1577,656
1621,16,4.2.195,0,571,0,94,195,289,167,28,289,356,0,50,365,3,3,213,212,334,357,17,1577,656
1621,16,5.2.356,0,571,0,14,356,370,356,0,370,370,-161,211,526,3,3,69,212,184,357,17,1577,656
1621,17,0.4.274,1,571,0,71,274,345,252,22,345,356,0,183,377,5,2,71,297,284,388,18,1577,599
1621,17,1.2.296,0,571,0,63,296,359,296,0,359,359,-101,151,478,3,3,106,212,220,357,18,1577,599
1621,17,3.2.266,0,582,1,41,266,307,266,0,307,356,-71,121,448,3,3,140,212,287,357,18,1577,599
1621,17,4.2.195,0,571,0,94,195,289,167,28,289,356,0,50,377,3,3,213,212,334,357,18,1577,599
1621,17,5.2.356,0,571,0,14,356,370,356,0,370,370,-161,211,538,3,3,69,212,184,357,18,1577,599
1621,18,1.2.296,0,571,0,63,296,359,296,0,359,359,-101,151,478,3,3,106,212,220,357,19,1577,528
1621,18,3.2.266,0,582,1,41,266,307,266,0,307,356,-71,121,448,3,3,140,212,287,357,19,1577,528
1621,18,4.2.195,1,571,0,94,195,289,167,28,289,356,0,50,377,3,3,213,212,334,357,19,1577,528
1621,18,5.2.356,0,571,0,14,356,370,356,0,370,370,-161,211,538,3,3,69,212,184,357,19,1577,528
1621,19,1.2.296,0,571,0,63,296,359,296,0,359,359,-7,57,384,3,4,106,118,220,357,20,1577,434
1621,19,3.2.289,0,571,0,41,289,330,266,23,330,356,0,50,377,3,4,140,118,287,357,20,1577,434
1621,19,4.3.289,1,571,0,27,289,316,289,0,316,356,-37,142,414,4,3,119,90,334,237,20,1577,434
1621,19,5.2.356,0,571,0,14,356,370,356,0,370,370,-67,117,444,3,4,69,118,184,357,20,1577,434
1621,20,1.2.296,0,571,0,63,296,359,296,0,359,359,-7,57,421,3,4,106,118,220,357,21,1577,407
1621,20,3.2.289,1,571,0,41,289,330,266,23,330,356,0,50,414,3,4,140,118,287,357,21,1577,407
1621,20,4.4.345,0,571,0,92,345,437,316,29,437,437,0,183,414,5,3,92,226,334,388,21,1577,407
1621,20,5.2.356,0,571,0,14,356,370,356,0,370,370,-67,117,481,3,4,69,118,184,357,21,1577,407
1621,21,1.2.330,0,571,0,63,330,393,296,34,393,393,0,50,414,3,5,106,77,220,357,22,1577,366
1621,21,3.3.330,1,571,0,27,330,357,330,0,357,357,-14,156,428,4,4,99,63,287,237,22,1577,366
1621,21,4.4.345,0,571,0,92,345,437,316,29,437,437,0,183,414,5,3,92,226,334,388,22,1577,366
1621,21,5.2.356,0,571,0,14,356,370,356,0,370,370,-26,76,440,3,5,69,77,184,357,22,1577,366
1621,22,1.2.330,0,571,0,63,330,393,296,34,393,393,0,50,428,3,5,106,77,220,357,23,1577,339
1621,22,3.4.357,0,583,1,72,357,429,357,0,429,429,-12,195,440,5,3,72,226,287,388,23,1577,339
1621,22,4.4.345,0,571,0,92,345,437,316,29,437,437,0,183,428,5,3,92,226,334,388,23,1577,339
1621,22,5.2.356,1,571,0,14,356,370,356,0,370,370,-26,76,454,3,5,69,77,184,357,23,1577,339
1621,23,1.2.370,0,571,0,63,370,433,296,74,433,433,0,76,454,3,6,106,63,220,357,24,1577,325
1621,23,3.4.357,0,583,1,72,357,429,357,0,429,429,-12,195,466,5,3,72,226,287,388,24,1577,325
1621,23,4.4.345,0,571,0,92,345,437,316,29,437,437,0,183,454,5,3,92,226,334,388,24,1577,325
1621,23,5.3.370,1,571,0,35,370,405,370,0,405,405,-13,169,467,4,5,55,36,184,237,24,1577,325
1621,24,1.2.370,1,571,0,63,370,433,296,74,433,433,0,76,467,3,6,106,63,220,357,25,1577,290
1621,24,3.4.357,0,583,1,72,357,429,357,0,429,429,-12,195,479,5,3,72,226,287,388,25,1577,290
1621,24,4.4.345,0,571,0,92,345,437,316,29,437,437,0,183,467,5,3,92,226,334,388,25,1577,290
1621,24,5.4.405,0,631,2,20,405,425,405,0,425,425,-60,243,527,5,3,20,226,184,388,25,1577,290
1621,25,1.3.433,1,571,0,1,433,434,433,0,434,434,-28,197,495,4,6,43,1,220,237,26,1577,227
1621,25,3.4.357,0,583,1,72,357,429,357,0,429,433,-12,195,479,5,3,72,226,287,388,26,1577,227
1621,25,4.4.345,0,571,0,92,345,437,316,29,437,437,0,183,467,5,3,92,226,334,388,26,1577,227
1621,25,5.4.405,0,631,2,20,405,425,405,0,425,433,-60,243,527,5,3,20,226,184,388,26,1577,227
1621,26,1.4.434,0,588,2,42,434,476,434,0,476,476,-89,272,584,5,3,42,226,220,388,27,1577,226
1621,26,3.4.357,0,583,1,72,357,429,357,0,429,434,-12,195,507,5,3,72,226,287,388,27,1577,226
1621,26,4.4.345,1,571,0,92,345,437,316,29,437,437,0,183,495,5,3,92,226,334,388,27,1577,226
1621,26,5.4.405,0,631,3,20,405,425,405,0,425,434,-60,243,555,5,3,20,226,184,388,27,1577,226
1621,27,1.4.437,0,571,0,42,437,479,434,3,479,479,0,183,495,5,4,42,134,220,388,28,1577,134
1621,27,3.4.437,0,571,0,72,437,509,357,80,509,509,0,183,495,5,4,72,134,287,388,28,1577,134
1621,27,5.4.437,1,571,0,20,437,457,405,32,457,457,0,183,495,5,4,20,134,184,388,28,1577,134
1621,28,1.4.457,0,571,0,42,457,499,434,23,499,499,0,183,495,5,5,42,114,220,388,29,1577,114
1621,28,3.4.457,1,571,0,72,457,529,357,100,529,529,0,183,495,5,5,72,114,287,388,29,1577,114
1621,29,1.4.529,1,571,0,42,529,571,434,95,571,571,0,183,495,5,6,42,42,220,388,30,1577,42
1622,0,0.0.0,0,442,0,19,0,19,0,0,19,19,0,0,0,1,1,131,294,131,294,1,1254,1254
1622,0,1.0.0,0,482,2,72,0,72,0,0,72,72,0,0,0,1,1,319,294,319,294,1,1254,1254
1622,0,2.0.0,0,492,4,67,0,67,0,0,67,67,0,0,0,1,1,194,294,194,294,1,1254,1254
1622,0,3.0.0,1,442,0,2,0,2,0,0,2,2,0,0,0,1,1,149,294,149,294,1,1254,1254
1622,0,4.0.0,0,458,1,74,0,74,0,0,74,74,0,0,0,1,1,274,294,274,294,1,1254,1254
1622,0,5.0.0,0,491,3,60,0,60,0,0,60,60,0,0,0,1,1,187,294,187,294,1,1254,1254
1622,1,0.0.2,0,442,0,19,2,21,0,2,21,21,0,0,0,1,2,131,292,131,294,2,1254,1252
1622,1,1.0.2,0,445,1,72,2,74,0,2,74,74,0,0,0,1,2,319,292,319,294,2,1254,1252
1622,1,2.0.2,0,492,3,67,2,69,0,2,69,69,0,0,0,1,2,194,292,194,294,2,1254,1252
1622,1,3.1.2,1,442,0,38,2,40,2,0,40,40,-2,2,2,2,1,147,221,149,221,2,1254,1252
1622,1,4.0.2,0,442,0,74,2,76,0,2,76,76,0,0,0,1,2,274,292,274,294,2,1254,1252
1622,1,5.0.2,0,491,2,60,2,62,0,2,62,62,0,0,0,1,2,187,292,187,294,2,1254,1252
1622,2,0.0.2,0,442,0,19,2,21,0,2,21,40,0,0,2,1,2,131,292,131,294,3,1254,1214
1622,2,1.0.2,0,445,1,72,2,74,0,2,74,74,0,0,2,1,2,319,292,319,294,3,1254,1214
1622,2,2.0.2,0,492,3,67,2,69,0,2,69,69,0,0,2,1,2,194,292,194,294,3,1254,1214
1622,2,3.2.40,1,442,0,8,40,48,40,0,48,48,-40,40,42,3,1,109,226,149,226,3,1254,1214
1622,2,4.0.2,0,442,0,74,2,76,0,2,76,76,0,0,2,1,2,274,292,274,294,3,1254,1214
1622,2,5.0.2,0,491,2,60,2,62,0,2,62,62,0,0,2,1,2,187,292,187,294,3,1254,1214
1622,3,0.0.2,0,442,0,19,2,21,0,2,21,48,0,0,42,1,2,131,292,131,294,4,1254,1206
1622,3,1.0.2,0,445,1,72,2,74,0,2,74,74,0,0,42,1,2,319,292,319,294,4,1254,1206
1622,3,2.0.2,0,492,3,67,2,69,0,2,69,69,0,0,42,1,2,194,292,194,294,4,1254,1206
1622,3,3.3.48,1,442,0,86,48,134,48,0,134,134,-48,48,90,4,1,101,291,149,291,4,1254,1206
1622,3,4.0.2,0,442,0,74,2,76,0,2,76,76,0,0,42,1,2,274,292,274,294,4,1254,1206
1622,3,5.0.2,0,491,2,60,2,62,0,2,62,62,0,0,42,1,2,187,292,187,294,4,1254,1206
1622,4,0.0.2,0,442,0,19,2,21,0,2,21,134,0,0,90,1,2,131,292,131,294,5,1254,1120
1622,4,1.0.2,0,445,1,72,2,74,0,2,74,134,0,0,90,1,2,319,292,319,294,5,1254,1120
1622,4,2.0.2,0,492,3,67,2,69,0,2,69,134,0,0,90,1,2,194,292,194,294,5,1254,1120
1622,4,3.4.134,1,442,0,15,134,149,134,0,149,149,-134,134,224,5,1,15,222,149,222,5,1254,1120
1622,4,4.0.2,0,442,0,74,2,76,0,2,76,134,0,0,90,1,2,274,292,274,294,5,1254,1120
1622,4,5.0.2,0,491,2,60,2,62,0,2,62,134,0,0,90,1,2,187,292,187,294,5,1254,1120
1622,5,0.0.2,0,442,0,19,2,21,0,2,21,149,0,0,224,1,2,131,292,131,294,6,1254,1105
1622,5,1.0.2,1,445,1,72,2,74,0,2,74,149,0,0,224,1,2,319,292,319,294,6,1254,1105
1622,5,2.0.2,0,492,3,67,2,69,0,2,69,149,0,0,224,1,2,194,292,194,294,6,1254,1105
1622,5,4.0.2,0,442,0,74,2,76,0,2,76,149,0,0,224,1,2,274,292,274,294,6,1254,1105
1622,5,5.0.2,0,491,2,60,2,62,0,2,62,149,0,0,224,1,2,187,292,187,294,6,1254,1105
1622,6,0.0.74,0,445,0,19,74,93,0,74,93,149,0,0,224,1,3,131,220,131,294,7,1254,1033
1622,6,1.1.74,1,445,0,85,74,159,74,0,159,159,-34,36,258,2,2,247,183,319,221,7,1254,1033
1622,6,2.0.74,0,445,0,67,74,141,0,74,141,149,0,0,224,1,3,194,220,194,294,7,1254,1033
1622,6,4.0.74,0,483,1,74,74,148,0,74,148,149,0,0,224,1,3,274,220,274,294,7,1254,1033
1622,6,5.0.74,0,494,2,60,74,134,0,74,134,149,0,0,224,1,3,187,220,187,294,7,1254,1033
1622,7,0.0.74,0,445,0,19,74,93,0,74,93,159,0,0,258,1,3,131,220,131,294,8,1254,948
1622,7,1.2.159,1,483,1,68,159,227,159,0,227,227,-111,151,369,3,2,162,218,319,226,8,1254,948
1622,7,2.0.74,0,445,0,67,74,141,0,74,141,159,0,0,258,1,3,194,220,194,294,8,1254,948
1622,7,4.0.74,0,483,1,74,74,148,0,74,148,159,0,0,258,1,3,274,220,274,294,8,1254,948
1622,7,5.0.74,0,494,2,60,74,134,0,74,134,159,0,0,258,1,3,187,220,187,294,8,1254,948
1622,8,0.0.74,0,483,0,19,74,93,0,74,93,227,0,0,369,1,3,131,220,131,294,9,1254,880
1622,8,1.3.227,1,483,0,42,227,269,227,0,269,269,-93,141,462,4,2,94,205,319,291,9,1254,880
1622,8,2.0.74,0,483,0,67,74,141,0,74,141,227,0,0,369,1,3,194,220,194,294,9,1254,880
1622,8,4.0.74,0,483,0,74,74,148,0,74,148,227,0,0,369,1,3,274,220,274,294,9,1254,880
1622,8,5.0.74,0,494,1,60,74,134,0,74,134,227,0,0,369,1,3,187,220,187,294,9,1254,880
1622,9,0.0.74,0,483,0,19,74,93,0,74,93,269,0,0,462,1,3,131,220,131,294,10,1254,838
1622,9,1.4.269,1,483,0,52,269,321,269,0,321,321,-120,254,582,5,2,52,207,319,222,10,1254,838
1622,9,2.0.74,0,483,0,67,74,141,0,74,141,269,0,0,462,1,3,194,220,194,294,10,1254,838
1622,9,4.0.74,0,483,0,74,74,148,0,74,148,269,0,0,462,1,3,274,220,274,294,10,1254,838
1622,9,5.0.74,0,494,1,60,74,134,0,74,134,269,0,0,462,1,3,187,220,187,294,10,1254,838
1622,10,0.0.74,0,483,0,19,74,93,0,74,93,321,0,0,582,1,3,131,220,131,294,11,1254,786
1622,10,2.0.74,0,483,0,67,74,141,0,74,141,321,0,0,582,1,3,194,220,194,294,11,1254,786
1622,10,4.0.74,1,483,0,74,74,148,0,74,148,321,0,0,582,1,3,274,220,274,294,11,1254,786
1622,10,5.0.74,0,494,1,60,74,134,0,74,134,321,0,0,582,1,3,187,220,187,294,11,1254,786
1622,11,0.0.148,0,483,0,19,148,167,0,148,167,321,0,0,582,1,4,131,146,131,294,12,1254,712
1622,11,2.0.148,0,483,0,67,148,215,0,148,215,321,0,0,582,1,4,194,146,194,294,12,1254,712
1622,11,4.1.159,1,483,0,22,159,181,148,11,181,321,0,36,582,2,3,200,98,274,221,12,1254,712
1622,11,5.0.148,0,495,1,60,148,208,0,148,208,321,0,0,582,1,4,187,146,187,294,12,1254,712
1622,12,0.0.148,0,483,0,19,148,167,0,148,167,321,0,0,582,1,4,131,146,131,294,13,1254,690
1622,12,2.0.148,0,483,0,67,148,215,0,148,215,321,0,0,582,1,4,194,146,194,294,13,1254,690
1622,12,4.2.227,1,501,2,95,227,322,181,46,322,322,0,151,582,3,3,178,150,274,226,13,1254,690
1622,12,5.0.148,0,495,1,60,148,208,0,148,208,321,0,0,582,1,4,187,146,187,294,13,1254,690
1622,13,0.0.148,0,501,0,19,148,167,0,148,167,322,0,0,582,1,4,131,146,131,294,14,1254,595
1622,13,2.0.148,0,501,0,67,148,215,0,148,215,322,0,0,582,1,4,194,146,194,294,14,1254,595
1622,13,4.3.322,1,501,0,20,322,342,322,0,342,342,-53,194,635,4,3,83,163,274,291,14,1254,595
1622,13,5.0.148,0,501,0,60,148,208,0,148,208,322,0,0,582,1,4,187,146,187,294,14,1254,595
1622,14,0.0.148,0,501,0,19,148,167,0,148,167,342,0,0,635,1,4,131,146,131,294,15,1254,575
1622,14,2.0.148,0,501,0,67,148,215,0,148,215,342,0,0,635,1,4,194,146,194,294,15,1254,575
1622,14,4.4.342,1,501,0,63,342,405,342,0,405,405,-21,275,656,5,3,63,155,274,222,15,1254,575
1622,14,5.0.148,0,501,0,60,148,208,0,148,208,342,0,0,635,1,4,187,146,187,294,15,1254,575
1622,15,0.0.148,1,501,0,19,148,167,0,148,167,405,0,0,656,1,4,131,146,131,294,16,1254,512
1622,15,2.0.148,0,501,0,67,148,215,0,148,215,405,0,0,656,1,4,194,146,194,294,16,1254,512
1622,15,5.0.148,0,501,0,60,148,208,0,148,208,405,0,0,656,1,4,187,146,187,294,16,1254,512
1622,16,0.1.181,1,501,0,21,181,202,167,14,202,405,0,36,656,2,4,112,76,131,221,17,1254,493
1622,16,2.0.167,0,501,0,67,167,234,0,167,234,405,0,0,656,1,5,194,127,194,294,17,1254,493
1622,16,5.0.167,0,501,0,60,167,227,0,167,227,405,0,0,656,1,5,187,127,187,294,17,1254,493
1622,17,0.2.322,1,501,0,2,322,324,202,120,324,405,0,151,656,3,4,91,55,131,226,18,1254,472
1622,17,2.0.167,0,501,0,67,167,234,0,167,234,405,0,0,656,1,5,194,127,194,294,18,1254,472
1622,17,5.0.167,0,501,0,60,167,227,0,167,227,405,0,0,656,1,5,187,127,187,294,18,1254,472
1622,18,0.3.342,0,532,1,64,342,406,324,18,406,406,0,194,656,4,4,89,143,131,291,19,1254,470
1622,18,2.0.167,0,501,0,67,167,234,0,167,234,405,0,0,656,1,5,194,127,194,294,19,1254,470
1622,18,5.0.167,1,501,0,60,167,227,0,167,227,405,0,0,656,1,5,187,127,187,294,19,1254,470
1622,19,0.3.342,0,532,1,64,342,406,324,18,406,406,0,194,656,4,4,89,143,131,291,20,1254,410
1622,19,2.0.227,1,501,0,67,227,294,0,227,294,405,0,0,656,1,6,194,67,194,294,20,1254,410
1622,19,5.1.227,0,501,0,44,227,271,227,0,271,405,-25,61,681,2,5,127,55,187,221,20,1254,410
1622,20,0.3.342,0,532,1,64,342,406,324,18,406,406,0,194,656,4,4,89,143,131,291,21,1254,343
1622,20,2.1.294,0,501,0,11,294,305,294,0,305,405,-92,128,748,2,5,127,55,194,221,21,1254,343
1622,20,5.1.227,1,501,0,44,227,271,227,0,271,405,-25,61,681,2,5,127,55,187,221,21,1254,343
1622,21,0.3.342,0,532,1,64,342,406,324,18,406,406,0,194,681,4,4,89,143,131,291,22,1254,299
1622,21,2.1.294,1,501,0,11,294,305,294,0,305,405,-23,84,704,2,6,127,11,194,221,22,1254,299
1622,21,5.2.324,0,532,1,52,324,376,271,53,376,405,0,151,681,3,5,83,53,187,226,22,1254,299
1622,22,0.3.342,0,532,1,64,342,406,324,18,406,406,0,194,704,4,4,89,143,131,291,23,1254,288
1622,22,2.2.324,1,501,0,1,324,325,305,19,325,405,0,151,704,3,5,116,53,194,226,23,1254,288
1622,22,5.2.324,0,532,1,52,324,376,271,53,376,405,0,151,704,3,5,83,53,187,226,23,1254,288
1622,23,0.3.342,0,532,1,64,342,406,324,18,406,406,0,194,704,4,4,89,143,131,291,24,1254,287
1622,23,2.3.342,0,501,0,59,342,401,325,17,401,405,0,194,704,4,4,115,143,194,291,24,1254,287
1622,23,5.2.325,1,501,0,52,325,377,271,54,377,405,0,151,704,3,6,83,52,187,226,24,1254,287
1622,24,0.3.342,0,532,1,64,342,406,324,18,406,406,0,194,704,4,4,89,143,131,291,25,1254,235
1622,24,2.3.342,1,501,0,59,342,401,325,17,401,405,0,194,704,4,4,115,143,194,291,25,1254,235
1622,24,5.3.377,0,545,2,20,377,397,377,0,397,405,-35,229,739,4,4,31,143,187,291,25,1254,235
1622,25,0.3.401,0,501,0,64,401,465,324,77,465,465,0,194,704,4,5,89,84,131,291,26,1254,176
1622,25,2.4.405,1,501,0,56,405,461,401,4,461,461,0,275,704,5,4,56,92,194,222,26,1254,176
1622,25,5.3.401,0,510,1,20,401,421,377,24,421,421,0,194,704,4,5,31,84,187,291,26,1254,176
1622,26,0.3.401,0,501,0,64,401,465,324,77,465,465,0,194,704,4,5,89,84,131,291,27,1254,120
1622,26,5.3.401,1,510,1,20,401,421,377,24,421,461,0,194,704,4,5,31,84,187,291,27,1254,120
1622,27,0.3.421,0,510,0,64,421,485,324,97,485,485,0,194,704,4,6,89,64,131,291,28,1254,100
1622,27,5.4.461,1,510,0,11,461,472,421,40,472,472,0,275,704,5,5,11,36,187,222,28,1254,100
1622,28,0.3.421,1,510,0,64,421,485,324,97,485,485,0,194,704,4,6,89,64,131,291,29,1254,89
1622,29,0.4.485,1,510,0,25,485,510,485,0,510,510,-13,288,717,5,6,25,25,131,222,30,1254,25
1623,0,0.0.0,1,521,0,32,0,32,0,0,32,32,0,0,0,1,1,272,306,272,306,1,1517,1517
1623,0,1.0.0,0,536,2,48,0,48,0,0,48,48,0,0,0,1,1,320,306,320,306,1,1517,1517
1623,0,2.0.0,0,529,1,13,0,13,0,0,13,13,0,0,0,1,1,122,306,122,306,1,1517,1517
1623,0,3.0.0,0,542,3,54,0,54,0,0,54,54,0,0,0,1,1,306,306,306,306,1,1517,1517
1623,0,4.0.0,0,600,5,95,0,95,0,0,95,95,0,0,0,1,1,310,306,310,306,1,1517,1517
1623,0,5.0.0,0,551,4,64,0,64,0,0,64,64,0,0,0,1,1,187,306,187,306,1,1517,1517
1623,1,0.1.32,0,521,0,88,32,120,32,0,120,120,-32,32,32,2,1,240,322,272,322,2,1517,1485
1623,1,1.0.32,1,521,0,48,32,80,0,32,80,80,0,0,0,1,2,320,274,320,306,2,1517,1485
1623,1,2.0.32,0,521,0,13,32,45,0,32,45,45,0,0,0,1,2,122,274,122,306,2,1517,1485
1623,1,3.0.32,0,542,1,54,32,86,0,32,86,86,0,0,0,1,2,306,274,306,306,2,1517,1485
1623,1,4.0.32,0,585,3,95,32,127,0,32,127,127,0,0,0,1,2,310,274,310,306,2,1517,1485
1623,1,5.0.32,0,571,2,64,32,96,0,32,96,96,0,0,0,1,2,187,274,187,306,2,1517,1485
1623,2,0.1.32,0,521,0,88,32,120,32,0,120,120,-32,32,32,2,1,240,322,272,322,3,1517,1437
1623,2,1.1.80,0,568,2,53,80,133,80,0,133,133,-80,80,80,2,1,272,322,320,322,3,1517,1437
1623,2,2.0.80,0,521,0,13,80,93,0,80,93,93,0,0,0,1,3,122,226,122,306,3,1517,1437
1623,2,3.0.80,1,548,1,54,80,134,0,80,134,134,0,0,0,1,3,306,226,306,306,3,1517,1437
1623,2,4.0.80,0,569,3,95,80,175,0,80,175,175,0,0,0,1,3,310,226,310,306,3,1517,1437
1623,2,5.0.80,0,571,4,64,80,144,0,80,144,144,0,0,0,1,3,187,226,187,306,3,1517,1437
1623,3,0.1.32,0,548,0,88,32,120,32,0,120,134,-32,32,32,2,1,240,322,272,322,4,1517,1383
1623,3,1.1.80,0,568,1,53,80,133,80,0,133,134,-80,80,80,2,1,272,322,320,322,4,1517,1383
1623,3,2.0.134,1,548,0,13,134,147,0,134,147,147,0,0,0,1,4,122,172,122,306,4,1517,1383
1623,3,3.1.134,0,568,1,76,134,210,134,0,210,210,-134,134,134,2,1,252,322,306,322,4,1517,1383
1623,3,4.0.134,0,568,1,95,134,229,0,134,229,229,0,0,0,1,4,310,172,310,306,4,1517,1383
1623,3,5.0.134,0,571,2,64,134,198,0,134,198,198,0,0,0,1,4,187,172,187,306,4,1517,1383
1623,4,0.1.32,0,548,0,88,32,120,32,0,120,147,-32,32,32,2,1,240,322,272,322,5,1517,1370
1623,4,1.1.80,0,568,1,53,80,133,80,0,133,147,-80,80,80,2,1,272,322,320,322,5,1517,1370
1623,4,2.1.147,0,548,0,5,147,152,147,0,152,152,-147,147,147,2,1,109,322,122,322,5,1517,1370
1623,4,3.1.134,0,568,1,76,134,210,134,0,210,210,-134,134,134,2,1,252,322,306,322,5,1517,1370
1623,4,4.0.147,1,548,0,95,147,242,0,147,242,242,0,0,0,1,5,310,159,310,306,5,1517,1370
1623,4,5.0.147,0,571,2,64,147,211,0,147,211,211,0,0,0,1,5,187,159,187,306,5,1517,1370
1623,5,0.1.32,0,548,0,88,32,120,32,0,120,242,-32,32,32,2,1,240,322,272,322,6,1517,1275
1623,5,1.1.80,0,568,1,53,80,133,80,0,133,242,-80,80,80,2,1,272,322,320,322,6,1517,1275
1623,5,2.1.147,0,548,0,5,147,152,147,0,152,242,-147,147,147,2,1,109,322,122,322,6,1517,1275
1623,5,3.1.134,0,568,1,76,134,210,134,0,210,242,-134,134,134,2,1,252,322,306,322,6,1517,1275
1623,5,4.1.242,0,589,2,73,242,315,242,0,315,315,-242,242,242,2,1,215,322,310,322,6,1517,1275
1623,5,5.0.242,1,548,0,64,242,306,0,242,306,306,0,0,0,1,6,187,64,187,306,6,1517,1275
1623,6,0.1.32,0,548,0,88,32,120,32,0,120,306,-32,32,32,2,1,240,322,272,322,7,1517,1211
1623,6,1.1.80,1,568,1,53,80,133,80,0,133,306,-80,80,80,2,1,272,322,320,322,7,1517,1211
1623,6,2.1.147,0,548,0,5,147,152,147,0,152,306,-147,147,147,2,1,109,322,122,322,7,1517,1211
1623,6,3.1.134,0,568,1,76,134,210,134,0,210,306,-134,134,134,2,1,252,322,306,322,7,1517,1211
1623,6,4.1.242,0,589,3,73,242,315,242,0,315,315,-242,242,242,2,1,215,322,310,322,7,1517,1211
1623,6,5.1.306,0,576,2,27,306,333,306,0,333,333,-306,306,306,2,1,123,322,187,322,7,1517,1211
1623,7,0.1.133,1,569,1,88,133,221,32,101,221,306,0,80,80,2,2,240,269,272,322,8,1517,1158
1623,7,1.2.133,0,568,0,74,133,207,133,0,207,306,-133,133,213,3,1,219,394,320,394,8,1517,1158
1623,7,2.1.147,0,575,2,5,147,152,147,0,152,306,-14,94,94,2,2,109,269,122,322,8,1517,1158
1623,7,3.1.134,0,568,0,76,134,210,134,0,210,306,-1,81,81,2,2,252,269,306,322,8,1517,1158
1623,7,4.1.242,0,589,4,73,242,315,242,0,315,315,-109,189,189,2,2,215,269,310,322,8,1517,1158
1623,7,5.1.306,0,576,3,27,306,333,306,0,333,333,-173,253,253,2,2,123,269,187,322,8,1517,1158
1623,8,0.2.221,0,569,0,5,221,226,221,0,226,306,-221,221,301,3,1,152,394,272,394,9,1517,1070
1623,8,1.2.133,0,569,0,74,133,207,133,0,207,306,-133,133,213,3,1,219,394,320,394,9,1517,1070
1623,8,2.1.221,0,569,0,5,221,226,147,74,226,306,0,80,80,2,3,109,181,122,322,9,1517,1070
1623,8,3.1.221,1,618,3,76,221,297,134,87,297,306,0,80,80,2,3,252,181,306,322,9,1517,1070
1623,8,4.1.242,0,589,1,73,242,315,242,0,315,315,-21,101,101,2,3,215,181,310,322,9,1517,1070
1623,8,5.1.306,0,598,2,27,306,333,306,0,333,333,-85,165,165,2,3,123,181,187,322,9,1517,1070
1623,9,0.2.221,0,618,0,5,221,226,221,0,226,306,-221,221,301,3,1,152,394,272,394,10,1517,994
1623,9,1.2.133,0,618,0,74,133,207,133,0,207,306,-133,133,213,3,1,219,394,320,394,10,1517,994
1623,9,2.1.297,1,618,0,5,297,302,147,150,302,306,0,80,80,2,4,109,105,122,322,10,1517,994
1623,9,3.2.297,0,618,0,75,297,372,297,0,372,372,-297,297,377,3,1,176,394,306,394,10,1517,994
1623,9,4.1.297,0,618,0,73,297,370,242,55,370,370,0,80,80,2,4,215,105,310,322,10,1517,994
1623,9,5.1.306,0,618,0,27,306,333,306,0,333,333,-9,89,89,2,4,123,105,187,322,10,1517,994
1623,10,0.2.221,0,618,0,5,221,226,221,0,226,306,-221,221,301,3,1,152,394,272,394,11,1517,989
1623,10,1.2.133,0,618,0,74,133,207,133,0,207,306,-133,133,213,3,1,219,394,320,394,11,1517,989
1623,10,2.2.302,0,623,1,54,302,356,302,0,356,356,-302,302,382,3,1,104,394,122,394,11,1517,989
1623,10,3.2.297,0,618,0,75,297,372,297,0,372,372,-297,297,377,3,1,176,394,306,394,11,1517,989
1623,10,4.1.302,1,618,0,73,302,375,242,60,375,375,0,80,80,2,5,215,100,310,322,11,1517,989
1623,10,5.1.306,0,618,0,27,306,333,306,0,333,333,-4,84,84,2,5,123,100,187,322,11,1517,989
1623,11,0.2.221,0,618,0,5,221,226,221,0,226,375,-221,221,301,3,1,152,394,272,394,12,1517,916
1623,11,1.2.133,0,618,0,74,133,207,133,0,207,375,-133,133,213,3,1,219,394,320,394,12,1517,916
1623,11,2.2.302,0,623,2,54,302,356,302,0,356,375,-302,302,382,3,1,104,394,122,394,12,1517,916
1623,11,3.2.297,0,618,0,75,297,372,297,0,372,375,-297,297,377,3,1,176,394,306,394,12,1517,916
1623,11,4.2.375,0,621,1,96,375,471,375,0,471,471,-375,375,455,3,1,142,394,310,394,12,1517,916
1623,11,5.1.375,1,618,0,27,375,402,306,69,402,402,0,80,80,2,6,123,27,187,322,12,1517,916
1623,12,0.2.221,0,618,0,5,221,226,221,0,226,402,-221,221,301,3,1,152,394,272,394,13,1517,889
1623,12,1.2.133,1,618,0,74,133,207,133,0,207,402,-133,133,213,3,1,219,394,320,394,13,1517,889
1623,12,2.2.302,0,623,2,54,302,356,302,0,356,402,-302,302,382,3,1,104,394,122,394,13,1517,889
1623,12,3.2.297,0,618,0,75,297,372,297,0,372,402,-297,297,377,3,1,176,394,306,394,13,1517,889
1623,12,4.2.375,0,621,1,96,375,471,375,0,471,471,-375,375,455,3,1,142,394,310,394,13,1517,889
1623,12,5.2.402,0,688,3,90,402,492,402,0,492,492,-402,402,482,3,1,96,394,187,394,13,1517,889
1623,13,0.2.221,0,618,0,5,221,226,221,0,226,402,-14,147,227,3,2,152,320,272,394,14,1517,815
1623,13,1.3.207,1,618,0,84,207,291,207,0,291,402,-207,207,420,4,1,145,244,320,244,14,1517,815
1623,13,2.2.302,0,623,2,54,302,356,302,0,356,402,-95,228,308,3,2,104,320,122,394,14,1517,815
1623,13,3.2.297,0,618,0,75,297,372,297,0,372,402,-90,223,303,3,2,176,320,306,394,14,1517,815
1623,13,4.2.375,0,621,1,96,375,471,375,0,471,471,-168,301,381,3,2,142,320,310,394,14,1517,815
1623,13,5.2.402,0,688,3,90,402,492,402,0,492,492,-195,328,408,3,2,96,320,187,394,14,1517,815
1623,14,0.2.221,0,618,0,5,221,226,221,0,226,402,-14,147,434,3,2,152,320,272,394,15,1517,731
1623,14,1.4.291,1,618,0,61,291,352,291,0,352,402,-291,291,711,5,1,61,251,320,251,15,1517,731
1623,14,2.2.302,0,623,2,54,302,356,302,0,356,402,-95,228,515,3,2,104,320,122,394,15,1517,731
1623,14,3.2.297,0,618,0,75,297,372,297,0,372,402,-90,223,510,3,2,176,320,306,394,15,1517,731
1623,14,4.2.375,0,621,1,96,375,471,375,0,471,471,-168,301,588,3,2,142,320,310,394,15,1517,731
1623,14,5.2.402,0,688,3,90,402,492,402,0,492,492,-195,328,615,3,2,96,320,187,394,15,1517,731
1623,15,0.2.221,1,618,0,5,221,226,221,0,226,402,-14,147,725,3,2,152,320,272,394,16,1517,670
1623,15,2.2.302,0,623,2,54,302,356,302,0,356,402,-95,228,806,3,2,104,320,122,394,16,1517,670
1623,15,3.2.297,0,618,0,75,297,372,297,0,372,402,-90,223,801,3,2,176,320,306,394,16,1517,670
1623,15,4.2.375,0,621,1,96,375,471,375,0,471,471,-168,301,879,3,2,142,320,310,394,16,1517,670
1623,15,5.2.402,0,688,3,90,402,492,402,0,492,492,-195,328,906,3,2,96,320,187,394,16,1517,670
1623,16,0.3.291,1,618,0,70,291,361,226,65,361,402,0,207,725,4,2,147,160,272,244,17,1517,665
1623,16,2.2.302,0,623,2,54,302,356,302,0,356,402,-76,223,801,3,3,104,315,122,394,17,1517,665
1623,16,3.2.297,0,618,0,75,297,372,297,0,372,402,-71,218,796,3,3,176,315,306,394,17,1517,665
1623,16,4.2.375,0,621,1,96,375,471,375,0,471,471,-149,296,874,3,3,142,315,310,394,17,1517,665
1623,16,5.2.402,0,688,3,90,402,492,402,0,492,492,-176,323,901,3,3,96,315,187,394,17,1517,665
1623,17,0.4.361,1,618,0,77,361,438,361,0,438,438,-9,300,734,5,2,77,190,272,251,18,1517,595
1623,17,2.2.302,0,623,2,54,302,356,302,0,356,402,-76,223,801,3,3,104,315,122,394,18,1517,595
1623,17,3.2.297,0,618,0,75,297,372,297,0,372,402,-71,218,796,3,3,176,315,306,394,18,1517,595
1623,17,4.2.375,0,621,1,96,375,471,375,0,471,471,-149,296,874,3,3,142,315,310,394,18,1517,595
1623,17,5.2.402,0,688,3,90,402,492,402,0,492,492,-176,323,901,3,3,96,315,187,394,18,1517,595
1623,18,2.2.302,0,623,2,54,302,356,302,0,356,438,-76,223,810,3,3,104,315,122,394,19,1517,518
1623,18,3.2.297,1,618,0,75,297,372,297,0,372,438,-71,218,805,3,3,176,315,306,394,19,1517,518
1623,18,4.2.375,0,621,1,96,375,471,375,0,471,471,-149,296,883,3,3,142,315,310,394,19,1517,518
1623,18,5.2.402,0,688,3,90,402,492,402,0,492,492,-176,323,910,3,3,96,315,187,394,19,1517,518
1623,19,2.2.372,0,618,0,54,372,426,302,70,426,438,0,218,805,3,4,104,240,122,394,20,1517,443
1623,19,3.3.372,1,618,0,45,372,417,372,0,417,438,-11,218,816,4,3,101,90,306,244,20,1517,443
1623,19,4.2.375,0,621,1,96,375,471,375,0,471,471,-3,221,808,3,4,142,240,310,394,20,1517,443
1623,19,5.2.402,0,688,2,90,402,492,402,0,492,492,-30,248,835,3,4,96,240,187,394,20,1517,443
1623,20,2.2.372,0,618,0,54,372,426,302,70,426,438,0,218,816,3,4,104,240,122,394,21,1517,398
1623,20,3.4.438,1,618,0,56,438,494,417,21,494,494,0,300,816,5,3,56,113,306,251,21,1517,398
1623,20,4.2.375,0,621,1,96,375,471,375,0,471,471,-3,221,819,3,4,142,240,310,394,21,1517,398
1623,20,5.2.402,0,688,2,90,402,492,402,0,492,492,-30,248,846,3,4,96,240,187,394,21,1517,398
1623,21,2.2.372,1,618,0,54,372,426,302,70,426,494,0,218,816,3,4,104,240,122,394,22,1517,342
1623,21,4.2.375,0,621,1,96,375,471,375,0,471,494,-3,221,819,3,4,142,240,310,394,22,1517,342
1623,21,5.2.402,0,688,2,90,402,492,402,0,492,494,-30,248,846,3,4,96,240,187,394,22,1517,342
1623,22,2.3.426,1,618,0,28,426,454,426,0,454,494,-9,227,825,4,4,50,45,122,244,23,1517,288
1623,22,4.2.426,0,618,0,96,426,522,375,51,522,522,0,218,816,3,5,142,186,310,394,23,1517,288
1623,22,5.2.426,0,658,1,90,426,516,402,24,516,516,0,218,816,3,5,96,186,187,394,23,1517,288
1623,23,2.4.494,1,618,0,22,494,516,454,40,516,516,0,300,825,5,4,22,57,122,251,24,1517,260
1623,23,4.2.426,0,618,0,96,426,522,375,51,522,522,0,218,825,3,5,142,186,310,394,24,1517,260
1623,23,5.2.426,0,658,1,90,426,516,402,24,516,516,0,218,825,3,5,96,186,187,394,24,1517,260
1623,24,4.2.426,1,618,0,96,426,522,375,51,522,522,0,218,825,3,5,142,186,310,394,25,1517,238
1623,24,5.2.426,0,658,1,90,426,516,402,24,516,516,0,218,825,3,5,96,186,187,394,25,1517,238
1623,25,4.3.522,1,618,0,13,522,535,522,0,535,535,-68,295,893,4,5,46,17,310,244,26,1517,142
1623,25,5.2.522,0,618,0,90,522,612,402,120,612,612,0,218,825,3,6,96,90,187,394,26,1517,142
1623,26,4.4.535,1,618,0,33,535,568,535,0,568,568,-19,319,912,5,5,33,35,310,251,27,1517,129
1623,26,5.2.522,0,618,0,90,522,612,402,120,612,612,0,218,893,3,6,96,90,187,394,27,1517,129
1623,27,5.2.522,1,618,0,90,522,612,402,120,612,612,0,218,912,3,6,96,90,187,394,28,1517,96
1623,28,5.3.612,1,618,0,4,612,616,612,0,616,616,-77,372,989,4,6,6,4,187,244,29,1517,6
1623,29,5.4.616,1,618,0,2,616,618,616,0,618,618,-48,367,1037,5,6,2,2,187,251,30,1517,2
1624,0,0.0.0,0,524,3,45,0,45,0,0,45,45,0,0,0,1,1,216,222,216,222,1,1386,1386
1624,0,1.0.0,0,500,2,23,0,23,0,0,23,23,0,0,0,1,1,220,222,220,222,1,1386,1386
1624,0,2.0.0,1,536,5,59,0,59,0,0,59,59,0,0,0,1,1,346,222,346,222,1,1386,1386
1624,0,3.0.0,0,479,0,8,0,8,0,0,8,8,0,0,0,1,1,166,222,166,222,1,1386,1386
1624,0,4.0.0,0,497,1,18,0,18,0,0,18,18,0,0,0,1,1,150,222,150,222,1,1386,1386
1624,0,5.0.0,0,533,4,69,0,69,0,0,69,69,0,0,0,1,1,288,222,288,222,1,1386,1386
1624,1,0.0.59,0,581,3,45,59,104,0,59,104,104,0,0,0,1,2,216,163,216,222,2,1386,1327
1624,1,1.0.59,1,559,2,23,59,82,0,59,82,82,0,0,0,1,2,220,163,220,222,2,1386,1327
1624,1,2.1.59,0,596,5,97,59,156,59,0,156,156,-59,59,59,2,1,287,226,346,226,2,1386,1327
1624,1,3.0.59,0,536,0,8,59,67,0,59,67,67,0,0,0,1,2,166,163,166,222,2,1386,1327
1624,1,4.0.59,0,554,1,18,59,77,0,59,77,77,0,0,0,1,2,150,163,150,222,2,1386,1327
1624,1,5.0.59,0,592,4,69,59,128,0,59,128,128,0,0,0,1,2,288,163,288,222,2,1386,1327
1624,2,0.0.82,0,588,3,45,82,127,0,82,127,127,0,0,0,1,3,216,140,216,222,3,1386,1304
1624,2,1.1.82,0,568,1,22,82,104,82,0,104,104,-82,82,82,2,1,197,226,220,226,3,1386,1304
1624,2,2.1.59,0,596,4,97,59,156,59,0,156,156,-59,59,59,2,1,287,226,346,226,3,1386,1304
1624,2,3.0.82,1,559,0,8,82,90,0,82,90,90,0,0,0,1,3,166,140,166,222,3,1386,1304
1624,2,4.0.82,0,577,2,18,82,100,0,82,100,100,0,0,0,1,3,150,140,150,222,3,1386,1304
1624,2,5.0.82,0,588,3,69,82,151,0,82,151,151,0,0,0,1,3,288,140,288,222,3,1386,1304
1624,3,0.0.90,0,559,0,45,90,135,0,90,135,135,0,0,0,1,4,216,132,216,222,4,1386,1296
1624,3,1.1.82,0,568,1,22,82,104,82,0,104,104,-82,82,82,2,1,197,226,220,226,4,1386,1296
1624,3,2.1.59,0,596,2,97,59,156,59,0,156,156,-59,59,59,2,1,287,226,346,226,4,1386,1296
1624,3,3.1.90,0,559,0,15,90,105,90,0,105,105,-90,90,90,2,1,158,226,166,226,4,1386,1296
1624,3,4.0.90,1,559,0,18,90,108,0,90,108,108,0,0,0,1,4,150,132,150,222,4,1386,1296
1624,3,5.0.90,0,559,0,69,90,159,0,90,159,159,0,0,0,1,4,288,132,288,222,4,1386,1296
1624,4,0.0.108,1,561,1,45,108,153,0,108,153,153,0,0,0,1,5,216,114,216,222,5,1386,1278
1624,4,1.1.82,0,573,3,22,82,104,82,0,104,108,-82,82,82,2,1,197,226,220,226,5,1386,1278
1624,4,2.1.59,0,596,4,97,59,156,59,0,156,156,-59,59,59,2,1,287,226,346,226,5,1386,1278
1624,4,3.1.90,0,559,0,15,90,105,90,0,105,108,-90,90,90,2,1,158,226,166,226,5,1386,1278
1624,4,4.1.108,0,568,2,26,108,134,108,0,134,134,-108,108,108,2,1,132,226,150,226,5,1386,1278
1624,4,5.0.108,0,559,0,69,108,177,0,108,177,177,0,0,0,1,5,288,114,288,222,5,1386,1278
1624,5,0.1.153,0,565,1,56,153,209,153,0,209,209,-153,153,153,2,1,171,226,216,226,6,1386,1233
1624,5,1.1.82,0,573,3,22,82,104,82,0,104,153,-82,82,82,2,1,197,226,220,226,6,1386,1233
1624,5,2.1.59,0,596,4,97,59,156,59,0,156,156,-59,59,59,2,1,287,226,346,226,6,1386,1233
1624,5,3.1.90,0,561,0,15,90,105,90,0,105,153,-90,90,90,2,1,158,226,166,226,6,1386,1233
1624,5,4.1.108,0,568,2,26,108,134,108,0,134,153,-108,108,108,2,1,132,226,150,226,6,1386,1233
1624,5,5.0.153,1,561,0,69,153,222,0,153,222,222,0,0,0,1,6,288,69,288,222,6,1386,1233
1624,6,0.1.153,0,565,1,56,153,209,153,0,209,222,-153,153,153,2,1,171,226,216,226,7,1386,1164
1624,6,1.1.82,1,573,3,22,82,104,82,0,104,222,-82,82,82,2,1,197,226,220,226,7,1386,1164
1624,6,2.1.59,0,596,4,97,59,156,59,0,156,222,-59,59,59,2,1,287,226,346,226,7,1386,1164
1624,6,3.1.90,0,561,0,15,90,105,90,0,105,222,-90,90,90,2,1,158,226,166,226,7,1386,1164
1624,6,4.1.108,0,568,2,26,108,134,108,0,134,222,-108,108,108,2,1,132,226,150,226,7,1386,1164
1624,6,5.1.222,0,565,1,10,222,232,222,0,232,232,-222,222,222,2,1,219,226,288,226,7,1386,1164
1624,7,0.1.153,0,573,0,56,153,209,153,0,209,222,-49,131,131,2,2,171,204,216,226,8,1386,1142
1624,7,1.2.104,0,588,1,79,104,183,104,0,183,222,-104,104,186,3,1,175,262,220,262,8,1386,1142
1624,7,2.1.104,0,588,1,97,104,201,59,45,201,222,0,82,82,2,2,287,204,346,226,8,1386,1142
1624,7,3.1.104,1,573,0,15,104,119,90,14,119,222,0,82,82,2,2,158,204,166,226,8,1386,1142
1624,7,4.1.108,0,588,1,26,108,134,108,0,134,222,-4,86,86,2,2,132,204,150,226,8,1386,1142
1624,7,5.1.222,0,573,0,10,222,232,222,0,232,232,-118,200,200,2,2,219,204,288,226,8,1386,1142
1624,8,0.1.153,0,573,0,56,153,209,153,0,209,222,-34,116,116,2,3,171,189,216,226,9,1386,1127
1624,8,1.2.104,0,588,1,79,104,183,104,0,183,222,-104,104,186,3,1,175,262,220,262,9,1386,1127
1624,8,2.1.119,1,573,0,97,119,216,59,60,216,222,0,82,82,2,3,287,189,346,226,9,1386,1127
1624,8,3.2.119,0,573,0,42,119,161,119,0,161,222,-119,119,201,3,1,143,262,166,262,9,1386,1127
1624,8,4.1.119,0,573,0,26,119,145,108,11,145,222,0,82,82,2,3,132,189,150,226,9,1386,1127
1624,8,5.1.222,0,573,0,10,222,232,222,0,232,232,-103,185,185,2,3,219,189,288,226,9,1386,1127
1624,9,0.1.216,0,575,1,56,216,272,153,63,272,272,0,82,82,2,4,171,92,216,226,10,1386,1030
1624,9,1.2.104,0,588,2,79,104,183,104,0,183,222,-104,104,186,3,1,175,262,220,262,10,1386,1030
1624,9,2.2.216,0,588,2,7,216,223,216,0,223,223,-216,216,298,3,1,190,262,346,262,10,1386,1030
1624,9,3.2.119,0,573,0,42,119,161,119,0,161,222,-119,119,201,3,1,143,262,166,262,10,1386,1030
1624,9,4.1.216,0,575,1,26,216,242,108,108,242,242,0,82,82,2,4,132,92,150,226,10,1386,1030
1624,9,5.1.222,1,573,0,10,222,232,222,0,232,232,-6,88,88,2,4,219,92,288,226,10,1386,1030
1624,10,0.1.232,0,573,0,56,232,288,153,79,288,288,0,88,88,2,5,171,82,216,226,11,1386,1020
1624,10,1.2.104,0,588,1,79,104,183,104,0,183,232,-104,104,192,3,1,175,262,220,262,11,1386,1020
1624,10,2.2.216,0,588,1,7,216,223,216,0,223,232,-216,216,304,3,1,190,262,346,262,11,1386,1020
1624,10,3.2.119,0,573,0,42,119,161,119,0,161,232,-119,119,207,3,1,143,262,166,262,11,1386,1020
1624,10,4.1.232,1,573,0,26,232,258,108,124,258,258,0,88,88,2,5,132,82,150,226,11,1386,1020
1624,10,5.2.232,0,588,1,29,232,261,232,0,261,261,-232,232,320,3,1,209,262,288,262,11,1386,1020
1624,11,0.1.258,1,573,0,56,258,314,153,105,314,314,0,88,88,2,6,171,56,216,226,12,1386,994
1624,11,1.2.104,0,588,1,79,104,183,104,0,183,258,-104,104,192,3,1,175,262,220,262,12,1386,994
1624,11,2.2.216,0,588,1,7,216,223,216,0,223,258,-216,216,304,3,1,190,262,346,262,12,1386,994
1624,11,3.2.119,0,573,0,42,119,161,119,0,161,258,-119,119,207,3,1,143,262,166,262,12,1386,994
1624,11,4.2.258,0,594,2,97,258,355,258,0,355,355,-258,258,346,3,1,106,262,150,262,12,1386,994
1624,11,5.2.232,0,588,1,29,232,261,232,0,261,261,-232,232,320,3,1,209,262,288,262,12,1386,994
1624,12,0.2.314,0,573,0,8,314,322,314,0,322,322,-314,314,402,3,1,115,262,216,262,13,1386,938
1624,12,1.2.104,0,588,1,79,104,183,104,0,183,314,-104,104,192,3,1,175,262,220,262,13,1386,938
1624,12,2.2.216,1,588,1,7,216,223,216,0,223,314,-216,216,304,3,1,190,262,346,262,13,1386,938
1624,12,3.2.119,0,573,0,42,119,161,119,0,161,314,-119,119,207,3,1,143,262,166,262,13,1386,938
1624,12,4.2.258,0,594,2,97,258,355,258,0,355,355,-258,258,346,3,1,106,262,150,262,13,1386,938
1624,12,5.2.232,0,588,1,29,232,261,232,0,261,314,-232,232,320,3,1,209,262,288,262,13,1386,938
1624,13,0.2.314,0,588,0,8,314,322,314,0,322,322,-91,307,395,3,2,115,255,216,262,14,1386,931
1624,13,1.2.104,0,588,0,79,104,183,104,0,223,314,79,137,225,3,2,175,255,220,262,14,1386,931
1624,13,2.3.223,1,601,1,96,223,319,223,0,319,319,-223,223,527,4,1,183,297,346,297,14,1386,931
1624,13,3.2.119,0,601,1,42,119,161,119,0,223,314,42,174,262,3,2,143,255,166,262,14,1386,931
1624,13,4.2.258,0,636,2,97,258,355,258,0,355,355,-35,251,339,3,2,106,255,150,262,14,1386,931
1624,13,5.2.232,0,601,1,29,232,261,232,0,261,314,-9,225,313,3,2,209,255,288,262,14,1386,931
1624,14,0.2.314,0,601,0,8,314,322,314,0,322,322,-91,307,618,3,2,115,255,216,262,15,1386,835
1624,14,1.2.104,0,628,1,79,104,183,104,0,223,319,79,137,448,3,2,175,255,220,262,15,1386,835
1624,14,2.4.319,0,601,0,87,319,406,319,0,406,406,-319,319,846,5,1,87,379,346,379,15,1386,835
1624,14,3.2.119,1,601,0,42,119,161,119,0,223,319,42,174,485,3,2,143,255,166,262,15,1386,835
1624,14,4.2.258,0,636,2,97,258,355,258,0,355,355,-35,251,562,3,2,106,255,150,262,15,1386,835
1624,14,5.2.232,0,601,0,29,232,261,232,0,261,319,-9,225,536,3,2,209,255,288,262,15,1386,835
1624,15,0.2.314,0,601,0,8,314,322,314,0,322,322,-91,265,576,3,3,115,213,216,262,16,1386,793
1624,15,1.2.223,0,601,0,79,223,302,104,119,302,319,0,174,485,3,3,175,213,220,262,16,1386,793
1624,15,2.4.319,0,601,0,87,319,406,319,0,406,406,-319,319,804,5,1,87,379,346,379,16,1386,793
1624,15,3.3.161,1,601,0,4,161,165,161,0,319,319,4,219,481,4,2,101,201,166,297,16,1386,793
1624,15,4.2.258,0,651,1,97,258,355,258,0,355,355,-35,209,520,3,3,106,213,150,262,16,1386,793
1624,15,5.2.232,0,601,0,29,232,261,232,0,261,319,-9,183,494,3,3,209,213,288,262,16,1386,793
1624,16,0.2.314,0,601,0,8,314,322,314,0,322,322,-91,265,572,3,3,115,213,216,262,17,1386,789
1624,16,1.2.223,0,601,0,79,223,302,104,119,302,319,0,174,481,3,3,175,213,220,262,17,1386,789
1624,16,2.4.319,0,601,0,87,319,406,319,0,406,406,-319,319,800,5,1,87,379,346,379,17,1386,789
1624,16,3.4.165,0,601,0,97,165,262,165,0,262,319,-165,165,646,5,1,97,379,166,379,17,1386,789
1624,16,4.2.258,0,651,1,97,258,355,258,0,355,355,-35,209,516,3,3,106,213,150,262,17,1386,789
1624,16,5.2.232,1,601,0,29,232,261,232,0,261,319,-9,183,490,3,3,209,213,288,262,17,1386,789
1624,17,0.2.314,0,602,1,8,314,322,314,0,322,322,-53,236,543,3,4,115,184,216,262,18,1386,760
1624,17,1.2.261,1,601,0,79,261,340,104,157,340,340,0,183,490,3,4,175,184,220,262,18,1386,760
1624,17,2.4.319,0,601,0,87,319,406,319,0,406,406,-319,319,809,5,1,87,379,346,379,18,1386,760
1624,17,3.4.165,0,601,0,97,165,262,165,0,262,319,-165,165,655,5,1,97,379,166,379,18,1386,760
1624,17,4.2.261,0,602,1,97,261,358,258,3,358,358,0,183,490,3,4,106,184,150,262,18,1386,760
1624,17,5.3.319,0,602,1,88,319,407,261,58,407,407,0,219,490,4,3,180,197,288,297,18,1386,760
1624,18,0.2.340,1,601,0,8,340,348,314,26,348,348,0,183,490,3,5,115,105,216,262,19,1386,681
1624,18,1.3.340,0,601,0,26,340,366,340,0,366,366,-21,240,511,4,3,96,197,220,297,19,1386,681
1624,18,2.4.319,0,601,0,87,319,406,319,0,406,406,-319,319,809,5,1,87,379,346,379,19,1386,681
1624,18,3.4.165,0,601,0,97,165,262,165,0,262,340,-165,165,655,5,1,97,379,166,379,19,1386,681
1624,18,4.2.340,0,601,0,97,340,437,258,82,437,437,0,183,490,3,5,106,105,150,262,19,1386,681
1624,18,5.3.319,0,602,1,88,319,407,261,58,407,407,0,219,490,4,3,180,197,288,297,19,1386,681
1624,19,0.3.348,0,634,2,77,348,425,348,0,425,425,-29,248,519,4,3,107,197,216,297,20,1386,673
1624,19,1.3.340,1,601,0,26,340,366,340,0,366,366,-21,240,511,4,3,96,197,220,297,20,1386,673
1624,19,2.4.319,0,601,0,87,319,406,319,0,406,406,-319,319,809,5,1,87,379,346,379,20,1386,673
1624,19,3.4.165,0,601,0,97,165,262,165,0,262,348,-165,165,655,5,1,97,379,166,379,20,1386,673
1624,19,4.2.348,0,601,0,97,348,445,258,90,445,445,0,183,490,3,6,106,97,150,262,20,1386,673
1624,19,5.3.319,0,602,1,88,319,407,261,58,407,407,0,219,490,4,3,180,197,288,297,20,1386,673
1624,20,0.3.366,0,626,1,77,366,443,348,18,443,443,0,240,511,4,4,107,171,216,297,21,1386,647
1624,20,1.4.366,0,648,2,70,366,436,366,0,436,436,-366,366,877,5,1,70,379,220,379,21,1386,647
1624,20,2.4.319,0,601,0,87,319,406,319,0,406,406,-319,319,830,5,1,87,379,346,379,21,1386,647
1624,20,3.4.165,0,601,0,97,165,262,165,0,262,366,-165,165,676,5,1,97,379,166,379,21,1386,647
1624,20,4.2.348,0,601,0,97,348,445,258,90,445,445,0,183,511,3,6,106,97,150,262,21,1386,647
1624,20,5.3.366,1,601,0,88,366,454,261,105,454,454,0,240,511,4,4,180,171,288,297,21,1386,647
1624,21,0.3.454,1,601,0,77,454,531,348,106,531,531,0,240,511,4,5,107,83,216,297,22,1386,559
1624,21,1.4.366,0,648,1,70,366,436,366,0,436,454,-366,366,877,5,1,70,379,220,379,22,1386,559
1624,21,2.4.319,0,601,0,87,319,406,319,0,406,454,-319,319,830,5,1,87,379,346,379,22,1386,559
1624,21,3.4.165,0,601,0,97,165,262,165,0,262,454,-165,165,676,5,1,97,379,166,379,22,1386,559
1624,21,4.2.348,0,601,0,97,348,445,258,90,445,454,0,183,511,3,6,106,97,150,262,22,1386,559
1624,21,5.4.454,0,649,2,92,454,546,454,0,546,546,-454,454,965,5,1,92,379,288,379,22,1386,559
1624,22,0.4.531,0,656,3,30,531,561,531,0,561,561,-531,531,1042,5,1,30,379,216,379,23,1386,482
1624,22,1.4.366,0,648,1,70,366,436,366,0,436,531,-366,366,877,5,1,70,379,220,379,23,1386,482
1624,22,2.4.319,0,601,0,87,319,406,319,0,406,531,-319,319,830,5,1,87,379,346,379,23,1386,482
1624,22,3.4.165,0,601,0,97,165,262,165,0,262,531,-165,165,676,5,1,97,379,166,379,23,1386,482
1624,22,4.2.348,1,601,0,97,348,445,258,90,445,531,0,183,511,3,6,106,97,150,262,23,1386,482
1624,22,5.4.454,0,649,2,92,454,546,454,0,546,546,-454,454,965,5,1,92,379,288,379,23,1386,482
1624,23,0.4.531,0,656,3,30,531,561,531,0,561,561,-531,531,1042,5,1,30,379,216,379,24,1386,385
1624,23,1.4.366,0,648,1,70,366,436,366,0,436,531,-366,366,877,5,1,70,379,220,379,24,1386,385
1624,23,2.4.319,0,601,0,87,319,406,319,0,406,531,-319,319,830,5,1,87,379,346,379,24,1386,385
1624,23,3.4.165,0,601,0,97,165,262,165,0,262,531,-165,165,676,5,1,97,379,166,379,24,1386,385
1624,23,4.3.531,1,601,0,6,531,537,445,86,537,537,0,240,511,4,6,9,6,150,297,24,1386,385
1624,23,5.4.454,0,649,2,92,454,546,454,0,546,546,-454,454,965,5,1,92,379,288,379,24,1386,385
1624,24,0.4.531,0,656,3,30,531,561,531,0,561,561,-531,531,1042,5,1,30,379,216,379,25,1386,379
1624,24,1.4.366,0,648,1,70,366,436,366,0,436,537,-366,366,877,5,1,70,379,220,379,25,1386,379
1624,24,2.4.319,0,601,0,87,319,406,319,0,406,537,-319,319,830,5,1,87,379,346,379,25,1386,379
1624,24,3.4.165,1,601,0,97,165,262,165,0,262,537,-165,165,676,5,1,97,379,166,379,25,1386,379
1624,24,4.4.537,0,662,4,3,537,540,537,0,540,540,-537,537,1048,5,1,3,379,150,379,25,1386,379
1624,24,5.4.454,0,649,2,92,454,546,454,0,546,546,-454,454,965,5,1,92,379,288,379,25,1386,379
1624,25,0.4.531,0,656,3,30,531,561,531,0,561,561,-269,434,945,5,2,30,282,216,379,26,1386,282
1624,25,1.4.366,0,648,1,70,366,436,366,0,436,537,-104,269,780,5,2,70,282,220,379,26,1386,282
1624,25,2.4.319,1,601,0,87,319,406,319,0,406,537,-57,222,733,5,2,87,282,346,379,26,1386,282
1624,25,4.4.537,0,662,4,3,537,540,537,0,540,540,-275,440,951,5,2,3,282,150,379,26,1386,282
1624,25,5.4.454,0,649,2,92,454,546,454,0,546,546,-192,357,868,5,2,92,282,288,379,26,1386,282
1624,26,0.4.531,0,656,2,30,531,561,531,0,561,561,-125,347,858,5,3,30,195,216,379,27,1386,195
1624,26,1.4.406,1,601,0,70,406,476,366,40,476,537,0,222,733,5,3,70,195,220,379,27,1386,195
1624,26,4.4.537,0,662,3,3,537,540,537,0,540,540,-131,353,864,5,3,3,195,150,379,27,1386,195
1624,26,5.4.454,0,649,1,92,454,546,454,0,546,546,-48,270,781,5,3,92,195,288,379,27,1386,195
1624,27,0.4.531,0,656,1,30,531,561,531,0,561,561,-55,277,788,5,4,30,125,216,379,28,1386,125
1624,27,4.4.537,0,662,2,3,537,540,537,0,540,540,-61,283,794,5,4,3,125,150,379,28,1386,125
1624,27,5.4.476,1,601,0,92,476,568,454,22,568,568,0,222,733,5,4,92,125,288,379,28,1386,125
1624,28,0.4.568,0,601,0,30,568,598,531,37,598,598,0,222,733,5,5,30,33,216,379,29,1386,33
1624,28,4.4.568,1,601,0,3,568,571,537,31,571,571,0,222,733,5,5,3,33,150,379,29,1386,33
1624,29,0.4.571,1,601,0,30,571,601,531,40,601,601,0,222,733,5,6,30,30,216,379,30,1386,30
1625,0,0.0.0,0,698,2,58,0,58,0,0,58,58,0,0,0,1,1,260,336,260,336,1,1951,1951
1625,0,1.0.0,0,751,5,98,0,98,0,0,98,98,0,0,0,1,1,417,336,417,336,1,1951,1951
1625,0,2.0.0,0,667,0,5,0,5,0,0,5,5,0,0,0,1,1,273,336,273,336,1,1951,1951
1625,0,3.0.0,0,711,4,61,0,61,0,0,61,61,0,0,0,1,1,226,336,226,336,1,1951,1951
1625,0,4.0.0,1,681,1,40,0,40,0,0,40,40,0,0,0,1,1,386,336,386,336,1,1951,1951
1625,0,5.0.0,0,709,3,74,0,74,0,0,74,74,0,0,0,1,1,389,336,389,336,1,1951,1951
1625,1,0.0.40,0,681,0,58,40,98,0,40,98,98,0,0,0,1,2,260,296,260,336,2,1951,1911
1625,1,1.0.40,0,722,3,98,40,138,0,40,138,138,0,0,0,1,2,417,296,417,336,2,1951,1911
1625,1,2.0.40,1,682,1,5,40,45,0,40,45,45,0,0,0,1,2,273,296,273,336,2,1951,1911
1625,1,3.0.40,0,714,2,61,40,101,0,40,101,101,0,0,0,1,2,226,296,226,336,2,1951,1911
1625,1,4.1.40,0,681,0,77,40,117,40,0,117,117,-40,40,40,2,1,346,426,386,426,2,1951,1911
1625,1,5.0.40,0,722,3,74,40,114,0,40,114,114,0,0,0,1,2,389,296,389,336,2,1951,1911
1625,2,0.0.45,0,682,0,58,45,103,0,45,103,103,0,0,0,1,3,260,291,260,336,3,1951,1906
1625,2,1.0.45,0,719,4,98,45,143,0,45,143,143,0,0,0,1,3,417,291,417,336,3,1951,1906
1625,2,2.1.45,0,707,1,91,45,136,45,0,136,136,-45,45,45,2,1,268,426,273,426,3,1951,1906
1625,2,3.0.45,0,714,2,61,45,106,0,45,106,106,0,0,0,1,3,226,291,226,336,3,1951,1906
1625,2,4.1.40,0,682,0,77,40,117,40,0,117,117,-40,40,40,2,1,346,426,386,426,3,1951,1906
1625,2,5.0.45,1,718,3,74,45,119,0,45,119,119,0,0,0,1,3,389,291,389,336,3,1951,1906
1625,3,0.0.119,0,718,0,58,119,177,0,119,177,177,0,0,0,1,4,260,217,260,336,4,1951,1832
1625,3,1.0.119,1,722,1,98,119,217,0,119,217,217,0,0,0,1,4,417,217,417,336,4,1951,1832
1625,3,2.1.45,0,718,0,91,45,136,45,0,136,136,-45,45,45,2,1,268,426,273,426,4,1951,1832
1625,3,3.0.119,0,723,2,61,119,180,0,119,180,180,0,0,0,1,4,226,217,226,336,4,1951,1832
1625,3,4.1.40,0,722,1,77,40,117,40,0,117,119,-40,40,40,2,1,346,426,386,426,4,1951,1832
1625,3,5.1.119,0,722,1,92,119,211,119,0,211,211,-119,119,119,2,1,315,426,389,426,4,1951,1832
1625,4,0.0.217,1,722,0,58,217,275,0,217,275,275,0,0,0,1,5,260,119,260,336,5,1951,1734
1625,4,1.1.217,0,722,0,89,217,306,217,0,306,306,-217,217,217,2,1,319,426,417,426,5,1951,1734
1625,4,2.1.45,0,742,1,91,45,136,45,0,136,217,-45,45,45,2,1,268,426,273,426,5,1951,1734
1625,4,3.0.217,0,722,0,61,217,278,0,217,278,278,0,0,0,1,5,226,119,226,336,5,1951,1734
1625,4,4.1.40,0,722,0,77,40,117,40,0,117,217,-40,40,40,2,1,346,426,386,426,5,1951,1734
1625,4,5.1.119,0,722,0,92,119,211,119,0,211,217,-119,119,119,2,1,315,426,389,426,5,1951,1734
1625,5,0.1.275,0,723,1,24,275,299,275,0,299,299,-275,275,275,2,1,202,426,260,426,6,1951,1676
1625,5,1.1.217,0,722,0,89,217,306,217,0,306,306,-217,217,217,2,1,319,426,417,426,6,1951,1676
1625,5,2.1.45,0,742,2,91,45,136,45,0,136,275,-45,45,45,2,1,268,426,273,426,6,1951,1676
1625,5,3.0.275,1,722,0,61,275,336,0,275,336,336,0,0,0,1,6,226,61,226,336,6,1951,1676
1625,5,4.1.40,0,722,0,77,40,117,40,0,117,275,-40,40,40,2,1,346,426,386,426,6,1951,1676
1625,5,5.1.119,0,722,0,92,119,211,119,0,211,275,-119,119,119,2,1,315,426,389,426,6,1951,1676
1625,6,0.1.275,0,723,1,24,275,299,275,0,299,336,-275,275,275,2,1,202,426,260,426,7,1951,1615
1625,6,1.1.217,0,722,0,89,217,306,217,0,306,336,-217,217,217,2,1,319,426,417,426,7,1951,1615
1625,6,2.1.45,0,742,2,91,45,136,45,0,136,336,-45,45,45,2,1,268,426,273,426,7,1951,1615
1625,6,3.1.336,0,722,0,53,336,389,336,0,389,389,-336,336,336,2,1,165,426,226,426,7,1951,1615
1625,6,4.1.40,1,722,0,77,40,117,40,0,117,336,-40,40,40,2,1,346,426,386,426,7,1951,1615
1625,6,5.1.119,0,722,0,92,119,211,119,0,211,336,-119,119,119,2,1,315,426,389,426,7,1951,1615
1625,7,0.1.275,0,723,1,24,275,299,275,0,299,336,-158,198,198,2,2,202,349,260,426,8,1951,1538
1625,7,1.1.217,0,722,0,89,217,306,217,0,306,336,-100,140,140,2,2,319,349,417,426,8,1951,1538
1625,7,2.1.117,0,735,2,91,117,208,45,72,208,336,0,40,40,2,2,268,349,273,426,8,1951,1538
1625,7,3.1.336,0,722,0,53,336,389,336,0,389,389,-219,259,259,2,2,165,349,226,426,8,1951,1538
1625,7,4.2.117,1,722,0,97,117,214,117,0,214,336,-117,117,157,3,1,269,329,386,329,8,1951,1538
1625,7,5.1.119,0,722,0,92,119,211,119,0,211,336,-2,42,42,2,2,315,349,389,426,8,1951,1538
1625,8,0.1.275,0,723,1,24,275,299,275,0,299,336,-158,198,315,2,2,202,349,260,426,9,1951,1441
1625,8,1.1.217,0,722,0,89,217,306,217,0,306,336,-100,140,257,2,2,319,349,417,426,9,1951,1441
1625,8,2.1.117,0,735,2,91,117,208,45,72,208,336,0,40,157,2,2,268,349,273,426,9,1951,1441
1625,8,3.1.336,0,722,0,53,336,389,336,0,389,389,-219,259,376,2,2,165,349,226,426,9,1951,1441
1625,8,4.3.214,0,722,0,99,214,313,214,0,313,336,-214,214,371,4,1,172,451,386,451,9,1951,1441
1625,8,5.1.119,1,722,0,92,119,211,119,0,211,336,-2,42,159,2,2,315,349,389,426,9,1951,1441
1625,9,0.1.275,0,723,1,24,275,299,275,0,299,336,-64,106,223,2,3,202,257,260,426,10,1951,1349
1625,9,1.1.217,0,722,0,89,217,306,217,0,306,336,-6,48,165,2,3,319,257,417,426,10,1951,1349
1625,9,2.1.211,0,723,1,91,211,302,45,166,302,336,0,42,159,2,3,268,257,273,426,10,1951,1349
1625,9,3.1.336,0,722,0,53,336,389,336,0,389,389,-125,167,284,2,3,165,257,226,426,10,1951,1349
1625,9,4.3.214,0,722,0,99,214,313,214,0,313,336,-214,214,373,4,1,172,451,386,451,10,1951,1349
1625,9,5.2.214,1,722,0,67,214,281,211,3,281,336,0,117,159,3,2,223,232,389,329,10,1951,1349
1625,10,0.1.275,0,723,1,24,275,299,275,0,299,336,-64,106,223,2,3,202,257,260,426,11,1951,1282
1625,10,1.1.217,0,722,0,89,217,306,217,0,306,336,-6,48,165,2,3,319,257,417,426,11,1951,1282
1625,10,2.1.211,1,723,1,91,211,302,45,166,302,336,0,42,159,2,3,268,257,273,426,11,1951,1282
1625,10,3.1.336,0,722,0,53,336,389,336,0,389,389,-125,167,284,2,3,165,257,226,426,11,1951,1282
1625,10,4.3.214,0,722,0,99,214,313,214,0,313,336,-214,214,373,4,1,172,451,386,451,11,1951,1282
1625,10,5.3.281,0,771,2,73,281,354,281,0,354,354,-281,281,440,4,1,156,451,389,451,11,1951,1282
1625,11,0.1.302,0,723,0,24,302,326,275,27,326,336,0,42,159,2,4,202,166,260,426,12,1951,1191
1625,11,1.1.302,0,735,1,89,302,391,217,85,391,391,0,42,159,2,4,319,166,417,426,12,1951,1191
1625,11,2.2.302,1,723,0,59,302,361,302,0,361,361,-21,138,180,3,3,177,165,273,329,12,1951,1191
1625,11,3.1.336,0,744,2,53,336,389,336,0,389,389,-34,76,193,2,4,165,166,226,426,12,1951,1191
1625,11,4.3.214,0,723,0,99,214,313,214,0,313,336,-214,214,373,4,1,172,451,386,451,12,1951,1191
1625,11,5.3.281,0,781,3,73,281,354,281,0,354,354,-281,281,440,4,1,156,451,389,451,12,1951,1191
1625,12,0.1.302,0,723,0,24,302,326,275,27,326,361,0,42,180,2,4,202,166,260,426,13,1951,1132
1625,12,1.1.302,1,735,1,89,302,391,217,85,391,391,0,42,180,2,4,319,166,417,426,13,1951,1132
1625,12,2.3.361,0,782,3,65,361,426,361,0,426,426,-361,361,541,4,1,118,451,273,451,13,1951,1132
1625,12,3.1.336,0,744,2,53,336,389,336,0,389,389,-34,76,214,2,4,165,166,226,426,13,1951,1132
1625,12,4.3.214,0,723,0,99,214,313,214,0,313,361,-214,214,394,4,1,172,451,386,451,13,1951,1132
1625,12,5.3.281,0,788,4,73,281,354,281,0,354,361,-281,281,461,4,1,156,451,389,451,13,1951,1132
1625,13,0.1.391,1,735,0,24,391,415,275,116,415,415,0,42,180,2,5,202,77,260,426,14,1951,1043
1625,13,1.2.391,0,747,1,84,391,475,391,0,475,475,-30,168,210,3,4,230,106,417,329,14,1951,1043
1625,13,2.3.361,0,782,2,65,361,426,361,0,426,426,-361,361,541,4,1,118,451,273,451,14,1951,1043
1625,13,3.1.391,0,747,1,53,391,444,336,55,444,444,0,42,180,2,5,165,77,226,426,14,1951,1043
1625,13,4.3.214,0,735,0,99,214,313,214,0,313,391,-214,214,394,4,1,172,451,386,451,14,1951,1043
1625,13,5.3.281,0,789,3,73,281,354,281,0,354,391,-281,281,461,4,1,156,451,389,451,14,1951,1043
1625,14,0.2.415,1,735,0,12,415,427,415,0,427,427,-54,192,234,3,4,178,106,260,329,15,1951,1019
1625,14,1.2.391,0,747,1,84,391,475,391,0,475,475,-30,168,210,3,4,230,106,417,329,15,1951,1019
1625,14,2.3.361,0,782,2,65,361,426,361,0,426,426,-361,361,541,4,1,118,451,273,451,15,1951,1019
1625,14,3.1.415,0,735,0,53,415,468,336,79,468,468,0,42,180,2,6,165,53,226,426,15,1951,1019
1625,14,4.3.214,0,735,0,99,214,313,214,0,313,415,-214,214,394,4,1,172,451,386,451,15,1951,1019
1625,14,5.3.281,0,789,3,73,281,354,281,0,354,415,-281,281,461,4,1,156,451,389,451,15,1951,1019
1625,15,0.3.427,0,764,1,84,427,511,427,0,511,511,-427,427,661,4,1,166,451,260,451,16,1951,1007
1625,15,1.2.427,1,735,0,84,427,511,391,36,511,511,0,192,234,3,5,230,94,417,329,16,1951,1007
1625,15,2.3.361,0,783,2,65,361,426,361,0,426,427,-361,361,595,4,1,118,451,273,451,16,1951,1007
1625,15,3.1.415,0,735,0,53,415,468,336,79,468,468,0,42,234,2,6,165,53,226,426,16,1951,1007
1625,15,4.3.214,0,735,0,99,214,313,214,0,313,427,-214,214,448,4,1,172,451,386,451,16,1951,1007
1625,15,5.3.281,0,789,3,73,281,354,281,0,354,427,-281,281,515,4,1,156,451,389,451,16,1951,1007
1625,16,0.3.427,0,764,1,84,427,511,427,0,511,511,-427,427,661,4,1,166,451,260,451,17,1951,923
1625,16,1.3.511,0,764,1,67,511,578,511,0,578,578,-511,511,745,4,1,146,451,417,451,17,1951,923
1625,16,2.3.361,0,783,2,65,361,426,361,0,426,511,-361,361,595,4,1,118,451,273,451,17,1951,923
1625,16,3.1.415,1,735,0,53,415,468,336,79,468,511,0,42,234,2,6,165,53,226,426,17,1951,923
1625,16,4.3.214,0,735,0,99,214,313,214,0,313,511,-214,214,448,4,1,172,451,386,451,17,1951,923
1625,16,5.3.281,0,789,3,73,281,354,281,0,354,511,-281,281,515,4,1,156,451,389,451,17,1951,923
1625,17,0.3.427,0,764,1,84,427,511,427,0,511,511,-427,427,661,4,1,166,451,260,451,18,1951,870
1625,17,1.3.511,0,764,1,67,511,578,511,0,578,578,-511,511,745,4,1,146,451,417,451,18,1951,870
1625,17,2.3.361,0,783,2,65,361,426,361,0,426,511,-361,361,595,4,1,118,451,273,451,18,1951,870
1625,17,3.2.511,1,735,0,10,511,521,468,43,521,521,0,192,234,3,6,112,10,226,329,18,1951,870
1625,17,4.3.214,0,735,0,99,214,313,214,0,313,511,-214,214,448,4,1,172,451,386,451,18,1951,870
1625,17,5.3.281,0,789,3,73,281,354,281,0,354,511,-281,281,515,4,1,156,451,389,451,18,1951,870
1625,18,0.3.427,0,764,1,84,427,511,427,0,511,521,-427,427,661,4,1,166,451,260,451,19,1951,860
1625,18,1.3.511,0,764,1,67,511,578,511,0,578,578,-511,511,745,4,1,146,451,417,451,19,1951,860
1625,18,2.3.361,0,783,2,65,361,426,361,0,426,521,-361,361,595,4,1,118,451,273,451,19,1951,860
1625,18,3.3.521,0,783,2,63,521,584,521,0,584,584,-521,521,755,4,1,102,451,226,451,19,1951,860
1625,18,4.3.214,1,735,0,99,214,313,214,0,313,521,-214,214,448,4,1,172,451,386,451,19,1951,860
1625,18,5.3.281,0,789,3,73,281,354,281,0,354,521,-281,281,515,4,1,156,451,389,451,19,1951,860
1625,19,0.3.427,0,764,1,84,427,511,427,0,511,521,-114,328,562,4,2,166,352,260,451,20,1951,761
1625,19,1.3.511,0,764,1,67,511,578,511,0,578,578,-198,412,646,4,2,146,352,417,451,20,1951,761
1625,19,2.3.361,0,783,2,65,361,426,361,0,426,521,-48,262,496,4,2,118,352,273,451,20,1951,761
1625,19,3.3.521,0,783,2,63,521,584,521,0,584,584,-208,422,656,4,2,102,352,226,451,20,1951,761
1625,19,4.4.313,1,735,0,73,313,386,313,0,386,521,-313,313,761,5,1,73,409,386,409,20,1951,761
1625,19,5.3.313,0,735,0,73,313,386,281,32,386,521,0,214,448,4,2,156,352,389,451,20,1951,761
1625,20,0.3.427,0,764,1,84,427,511,427,0,511,521,-114,328,875,4,2,166,352,260,451,21,1951,688
1625,20,1.3.511,0,764,1,67,511,578,511,0,578,578,-198,412,959,4,2,146,352,417,451,21,1951,688
1625,20,2.3.361,0,783,2,65,361,426,361,0,426,521,-48,262,809,4,2,118,352,273,451,21,1951,688
1625,20,3.3.521,0,783,2,63,521,584,521,0,584,584,-208,422,969,4,2,102,352,226,451,21,1951,688
1625,20,5.3.313,1,735,0,73,313,386,281,32,386,521,0,214,761,4,2,156,352,389,451,21,1951,688
1625,21,0.3.427,0,764,1,84,427,511,427,0,511,521,-41,255,802,4,3,166,279,260,451,22,1951,615
1625,21,1.3.511,0,764,1,67,511,578,511,0,578,578,-125,339,886,4,3,146,279,417,451,22,1951,615
1625,21,2.3.386,0,735,0,65,386,451,361,25,451,521,0,214,761,4,3,118,279,273,451,22,1951,615
1625,21,3.3.521,0,783,2,63,521,584,521,0,584,584,-135,349,896,4,3,102,279,226,451,22,1951,615
1625,21,5.4.386,1,735,0,83,386,469,386,0,469,521,0,313,761,5,2,83,336,389,409,22,1951,615
1625,22,0.3.427,0,764,1,84,427,511,427,0,511,521,-41,255,802,4,3,166,279,260,451,23,1951,532
1625,22,1.3.511,0,764,1,67,511,578,511,0,578,578,-125,339,886,4,3,146,279,417,451,23,1951,532
1625,22,2.3.386,1,735,0,65,386,451,361,25,451,521,0,214,761,4,3,118,279,273,451,23,1951,532
1625,22,3.3.521,0,783,2,63,521,584,521,0,584,584,-135,349,896,4,3,102,279,226,451,23,1951,532
1625,23,0.3.451,0,735,0,84,451,535,427,24,535,535,0,214,761,4,4,166,214,260,451,24,1951,467
1625,23,1.3.511,0,783,1,67,511,578,511,0,578,578,-60,274,821,4,4,146,214,417,451,24,1951,467
1625,23,2.4.469,1,735,0,53,469,522,451,18,522,522,0,313,761,5,3,53,253,273,409,24,1951,467
1625,23,3.3.521,0,817,2,63,521,584,521,0,584,584,-70,284,831,4,4,102,214,226,451,24,1951,467
1625,24,0.3.451,1,735,0,84,451,535,427,24,535,535,0,214,761,4,4,166,214,260,451,25,1951,414
1625,24,1.3.511,0,783,1,67,511,578,511,0,578,578,-60,274,821,4,4,146,214,417,451,25,1951,414
1625,24,3.3.521,0,817,2,63,521,584,521,0,584,584,-70,284,831,4,4,102,214,226,451,25,1951,414
1625,25,0.4.535,0,735,0,82,535,617,535,0,617,617,-13,326,774,5,4,82,200,260,409,26,1951,330
1625,25,1.3.535,1,735,0,67,535,602,511,24,602,602,0,214,761,4,5,146,130,417,451,26,1951,330
1625,25,3.3.535,0,744,1,63,535,598,521,14,598,598,0,214,761,4,5,102,130,226,451,26,1951,330
1625,26,0.4.535,0,735,0,82,535,617,535,0,617,617,-13,326,774,5,4,82,200,260,409,27,1951,263
1625,26,1.4.602,0,802,1,79,602,681,602,0,681,681,-80,393,841,5,4,79,200,417,409,27,1951,263
1625,26,3.3.602,1,735,0,63,602,665,521,81,665,665,0,214,761,4,6,102,63,226,451,27,1951,263
1625,27,0.4.535,1,735,0,82,535,617,535,0,617,665,-13,326,774,5,4,82,200,260,409,28,1951,200
1625,27,1.4.602,0,802,2,79,602,681,602,0,681,681,-80,393,841,5,4,79,200,417,409,28,1951,200
1625,27,3.4.665,0,783,1,39,665,704,665,0,704,704,-143,456,904,5,4,39,200,226,409,28,1951,200
1625,28,1.4.617,1,735,0,79,617,696,602,15,696,696,0,326,774,5,5,79,118,417,409,29,1951,118
1625,28,3.4.665,0,783,1,39,665,704,665,0,704,704,-48,374,822,5,5,39,118,226,409,29,1951,118
1625,29,3.4.696,1,735,0,39,696,735,665,31,735,735,0,326,774,5,6,39,39,226,409,30,1951,39
1626,0,0.0.0,0,657,5,71,0,71,0,0,71,71,0,0,0,1,1,303,349,303,349,1,1720,1720
1626,0,1.0.0,0,624,2,74,0,74,0,0,74,74,0,0,0,1,1,318,349,318,349,1,1720,1720
1626,0,2.0.0,0,636,3,50,0,50,0,0,50,50,0,0,0,1,1,199,349,199,349,1,1720,1720
1626,0,3.0.0,1,586,0,15,0,15,0,0,15,15,0,0,0,1,1,284,349,284,349,1,1720,1720
1626,0,4.0.0,0,619,1,61,0,61,0,0,61,61,0,0,0,1,1,324,349,324,349,1,1720,1720
1626,0,5.0.0,0,638,4,78,0,78,0,0,78,78,0,0,0,1,1,292,349,292,349,1,1720,1720
1626,1,0.0.15,0,612,3,71,15,86,0,15,86,86,0,0,0,1,2,303,334,303,349,2,1720,1705
1626,1,1.0.15,0,601,1,74,15,89,0,15,89,89,0,0,0,1,2,318,334,318,349,2,1720,1705
1626,1,2.0.15,0,620,4,50,15,65,0,15,65,65,0,0,0,1,2,199,334,199,349,2,1720,1705
1626,1,3.1.15,0,586,0,91,15,106,15,0,106,106,-15,15,15,2,1,269,430,284,430,2,1720,1705
1626,1,4.0.15,1,610,2,61,15,76,0,15,76,76,0,0,0,1,2,324,334,324,349,2,1720,1705
1626,1,5.0.15,0,586,0,78,15,93,0,15,93,93,0,0,0,1,2,292,334,292,349,2,1720,1705
1626,2,0.0.76,0,630,2,71,76,147,0,76,147,147,0,0,0,1,3,303,273,303,349,3,1720,1644
1626,2,1.0.76,1,630,2,74,76,150,0,76,150,150,0,0,0,1,3,318,273,318,349,3,1720,1644
1626,2,2.0.76,0,620,1,50,76,126,0,76,126,126,0,0,0,1,3,199,273,199,349,3,1720,1644
1626,2,3.1.15,0,610,0,91,15,106,15,0,106,106,-15,15,15,2,1,269,430,284,430,3,1720,1644
1626,2,4.1.76,0,634,3,30,76,106,76,0,106,106,-76,76,76,2,1,263,430,324,430,3,1720,1644
1626,2,5.0.76,0,610,0,78,76,154,0,76,154,154,0,0,0,1,3,292,273,292,349,3,1720,1644
1626,3,0.0.150,1,630,0,71,150,221,0,150,221,221,0,0,0,1,4,303,199,303,349,4,1720,1570
1626,3,1.1.150,0,630,0,57,150,207,150,0,207,207,-150,150,150,2,1,244,430,318,430,4,1720,1570
1626,3,2.0.150,0,630,0,50,150,200,0,150,200,200,0,0,0,1,4,199,199,199,349,4,1720,1570
1626,3,3.1.15,0,630,0,91,15,106,15,0,106,150,-15,15,15,2,1,269,430,284,430,4,1720,1570
1626,3,4.1.76,0,634,1,30,76,106,76,0,106,150,-76,76,76,2,1,263,430,324,430,4,1720,1570
1626,3,5.0.150,0,630,0,78,150,228,0,150,228,228,0,0,0,1,4,292,199,292,349,4,1720,1570
1626,4,0.1.221,0,630,0,92,221,313,221,0,313,313,-221,221,221,2,1,232,430,303,430,5,1720,1499
1626,4,1.1.150,0,630,0,57,150,207,150,0,207,221,-150,150,150,2,1,244,430,318,430,5,1720,1499
1626,4,2.0.221,0,630,0,50,221,271,0,221,271,271,0,0,0,1,5,199,128,199,349,5,1720,1499
1626,4,3.1.15,0,630,0,91,15,106,15,0,106,221,-15,15,15,2,1,269,430,284,430,5,1720,1499
1626,4,4.1.76,0,634,1,30,76,106,76,0,106,221,-76,76,76,2,1,263,430,324,430,5,1720,1499
1626,4,5.0.221,1,630,0,78,221,299,0,221,299,299,0,0,0,1,5,292,128,292,349,5,1720,1499
1626,5,0.1.221,0,630,0,92,221,313,221,0,313,313,-221,221,221,2,1,232,430,303,430,6,1720,1421
1626,5,1.1.150,0,630,0,57,150,207,150,0,207,299,-150,150,150,2,1,244,430,318,430,6,1720,1421
1626,5,2.0.299,1,630,0,50,299,349,0,299,349,349,0,0,0,1,6,199,50,199,349,6,1720,1421
1626,5,3.1.15,0,630,0,91,15,106,15,0,106,299,-15,15,15,2,1,269,430,284,430,6,1720,1421
1626,5,4.1.76,0,634,1,30,76,106,76,0,106,299,-76,76,76,2,1,263,430,324,430,6,1720,1421
1626,5,5.1.299,0,630,0,76,299,375,299,0,375,375,-299,299,299,2,1,214,430,292,430,6,1720,1421
1626,6,0.1.221,0,630,0,92,221,313,221,0,313,349,-221,221,221,2,1,232,430,303,430,7,1720,1371
1626,6,1.1.150,0,630,0,57,150,207,150,0,207,349,-150,150,150,2,1,244,430,318,430,7,1720,1371
1626,6,2.1.349,0,647,2,84,349,433,349,0,433,433,-349,349,349,2,1,149,430,199,430,7,1720,1371
1626,6,3.1.15,0,630,0,91,15,106,15,0,106,349,-15,15,15,2,1,269,430,284,430,7,1720,1371
1626,6,4.1.76,1,634,1,30,76,106,76,0,106,349,-76,76,76,2,1,263,430,324,430,7,1720,1371
1626,6,5.1.299,0,630,0,76,299,375,299,0,375,375,-299,299,299,2,1,214,430,292,430,7,1720,1371
1626,7,0.1.221,0,649,2,92,221,313,221,0,313,349,-115,191,191,2,2,232,400,303,430,8,1720,1341
1626,7,1.1.150,0,634,0,57,150,207,150,0,207,349,-44,120,120,2,2,244,400,318,430,8,1720,1341
1626,7,2.1.349,0,647,1,84,349,433,349,0,433,433,-243,319,319,2,2,149,400,199,430,8,1720,1341
1626,7,3.1.106,0,634,0,91,106,197,15,91,197,349,0,76,76,2,2,269,400,284,430,8,1720,1341
1626,7,4.2.106,1,634,0,98,106,204,106,0,204,349,-106,106,182,3,1,233,297,324,297,8,1720,1341
1626,7,5.1.299,0,634,0,76,299,375,299,0,375,375,-193,269,269,2,2,214,400,292,430,8,1720,1341
1626,8,0.1.221,0,649,2,92,221,313,221,0,313,349,-115,191,297,2,2,232,400,303,430,9,1720,1243
1626,8,1.1.150,0,634,0,57,150,207,150,0,207,349,-44,120,226,2,2,244,400,318,430,9,1720,1243
1626,8,2.1.349,0,647,1,84,349,433,349,0,433,433,-243,319,425,2,2,149,400,199,430,9,1720,1243
1626,8,3.1.106,0,634,0,91,106,197,15,91,197,349,0,76,182,2,2,269,400,284,430,9,1720,1243
1626,8,4.3.204,1,634,0,92,204,296,204,0,296,349,-204,204,386,4,1,135,306,324,306,9,1720,1243
1626,8,5.1.299,0,634,0,76,299,375,299,0,375,375,-193,269,375,2,2,214,400,292,430,9,1720,1243
1626,9,0.1.221,0,649,2,92,221,313,221,0,313,349,-115,191,501,2,2,232,400,303,430,10,1720,1151
1626,9,1.1.150,0,634,0,57,150,207,150,0,207,349,-44,120,430,2,2,244,400,318,430,10,1720,1151
1626,9,2.1.349,0,647,1,84,349,433,349,0,433,433,-243,319,629,2,2,149,400,199,430,10,1720,1151
1626,9,3.1.106,0,634,0,91,106,197,15,91,197,349,0,76,386,2,2,269,400,284,430,10,1720,1151
1626,9,4.4.296,1,634,0,43,296,339,296,0,339,349,-296,296,682,5,1,43,338,324,338,10,1720,1151
1626,9,5.1.299,0,634,0,76,299,375,299,0,375,375,-193,269,579,2,2,214,400,292,430,10,1720,1151
1626,10,0.1.221,0,649,2,92,221,313,221,0,313,349,-115,191,797,2,2,232,400,303,430,11,1720,1108
1626,10,1.1.150,0,634,0,57,150,207,150,0,207,349,-44,120,726,2,2,244,400,318,430,11,1720,1108
1626,10,2.1.349,0,647,1,84,349,433,349,0,433,433,-243,319,925,2,2,149,400,199,430,11,1720,1108
1626,10,3.1.106,1,634,0,91,106,197,15,91,197,349,0,76,682,2,2,269,400,284,430,11,1720,1108
1626,10,5.1.299,0,634,0,76,299,375,299,0,375,375,-193,269,875,2,2,214,400,292,430,11,1720,1108
1626,11,0.1.221,0,649,2,92,221,313,221,0,313,349,-24,100,706,2,3,232,309,303,430,12,1720,1017
1626,11,1.1.197,0,634,0,57,197,254,150,47,254,349,0,76,682,2,3,244,309,318,430,12,1720,1017
1626,11,2.1.349,0,647,1,84,349,433,349,0,433,433,-152,228,834,2,3,149,309,199,430,12,1720,1017
1626,11,3.2.204,1,634,0,76,204,280,197,7,280,349,0,106,682,3,2,178,199,284,297,12,1720,1017
1626,11,5.1.299,0,634,0,76,299,375,299,0,375,375,-102,178,784,2,3,214,309,292,430,12,1720,1017
1626,12,0.1.221,0,649,2,92,221,313,221,0,313,349,-24,100,706,2,3,232,309,303,430,13,1720,941
1626,12,1.1.197,0,634,0,57,197,254,150,47,254,349,0,76,682,2,3,244,309,318,430,13,1720,941
1626,12,2.1.349,0,647,1,84,349,433,349,0,433,433,-152,228,834,2,3,149,309,199,430,13,1720,941
1626,12,3.3.296,1,634,0,22,296,318,280,16,318,349,0,204,682,4,2,102,214,284,306,13,1720,941
1626,12,5.1.299,0,634,0,76,299,375,299,0,375,375,-102,178,784,2,3,214,309,292,430,13,1720,941
1626,13,0.1.221,0,649,2,92,221,313,221,0,313,349,-24,100,706,2,3,232,309,303,430,14,1720,919
1626,13,1.1.197,0,634,0,57,197,254,150,47,254,349,0,76,682,2,3,244,309,318,430,14,1720,919
1626,13,2.1.349,0,647,1,84,349,433,349,0,433,433,-152,228,834,2,3,149,309,199,430,14,1720,919
1626,13,3.4.339,1,634,0,80,339,419,318,21,419,419,0,296,682,5,2,80,295,284,338,14,1720,919
1626,13,5.1.299,0,634,0,76,299,375,299,0,375,375,-102,178,784,2,3,214,309,292,430,14,1720,919
1626,14,0.1.221,0,649,2,92,221,313,221,0,313,419,-24,100,706,2,3,232,309,303,430,15,1720,839
1626,14,1.1.197,1,634,0,57,197,254,150,47,254,419,0,76,682,2,3,244,309,318,430,15,1720,839
1626,14,2.1.349,0,647,1,84,349,433,349,0,433,433,-152,228,834,2,3,149,309,199,430,15,1720,839
1626,14,5.1.299,0,634,0,76,299,375,299,0,375,419,-102,178,784,2,3,214,309,292,430,15,1720,839
1626,15,0.1.254,0,634,0,92,254,346,221,33,346,419,0,76,682,2,4,232,252,303,430,16,1720,782
1626,15,1.2.280,1,634,0,89,280,369,254,26,369,419,0,106,682,3,3,187,123,318,297,16,1720,782
1626,15,2.1.349,0,647,1,84,349,433,349,0,433,433,-95,171,777,2,4,149,252,199,430,16,1720,782
1626,15,5.1.299,0,634,0,76,299,375,299,0,375,419,-45,121,727,2,4,214,252,292,430,16,1720,782
1626,16,0.1.254,0,634,0,92,254,346,221,33,346,419,0,76,682,2,4,232,252,303,430,17,1720,693
1626,16,1.3.369,1,634,0,10,369,379,369,0,379,419,-51,255,733,4,3,98,192,318,306,17,1720,693
1626,16,2.1.349,0,647,1,84,349,433,349,0,433,433,-95,171,777,2,4,149,252,199,430,17,1720,693
1626,16,5.1.299,0,634,0,76,299,375,299,0,375,419,-45,121,727,2,4,214,252,292,430,17,1720,693
1626,17,0.1.254,0,634,0,92,254,346,221,33,346,419,0,76,733,2,4,232,252,303,430,18,1720,683
1626,17,1.4.419,1,634,0,88,419,507,379,40,507,507,0,296,733,5,3,88,215,318,338,18,1720,683
1626,17,2.1.349,0,647,1,84,349,433,349,0,433,433,-95,171,828,2,4,149,252,199,430,18,1720,683
1626,17,5.1.299,0,634,0,76,299,375,299,0,375,419,-45,121,778,2,4,214,252,292,430,18,1720,683
1626,18,0.1.254,1,634,0,92,254,346,221,33,346,507,0,76,733,2,4,232,252,303,430,19,1720,595
1626,18,2.1.349,0,647,1,84,349,433,349,0,433,507,-95,171,828,2,4,149,252,199,430,19,1720,595
1626,18,5.1.299,0,634,0,76,299,375,299,0,375,507,-45,121,778,2,4,214,252,292,430,19,1720,595
1626,19,0.2.369,1,634,0,15,369,384,346,23,384,507,0,106,733,3,4,140,34,303,297,20,1720,503
1626,19,2.1.349,0,647,1,84,349,433,349,0,433,507,-3,79,736,2,5,149,160,199,430,20,1720,503
1626,19,5.1.346,0,634,0,76,346,422,299,47,422,507,0,76,733,2,5,214,160,292,430,20,1720,503
1626,20,0.3.384,1,634,0,90,384,474,384,0,474,507,-5,260,738,4,4,125,182,303,306,21,1720,488
1626,20,2.1.349,0,647,1,84,349,433,349,0,433,507,-3,79,736,2,5,149,160,199,430,21,1720,488
1626,20,5.1.346,0,634,0,76,346,422,299,47,422,507,0,76,733,2,5,214,160,292,430,21,1720,488
1626,21,0.4.507,1,634,0,35,507,542,474,33,542,542,0,296,738,5,4,35,127,303,338,22,1720,398
1626,21,2.1.349,0,647,1,84,349,433,349,0,433,507,-3,79,741,2,5,149,160,199,430,22,1720,398
1626,21,5.1.346,0,634,0,76,346,422,299,47,422,507,0,76,738,2,5,214,160,292,430,22,1720,398
1626,22,2.1.349,0,647,1,84,349,433,349,0,433,542,-3,79,741,2,5,149,160,199,430,23,1720,363
1626,22,5.1.346,1,634,0,76,346,422,299,47,422,542,0,76,738,2,5,214,160,292,430,23,1720,363
1626,23,2.1.422,0,634,0,84,422,506,349,73,506,542,0,76,738,2,6,149,84,199,430,24,1720,287
1626,23,5.2.422,1,634,0,6,422,428,422,0,428,542,-38,144,776,3,5,138,19,292,297,24,1720,287
1626,24,2.1.422,0,634,0,84,422,506,349,73,506,542,0,76,776,2,6,149,84,199,430,25,1720,281
1626,24,5.3.474,1,634,0,58,474,532,428,46,532,542,0,260,776,4,5,132,92,292,306,25,1720,281
1626,25,2.1.422,0,634,0,84,422,506,349,73,506,542,0,76,776,2,6,149,84,199,430,26,1720,223
1626,25,5.4.542,1,634,0,74,542,616,532,10,616,616,0,296,776,5,5,74,92,292,338,26,1720,223
1626,26,2.1.422,1,634,0,84,422,506,349,73,506,616,0,76,776,2,6,149,84,199,430,27,1720,149
1626,27,2.2.506,1,634,0,13,506,519,506,0,519,616,-78,222,854,3,6,65,13,199,297,28,1720,65
1626,28,2.3.532,1,634,0,34,532,566,519,13,566,616,0,260,854,4,6,52,34,199,306,29,1720,52
1626,29,2.4.616,1,634,0,18,616,634,566,50,634,634,0,296,854,5,6,18,18,199,338,30,1720,18
1627,0,0.0.0,0,666,1,84,0,84,0,0,84,84,0,0,0,1,1,347,463,347,463,1,1889,1889
1627,0,1.0.0,1,664,0,50,0,50,0,0,50,50,0,0,0,1,1,318,463,318,463,1,1889,1889
1627,0,2.0.0,0,721,5,96,0,96,0,0,96,96,0,0,0,1,1,325,463,325,463,1,1889,1889
1627,0,3.0.0,0,709,4,67,0,67,0,0,67,67,0,0,0,1,1,243,463,243,463,1,1889,1889
1627,0,4.0.0,0,686,2,83,0,83,0,0,83,83,0,0,0,1,1,362,463,362,463,1,1889,1889
1627,0,5.0.0,0,689,3,83,0,83,0,0,83,83,0,0,0,1,1,294,463,294,463,1,1889,1889
1627,1,0.0.50,0,666,1,84,50,134,0,50,134,134,0,0,0,1,2,347,413,347,463,2,1889,1839
1627,1,1.1.50,1,664,0,25,50,75,50,0,75,75,-50,50,50,2,1,268,333,318,333,2,1889,1839
1627,1,2.0.50,0,721,4,96,50,146,0,50,146,146,0,0,0,1,2,325,413,325,463,2,1889,1839
1627,1,3.0.50,0,709,3,67,50,117,0,50,117,117,0,0,0,1,2,243,413,243,463,2,1889,1839
1627,1,4.0.50,0,664,0,83,50,133,0,50,133,133,0,0,0,1,2,362,413,362,463,2,1889,1839
1627,1,5.0.50,0,689,2,83,50,133,0,50,133,133,0,0,0,1,2,294,413,294,463,2,1889,1839
1627,2,0.0.50,0,666,1,84,50,134,0,50,134,134,0,0,50,1,2,347,413,347,463,3,1889,1814
1627,2,1.2.75,1,664,0,95,75,170,75,0,170,170,-75,75,125,3,1,243,366,318,366,3,1889,1814
1627,2,2.0.50,0,721,4,96,50,146,0,50,146,146,0,0,50,1,2,325,413,325,463,3,1889,1814
1627,2,3.0.50,0,709,3,67,50,117,0,50,117,117,0,0,50,1,2,243,413,243,463,3,1889,1814
1627,2,4.0.50,0,664,0,83,50,133,0,50,133,133,0,0,50,1,2,362,413,362,463,3,1889,1814
1627,2,5.0.50,0,689,2,83,50,133,0,50,133,133,0,0,50,1,2,294,413,294,463,3,1889,1814
1627,3,0.0.50,0,666,1,84,50,134,0,50,134,170,0,0,125,1,2,347,413,347,463,4,1889,1719
1627,3,1.3.170,1,664,0,51,170,221,170,0,221,221,-170,170,295,4,1,148,359,318,359,4,1889,1719
1627,3,2.0.50,0,721,4,96,50,146,0,50,146,170,0,0,125,1,2,325,413,325,463,4,1889,1719
1627,3,3.0.50,0,709,3,67,50,117,0,50,117,170,0,0,125,1,2,243,413,243,463,4,1889,1719
1627,3,4.0.50,0,664,0,83,50,133,0,50,133,170,0,0,125,1,2,362,413,362,463,4,1889,1719
1627,3,5.0.50,0,689,2,83,50,133,0,50,133,170,0,0,125,1,2,294,413,294,463,4,1889,1719
1627,4,0.0.50,0,666,1,84,50,134,0,50,134,221,0,0,295,1,2,347,413,347,463,5,1889,1668
1627,4,1.4.221,1,664,0,97,221,318,221,0,318,318,-221,221,516,5,1,97,368,318,368,5,1889,1668
1627,4,2.0.50,0,721,4,96,50,146,0,50,146,221,0,0,295,1,2,325,413,325,463,5,1889,1668
1627,4,3.0.50,0,709,3,67,50,117,0,50,117,221,0,0,295,1,2,243,413,243,463,5,1889,1668
1627,4,4.0.50,0,664,0,83,50,133,0,50,133,221,0,0,295,1,2,362,413,362,463,5,1889,1668
1627,4,5.0.50,0,689,2,83,50,133,0,50,133,221,0,0,295,1,2,294,413,294,463,5,1889,1668
1627,5,0.0.50,0,666,1,84,50,134,0,50,134,318,0,0,516,1,2,347,413,347,463,6,1889,1571
1627,5,2.0.50,0,721,4,96,50,146,0,50,146,318,0,0,516,1,2,325,413,325,463,6,1889,1571
1627,5,3.0.50,0,709,3,67,50,117,0,50,117,318,0,0,516,1,2,243,413,243,463,6,1889,1571
1627,5,4.0.50,1,664,0,83,50,133,0,50,133,318,0,0,516,1,2,362,413,362,463,6,1889,1571
1627,5,5.0.50,0,689,2,83,50,133,0,50,133,318,0,0,516,1,2,294,413,294,463,6,1889,1571
1627,6,0.0.133,0,664,0,84,133,217,0,133,217,318,0,0,516,1,3,347,330,347,463,7,1889,1488
1627,6,2.0.133,0,672,1,96,133,229,0,133,229,318,0,0,516,1,3,325,330,325,463,7,1889,1488
1627,6,3.0.133,0,714,3,67,133,200,0,133,200,318,0,0,516,1,3,243,330,243,463,7,1889,1488
1627,6,4.1.133,1,664,0,81,133,214,133,0,214,318,-58,108,574,2,2,279,308,362,333,7,1889,1488
1627,6,5.0.133,0,689,2,83,133,216,0,133,216,318,0,0,516,1,3,294,330,294,463,7,1889,1488
1627,7,0.0.133,0,664,0,84,133,217,0,133,217,318,0,0,574,1,3,347,330,347,463,8,1889,1407
1627,7,2.0.133,0,672,1,96,133,229,0,133,229,318,0,0,574,1,3,325,330,325,463,8,1889,1407
1627,7,3.0.133,0,714,3,67,133,200,0,133,200,318,0,0,574,1,3,243,330,243,463,8,1889,1407
1627,7,4.2.214,1,672,1,99,214,313,214,0,313,318,-44,119,618,3,2,198,271,362,366,8,1889,1407
1627,7,5.0.133,0,689,2,83,133,216,0,133,216,318,0,0,574,1,3,294,330,294,463,8,1889,1407
1627,8,0.0.133,0,700,2,84,133,217,0,133,217,318,0,0,618,1,3,347,330,347,463,9,1889,1308
1627,8,2.0.133,0,672,0,96,133,229,0,133,229,318,0,0,618,1,3,325,330,325,463,9,1889,1308
1627,8,3.0.133,0,722,3,67,133,200,0,133,200,318,0,0,618,1,3,243,330,243,463,9,1889,1308
1627,8,4.3.313,1,672,0,85,313,398,313,0,398,398,-92,262,710,4,2,99,308,362,359,9,1889,1308
1627,8,5.0.133,0,694,1,83,133,216,0,133,216,318,0,0,618,1,3,294,330,294,463,9,1889,1308
1627,9,0.0.133,0,730,3,84,133,217,0,133,217,398,0,0,710,1,3,347,330,347,463,10,1889,1223
1627,9,2.0.133,0,672,0,96,133,229,0,133,229,398,0,0,710,1,3,325,330,325,463,10,1889,1223
1627,9,3.0.133,0,726,2,67,133,200,0,133,200,398,0,0,710,1,3,243,330,243,463,10,1889,1223
1627,9,4.4.398,1,672,0,14,398,412,398,0,412,412,-80,301,790,5,2,14,271,362,368,10,1889,1223
1627,9,5.0.133,0,698,1,83,133,216,0,133,216,398,0,0,710,1,3,294,330,294,463,10,1889,1223
1627,10,0.0.133,1,730,3,84,133,217,0,133,217,412,0,0,790,1,3,347,330,347,463,11,1889,1209
1627,10,2.0.133,0,672,0,96,133,229,0,133,229,412,0,0,790,1,3,325,330,325,463,11,1889,1209
1627,10,3.0.133,0,726,2,67,133,200,0,133,200,412,0,0,790,1,3,243,330,243,463,11,1889,1209
1627,10,5.0.133,0,698,1,83,133,216,0,133,216,412,0,0,790,1,3,294,330,294,463,11,1889,1209
1627,11,0.1.217,1,730,0,60,217,277,217,0,277,412,-3,111,793,2,3,263,227,347,333,12,1889,1125
1627,11,2.0.217,0,730,0,96,217,313,0,217,313,412,0,0,790,1,4,325,246,325,463,12,1889,1125
1627,11,3.0.217,0,752,2,67,217,284,0,217,284,412,0,0,790,1,4,243,246,243,463,12,1889,1125
1627,11,5.0.217,0,735,1,83,217,300,0,217,300,412,0,0,790,1,4,294,246,294,463,12,1889,1125
1627,12,0.2.313,1,730,0,19,313,332,277,36,332,412,0,119,793,3,3,203,172,347,366,13,1889,1065
1627,12,2.0.217,0,730,0,96,217,313,0,217,313,412,0,0,793,1,4,325,246,325,463,13,1889,1065
1627,12,3.0.217,0,752,2,67,217,284,0,217,284,412,0,0,793,1,4,243,246,243,463,13,1889,1065
1627,12,5.0.217,0,735,1,83,217,300,0,217,300,412,0,0,793,1,4,294,246,294,463,13,1889,1065
1627,13,0.3.398,1,752,2,97,398,495,332,66,495,495,0,262,793,4,3,184,223,347,359,14,1889,1046
1627,13,2.0.217,0,730,0,96,217,313,0,217,313,412,0,0,793,1,4,325,246,325,463,14,1889,1046
1627,13,3.0.217,0,752,2,67,217,284,0,217,284,412,0,0,793,1,4,243,246,243,463,14,1889,1046
1627,13,5.0.217,0,735,1,83,217,300,0,217,300,412,0,0,793,1,4,294,246,294,463,14,1889,1046
1627,14,0.4.495,0,752,0,87,495,582,495,0,582,582,-83,384,876,5,3,87,257,347,368,15,1889,949
1627,14,2.0.217,0,752,0,96,217,313,0,217,313,495,0,0,793,1,4,325,246,325,463,15,1889,949
1627,14,3.0.217,0,752,0,67,217,284,0,217,284,495,0,0,793,1,4,243,246,243,463,15,1889,949
1627,14,5.0.217,1,752,0,83,217,300,0,217,300,495,0,0,793,1,4,294,246,294,463,15,1889,949
1627,15,0.4.495,0,752,0,87,495,582,495,0,582,582,-83,384,876,5,3,87,257,347,368,16,1889,866
1627,15,2.0.300,1,752,0,96,300,396,0,300,396,495,0,0,793,1,5,325,163,325,463,16,1889,866
1627,15,3.0.300,0,752,0,67,300,367,0,300,367,495,0,0,793,1,5,243,163,243,463,16,1889,866
1627,15,5.1.300,0,752,0,59,300,359,300,0,359,495,-23,134,816,2,4,211,167,294,333,16,1889,866
1627,16,0.4.495,0,752,0,87,495,582,495,0,582,582,-83,384,876,5,3,87,257,347,368,17,1889,770
1627,16,2.1.396,0,752,0,78,396,474,396,0,474,495,-119,230,912,2,4,229,167,325,333,17,1889,770
1627,16,3.0.396,1,752,0,67,396,463,0,396,463,495,0,0,793,1,6,243,67,243,463,17,1889,770
1627,16,5.1.300,0,752,0,59,300,359,300,0,359,495,-23,134,816,2,4,211,167,294,333,17,1889,770
1627,17,0.4.495,0,752,0,87,495,582,495,0,582,582,-83,384,876,5,3,87,257,347,368,18,1889,703
1627,17,2.1.396,0,752,0,78,396,474,396,0,474,495,-119,230,912,2,4,229,167,325,333,18,1889,703
1627,17,3.1.463,0,752,0,30,463,493,463,0,493,495,-186,297,979,2,4,176,167,243,333,18,1889,703
1627,17,5.1.300,1,752,0,59,300,359,300,0,359,495,-23,134,816,2,4,211,167,294,333,18,1889,703
1627,18,0.4.495,0,752,0,87,495,582,495,0,582,582,-83,384,899,5,3,87,257,347,368,19,1889,644
1627,18,2.1.396,0,752,0,78,396,474,396,0,474,495,-37,171,853,2,5,229,108,325,333,19,1889,644
1627,18,3.1.463,0,752,0,30,463,493,463,0,493,495,-104,238,920,2,5,176,108,243,333,19,1889,644
1627,18,5.2.359,1,752,0,44,359,403,359,0,403,495,-27,146,843,3,4,152,153,294,366,19,1889,644
1627,19,0.4.495,0,752,0,87,495,582,495,0,582,582,-83,384,926,5,3,87,257,347,368,20,1889,600
1627,19,2.1.396,0,752,0,78,396,474,396,0,474,495,-37,171,880,2,5,229,108,325,333,20,1889,600
1627,19,3.1.463,0,752,0,30,463,493,463,0,493,495,-104,238,947,2,5,176,108,243,333,20,1889,600
1627,19,5.3.495,1,752,0,43,495,538,403,92,538,538,0,262,843,4,4,108,126,294,359,20,1889,600
1627,20,0.4.495,0,752,0,87,495,582,495,0,582,582,-83,384,926,5,3,87,257,347,368,21,1889,557
1627,20,2.1.396,1,752,0,78,396,474,396,0,474,538,-37,171,880,2,5,229,108,325,333,21,1889,557
1627,20,3.1.463,0,752,0,30,463,493,463,0,493,538,-104,238,947,2,5,176,108,243,333,21,1889,557
1627,20,5.4.538,0,795,1,65,538,603,538,0,603,603,-126,427,969,5,3,65,257,294,368,21,1889,557
1627,21,0.4.495,0,752,0,87,495,582,495,0,582,582,-83,384,963,5,3,87,257,347,368,22,1889,479
1627,21,2.2.474,0,752,0,65,474,539,474,0,539,539,-71,217,951,3,5,151,109,325,366,22,1889,479
1627,21,3.1.474,1,752,0,30,474,504,463,11,504,538,0,171,880,2,6,176,30,243,333,22,1889,479
1627,21,5.4.538,0,795,1,65,538,603,538,0,603,603,-126,427,1006,5,3,65,257,294,368,22,1889,479
1627,22,0.4.495,0,752,0,87,495,582,495,0,582,582,-83,384,963,5,3,87,257,347,368,23,1889,449
1627,22,2.2.474,1,752,0,65,474,539,474,0,539,539,-71,217,951,3,5,151,109,325,366,23,1889,449
1627,22,3.2.504,0,752,0,44,504,548,504,0,548,548,-101,247,981,3,5,146,109,243,366,23,1889,449
1627,22,5.4.538,0,795,1,65,538,603,538,0,603,603,-126,427,1006,5,3,65,257,294,368,23,1889,449
1627,23,0.4.495,0,752,0,87,495,582,495,0,582,582,-83,384,1034,5,3,87,257,347,368,24,1889,384
1627,23,2.3.539,1,752,0,3,539,542,539,0,542,542,-1,263,952,4,5,86,83,325,359,24,1889,384
1627,23,3.2.539,0,752,0,44,539,583,504,35,583,583,0,217,951,3,6,146,44,243,366,24,1889,384
1627,23,5.4.538,0,795,1,65,538,603,538,0,603,603,-126,427,1077,5,3,65,257,294,368,24,1889,384
1627,24,0.4.495,0,752,0,87,495,582,495,0,582,582,-83,384,1035,5,3,87,257,347,368,25,1889,381
1627,24,2.4.542,0,799,2,83,542,625,542,0,625,625,-130,431,1082,5,3,83,257,325,368,25,1889,381
1627,24,3.2.539,1,752,0,44,539,583,504,35,583,583,0,217,952,3,6,146,44,243,366,25,1889,381
1627,24,5.4.538,0,795,1,65,538,603,538,0,603,603,-126,427,1078,5,3,65,257,294,368,25,1889,381
1627,25,0.4.495,0,752,0,87,495,582,495,0,582,583,-83,384,1035,5,3,87,257,347,368,26,1889,337
1627,25,2.4.542,0,799,2,83,542,625,542,0,625,625,-130,431,1082,5,3,83,257,325,368,26,1889,337
1627,25,3.3.583,1,752,0,80,583,663,583,0,663,663,-41,304,993,4,6,102,80,243,359,26,1889,337
1627,25,5.4.538,0,795,1,65,538,603,538,0,603,603,-126,427,1078,5,3,65,257,294,368,26,1889,337
1627,26,0.4.495,1,752,0,87,495,582,495,0,582,663,-83,384,1076,5,3,87,257,347,368,27,1889,257
1627,26,2.4.542,0,799,3,83,542,625,542,0,625,663,-130,431,1123,5,3,83,257,325,368,27,1889,257
1627,26,3.4.663,0,768,1,22,663,685,663,0,685,685,-251,552,1244,5,3,22,257,243,368,27,1889,257
1627,26,5.4.538,0,795,2,65,538,603,538,0,603,663,-126,427,1119,5,3,65,257,294,368,27,1889,257
1627,27,2.4.582,0,752,0,83,582,665,542,40,665,665,0,384,1076,5,4,83,170,325,368,28,1889,170
1627,27,3.4.663,0,768,1,22,663,685,663,0,685,685,-81,465,1157,5,4,22,170,243,368,28,1889,170
1627,27,5.4.582,1,752,0,65,582,647,538,44,647,663,0,384,1076,5,4,65,170,294,368,28,1889,170
1627,28,2.4.647,1,752,0,83,647,730,542,105,730,730,0,384,1076,5,5,83,105,325,368,29,1889,105
1627,28,3.4.663,0,768,1,22,663,685,663,0,685,685,-16,400,1092,5,5,22,105,243,368,29,1889,105
1627,29,3.4.730,1,752,0,22,730,752,663,67,752,752,0,384,1076,5,6,22,22,243,368,30,1889,22
1628,0,0.0.0,0,536,5,97,0,97,0,0,97,97,0,0,0,1,1,192,280,192,280,1,1363,1363
1628,0,1.0.0,0,492,3,26,0,26,0,0,26,26,0,0,0,1,1,219,280,219,280,1,1363,1363
1628,0,2.0.0,0,483,2,42,0,42,0,0,42,42,0,0,0,1,1,252,280,252,280,1,1363,1363
1628,0,3.0.0,0,475,1,21,0,21,0,0,21,21,0,0,0,1,1,204,280,204,280,1,1363,1363
1628,0,4.0.0,1,466,0,6,0,6,0,0,6,6,0,0,0,1,1,201,280,201,280,1,1363,1363
1628,0,5.0.0,0,529,4,88,0,88,0,0,88,88,0,0,0,1,1,295,280,295,280,1,1363,1363
1628,1,0.0.6,0,520,4,97,6,103,0,6,103,103,0,0,0,1,2,192,274,192,280,2,1363,1357
1628,1,1.0.6,0,480,2,26,6,32,0,6,32,32,0,0,0,1,2,219,274,219,280,2,1363,1357
1628,1,2.0.6,0,475,1,42,6,48,0,6,48,48,0,0,0,1,2,252,274,252,280,2,1363,1357
1628,1,3.0.6,1,466,0,21,6,27,0,6,27,27,0,0,0,1,2,204,274,204,280,2,1363,1357
1628,1,4.1.6,0,466,0,33,6,39,6,0,39,39,-6,6,6,2,1,195,335,201,335,2,1363,1357
1628,1,5.0.6,0,496,3,88,6,94,0,6,94,94,0,0,0,1,2,295,274,295,280,2,1363,1357
1628,2,0.0.27,0,504,4,97,27,124,0,27,124,124,0,0,0,1,3,192,253,192,280,3,1363,1336
1628,2,1.0.27,1,471,1,26,27,53,0,27,53,53,0,0,0,1,3,219,253,219,280,3,1363,1336
1628,2,2.0.27,0,466,0,42,27,69,0,27,69,69,0,0,0,1,3,252,253,252,280,3,1363,1336
1628,2,3.1.27,0,475,3,68,27,95,27,0,95,95,-27,27,27,2,1,183,335,204,335,3,1363,1336
1628,2,4.1.6,0,466,0,33,6,39,6,0,39,39,-6,6,6,2,1,195,335,201,335,3,1363,1336
1628,2,5.0.27,0,474,2,88,27,115,0,27,115,115,0,0,0,1,3,295,253,295,280,3,1363,1336
1628,3,0.0.53,0,506,3,97,53,150,0,53,150,150,0,0,0,1,4,192,227,192,280,4,1363,1310
1628,3,1.1.53,0,507,4,93,53,146,53,0,146,146,-53,53,53,2,1,193,335,219,335,4,1363,1310
1628,3,2.0.53,1,471,0,42,53,95,0,53,95,95,0,0,0,1,4,252,227,252,280,4,1363,1310
1628,3,3.1.27,0,487,1,68,27,95,27,0,95,95,-27,27,27,2,1,183,335,204,335,4,1363,1310
1628,3,4.1.6,0,471,0,33,6,39,6,0,39,53,-6,6,6,2,1,195,335,201,335,4,1363,1310
1628,3,5.0.53,0,497,2,88,53,141,0,53,141,141,0,0,0,1,4,295,227,295,280,4,1363,1310
1628,4,0.0.95,0,506,3,97,95,192,0,95,192,192,0,0,0,1,5,192,185,192,280,5,1363,1268
1628,4,1.1.53,0,511,4,93,53,146,53,0,146,146,-53,53,53,2,1,193,335,219,335,5,1363,1268
1628,4,2.1.95,0,501,2,71,95,166,95,0,166,166,-95,95,95,2,1,210,335,252,335,5,1363,1268
1628,4,3.1.27,0,487,1,68,27,95,27,0,95,95,-27,27,27,2,1,183,335,204,335,5,1363,1268
1628,4,4.1.6,0,471,0,33,6,39,6,0,39,95,-6,6,6,2,1,195,335,201,335,5,1363,1268
1628,4,5.0.95,1,471,0,88,95,183,0,95,183,183,0,0,0,1,5,295,185,295,280,5,1363,1268
1628,5,0.0.183,1,471,0,97,183,280,0,183,280,280,0,0,0,1,6,192,97,192,280,6,1363,1180
1628,5,1.1.53,0,511,3,93,53,146,53,0,146,183,-53,53,53,2,1,193,335,219,335,6,1363,1180
1628,5,2.1.95,0,501,2,71,95,166,95,0,166,183,-95,95,95,2,1,210,335,252,335,6,1363,1180
1628,5,3.1.27,0,487,1,68,27,95,27,0,95,183,-27,27,27,2,1,183,335,204,335,6,1363,1180
1628,5,4.1.6,0,471,0,33,6,39,6,0,39,183,-6,6,6,2,1,195,335,201,335,6,1363,1180
1628,5,5.1.183,0,471,0,42,183,225,183,0,225,225,-183,183,183,2,1,207,335,295,335,6,1363,1180
1628,6,0.1.280,0,501,2,28,280,308,280,0,308,308,-280,280,280,2,1,95,335,192,335,7,1363,1083
1628,6,1.1.53,0,511,3,93,53,146,53,0,146,280,-53,53,53,2,1,193,335,219,335,7,1363,1083
1628,6,2.1.95,0,501,2,71,95,166,95,0,166,280,-95,95,95,2,1,210,335,252,335,7,1363,1083
1628,6,3.1.27,0,487,1,68,27,95,27,0,95,280,-27,27,27,2,1,183,335,204,335,7,1363,1083
1628,6,4.1.6,1,471,0,33,6,39,6,0,39,280,-6,6,6,2,1,195,335,201,335,7,1363,1083
1628,6,5.1.183,0,471,0,42,183,225,183,0,225,280,-183,183,183,2,1,207,335,295,335,7,1363,1083
1628,7,0.1.280,0,501,1,28,280,308,280,0,308,308,-241,247,247,2,2,95,302,192,335,8,1363,1050
1628,7,1.1.53,0,511,2,93,53,146,53,0,146,280,-14,20,20,2,2,193,302,219,335,8,1363,1050
1628,7,2.1.95,0,501,1,71,95,166,95,0,166,280,-56,62,62,2,2,210,302,252,335,8,1363,1050
1628,7,3.1.39,0,471,0,68,39,107,27,12,107,280,0,6,6,2,2,183,302,204,335,8,1363,1050
1628,7,4.2.39,1,471,0,1,39,40,39,0,40,280,-39,39,45,3,1,162,136,201,136,8,1363,1050
1628,7,5.1.183,0,471,0,42,183,225,183,0,225,280,-144,150,150,2,2,207,302,295,335,8,1363,1050
1628,8,0.1.280,0,501,1,28,280,308,280,0,308,308,-241,247,286,2,2,95,302,192,335,9,1363,1049
1628,8,1.1.53,0,511,2,93,53,146,53,0,146,280,-14,20,59,2,2,193,302,219,335,9,1363,1049
1628,8,2.1.95,0,501,1,71,95,166,95,0,166,280,-56,62,101,2,2,210,302,252,335,9,1363,1049
1628,8,3.1.39,0,471,0,68,39,107,27,12,107,280,0,6,45,2,2,183,302,204,335,9,1363,1049
1628,8,4.3.40,1,471,0,78,40,118,40,0,118,280,-40,40,85,4,1,161,312,201,312,9,1363,1049
1628,8,5.1.183,0,471,0,42,183,225,183,0,225,280,-144,150,189,2,2,207,302,295,335,9,1363,1049
1628,9,0.1.280,0,501,1,28,280,308,280,0,308,308,-241,247,326,2,2,95,302,192,335,10,1363,971
1628,9,1.1.53,0,511,2,93,53,146,53,0,146,280,-14,20,99,2,2,193,302,219,335,10,1363,971
1628,9,2.1.95,0,501,1,71,95,166,95,0,166,280,-56,62,141,2,2,210,302,252,335,10,1363,971
1628,9,3.1.39,0,471,0,68,39,107,27,12,107,280,0,6,85,2,2,183,302,204,335,10,1363,971
1628,9,4.4.118,1,471,0,83,118,201,118,0,201,280,-118,118,203,5,1,83,300,201,300,10,1363,971
1628,9,5.1.183,0,471,0,42,183,225,183,0,225,280,-144,150,229,2,2,207,302,295,335,10,1363,971
1628,10,0.1.280,0,501,1,28,280,308,280,0,308,308,-241,247,444,2,2,95,302,192,335,11,1363,888
1628,10,1.1.53,0,511,2,93,53,146,53,0,146,280,-14,20,217,2,2,193,302,219,335,11,1363,888
1628,10,2.1.95,0,501,1,71,95,166,95,0,166,280,-56,62,259,2,2,210,302,252,335,11,1363,888
1628,10,3.1.39,1,471,0,68,39,107,27,12,107,280,0,6,203,2,2,183,302,204,335,11,1363,888
1628,10,5.1.183,0,471,0,42,183,225,183,0,225,280,-144,150,347,2,2,207,302,295,335,11,1363,888
1628,11,0.1.280,0,501,2,28,280,308,280,0,308,308,-173,179,376,2,3,95,234,192,335,12,1363,820
1628,11,1.1.107,0,497,1,93,107,200,53,54,200,280,0,6,203,2,3,193,234,219,335,12,1363,820
1628,11,2.1.107,0,471,0,71,107,178,95,12,178,280,0,6,203,2,3,210,234,252,335,12,1363,820
1628,11,3.2.107,1,471,0,11,107,118,107,0,118,280,-67,106,270,3,2,115,135,204,136,12,1363,820
1628,11,5.1.183,0,471,0,42,183,225,183,0,225,280,-76,82,279,2,3,207,234,295,335,12,1363,820
1628,12,0.1.280,0,501,2,28,280,308,280,0,308,308,-173,179,443,2,3,95,234,192,335,13,1363,809
1628,12,1.1.107,0,497,1,93,107,200,53,54,200,280,0,6,270,2,3,193,234,219,335,13,1363,809
1628,12,2.1.107,0,471,0,71,107,178,95,12,178,280,0,6,270,2,3,210,234,252,335,13,1363,809
1628,12,3.3.118,1,471,0,40,118,158,118,0,158,280,0,40,270,4,2,104,234,204,312,13,1363,809
1628,12,5.1.183,0,471,0,42,183,225,183,0,225,280,-76,82,346,2,3,207,234,295,335,13,1363,809
1628,13,0.1.280,0,501,2,28,280,308,280,0,308,308,-173,179,443,2,3,95,234,192,335,14,1363,769
1628,13,1.1.107,0,497,1,93,107,200,53,54,200,280,0,6,270,2,3,193,234,219,335,14,1363,769
1628,13,2.1.107,0,471,0,71,107,178,95,12,178,280,0,6,270,2,3,210,234,252,335,14,1363,769
1628,13,3.4.201,1,471,0,64,201,265,158,43,265,280,0,118,270,5,2,64,217,204,300,14,1363,769
1628,13,5.1.183,0,471,0,42,183,225,183,0,225,280,-76,82,346,2,3,207,234,295,335,14,1363,769
1628,14,0.1.280,0,501,2,28,280,308,280,0,308,308,-173,179,443,2,3,95,234,192,335,15,1363,705
1628,14,1.1.107,0,497,1,93,107,200,53,54,200,280,0,6,270,2,3,193,234,219,335,15,1363,705
1628,14,2.1.107,1,471,0,71,107,178,95,12,178,280,0,6,270,2,3,210,234,252,335,15,1363,705
1628,14,5.1.183,0,471,0,42,183,225,183,0,225,280,-76,82,346,2,3,207,234,295,335,15,1363,705
1628,15,0.1.280,0,501,1,28,280,308,280,0,308,308,-102,108,372,2,4,95,163,192,335,16,1363,634
1628,15,1.1.178,0,515,2,93,178,271,53,125,271,280,0,6,270,2,4,193,163,219,335,16,1363,634
1628,15,2.2.178,1,471,0,19,178,197,178,0,197,280,-60,166,330,3,3,139,124,252,136,16,1363,634
1628,15,5.1.183,0,471,0,42,183,225,183,0,225,280,-5,11,275,2,4,207,163,295,335,16,1363,634
1628,16,0.1.280,0,501,1,28,280,308,280,0,308,308,-102,108,432,2,4,95,163,192,335,17,1363,615
1628,16,1.1.178,0,515,2,93,178,271,53,125,271,280,0,6,330,2,4,193,163,219,335,17,1363,615
1628,16,2.3.197,1,471,0,71,197,268,197,0,268,280,-39,79,369,4,3,120,194,252,312,17,1363,615
1628,16,5.1.183,0,471,0,42,183,225,183,0,225,280,-5,11,335,2,4,207,163,295,335,17,1363,615
1628,17,0.1.280,0,501,1,28,280,308,280,0,308,308,-102,108,471,2,4,95,163,192,335,18,1363,544
1628,17,1.1.178,0,515,2,93,178,271,53,125,271,280,0,6,369,2,4,193,163,219,335,18,1363,544
1628,17,2.4.268,1,471,0,49,268,317,268,0,317,317,-3,121,372,5,3,49,153,252,300,18,1363,544
1628,17,5.1.183,0,471,0,42,183,225,183,0,225,280,-5,11,374,2,4,207,163,295,335,18,1363,544
1628,18,0.1.280,0,501,1,28,280,308,280,0,308,317,-102,108,474,2,4,95,163,192,335,19,1363,495
1628,18,1.1.178,0,515,2,93,178,271,53,125,271,317,0,6,372,2,4,193,163,219,335,19,1363,495
1628,18,5.1.183,1,471,0,42,183,225,183,0,225,317,-5,11,377,2,4,207,163,295,335,19,1363,495
1628,19,0.1.280,0,501,1,28,280,308,280,0,308,317,-55,66,432,2,5,95,121,192,335,20,1363,453
1628,19,1.1.225,0,471,0,93,225,318,53,172,318,318,0,11,377,2,5,193,121,219,335,20,1363,453
1628,19,5.2.225,1,471,0,82,225,307,225,0,307,317,-28,194,405,3,4,165,105,295,136,20,1363,453
1628,20,0.1.280,0,501,1,28,280,308,280,0,308,317,-55,66,460,2,5,95,121,192,335,21,1363,371
1628,20,1.1.225,0,471,0,93,225,318,53,172,318,318,0,11,405,2,5,193,121,219,335,21,1363,371
1628,20,5.3.307,1,471,0,27,307,334,307,0,334,334,-39,118,444,4,4,83,123,295,312,21,1363,371
1628,21,0.1.280,0,501,1,28,280,308,280,0,308,334,-55,66,499,2,5,95,121,192,335,22,1363,344
1628,21,1.1.225,0,471,0,93,225,318,53,172,318,334,0,11,444,2,5,193,121,219,335,22,1363,344
1628,21,5.4.334,1,471,0,56,334,390,334,0,390,390,-17,138,461,5,4,56,104,295,300,22,1363,344
1628,22,0.1.280,0,501,1,28,280,308,280,0,308,390,-55,66,516,2,5,95,121,192,335,23,1363,288
1628,22,1.1.225,1,471,0,93,225,318,53,172,318,390,0,11,461,2,5,193,121,219,335,23,1363,288
1628,23,0.1.318,0,471,0,28,318,346,280,38,346,390,0,11,461,2,6,95,28,192,335,24,1363,195
1628,23,1.2.318,1,471,0,1,318,319,318,0,319,390,-11,205,472,3,5,100,23,219,136,24,1363,195
1628,24,0.1.318,0,471,0,28,318,346,280,38,346,390,0,11,472,2,6,95,28,192,335,25,1363,194
1628,24,1.3.334,1,474,1,92,334,426,319,15,426,426,0,118,472,4,5,99,96,219,312,25,1363,194
1628,25,0.1.318,0,474,0,28,318,346,280,38,346,426,0,11,472,2,6,95,28,192,335,26,1363,102
1628,25,1.4.426,1,474,0,7,426,433,426,0,433,433,-36,174,508,5,5,7,48,219,300,26,1363,102
1628,26,0.1.318,1,474,0,28,318,346,280,38,346,433,0,11,508,2,6,95,28,192,335,27,1363,95
1628,27,0.2.346,1,474,0,22,346,368,346,0,368,433,-27,232,535,3,6,67,22,192,136,28,1363,67
1628,28,0.3.426,1,474,0,4,426,430,368,58,430,433,0,118,535,4,6,45,4,192,312,29,1363,45
1628,29,0.4.433,1,474,0,41,433,474,430,3,474,474,0,174,535,5,6,41,41,192,300,30,1363,41
1629,0,0.0.0,1,475,2,11,0,11,0,0,11,11,0,0,0,1,1,236,293,236,293,1,1332,1332
1629,0,1.0.0,0,469,1,1,0,1,0,0,1,1,0,0,0,1,1,119,293,119,293,1,1332,1332
1629,0,2.0.0,0,548,5,88,0,88,0,0,88,88,0,0,0,1,1,278,293,278,293,1,1332,1332
1629,0,3.0.0,0,518,3,74,0,74,0,0,74,74,0,0,0,1,1,263,293,263,293,1,1332,1332
1629,0,4.0.0,0,468,0,27,0,27,0,0,27,27,0,0,0,1,1,237,293,237,293,1,1332,1332
1629,0,5.0.0,0,533,4,92,0,92,0,0,92,92,0,0,0,1,1,199,293,199,293,1,1332,1332
1629,1,0.1.11,0,475,0,95,11,106,11,0,106,106,-11,11,11,2,1,225,339,236,339,2,1332,1321
1629,1,1.0.11,0,475,0,1,11,12,0,11,12,12,0,0,0,1,2,119,282,119,293,2,1332,1321
1629,1,2.0.11,0,495,3,88,11,99,0,11,99,99,0,0,0,1,2,278,282,278,293,2,1332,1321
1629,1,3.0.11,0,476,1,74,11,85,0,11,85,85,0,0,0,1,2,263,282,263,293,2,1332,1321
1629,1,4.0.11,1,475,0,27,11,38,0,11,38,38,0,0,0,1,2,237,282,237,293,2,1332,1321
1629,1,5.0.11,0,489,2,92,11,103,0,11,103,103,0,0,0,1,2,199,282,199,293,2,1332,1321
1629,2,0.1.11,0,475,0,95,11,106,11,0,106,106,-11,11,11,2,1,225,339,236,339,3,1332,1294
1629,2,1.0.38,1,475,0,1,38,39,0,38,39,39,0,0,0,1,3,119,255,119,293,3,1332,1294
1629,2,2.0.38,0,484,2,88,38,126,0,38,126,126,0,0,0,1,3,278,255,278,293,3,1332,1294
1629,2,3.0.38,0,475,0,74,38,112,0,38,112,112,0,0,0,1,3,263,255,263,293,3,1332,1294
1629,2,4.1.38,0,479,1,85,38,123,38,0,123,123,-38,38,38,2,1,210,339,237,339,3,1332,1294
1629,2,5.0.38,0,488,3,92,38,130,0,38,130,130,0,0,0,1,3,199,255,199,293,3,1332,1294
1629,3,0.1.11,0,475,0,95,11,106,11,0,106,106,-11,11,11,2,1,225,339,236,339,4,1332,1293
1629,3,1.1.39,0,503,4,61,39,100,39,0,100,100,-39,39,39,2,1,118,339,119,339,4,1332,1293
1629,3,2.0.39,0,485,2,88,39,127,0,39,127,127,0,0,0,1,4,278,254,278,293,4,1332,1293
1629,3,3.0.39,1,475,0,74,39,113,0,39,113,113,0,0,0,1,4,263,254,263,293,4,1332,1293
1629,3,4.1.38,0,479,1,85,38,123,38,0,123,123,-38,38,38,2,1,210,339,237,339,4,1332,1293
1629,3,5.0.39,0,489,3,92,39,131,0,39,131,131,0,0,0,1,4,199,254,199,293,4,1332,1293
1629,4,0.1.11,0,475,0,95,11,106,11,0,106,113,-11,11,11,2,1,225,339,236,339,5,1332,1219
1629,4,1.1.39,0,503,4,61,39,100,39,0,100,113,-39,39,39,2,1,118,339,119,339,5,1332,1219
1629,4,2.0.113,1,475,0,88,113,201,0,113,201,201,0,0,0,1,5,278,180,278,293,5,1332,1219
1629,4,3.1.113,0,481,2,7,113,120,113,0,120,120,-113,113,113,2,1,189,339,263,339,5,1332,1219
1629,4,4.1.38,0,479,1,85,38,123,38,0,123,123,-38,38,38,2,1,210,339,237,339,5,1332,1219
1629,4,5.0.113,0,483,3,92,113,205,0,113,205,205,0,0,0,1,5,199,180,199,293,5,1332,1219
1629,5,0.1.11,0,475,0,95,11,106,11,0,106,201,-11,11,11,2,1,225,339,236,339,6,1332,1131
1629,5,1.1.39,0,509,3,61,39,100,39,0,100,201,-39,39,39,2,1,118,339,119,339,6,1332,1131
1629,5,2.1.201,0,475,0,65,201,266,201,0,266,266,-201,201,201,2,1,190,339,278,339,6,1332,1131
1629,5,3.1.113,0,481,2,7,113,120,113,0,120,201,-113,113,113,2,1,189,339,263,339,6,1332,1131
1629,5,4.1.38,0,479,1,85,38,123,38,0,123,201,-38,38,38,2,1,210,339,237,339,6,1332,1131
1629,5,5.0.201,1,475,0,92,201,293,0,201,293,293,0,0,0,1,6,199,92,199,293,6,1332,1131
1629,6,0.1.11,0,475,0,95,11,106,11,0,106,293,-11,11,11,2,1,225,339,236,339,7,1332,1039
1629,6,1.1.39,0,509,3,61,39,100,39,0,100,293,-39,39,39,2,1,118,339,119,339,7,1332,1039
1629,6,2.1.201,0,475,0,65,201,266,201,0,266,293,-201,201,201,2,1,190,339,278,339,7,1332,1039
1629,6,3.1.113,1,481,2,7,113,120,113,0,120,293,-113,113,113,2,1,189,339,263,339,7,1332,1039
1629,6,4.1.38,0,479,1,85,38,123,38,0,123,293,-38,38,38,2,1,210,339,237,339,7,1332,1039
1629,6,5.1.293,0,475,0,26,293,319,293,0,319,319,-293,293,293,2,1,107,339,199,339,7,1332,1039
1629,7,0.1.11,0,481,0,95,11,106,11,0,120,293,95,18,18,2,2,225,332,236,339,8,1332,1032
1629,7,1.1.39,0,516,2,61,39,100,39,0,120,293,61,52,52,2,2,118,332,119,339,8,1332,1032
1629,7,2.1.201,0,529,3,65,201,266,201,0,266,293,-81,194,194,2,2,190,332,278,339,8,1332,1032
1629,7,3.2.120,1,505,1,78,120,198,120,0,198,293,-120,120,233,3,1,182,203,263,203,8,1332,1032
1629,7,4.1.120,0,481,0,85,120,205,38,82,205,293,0,113,113,2,2,210,332,237,339,8,1332,1032
1629,7,5.1.293,0,481,0,26,293,319,293,0,319,319,-173,286,286,2,2,107,332,199,339,8,1332,1032
1629,8,0.1.11,0,505,0,95,11,106,11,0,120,293,95,18,138,2,2,225,332,236,339,9,1332,954
1629,8,1.1.39,0,516,1,61,39,100,39,0,120,293,61,52,172,2,2,118,332,119,339,9,1332,954
1629,8,2.1.201,0,529,2,65,201,266,201,0,266,293,-81,194,314,2,2,190,332,278,339,9,1332,954
1629,8,3.3.198,1,516,1,98,198,296,198,0,296,296,-198,198,431,4,1,104,267,263,267,9,1332,954
1629,8,4.1.120,0,505,0,85,120,205,38,82,205,293,0,113,233,2,2,210,332,237,339,9,1332,954
1629,8,5.1.293,0,505,0,26,293,319,293,0,319,319,-173,286,406,2,2,107,332,199,339,9,1332,954
1629,9,0.1.11,0,531,2,95,11,106,11,0,120,296,95,18,336,2,2,225,332,236,339,10,1332,856
1629,9,1.1.39,0,516,0,61,39,100,39,0,120,296,61,52,370,2,2,118,332,119,339,10,1332,856
1629,9,2.1.201,0,531,2,65,201,266,201,0,266,296,-81,194,512,2,2,190,332,278,339,10,1332,856
1629,9,3.4.296,1,516,0,6,296,302,296,0,302,302,-296,296,727,5,1,6,230,263,230,10,1332,856
1629,9,4.1.120,0,531,2,85,120,205,38,82,205,296,0,113,431,2,2,210,332,237,339,10,1332,856
1629,9,5.1.293,0,529,1,26,293,319,293,0,319,319,-173,286,604,2,2,107,332,199,339,10,1332,856
1629,10,0.1.11,1,531,2,95,11,106,11,0,120,302,95,18,632,2,2,225,332,236,339,11,1332,850
1629,10,1.1.39,0,516,0,61,39,100,39,0,120,302,61,52,666,2,2,118,332,119,339,11,1332,850
1629,10,2.1.201,0,531,2,65,201,266,201,0,266,302,-81,194,808,2,2,190,332,278,339,11,1332,850
1629,10,4.1.120,0,531,2,85,120,205,38,82,205,302,0,113,727,2,2,210,332,237,339,11,1332,850
1629,10,5.1.293,0,529,1,26,293,319,293,0,319,319,-173,286,900,2,2,107,332,199,339,11,1332,850
1629,11,0.2.198,1,531,0,26,198,224,106,92,224,302,0,120,632,3,2,130,125,236,203,12,1332,755
1629,11,1.1.120,0,531,0,61,120,181,39,81,181,302,0,18,632,2,3,118,237,119,339,12,1332,755
1629,11,2.1.201,0,531,0,65,201,266,201,0,266,302,-81,99,713,2,3,190,237,278,339,12,1332,755
1629,11,4.1.120,0,531,0,85,120,205,38,82,205,302,0,18,632,2,3,210,237,237,339,12,1332,755
1629,11,5.1.293,0,531,0,26,293,319,293,0,319,319,-173,191,805,2,3,107,237,199,339,12,1332,755
1629,12,0.3.296,1,531,0,11,296,307,224,72,307,307,0,198,632,4,2,104,169,236,267,13,1332,729
1629,12,1.1.120,0,531,0,61,120,181,39,81,181,302,0,18,632,2,3,118,237,119,339,13,1332,729
1629,12,2.1.201,0,531,0,65,201,266,201,0,266,302,-81,99,713,2,3,190,237,278,339,13,1332,729
1629,12,4.1.120,0,531,0,85,120,205,38,82,205,302,0,18,632,2,3,210,237,237,339,13,1332,729
1629,12,5.1.293,0,531,0,26,293,319,293,0,319,319,-173,191,805,2,3,107,237,199,339,13,1332,729
1629,13,0.4.307,1,531,0,93,307,400,307,0,400,400,-5,301,637,5,2,93,224,236,230,14,1332,718
1629,13,1.1.120,0,531,0,61,120,181,39,81,181,307,0,18,632,2,3,118,237,119,339,14,1332,718
1629,13,2.1.201,0,531,0,65,201,266,201,0,266,307,-81,99,713,2,3,190,237,278,339,14,1332,718
1629,13,4.1.120,0,531,0,85,120,205,38,82,205,307,0,18,632,2,3,210,237,237,339,14,1332,718
1629,13,5.1.293,0,531,0,26,293,319,293,0,319,319,-173,191,805,2,3,107,237,199,339,14,1332,718
1629,14,1.1.120,0,531,0,61,120,181,39,81,181,400,0,18,637,2,3,118,237,119,339,15,1332,625
1629,14,2.1.201,0,531,0,65,201,266,201,0,266,400,-81,99,718,2,3,190,237,278,339,15,1332,625
1629,14,4.1.120,1,531,0,85,120,205,38,82,205,400,0,18,637,2,3,210,237,237,339,15,1332,625
1629,14,5.1.293,0,531,0,26,293,319,293,0,319,400,-173,191,810,2,3,107,237,199,339,15,1332,625
1629,15,1.1.205,0,531,0,61,205,266,39,166,266,400,0,18,637,2,4,118,152,119,339,16,1332,540
1629,15,2.1.205,0,531,0,65,205,270,201,4,270,400,0,18,637,2,4,190,152,278,339,16,1332,540
1629,15,4.2.224,1,531,0,1,224,225,205,19,225,400,0,120,637,3,3,125,99,237,203,16,1332,540
1629,15,5.1.293,0,531,0,26,293,319,293,0,319,400,-88,106,725,2,4,107,152,199,339,16,1332,540
1629,16,1.1.205,0,531,0,61,205,266,39,166,266,400,0,18,637,2,4,118,152,119,339,17,1332,539
1629,16,2.1.205,0,531,0,65,205,270,201,4,270,400,0,18,637,2,4,190,152,278,339,17,1332,539
1629,16,4.3.307,1,531,0,71,307,378,225,82,378,400,0,198,637,4,3,124,158,237,267,17,1332,539
1629,16,5.1.293,0,531,0,26,293,319,293,0,319,400,-88,106,725,2,4,107,152,199,339,17,1332,539
1629,17,1.1.205,0,531,0,61,205,266,39,166,266,400,0,18,637,2,4,118,152,119,339,18,1332,468
1629,17,2.1.205,0,531,0,65,205,270,201,4,270,400,0,18,637,2,4,190,152,278,339,18,1332,468
1629,17,4.4.400,1,531,0,53,400,453,378,22,453,453,0,301,637,5,3,53,131,237,230,18,1332,468
1629,17,5.1.293,0,531,0,26,293,319,293,0,319,400,-88,106,725,2,4,107,152,199,339,18,1332,468
1629,18,1.1.205,1,531,0,61,205,266,39,166,266,453,0,18,637,2,4,118,152,119,339,19,1332,415
1629,18,2.1.205,0,531,0,65,205,270,201,4,270,453,0,18,637,2,4,190,152,278,339,19,1332,415
1629,18,5.1.293,0,531,0,26,293,319,293,0,319,453,-88,106,725,2,4,107,152,199,339,19,1332,415
1629,19,1.2.266,1,531,0,6,266,272,266,0,272,453,-41,161,678,3,4,57,98,119,203,20,1332,354
1629,19,2.1.266,0,531,0,65,266,331,201,65,331,453,0,18,637,2,5,190,91,278,339,20,1332,354
1629,19,5.1.293,0,531,0,26,293,319,293,0,319,453,-27,45,664,2,5,107,91,199,339,20,1332,354
1629,20,1.3.378,1,531,0,35,378,413,272,106,413,453,0,198,678,4,4,51,87,119,267,21,1332,348
1629,20,2.1.266,0,531,0,65,266,331,201,65,331,453,0,18,678,2,5,190,91,278,339,21,1332,348
1629,20,5.1.293,0,531,0,26,293,319,293,0,319,453,-27,45,705,2,5,107,91,199,339,21,1332,348
1629,21,1.4.453,1,531,0,16,453,469,413,40,469,469,0,301,678,5,4,16,78,119,230,22,1332,313
1629,21,2.1.266,0,531,0,65,266,331,201,65,331,453,0,18,678,2,5,190,91,278,339,22,1332,313
1629,21,5.1.293,0,531,0,26,293,319,293,0,319,453,-27,45,705,2,5,107,91,199,339,22,1332,313
1629,22,2.1.266,1,531,0,65,266,331,201,65,331,469,0,18,678,2,5,190,91,278,339,23,1332,297
1629,22,5.1.293,0,531,0,26,293,319,293,0,319,469,-27,45,705,2,5,107,91,199,339,23,1332,297
1629,23,2.2.331,0,531,0,71,331,402,331,0,402,469,-59,220,737,3,5,125,92,278,203,24,1332,232
1629,23,5.1.331,1,531,0,26,331,357,293,38,357,469,0,18,678,2,6,107,26,199,339,24,1332,232
1629,24,2.2.331,0,531,0,71,331,402,331,0,402,469,-59,220,737,3,5,125,92,278,203,25,1332,206
1629,24,5.2.357,1,531,0,21,357,378,357,0,378,469,-85,246,763,3,5,81,92,199,203,25,1332,206
1629,25,2.2.378,0,531,0,71,378,449,331,47,449,469,0,246,763,3,6,125,71,278,203,26,1332,185
1629,25,5.3.413,1,531,0,12,413,425,378,35,425,469,0,198,763,4,5,60,52,199,267,26,1332,185
1629,26,2.2.378,0,531,0,71,378,449,331,47,449,469,0,246,763,3,6,125,71,278,203,27,1332,173
1629,26,5.4.469,1,531,0,48,469,517,425,44,517,517,0,301,763,5,5,48,62,199,230,27,1332,173
1629,27,2.2.378,1,531,0,71,378,449,331,47,449,517,0,246,763,3,6,125,71,278,203,28,1332,125
1629,28,2.3.449,1,531,0,40,449,489,449,0,489,517,-24,222,787,4,6,54,40,278,267,29,1332,54
1629,29,2.4.517,1,531,0,14,517,531,489,28,531,531,0,301,787,5,6,14,14,278,230,30,1332,14
1630,0,0.0.0,0,504,2,24,0,24,0,0,24,24,0,0,0,1,1,180,308,180,308,1,1301,1301
1630,0,1.0.0,0,508,3,76,0,76,0,0,76,76,0,0,0,1,1,218,308,218,308,1,1301,1301
1630,0,2.0.0,0,493,1,34,0,34,0,0,34,34,0,0,0,1,1,205,308,205,308,1,1301,1301
1630,0,3.0.0,1,491,0,28,0,28,0,0,28,28,0,0,0,1,1,222,308,222,308,1,1301,1301
1630,0,4.0.0,0,491,0,49,0,49,0,0,49,49,0,0,0,1,1,176,308,176,308,1,1301,1301
1630,0,5.0.0,0,521,4,97,0,97,0,0,97,97,0,0,0,1,1,300,308,300,308,1,1301,1301
1630,1,0.0.28,0,493,1,24,28,52,0,28,52,52,0,0,0,1,2,180,280,180,308,2,1301,1273
1630,1,1.0.28,0,508,3,76,28,104,0,28,104,104,0,0,0,1,2,218,280,218,308,2,1301,1273
1630,1,2.0.28,0,491,0,34,28,62,0,28,62,62,0,0,0,1,2,205,280,205,308,2,1301,1273
1630,1,3.1.28,1,491,0,45,28,73,28,0,73,73,-28,28,28,2,1,194,241,222,241,2,1301,1273
1630,1,4.0.28,0,491,0,49,28,77,0,28,77,77,0,0,0,1,2,176,280,176,308,2,1301,1273
1630,1,5.0.28,0,502,2,97,28,125,0,28,125,125,0,0,0,1,2,300,280,300,308,2,1301,1273
1630,2,0.0.28,0,493,1,24,28,52,0,28,52,73,0,0,28,1,2,180,280,180,308,3,1301,1228
1630,2,1.0.28,0,508,3,76,28,104,0,28,104,104,0,0,28,1,2,218,280,218,308,3,1301,1228
1630,2,2.0.28,0,491,0,34,28,62,0,28,62,73,0,0,28,1,2,205,280,205,308,3,1301,1228
1630,2,3.2.73,1,491,0,45,73,118,73,0,118,118,-73,73,101,3,1,149,172,222,172,3,1301,1228
1630,2,4.0.28,0,491,0,49,28,77,0,28,77,77,0,0,28,1,2,176,280,176,308,3,1301,1228
1630,2,5.0.28,0,502,2,97,28,125,0,28,125,125,0,0,28,1,2,300,280,300,308,3,1301,1228
1630,3,0.0.28,0,493,1,24,28,52,0,28,52,118,0,0,101,1,2,180,280,180,308,4,1301,1183
1630,3,1.0.28,0,508,3,76,28,104,0,28,104,118,0,0,101,1,2,218,280,218,308,4,1301,1183
1630,3,2.0.28,0,491,0,34,28,62,0,28,62,118,0,0,101,1,2,205,280,205,308,4,1301,1183
1630,3,3.3.118,1,491,0,57,118,175,118,0,175,175,-118,118,219,4,1,104,320,222,320,4,1301,1183
1630,3,4.0.28,0,491,0,49,28,77,0,28,77,118,0,0,101,1,2,176,280,176,308,4,1301,1183
1630,3,5.0.28,0,502,2,97,28,125,0,28,125,125,0,0,101,1,2,300,280,300,308,4,1301,1183
1630,4,0.0.28,0,493,1,24,28,52,0,28,52,175,0,0,219,1,2,180,280,180,308,5,1301,1126
1630,4,1.0.28,0,508,3,76,28,104,0,28,104,175,0,0,219,1,2,218,280,218,308,5,1301,1126
1630,4,2.0.28,0,491,0,34,28,62,0,28,62,175,0,0,219,1,2,205,280,205,308,5,1301,1126
1630,4,3.4.175,1,491,0,47,175,222,175,0,222,222,-175,175,394,5,1,47,260,222,260,5,1301,1126
1630,4,4.0.28,0,491,0,49,28,77,0,28,77,175,0,0,219,1,2,176,280,176,308,5,1301,1126
1630,4,5.0.28,0,502,2,97,28,125,0,28,125,175,0,0,219,1,2,300,280,300,308,5,1301,1126
1630,5,0.0.28,1,493,1,24,28,52,0,28,52,222,0,0,394,1,2,180,280,180,308,6,1301,1079
1630,5,1.0.28,0,508,3,76,28,104,0,28,104,222,0,0,394,1,2,218,280,218,308,6,1301,1079
1630,5,2.0.28,0,491,0,34,28,62,0,28,62,222,0,0,394,1,2,205,280,205,308,6,1301,1079
1630,5,4.0.28,0,491,0,49,28,77,0,28,77,222,0,0,394,1,2,176,280,176,308,6,1301,1079
1630,5,5.0.28,0,502,2,97,28,125,0,28,125,222,0,0,394,1,2,300,280,300,308,6,1301,1079
1630,6,0.1.73,1,493,0,63,73,136,52,21,136,222,0,28,394,2,2,156,196,180,241,7,1301,1055
1630,6,1.0.52,0,511,2,76,52,128,0,52,128,222,0,0,394,1,3,218,256,218,308,7,1301,1055
1630,6,2.0.52,0,497,1,34,52,86,0,52,86,222,0,0,394,1,3,205,256,205,308,7,1301,1055
1630,6,4.0.52,0,497,1,49,52,101,0,52,101,222,0,0,394,1,3,176,256,176,308,7,1301,1055
1630,6,5.0.52,0,493,0,97,52,149,0,52,149,222,0,0,394,1,3,300,256,300,308,7,1301,1055
1630,7,0.2.136,1,493,0,29,136,165,136,0,165,222,-18,91,412,3,2,93,127,180,172,8,1301,992
1630,7,1.0.52,0,511,2,76,52,128,0,52,128,222,0,0,394,1,3,218,256,218,308,8,1301,992
1630,7,2.0.52,0,497,1,34,52,86,0,52,86,222,0,0,394,1,3,205,256,205,308,8,1301,992
1630,7,4.0.52,0,497,1,49,52,101,0,52,101,222,0,0,394,1,3,176,256,176,308,8,1301,992
1630,7,5.0.52,0,493,0,97,52,149,0,52,149,222,0,0,394,1,3,300,256,300,308,8,1301,992
1630,8,0.3.175,1,493,0,18,175,193,165,10,193,222,0,118,412,4,2,64,263,180,320,9,1301,963
1630,8,1.0.52,0,511,2,76,52,128,0,52,128,222,0,0,412,1,3,218,256,218,308,9,1301,963
1630,8,2.0.52,0,497,1,34,52,86,0,52,86,222,0,0,412,1,3,205,256,205,308,9,1301,963
1630,8,4.0.52,0,497,1,49,52,101,0,52,101,222,0,0,412,1,3,176,256,176,308,9,1301,963
1630,8,5.0.52,0,493,0,97,52,149,0,52,149,222,0,0,412,1,3,300,256,300,308,9,1301,963
1630,9,0.4.222,1,493,0,46,222,268,193,29,268,268,0,175,412,5,2,46,213,180,260,10,1301,945
1630,9,1.0.52,0,511,2,76,52,128,0,52,128,222,0,0,412,1,3,218,256,218,308,10,1301,945
1630,9,2.0.52,0,497,1,34,52,86,0,52,86,222,0,0,412,1,3,205,256,205,308,10,1301,945
1630,9,4.0.52,0,497,1,49,52,101,0,52,101,222,0,0,412,1,3,176,256,176,308,10,1301,945
1630,9,5.0.52,0,493,0,97,52,149,0,52,149,222,0,0,412,1,3,300,256,300,308,10,1301,945
1630,10,1.0.52,0,511,2,76,52,128,0,52,128,268,0,0,412,1,3,218,256,218,308,11,1301,899
1630,10,2.0.52,1,497,1,34,52,86,0,52,86,268,0,0,412,1,3,205,256,205,308,11,1301,899
1630,10,4.0.52,0,497,1,49,52,101,0,52,101,268,0,0,412,1,3,176,256,176,308,11,1301,899
1630,10,5.0.52,0,493,0,97,52,149,0,52,149,268,0,0,412,1,3,300,256,300,308,11,1301,899
1630,11,1.0.86,0,511,1,76,86,162,0,86,162,268,0,0,412,1,4,218,222,218,308,12,1301,865
1630,11,2.1.136,1,497,0,58,136,194,86,50,194,268,0,28,412,2,3,171,133,205,241,12,1301,865
1630,11,4.0.86,0,497,0,49,86,135,0,86,135,268,0,0,412,1,4,176,222,176,308,12,1301,865
1630,11,5.0.86,0,520,2,97,86,183,0,86,183,268,0,0,412,1,4,300,222,300,308,12,1301,865
1630,12,1.0.86,0,511,1,76,86,162,0,86,162,268,0,0,412,1,4,218,222,218,308,13,1301,807
1630,12,2.2.194,1,497,0,25,194,219,194,0,219,268,-29,120,441,3,3,113,98,205,172,13,1301,807
1630,12,4.0.86,0,497,0,49,86,135,0,86,135,268,0,0,412,1,4,176,222,176,308,13,1301,807
1630,12,5.0.86,0,531,2,97,86,183,0,86,183,268,0,0,412,1,4,300,222,300,308,13,1301,807
1630,13,1.0.86,0,511,1,76,86,162,0,86,162,268,0,0,441,1,4,218,222,218,308,14,1301,782
1630,13,2.3.219,1,497,0,9,219,228,219,0,228,268,-26,144,467,4,3,88,245,205,320,14,1301,782
1630,13,4.0.86,0,497,0,49,86,135,0,86,135,268,0,0,441,1,4,176,222,176,308,14,1301,782
1630,13,5.0.86,0,532,2,97,86,183,0,86,183,268,0,0,441,1,4,300,222,300,308,14,1301,782
1630,14,1.0.86,0,511,1,76,86,162,0,86,162,268,0,0,467,1,4,218,222,218,308,15,1301,773
1630,14,2.4.268,1,497,0,79,268,347,228,40,347,347,0,175,467,5,3,79,167,205,260,15,1301,773
1630,14,4.0.86,0,497,0,49,86,135,0,86,135,268,0,0,467,1,4,176,222,176,308,15,1301,773
1630,14,5.0.86,0,532,2,97,86,183,0,86,183,268,0,0,467,1,4,300,222,300,308,15,1301,773
1630,15,1.0.86,0,511,1,76,86,162,0,86,162,347,0,0,467,1,4,218,222,218,308,16,1301,694
1630,15,4.0.86,0,497,0,49,86,135,0,86,135,347,0,0,467,1,4,176,222,176,308,16,1301,694
1630,15,5.0.86,1,532,2,97,86,183,0,86,183,347,0,0,467,1,4,300,222,300,308,16,1301,694
1630,16,1.0.183,0,538,1,76,183,259,0,183,259,347,0,0,467,1,5,218,125,218,308,17,1301,597
1630,16,4.0.183,0,532,0,49,183,232,0,183,232,347,0,0,467,1,5,176,125,176,308,17,1301,597
1630,16,5.1.194,1,532,0,9,194,203,183,11,203,347,0,28,467,2,4,203,75,300,241,17,1301,597
1630,17,1.0.183,0,538,1,76,183,259,0,183,259,347,0,0,467,1,5,218,125,218,308,18,1301,588
1630,17,4.0.183,0,532,0,49,183,232,0,183,232,347,0,0,467,1,5,176,125,176,308,18,1301,588
1630,17,5.2.219,1,538,1,59,219,278,203,16,278,347,0,120,467,3,4,194,73,300,172,18,1301,588
1630,18,1.0.183,0,538,0,76,183,259,0,183,259,347,0,0,467,1,5,218,125,218,308,19,1301,529
1630,18,4.0.183,1,538,0,49,183,232,0,183,232,347,0,0,467,1,5,176,125,176,308,19,1301,529
1630,18,5.3.278,0,538,0,96,278,374,278,0,374,374,-50,194,517,4,4,135,236,300,320,19,1301,529
1630,19,1.0.232,1,538,0,76,232,308,0,232,308,347,0,0,467,1,6,218,76,218,308,20,1301,480
1630,19,4.1.232,0,538,0,37,232,269,232,0,269,347,-29,57,496,2,5,127,66,176,241,20,1301,480
1630,19,5.3.278,0,538,0,96,278,374,278,0,374,374,-50,194,517,4,4,135,236,300,320,20,1301,480
1630,20,1.1.308,0,538,0,29,308,337,308,0,337,347,-105,133,572,2,5,142,66,218,241,21,1301,404
1630,20,4.1.232,1,538,0,37,232,269,232,0,269,347,-29,57,496,2,5,127,66,176,241,21,1301,404
1630,20,5.3.278,0,538,0,96,278,374,278,0,374,374,-50,194,517,4,4,135,236,300,320,21,1301,404
1630,21,1.1.308,0,538,0,29,308,337,308,0,337,347,-39,96,535,2,6,142,29,218,241,22,1301,367
1630,21,4.2.278,1,538,0,2,278,280,269,9,280,347,0,120,496,3,5,90,14,176,172,22,1301,367
1630,21,5.3.278,0,538,0,96,278,374,278,0,374,374,-50,194,546,4,4,135,236,300,320,22,1301,367
1630,22,1.1.308,1,538,0,29,308,337,308,0,337,347,-39,96,535,2,6,142,29,218,241,23,1301,365
1630,22,4.3.280,0,541,1,64,280,344,280,0,344,347,-52,196,548,4,4,88,236,176,320,23,1301,365
1630,22,5.3.278,0,538,0,96,278,374,278,0,374,374,-50,194,546,4,4,135,236,300,320,23,1301,365
1630,23,1.2.337,1,538,0,12,337,349,337,0,349,349,-57,177,592,3,6,113,12,218,172,24,1301,336
1630,23,4.3.280,0,541,1,64,280,344,280,0,344,347,-52,196,587,4,4,88,236,176,320,24,1301,336
1630,23,5.3.278,0,538,0,96,278,374,278,0,374,374,-50,194,585,4,4,135,236,300,320,24,1301,336
1630,24,1.3.349,0,560,2,76,349,425,349,0,425,425,-121,265,713,4,4,101,236,218,320,25,1301,324
1630,24,4.3.280,0,541,1,64,280,344,280,0,344,349,-52,196,644,4,4,88,236,176,320,25,1301,324
1630,24,5.3.278,1,538,0,96,278,374,278,0,374,374,-50,194,642,4,4,135,236,300,320,25,1301,324
1630,25,1.3.374,0,538,0,76,374,450,349,25,450,450,0,194,642,4,5,101,140,218,320,26,1301,228
1630,25,4.3.374,0,539,1,64,374,438,280,94,438,438,0,194,642,4,5,88,140,176,320,26,1301,228
1630,25,5.4.374,1,538,0,39,374,413,374,0,413,413,-27,202,669,5,4,39,88,300,260,26,1301,228
1630,26,1.3.374,0,538,0,76,374,450,349,25,450,450,0,194,669,4,5,101,140,218,320,27,1301,189
1630,26,4.3.374,1,539,1,64,374,438,280,94,438,438,0,194,669,4,5,88,140,176,320,27,1301,189
1630,27,1.3.438,0,539,0,76,438,514,349,89,514,514,0,194,669,4,6,101,76,218,320,28,1301,125
1630,27,4.4.438,1,539,0,24,438,462,438,0,462,462,-25,227,694,5,5,24,49,176,260,28,1301,125
1630,28,1.3.438,1,539,0,76,438,514,349,89,514,514,0,194,694,4,6,101,76,218,320,29,1301,101
1630,29,1.4.514,1,539,0,25,514,539,514,0,539,539,-52,279,746,5,6,25,25,218,260,30,1301,25
1631,0,0.0.0,0,607,1,37,0,37,0,0,37,37,0,0,0,1,1,223,322,223,322,1,1664,1664
1631,0,1.0.0,0,635,3,52,0,52,0,0,52,52,0,0,0,1,1,217,322,217,322,1,1664,1664
1631,0,2.0.0,0,643,4,79,0,79,0,0,79,79,0,0,0,1,1,330,322,330,322,1,1664,1664
1631,0,3.0.0,0,652,5,80,0,80,0,0,80,80,0,0,0,1,1,279,322,279,322,1,1664,1664
1631,0,4.0.0,0,612,2,71,0,71,0,0,71,71,0,0,0,1,1,313,322,313,322,1,1664,1664
1631,0,5.0.0,1,583,0,3,0,3,0,0,3,3,0,0,0,1,1,302,322,302,322,1,1664,1664
1631,1,0.0.3,1,583,0,37,3,40,0,3,40,40,0,0,0,1,2,223,319,223,322,2,1664,1661
1631,1,1.0.3,0,605,2,52,3,55,0,3,55,55,0,0,0,1,2,217,319,217,322,2,1664,1661
1631,1,2.0.3,0,612,4,79,3,82,0,3,82,82,0,0,0,1,2,330,319,330,322,2,1664,1661
1631,1,3.0.3,0,607,3,80,3,83,0,3,83,83,0,0,0,1,2,279,319,279,322,2,1664,1661
1631,1,4.0.3,0,600,1,71,3,74,0,3,74,74,0,0,0,1,2,313,319,313,322,2,1664,1661
1631,1,5.1.3,0,583,0,91,3,94,3,0,94,94,-3,3,3,2,1,299,443,302,443,2,1664,1661
1631,2,0.1.40,0,610,4,32,40,72,40,0,72,72,-40,40,40,2,1,186,443,223,443,3,1664,1624
1631,2,1.0.40,0,605,2,52,40,92,0,40,92,92,0,0,0,1,3,217,282,217,322,3,1664,1624
1631,2,2.0.40,0,608,3,79,40,119,0,40,119,119,0,0,0,1,3,330,282,330,322,3,1664,1624
1631,2,3.0.40,0,593,1,80,40,120,0,40,120,120,0,0,0,1,3,279,282,279,322,3,1664,1624
1631,2,4.0.40,1,583,0,71,40,111,0,40,111,111,0,0,0,1,3,313,282,313,322,3,1664,1624
1631,2,5.1.3,0,583,0,91,3,94,3,0,94,94,-3,3,3,2,1,299,443,302,443,3,1664,1624
1631,3,0.1.40,0,610,3,32,40,72,40,0,72,111,-40,40,40,2,1,186,443,223,443,4,1664,1553
1631,3,1.0.111,0,600,2,52,111,163,0,111,163,163,0,0,0,1,4,217,211,217,322,4,1664,1553
1631,3,2.0.111,1,593,1,79,111,190,0,111,190,190,0,0,0,1,4,330,211,330,322,4,1664,1553
1631,3,3.0.111,0,583,0,80,111,191,0,111,191,191,0,0,0,1,4,279,211,279,322,4,1664,1553
1631,3,4.1.111,0,620,4,89,111,200,111,0,200,200,-111,111,111,2,1,242,443,313,443,4,1664,1553
1631,3,5.1.3,0,583,0,91,3,94,3,0,94,111,-3,3,3,2,1,299,443,302,443,4,1664,1553
1631,4,0.1.40,0,610,2,32,40,72,40,0,72,190,-40,40,40,2,1,186,443,223,443,5,1664,1474
1631,4,1.0.190,1,600,1,52,190,242,0,190,242,242,0,0,0,1,5,217,132,217,322,5,1664,1474
1631,4,2.1.190,0,642,4,52,190,242,190,0,242,242,-190,190,190,2,1,251,443,330,443,5,1664,1474
1631,4,3.0.190,0,593,0,80,190,270,0,190,270,270,0,0,0,1,5,279,132,279,322,5,1664,1474
1631,4,4.1.111,0,620,3,89,111,200,111,0,200,200,-111,111,111,2,1,242,443,313,443,5,1664,1474
1631,4,5.1.3,0,593,0,91,3,94,3,0,94,190,-3,3,3,2,1,299,443,302,443,5,1664,1474
1631,5,0.1.40,0,610,1,32,40,72,40,0,72,242,-40,40,40,2,1,186,443,223,443,6,1664,1422
1631,5,1.1.242,0,634,3,96,242,338,242,0,338,338,-242,242,242,2,1,165,443,217,443,6,1664,1422
1631,5,2.1.190,0,651,4,52,190,242,190,0,242,242,-190,190,190,2,1,251,443,330,443,6,1664,1422
1631,5,3.0.242,1,600,0,80,242,322,0,242,322,322,0,0,0,1,6,279,80,279,322,6,1664,1422
1631,5,4.1.111,0,620,2,89,111,200,111,0,200,242,-111,111,111,2,1,242,443,313,443,6,1664,1422
1631,5,5.1.3,0,600,0,91,3,94,3,0,94,242,-3,3,3,2,1,299,443,302,443,6,1664,1422
1631,6,0.1.40,0,610,1,32,40,72,40,0,72,322,-40,40,40,2,1,186,443,223,443,7,1664,1342
1631,6,1.1.242,0,634,3,96,242,338,242,0,338,338,-242,242,242,2,1,165,443,217,443,7,1664,1342
1631,6,2.1.190,0,651,4,52,190,242,190,0,242,322,-190,190,190,2,1,251,443,330,443,7,1664,1342
1631,6,3.1.322,0,600,0,83,322,405,322,0,405,405,-322,322,322,2,1,199,443,279,443,7,1664,1342
1631,6,4.1.111,0,620,2,89,111,200,111,0,200,322,-111,111,111,2,1,242,443,313,443,7,1664,1342
1631,6,5.1.3,1,600,0,91,3,94,3,0,94,322,-3,3,3,2,1,299,443,302,443,7,1664,1342
1631,7,0.1.94,0,600,0,32,94,126,40,54,126,322,0,3,3,2,2,186,352,223,443,8,1664,1251
1631,7,1.1.242,0,634,1,96,242,338,242,0,338,338,-148,151,151,2,2,165,352,217,443,8,1664,1251
1631,7,2.1.190,0,651,4,52,190,242,190,0,242,322,-96,99,99,2,2,251,352,330,443,8,1664,1251
1631,7,3.1.322,0,600,0,83,322,405,322,0,405,405,-228,231,231,2,2,199,352,279,443,8,1664,1251
1631,7,4.1.111,0,648,3,89,111,200,111,0,200,322,-17,20,20,2,2,242,352,313,443,8,1664,1251
1631,7,5.2.94,1,635,2,97,94,191,94,0,191,322,-94,94,97,3,1,208,238,302,238,8,1664,1251
1631,8,0.1.94,0,635,0,32,94,126,40,54,126,322,0,3,97,2,2,186,352,223,443,9,1664,1154
1631,8,1.1.242,0,635,0,96,242,338,242,0,338,338,-148,151,245,2,2,165,352,217,443,9,1664,1154
1631,8,2.1.190,0,651,2,52,190,242,190,0,242,322,-96,99,193,2,2,251,352,330,443,9,1664,1154
1631,8,3.1.322,0,635,0,83,322,405,322,0,405,405,-228,231,325,2,2,199,352,279,443,9,1664,1154
1631,8,4.1.111,0,648,1,89,111,200,111,0,200,322,-17,20,114,2,2,242,352,313,443,9,1664,1154
1631,8,5.3.191,1,660,3,81,191,272,191,0,272,322,-191,191,288,4,1,111,273,302,273,9,1664,1154
1631,9,0.1.94,0,660,0,32,94,126,40,54,126,322,0,3,288,2,2,186,352,223,443,10,1664,1073
1631,9,1.1.242,0,660,0,96,242,338,242,0,338,338,-148,151,436,2,2,165,352,217,443,10,1664,1073
1631,9,2.1.190,0,660,0,52,190,242,190,0,242,322,-96,99,384,2,2,251,352,330,443,10,1664,1073
1631,9,3.1.322,0,660,0,83,322,405,322,0,405,405,-228,231,516,2,2,199,352,279,443,10,1664,1073
1631,9,4.1.111,0,660,0,89,111,200,111,0,200,322,-17,20,305,2,2,242,352,313,443,10,1664,1073
1631,9,5.4.272,1,660,0,30,272,302,272,0,302,322,-272,272,560,5,1,30,388,302,388,10,1664,1073
1631,10,0.1.94,1,660,0,32,94,126,40,54,126,322,0,3,560,2,2,186,352,223,443,11,1664,1043
1631,10,1.1.242,0,660,0,96,242,338,242,0,338,338,-148,151,708,2,2,165,352,217,443,11,1664,1043
1631,10,2.1.190,0,660,0,52,190,242,190,0,242,322,-96,99,656,2,2,251,352,330,443,11,1664,1043
1631,10,3.1.322,0,660,0,83,322,405,322,0,405,405,-228,231,788,2,2,199,352,279,443,11,1664,1043
1631,10,4.1.111,0,660,0,89,111,200,111,0,200,322,-17,20,577,2,2,242,352,313,443,11,1664,1043
1631,11,0.2.191,1,660,0,32,191,223,126,65,223,322,0,94,560,3,2,154,141,223,238,12,1664,1011
1631,11,1.1.242,0,660,0,96,242,338,242,0,338,338,-116,119,676,2,3,165,320,217,443,12,1664,1011
1631,11,2.1.190,0,660,0,52,190,242,190,0,242,322,-64,67,624,2,3,251,320,330,443,12,1664,1011
1631,11,3.1.322,0,660,0,83,322,405,322,0,405,405,-196,199,756,2,3,199,320,279,443,12,1664,1011
1631,11,4.1.126,0,660,0,89,126,215,111,15,215,322,0,3,560,2,3,242,320,313,443,12,1664,1011
1631,12,0.3.272,1,660,0,24,272,296,223,49,296,322,0,191,560,4,2,122,192,223,273,13,1664,979
1631,12,1.1.242,0,660,0,96,242,338,242,0,338,338,-116,119,676,2,3,165,320,217,443,13,1664,979
1631,12,2.1.190,0,660,0,52,190,242,190,0,242,322,-64,67,624,2,3,251,320,330,443,13,1664,979
1631,12,3.1.322,0,660,0,83,322,405,322,0,405,405,-196,199,756,2,3,199,320,279,443,13,1664,979
1631,12,4.1.126,0,660,0,89,126,215,111,15,215,322,0,3,560,2,3,242,320,313,443,13,1664,979
1631,13,0.4.302,0,660,0,98,302,400,296,6,400,400,0,272,560,5,2,98,358,223,388,14,1664,955
1631,13,1.1.242,0,660,0,96,242,338,242,0,338,338,-116,119,676,2,3,165,320,217,443,14,1664,955
1631,13,2.1.190,0,660,0,52,190,242,190,0,242,322,-64,67,624,2,3,251,320,330,443,14,1664,955
1631,13,3.1.322,0,660,0,83,322,405,322,0,405,405,-196,199,756,2,3,199,320,279,443,14,1664,955
1631,13,4.1.126,1,660,0,89,126,215,111,15,215,322,0,3,560,2,3,242,320,313,443,14,1664,955
1631,14,0.4.302,0,660,0,98,302,400,296,6,400,400,0,272,560,5,2,98,358,223,388,15,1664,866
1631,14,1.1.242,0,660,0,96,242,338,242,0,338,338,-27,30,587,2,4,165,231,217,443,15,1664,866
1631,14,2.1.215,0,660,0,52,215,267,190,25,267,322,0,3,560,2,4,251,231,330,443,15,1664,866
1631,14,3.1.322,0,660,0,83,322,405,322,0,405,405,-107,110,667,2,4,199,231,279,443,15,1664,866
1631,14,4.2.223,1,660,0,3,223,226,215,8,226,322,0,94,560,3,3,153,109,313,238,15,1664,866
1631,15,0.4.302,0,660,0,98,302,400,296,6,400,400,0,272,560,5,2,98,358,223,388,16,1664,863
1631,15,1.1.242,0,660,0,96,242,338,242,0,338,338,-27,30,587,2,4,165,231,217,443,16,1664,863
1631,15,2.1.215,0,660,0,52,215,267,190,25,267,322,0,3,560,2,4,251,231,330,443,16,1664,863
1631,15,3.1.322,0,660,0,83,322,405,322,0,405,405,-107,110,667,2,4,199,231,279,443,16,1664,863
1631,15,4.3.296,1,660,0,57,296,353,226,70,353,353,0,191,560,4,3,150,168,313,273,16,1664,863
1631,16,0.4.302,0,660,0,98,302,400,296,6,400,400,0,272,560,5,2,98,358,223,388,17,1664,806
1631,16,1.1.242,0,660,0,96,242,338,242,0,338,353,-27,30,587,2,4,165,231,217,443,17,1664,806
1631,16,2.1.215,1,660,0,52,215,267,190,25,267,353,0,3,560,2,4,251,231,330,443,17,1664,806
1631,16,3.1.322,0,660,0,83,322,405,322,0,405,405,-107,110,667,2,4,199,231,279,443,17,1664,806
1631,16,4.4.353,0,711,1,93,353,446,353,0,446,446,-51,323,611,5,2,93,358,313,388,17,1664,806
1631,17,0.4.302,0,660,0,98,302,400,296,6,400,400,0,272,560,5,2,98,358,223,388,18,1664,754
1631,17,1.1.267,0,660,0,96,267,363,242,25,363,363,0,3,560,2,5,165,179,217,443,18,1664,754
1631,17,2.2.267,1,660,0,77,267,344,267,0,344,353,-41,135,601,3,4,199,106,330,238,18,1664,754
1631,17,3.1.322,0,660,0,83,322,405,322,0,405,405,-55,58,615,2,5,199,179,279,443,18,1664,754
1631,17,4.4.353,0,711,1,93,353,446,353,0,446,446,-51,323,611,5,2,93,358,313,388,18,1664,754
1631,18,0.4.302,0,660,0,98,302,400,296,6,400,400,0,272,601,5,2,98,358,223,388,19,1664,677
1631,18,1.1.267,0,660,0,96,267,363,242,25,363,363,0,3,601,2,5,165,179,217,443,19,1664,677
1631,18,2.3.353,1,660,0,77,353,430,344,9,430,430,0,191,601,4,4,122,111,330,273,19,1664,677
1631,18,3.1.322,0,660,0,83,322,405,322,0,405,405,-55,58,656,2,5,199,179,279,443,19,1664,677
1631,18,4.4.353,0,711,1,93,353,446,353,0,446,446,-51,323,652,5,2,93,358,313,388,19,1664,677
1631,19,0.4.302,1,660,0,98,302,400,296,6,400,430,0,272,601,5,2,98,358,223,388,20,1664,600
1631,19,1.1.267,0,660,0,96,267,363,242,25,363,430,0,3,601,2,5,165,179,217,443,20,1664,600
1631,19,2.4.430,0,690,1,45,430,475,430,0,475,475,-128,400,729,5,2,45,358,330,388,20,1664,600
1631,19,3.1.322,0,660,0,83,322,405,322,0,405,430,-55,58,656,2,5,199,179,279,443,20,1664,600
1631,19,4.4.353,0,711,2,93,353,446,353,0,446,446,-51,323,652,5,2,93,358,313,388,20,1664,600
1631,20,1.1.267,0,660,0,96,267,363,242,25,363,430,0,3,601,2,5,165,179,217,443,21,1664,502
1631,20,2.4.430,1,690,1,45,430,475,430,0,475,475,-30,302,631,5,3,45,260,330,388,21,1664,502
1631,20,3.1.322,0,660,0,83,322,405,322,0,405,430,-55,58,656,2,5,199,179,279,443,21,1664,502
1631,20,4.4.400,0,660,0,93,400,493,353,47,493,493,0,272,601,5,3,93,260,313,388,21,1664,502
1631,21,1.1.267,0,690,0,96,267,363,242,25,363,475,0,3,631,2,5,165,179,217,443,22,1664,457
1631,21,3.1.322,0,690,0,83,322,405,322,0,405,475,-55,58,686,2,5,199,179,279,443,22,1664,457
1631,21,4.4.475,1,690,0,93,475,568,353,122,568,568,0,302,631,5,4,93,215,313,388,22,1664,457
1631,22,1.1.267,1,690,0,96,267,363,242,25,363,568,0,3,631,2,5,165,179,217,443,23,1664,364
1631,22,3.1.322,0,690,0,83,322,405,322,0,405,568,-55,58,686,2,5,199,179,279,443,23,1664,364
1631,23,1.2.363,1,690,0,17,363,380,363,0,380,568,-19,154,650,3,5,69,29,217,238,24,1664,268
1631,23,3.1.363,0,690,0,83,363,446,322,41,446,568,0,3,631,2,6,199,83,279,443,24,1664,268
1631,24,1.3.430,1,690,0,18,430,448,380,50,448,568,0,191,650,4,5,52,34,217,273,25,1664,251
1631,24,3.1.363,0,690,0,83,363,446,322,41,446,568,0,3,650,2,6,199,83,279,443,25,1664,251
1631,25,1.4.568,1,690,0,34,568,602,448,120,602,602,0,302,650,5,5,34,122,217,388,26,1664,233
1631,25,3.1.363,0,690,0,83,363,446,322,41,446,568,0,3,650,2,6,199,83,279,443,26,1664,233
1631,26,3.1.363,1,690,0,83,363,446,322,41,446,602,0,3,650,2,6,199,83,279,443,27,1664,199
1631,27,3.2.446,1,690,0,12,446,458,446,0,458,602,-66,220,716,3,6,116,12,279,238,28,1664,116
1631,28,3.3.458,1,690,0,16,458,474,458,0,474,602,-10,201,726,4,6,104,16,279,273,29,1664,104
1631,29,3.4.602,1,690,0,88,602,690,474,128,690,690,0,302,726,5,6,88,88,279,388,30,1664,88
1632,0,0.0.0,0,510,4,50,0,50,0,0,50,50,0,0,0,1,1,267,237,267,237,1,1339,1339
1632,0,1.0.0,0,477,2,28,0,28,0,0,28,28,0,0,0,1,1,219,237,219,237,1,1339,1339
1632,0,2.0.0,0,486,3,26,0,26,0,0,26,26,0,0,0,1,1,159,237,159,237,1,1339,1339
1632,0,3.0.0,0,476,1,34,0,34,0,0,34,34,0,0,0,1,1,240,237,240,237,1,1339,1339
1632,0,4.0.0,0,527,5,92,0,92,0,0,92,92,0,0,0,1,1,251,237,251,237,1,1339,1339
1632,0,5.0.0,1,460,0,7,0,7,0,0,7,7,0,0,0,1,1,203,237,203,237,1,1339,1339
1632,1,0.0.7,0,472,2,50,7,57,0,7,57,57,0,0,0,1,2,267,230,267,237,2,1339,1332
1632,1,1.0.7,0,460,0,28,7,35,0,7,35,35,0,0,0,1,2,219,230,219,237,2,1339,1332
1632,1,2.0.7,0,469,1,26,7,33,0,7,33,33,0,0,0,1,2,159,230,159,237,2,1339,1332
1632,1,3.0.7,1,460,0,34,7,41,0,7,41,41,0,0,0,1,2,240,230,240,237,2,1339,1332
1632,1,4.0.7,0,474,3,92,7,99,0,7,99,99,0,0,0,1,2,251,230,251,237,2,1339,1332
1632,1,5.1.7,0,460,0,74,7,81,7,0,81,81,-7,7,7,2,1,196,346,203,346,2,1339,1332
1632,2,0.0.41,0,472,1,50,41,91,0,41,91,91,0,0,0,1,3,267,196,267,237,3,1339,1298
1632,2,1.0.41,1,460,0,28,41,69,0,41,69,69,0,0,0,1,3,219,196,219,237,3,1339,1298
1632,2,2.0.41,0,472,1,26,41,67,0,41,67,67,0,0,0,1,3,159,196,159,237,3,1339,1298
1632,2,3.1.41,0,483,2,22,41,63,41,0,63,63,-41,41,41,2,1,206,346,240,346,3,1339,1298
1632,2,4.0.41,0,485,3,92,41,133,0,41,133,133,0,0,0,1,3,251,196,251,237,3,1339,1298
1632,2,5.1.7,0,460,0,74,7,81,7,0,81,81,-7,7,7,2,1,196,346,203,346,3,1339,1298
1632,3,0.0.69,1,472,2,50,69,119,0,69,119,119,0,0,0,1,4,267,168,267,237,4,1339,1270
1632,3,1.1.69,0,485,4,65,69,134,69,0,134,134,-69,69,69,2,1,191,346,219,346,4,1339,1270
1632,3,2.0.69,0,469,1,26,69,95,0,69,95,95,0,0,0,1,4,159,168,159,237,4,1339,1270
1632,3,3.1.41,0,483,3,22,41,63,41,0,63,69,-41,41,41,2,1,206,346,240,346,4,1339,1270
1632,3,4.0.69,0,460,0,92,69,161,0,69,161,161,0,0,0,1,4,251,168,251,237,4,1339,1270
1632,3,5.1.7,0,460,0,74,7,81,7,0,81,81,-7,7,7,2,1,196,346,203,346,4,1339,1270
1632,4,0.1.119,0,472,0,99,119,218,119,0,218,218,-119,119,119,2,1,217,346,267,346,5,1339,1220
1632,4,1.1.69,0,485,3,65,69,134,69,0,134,134,-69,69,69,2,1,191,346,219,346,5,1339,1220
1632,4,2.0.119,1,479,1,26,119,145,0,119,145,145,0,0,0,1,5,159,118,159,237,5,1339,1220
1632,4,3.1.41,0,483,2,22,41,63,41,0,63,119,-41,41,41,2,1,206,346,240,346,5,1339,1220
1632,4,4.0.119,0,472,0,92,119,211,0,119,211,211,0,0,0,1,5,251,118,251,237,5,1339,1220
1632,4,5.1.7,0,472,0,74,7,81,7,0,81,119,-7,7,7,2,1,196,346,203,346,5,1339,1220
1632,5,0.1.119,0,482,1,99,119,218,119,0,218,218,-119,119,119,2,1,217,346,267,346,6,1339,1194
1632,5,1.1.69,0,500,3,65,69,134,69,0,134,145,-69,69,69,2,1,191,346,219,346,6,1339,1194
1632,5,2.1.145,0,515,4,45,145,190,145,0,190,190,-145,145,145,2,1,133,346,159,346,6,1339,1194
1632,5,3.1.41,0,483,2,22,41,63,41,0,63,145,-41,41,41,2,1,206,346,240,346,6,1339,1194
1632,5,4.0.145,1,479,0,92,145,237,0,145,237,237,0,0,0,1,6,251,92,251,237,6,1339,1194
1632,5,5.1.7,0,479,0,74,7,81,7,0,81,145,-7,7,7,2,1,196,346,203,346,6,1339,1194
1632,6,0.1.119,0,482,1,99,119,218,119,0,218,237,-119,119,119,2,1,217,346,267,346,7,1339,1102
1632,6,1.1.69,0,500,3,65,69,134,69,0,134,237,-69,69,69,2,1,191,346,219,346,7,1339,1102
1632,6,2.1.145,0,515,4,45,145,190,145,0,190,237,-145,145,145,2,1,133,346,159,346,7,1339,1102
1632,6,3.1.41,1,483,2,22,41,63,41,0,63,237,-41,41,41,2,1,206,346,240,346,7,1339,1102
1632,6,4.1.237,0,482,1,41,237,278,237,0,278,278,-237,237,237,2,1,159,346,251,346,7,1339,1102
1632,6,5.1.7,0,479,0,74,7,81,7,0,81,237,-7,7,7,2,1,196,346,203,346,7,1339,1102
1632,7,0.1.119,0,556,3,99,119,218,119,0,218,237,-56,97,97,2,2,217,324,267,346,8,1339,1080
1632,7,1.1.69,0,500,1,65,69,134,69,0,134,237,-6,47,47,2,2,191,324,219,346,8,1339,1080
1632,7,2.1.145,0,520,2,45,145,190,145,0,190,237,-82,123,123,2,2,133,324,159,346,8,1339,1080
1632,7,3.2.63,1,483,0,79,63,142,63,0,142,237,-63,63,104,3,1,184,208,240,208,8,1339,1080
1632,7,4.1.237,0,483,0,41,237,278,237,0,278,278,-174,215,215,2,2,159,324,251,346,8,1339,1080
1632,7,5.1.63,0,483,0,74,63,137,7,56,137,237,0,41,41,2,2,196,324,203,346,8,1339,1080
1632,8,0.1.119,0,556,3,99,119,218,119,0,218,237,-56,97,160,2,2,217,324,267,346,9,1339,1001
1632,8,1.1.69,0,500,1,65,69,134,69,0,134,237,-6,47,110,2,2,191,324,219,346,9,1339,1001
1632,8,2.1.145,0,520,2,45,145,190,145,0,190,237,-82,123,186,2,2,133,324,159,346,9,1339,1001
1632,8,3.3.142,1,483,0,75,142,217,142,0,217,237,-142,142,246,4,1,105,327,240,327,9,1339,1001
1632,8,4.1.237,0,483,0,41,237,278,237,0,278,278,-174,215,278,2,2,159,324,251,346,9,1339,1001
1632,8,5.1.63,0,483,0,74,63,137,7,56,137,237,0,41,104,2,2,196,324,203,346,9,1339,1001
1632,9,0.1.119,0,556,3,99,119,218,119,0,218,237,-56,97,302,2,2,217,324,267,346,10,1339,926
1632,9,1.1.69,0,500,1,65,69,134,69,0,134,237,-6,47,252,2,2,191,324,219,346,10,1339,926
1632,9,2.1.145,0,520,2,45,145,190,145,0,190,237,-82,123,328,2,2,133,324,159,346,10,1339,926
1632,9,3.4.217,1,483,0,30,217,247,217,0,247,247,-217,217,463,5,1,30,221,240,221,10,1339,926
1632,9,4.1.237,0,483,0,41,237,278,237,0,278,278,-174,215,420,2,2,159,324,251,346,10,1339,926
1632,9,5.1.63,0,483,0,74,63,137,7,56,137,237,0,41,246,2,2,196,324,203,346,10,1339,926
1632,10,0.1.119,0,556,3,99,119,218,119,0,218,247,-56,97,519,2,2,217,324,267,346,11,1339,896
1632,10,1.1.69,0,500,1,65,69,134,69,0,134,247,-6,47,469,2,2,191,324,219,346,11,1339,896
1632,10,2.1.145,0,520,2,45,145,190,145,0,190,247,-82,123,545,2,2,133,324,159,346,11,1339,896
1632,10,4.1.237,0,483,0,41,237,278,237,0,278,278,-174,215,637,2,2,159,324,251,346,11,1339,896
1632,10,5.1.63,1,483,0,74,63,137,7,56,137,247,0,41,463,2,2,196,324,203,346,11,1339,896
1632,11,0.1.137,0,483,0,99,137,236,119,18,236,247,0,41,463,2,3,217,250,267,346,12,1339,822
1632,11,1.1.137,0,506,1,65,137,202,69,68,202,247,0,41,463,2,3,191,250,219,346,12,1339,822
1632,11,2.1.145,0,520,2,45,145,190,145,0,190,247,-8,49,471,2,3,133,250,159,346,12,1339,822
1632,11,4.1.237,0,483,0,41,237,278,237,0,278,278,-100,141,563,2,3,159,250,251,346,12,1339,822
1632,11,5.2.142,1,483,0,36,142,178,137,5,178,247,0,63,463,3,2,122,129,203,208,12,1339,822
1632,12,0.1.137,0,483,0,99,137,236,119,18,236,247,0,41,463,2,3,217,250,267,346,13,1339,786
1632,12,1.1.137,0,506,1,65,137,202,69,68,202,247,0,41,463,2,3,191,250,219,346,13,1339,786
1632,12,2.1.145,0,520,2,45,145,190,145,0,190,247,-8,49,471,2,3,133,250,159,346,13,1339,786
1632,12,4.1.237,0,483,0,41,237,278,237,0,278,278,-100,141,563,2,3,159,250,251,346,13,1339,786
1632,12,5.3.217,1,483,0,65,217,282,178,39,282,282,0,142,463,4,2,86,252,203,327,13,1339,786
1632,13,0.1.137,0,483,0,99,137,236,119,18,236,282,0,41,463,2,3,217,250,267,346,14,1339,721
1632,13,1.1.137,0,510,1,65,137,202,69,68,202,282,0,41,463,2,3,191,250,219,346,14,1339,721
1632,13,2.1.145,0,520,2,45,145,190,145,0,190,282,-8,49,471,2,3,133,250,159,346,14,1339,721
1632,13,4.1.237,0,483,0,41,237,278,237,0,278,282,-100,141,563,2,3,159,250,251,346,14,1339,721
1632,13,5.4.282,1,483,0,21,282,303,282,0,303,303,-35,252,498,5,2,21,191,203,221,14,1339,721
1632,14,0.1.137,0,483,0,99,137,236,119,18,236,303,0,41,498,2,3,217,250,267,346,15,1339,700
1632,14,1.1.137,1,510,1,65,137,202,69,68,202,303,0,41,498,2,3,191,250,219,346,15,1339,700
1632,14,2.1.145,0,520,2,45,145,190,145,0,190,303,-8,49,506,2,3,133,250,159,346,15,1339,700
1632,14,4.1.237,0,483,0,41,237,278,237,0,278,303,-100,141,598,2,3,159,250,251,346,15,1339,700
1632,15,0.1.202,0,512,1,99,202,301,119,83,301,303,0,41,498,2,4,217,185,267,346,16,1339,635
1632,15,1.2.202,1,510,0,22,202,224,202,0,224,303,-24,87,522,3,3,126,93,219,208,16,1339,635
1632,15,2.1.202,0,516,2,45,202,247,145,57,247,303,0,41,498,2,4,133,185,159,346,16,1339,635
1632,15,4.1.237,0,510,0,41,237,278,237,0,278,303,-35,76,533,2,4,159,185,251,346,16,1339,635
1632,16,0.1.202,0,512,1,99,202,301,119,83,301,303,0,41,522,2,4,217,185,267,346,17,1339,613
1632,16,1.3.282,1,512,1,60,282,342,224,58,342,342,0,142,522,4,3,104,187,219,327,17,1339,613
1632,16,2.1.202,0,516,2,45,202,247,145,57,247,303,0,41,522,2,4,133,185,159,346,17,1339,613
1632,16,4.1.237,0,510,0,41,237,278,237,0,278,303,-35,76,557,2,4,159,185,251,346,17,1339,613
1632,17,0.1.202,0,512,0,99,202,301,119,83,301,342,0,41,522,2,4,217,185,267,346,18,1339,553
1632,17,1.4.342,1,512,0,44,342,386,342,0,386,386,-39,291,561,5,3,44,170,219,221,18,1339,553
1632,17,2.1.202,0,518,1,45,202,247,145,57,247,342,0,41,522,2,4,133,185,159,346,18,1339,553
1632,17,4.1.237,0,518,1,41,237,278,237,0,278,342,-35,76,557,2,4,159,185,251,346,18,1339,553
1632,18,0.1.202,0,512,0,99,202,301,119,83,301,386,0,41,561,2,4,217,185,267,346,19,1339,509
1632,18,2.1.202,1,518,1,45,202,247,145,57,247,386,0,41,561,2,4,133,185,159,346,19,1339,509
1632,18,4.1.237,0,518,1,41,237,278,237,0,278,386,-35,76,596,2,4,159,185,251,346,19,1339,509
1632,19,0.1.247,0,534,1,99,247,346,119,128,346,386,0,41,561,2,5,217,140,267,346,20,1339,464
1632,19,2.2.247,1,518,0,31,247,278,247,0,278,386,-23,110,584,3,4,88,71,159,208,20,1339,464
1632,19,4.1.247,0,518,0,41,247,288,237,10,288,386,0,41,561,2,5,159,140,251,346,20,1339,464
1632,20,0.1.247,0,534,1,99,247,346,119,128,346,386,0,41,584,2,5,217,140,267,346,21,1339,433
1632,20,2.3.342,1,534,1,46,342,388,278,64,388,388,0,142,584,4,4,57,127,159,327,21,1339,433
1632,20,4.1.247,0,518,0,41,247,288,237,10,288,386,0,41,584,2,5,159,140,251,346,21,1339,433
1632,21,0.1.247,0,534,0,99,247,346,119,128,346,388,0,41,584,2,5,217,140,267,346,22,1339,387
1632,21,2.4.388,1,534,0,11,388,399,388,0,399,399,-2,293,586,5,4,11,126,159,221,22,1339,387
1632,21,4.1.247,0,553,1,41,247,288,237,10,288,388,0,41,584,2,5,159,140,251,346,22,1339,387
1632,22,0.1.247,1,534,0,99,247,346,119,128,346,399,0,41,586,2,5,217,140,267,346,23,1339,376
1632,22,4.1.247,0,553,1,41,247,288,237,10,288,399,0,41,586,2,5,159,140,251,346,23,1339,376
1632,23,0.2.346,1,534,0,36,346,382,346,0,382,399,-68,178,654,3,5,118,40,267,208,24,1339,277
1632,23,4.1.346,0,534,0,41,346,387,237,109,387,399,0,41,586,2,6,159,41,251,346,24,1339,277
1632,24,0.3.388,1,534,0,31,388,419,382,6,419,419,0,142,654,4,5,82,81,267,327,25,1339,241
1632,24,4.1.346,0,534,0,41,346,387,237,109,387,399,0,41,654,2,6,159,41,251,346,25,1339,241
1632,25,0.4.419,1,534,0,51,419,470,419,0,470,470,-20,313,674,5,5,51,115,267,221,26,1339,210
1632,25,4.1.346,0,534,0,41,346,387,237,109,387,419,0,41,654,2,6,159,41,251,346,26,1339,210
1632,26,4.1.346,1,534,0,41,346,387,237,109,387,470,0,41,674,2,6,159,41,251,346,27,1339,159
1632,27,4.2.387,1,534,0,4,387,391,387,0,391,470,-5,183,679,3,6,118,4,251,208,28,1339,118
1632,28,4.3.419,1,534,0,50,419,469,391,28,469,470,0,142,679,4,6,114,50,251,327,29,1339,114
1632,29,4.4.470,1,534,0,64,470,534,469,1,534,534,0,313,679,5,6,64,64,251,221,30,1339,64
1633,0,0.0.0,0,514,4,63,0,63,0,0,63,63,0,0,0,1,1,210,252,210,252,1,1305,1305
1633,0,1.0.0,0,451,0,4,0,4,0,0,4,4,0,0,0,1,1,120,252,120,252,1,1305,1305
1633,0,2.0.0,0,500,3,71,0,71,0,0,71,71,0,0,0,1,1,283,252,283,252,1,1305,1305
1633,0,3.0.0,0,516,5,87,0,87,0,0,87,87,0,0,0,1,1,299,252,299,252,1,1305,1305
1633,0,4.0.0,0,466,2,15,0,15,0,0,15,15,0,0,0,1,1,188,252,188,252,1,1305,1305
1633,0,5.0.0,1,452,1,12,0,12,0,0,12,12,0,0,0,1,1,205,252,205,252,1,1305,1305
1633,1,0.0.12,0,492,4,63,12,75,0,12,75,75,0,0,0,1,2,210,240,210,252,2,1305,1293
1633,1,1.0.12,0,452,0,4,12,16,0,12,16,16,0,0,0,1,2,120,240,120,252,2,1305,1293
1633,1,2.0.12,0,466,2,71,12,83,0,12,83,83,0,0,0,1,2,283,240,283,252,2,1305,1293
1633,1,3.0.12,0,473,3,87,12,99,0,12,99,99,0,0,0,1,2,299,240,299,252,2,1305,1293
1633,1,4.0.12,1,454,1,15,12,27,0,12,27,27,0,0,0,1,2,188,240,188,252,2,1305,1293
1633,1,5.1.12,0,452,0,58,12,70,12,0,70,70,-12,12,12,2,1,193,349,205,349,2,1305,1293
1633,2,0.0.27,0,483,2,63,27,90,0,27,90,90,0,0,0,1,3,210,225,210,252,3,1305,1278
1633,2,1.0.27,1,454,0,4,27,31,0,27,31,31,0,0,0,1,3,120,225,120,252,3,1305,1278
1633,2,2.0.27,0,479,1,71,27,98,0,27,98,98,0,0,0,1,3,283,225,283,252,3,1305,1278
1633,2,3.0.27,0,483,2,87,27,114,0,27,114,114,0,0,0,1,3,299,225,299,252,3,1305,1278
1633,2,4.1.27,0,479,1,92,27,119,27,0,119,119,-27,27,27,2,1,173,349,188,349,3,1305,1278
1633,2,5.1.12,0,454,0,58,12,70,12,0,70,70,-12,12,12,2,1,193,349,205,349,3,1305,1278
1633,3,0.0.31,0,483,3,63,31,94,0,31,94,94,0,0,0,1,4,210,221,210,252,4,1305,1274
1633,3,1.1.31,0,467,1,33,31,64,31,0,64,64,-31,31,31,2,1,116,349,120,349,4,1305,1274
1633,3,2.0.31,1,454,0,71,31,102,0,31,102,102,0,0,0,1,4,283,221,283,252,4,1305,1274
1633,3,3.0.31,0,467,1,87,31,118,0,31,118,118,0,0,0,1,4,299,221,299,252,4,1305,1274
1633,3,4.1.27,0,479,2,92,27,119,27,0,119,119,-27,27,27,2,1,173,349,188,349,4,1305,1274
1633,3,5.1.12,0,454,0,58,12,70,12,0,70,70,-12,12,12,2,1,193,349,205,349,4,1305,1274
1633,4,0.0.102,0,468,1,63,102,165,0,102,165,165,0,0,0,1,5,210,150,210,252,5,1305,1203
1633,4,1.1.31,0,478,2,33,31,64,31,0,64,102,-31,31,31,2,1,116,349,120,349,5,1305,1203
1633,4,2.1.102,0,482,4,39,102,141,102,0,141,141,-102,102,102,2,1,212,349,283,349,5,1305,1203
1633,4,3.0.102,1,454,0,87,102,189,0,102,189,189,0,0,0,1,5,299,150,299,252,5,1305,1203
1633,4,4.1.27,0,479,3,92,27,119,27,0,119,119,-27,27,27,2,1,173,349,188,349,5,1305,1203
1633,4,5.1.12,0,454,0,58,12,70,12,0,70,102,-12,12,12,2,1,193,349,205,349,5,1305,1203
1633,5,0.0.189,1,454,0,63,189,252,0,189,252,252,0,0,0,1,6,210,63,210,252,6,1305,1116
1633,5,1.1.31,0,478,1,33,31,64,31,0,64,189,-31,31,31,2,1,116,349,120,349,6,1305,1116
1633,5,2.1.102,0,482,3,39,102,141,102,0,141,189,-102,102,102,2,1,212,349,283,349,6,1305,1116
1633,5,3.1.189,0,488,4,60,189,249,189,0,249,249,-189,189,189,2,1,212,349,299,349,6,1305,1116
1633,5,4.1.27,0,479,2,92,27,119,27,0,119,189,-27,27,27,2,1,173,349,188,349,6,1305,1116
1633,5,5.1.12,0,454,0,58,12,70,12,0,70,189,-12,12,12,2,1,193,349,205,349,6,1305,1116
1633,6,0.1.252,0,492,5,67,252,319,252,0,319,319,-252,252,252,2,1,147,349,210,349,7,1305,1053
1633,6,1.1.31,0,478,1,33,31,64,31,0,64,252,-31,31,31,2,1,116,349,120,349,7,1305,1053
1633,6,2.1.102,0,482,3,39,102,141,102,0,141,252,-102,102,102,2,1,212,349,283,349,7,1305,1053
1633,6,3.1.189,0,488,4,60,189,249,189,0,249,252,-189,189,189,2,1,212,349,299,349,7,1305,1053
1633,6,4.1.27,0,479,2,92,27,119,27,0,119,252,-27,27,27,2,1,173,349,188,349,7,1305,1053
1633,6,5.1.12,1,454,0,58,12,70,12,0,70,252,-12,12,12,2,1,193,349,205,349,7,1305,1053
1633,7,0.1.252,0,492,4,67,252,319,252,0,319,319,-182,194,194,2,2,147,291,210,349,8,1305,995
1633,7,1.1.70,0,454,0,33,70,103,31,39,103,252,0,12,12,2,2,116,291,120,349,8,1305,995
1633,7,2.1.102,0,482,1,39,102,141,102,0,141,252,-32,44,44,2,2,212,291,283,349,8,1305,995
1633,7,3.1.189,0,488,3,60,189,249,189,0,249,252,-119,131,131,2,2,212,291,299,349,8,1305,995
1633,7,4.1.70,0,483,2,92,70,162,27,43,162,252,0,12,12,2,2,173,291,188,349,8,1305,995
1633,7,5.2.70,1,454,0,73,70,143,70,0,143,252,-70,70,82,3,1,135,273,205,273,8,1305,995
1633,8,0.1.252,0,492,4,67,252,319,252,0,319,319,-182,194,264,2,2,147,291,210,349,9,1305,922
1633,8,1.1.70,0,454,0,33,70,103,31,39,103,252,0,12,82,2,2,116,291,120,349,9,1305,922
1633,8,2.1.102,0,482,1,39,102,141,102,0,141,252,-32,44,114,2,2,212,291,283,349,9,1305,922
1633,8,3.1.189,0,488,3,60,189,249,189,0,249,252,-119,131,201,2,2,212,291,299,349,9,1305,922
1633,8,4.1.70,0,483,2,92,70,162,27,43,162,252,0,12,82,2,2,173,291,188,349,9,1305,922
1633,8,5.3.143,1,454,0,50,143,193,143,0,193,252,-143,143,225,4,1,62,181,205,181,9,1305,922
1633,9,0.1.252,0,492,4,67,252,319,252,0,319,319,-182,194,407,2,2,147,291,210,349,10,1305,872
1633,9,1.1.70,0,454,0,33,70,103,31,39,103,252,0,12,225,2,2,116,291,120,349,10,1305,872
1633,9,2.1.102,0,482,1,39,102,141,102,0,141,252,-32,44,257,2,2,212,291,283,349,10,1305,872
1633,9,3.1.189,0,488,3,60,189,249,189,0,249,252,-119,131,344,2,2,212,291,299,349,10,1305,872
1633,9,4.1.70,0,483,2,92,70,162,27,43,162,252,0,12,225,2,2,173,291,188,349,10,1305,872
1633,9,5.4.193,1,454,0,12,193,205,193,0,205,252,-193,193,418,5,1,12,250,205,250,10,1305,872
1633,10,0.1.252,0,492,4,67,252,319,252,0,319,319,-182,194,600,2,2,147,291,210,349,11,1305,860
1633,10,1.1.70,0,454,0,33,70,103,31,39,103,252,0,12,418,2,2,116,291,120,349,11,1305,860
1633,10,2.1.102,1,482,1,39,102,141,102,0,141,252,-32,44,450,2,2,212,291,283,349,11,1305,860
1633,10,3.1.189,0,488,3,60,189,249,189,0,249,252,-119,131,537,2,2,212,291,299,349,11,1305,860
1633,10,4.1.70,0,483,2,92,70,162,27,43,162,252,0,12,418,2,2,173,291,188,349,11,1305,860
1633,11,0.1.252,0,492,2,67,252,319,252,0,319,319,-111,155,561,2,3,147,252,210,349,12,1305,821
1633,11,1.1.141,0,482,0,33,141,174,31,110,174,252,0,44,450,2,3,116,252,120,349,12,1305,821
1633,11,2.2.143,1,482,0,83,143,226,141,2,226,252,0,70,450,3,2,173,200,283,273,12,1305,821
1633,11,3.1.189,0,488,1,60,189,249,189,0,249,252,-48,92,498,2,3,212,252,299,349,12,1305,821
1633,11,4.1.141,0,482,0,92,141,233,27,114,233,252,0,44,450,2,3,173,252,188,349,12,1305,821
1633,12,0.1.252,0,492,2,67,252,319,252,0,319,319,-111,155,561,2,3,147,252,210,349,13,1305,738
1633,12,1.1.141,0,482,0,33,141,174,31,110,174,252,0,44,450,2,3,116,252,120,349,13,1305,738
1633,12,2.3.226,1,482,0,15,226,241,226,0,241,252,-33,176,483,4,2,90,131,283,181,13,1305,738
1633,12,3.1.189,0,488,1,60,189,249,189,0,249,252,-48,92,498,2,3,212,252,299,349,13,1305,738
1633,12,4.1.141,0,482,0,92,141,233,27,114,233,252,0,44,450,2,3,173,252,188,349,13,1305,738
1633,13,0.1.252,0,492,2,67,252,319,252,0,319,319,-111,155,594,2,3,147,252,210,349,14,1305,723
1633,13,1.1.141,0,482,0,33,141,174,31,110,174,252,0,44,483,2,3,116,252,120,349,14,1305,723
1633,13,2.4.241,1,482,0,75,241,316,241,0,316,316,-36,229,519,5,2,75,238,283,250,14,1305,723
1633,13,3.1.189,0,488,1,60,189,249,189,0,249,252,-48,92,531,2,3,212,252,299,349,14,1305,723
1633,13,4.1.141,0,482,0,92,141,233,27,114,233,252,0,44,483,2,3,173,252,188,349,14,1305,723
1633,14,0.1.252,0,492,2,67,252,319,252,0,319,319,-111,155,630,2,3,147,252,210,349,15,1305,648
1633,14,1.1.141,1,482,0,33,141,174,31,110,174,316,0,44,519,2,3,116,252,120,349,15,1305,648
1633,14,3.1.189,0,488,1,60,189,249,189,0,249,316,-48,92,567,2,3,212,252,299,349,15,1305,648
1633,14,4.1.141,0,482,0,92,141,233,27,114,233,316,0,44,519,2,3,173,252,188,349,15,1305,648
1633,15,0.1.252,0,492,2,67,252,319,252,0,319,319,-78,122,597,2,4,147,219,210,349,16,1305,615
1633,15,1.2.226,1,482,0,28,226,254,174,52,254,316,0,70,519,3,3,83,117,120,273,16,1305,615
1633,15,3.1.189,0,488,1,60,189,249,189,0,249,316,-15,59,534,2,4,212,219,299,349,16,1305,615
1633,15,4.1.174,0,482,0,92,174,266,27,147,266,316,0,44,519,2,4,173,219,188,349,16,1305,615
1633,16,0.1.252,0,492,2,67,252,319,252,0,319,319,-78,122,597,2,4,147,219,210,349,17,1305,587
1633,16,1.3.254,1,482,0,2,254,256,254,0,256,316,-13,189,532,4,3,55,116,120,181,17,1305,587
1633,16,3.1.189,0,488,1,60,189,249,189,0,249,316,-15,59,534,2,4,212,219,299,349,17,1305,587
1633,16,4.1.174,0,482,0,92,174,266,27,147,266,316,0,44,519,2,4,173,219,188,349,17,1305,587
1633,17,0.1.252,0,492,2,67,252,319,252,0,319,319,-78,122,610,2,4,147,219,210,349,18,1305,585
1633,17,1.4.316,1,482,0,53,316,369,256,60,369,369,0,229,532,5,3,53,163,120,250,18,1305,585
1633,17,3.1.189,0,488,1,60,189,249,189,0,249,316,-15,59,547,2,4,212,219,299,349,18,1305,585
1633,17,4.1.174,0,482,0,92,174,266,27,147,266,316,0,44,532,2,4,173,219,188,349,18,1305,585
1633,18,0.1.252,0,492,2,67,252,319,252,0,319,369,-78,122,610,2,4,147,219,210,349,19,1305,532
1633,18,3.1.189,0,488,1,60,189,249,189,0,249,369,-15,59,547,2,4,212,219,299,349,19,1305,532
1633,18,4.1.174,1,482,0,92,174,266,27,147,266,369,0,44,532,2,4,173,219,188,349,19,1305,532
1633,19,0.1.266,0,545,1,67,266,333,252,14,333,369,0,44,532,2,5,147,127,210,349,20,1305,440
1633,19,3.1.266,0,482,0,60,266,326,189,77,326,369,0,44,532,2,5,212,127,299,349,20,1305,440
1633,19,4.2.266,1,482,0,4,266,270,266,0,270,369,-12,82,544,3,4,81,89,188,273,20,1305,440
1633,20,0.1.266,0,545,1,67,266,333,252,14,333,369,0,44,544,2,5,147,127,210,349,21,1305,436
1633,20,3.1.266,0,482,0,60,266,326,189,77,326,369,0,44,544,2,5,212,127,299,349,21,1305,436
1633,20,4.3.270,1,482,0,43,270,313,270,0,313,369,-14,203,558,4,4,77,114,188,181,21,1305,436
1633,21,0.1.266,0,545,1,67,266,333,252,14,333,369,0,44,558,2,5,147,127,210,349,22,1305,393
1633,21,3.1.266,0,482,0,60,266,326,189,77,326,369,0,44,558,2,5,212,127,299,349,22,1305,393
1633,21,4.4.369,1,482,0,34,369,403,313,56,403,403,0,229,558,5,4,34,110,188,250,22,1305,393
1633,22,0.1.266,0,545,1,67,266,333,252,14,333,403,0,44,558,2,5,147,127,210,349,23,1305,359
1633,22,3.1.266,1,482,0,60,266,326,189,77,326,403,0,44,558,2,5,212,127,299,349,23,1305,359
1633,23,0.1.326,0,482,0,67,326,393,252,74,393,403,0,44,558,2,6,147,67,210,349,24,1305,299
1633,23,3.2.326,1,482,0,46,326,372,326,0,372,403,-56,138,614,3,5,152,85,299,273,24,1305,299
1633,24,0.1.326,0,482,0,67,326,393,252,74,393,403,0,44,614,2,6,147,67,210,349,25,1305,253
1633,24,3.3.372,1,482,0,34,372,406,372,0,406,406,-59,262,673,4,5,106,71,299,181,25,1305,253
1633,25,0.1.326,0,482,0,67,326,393,252,74,393,406,0,44,673,2,6,147,67,210,349,26,1305,219
1633,25,3.4.406,1,482,0,72,406,478,406,0,478,478,-3,232,676,5,5,72,76,299,250,26,1305,219
1633,26,0.1.326,1,482,0,67,326,393,252,74,393,478,0,44,676,2,6,147,67,210,349,27,1305,147
1633,27,0.2.393,1,482,0,39,393,432,393,0,432,478,-21,159,697,3,6,80,39,210,273,28,1305,80
1633,28,0.3.432,1,482,0,37,432,469,432,0,469,478,-26,288,723,4,6,41,37,210,181,29,1305,41
1633,29,0.4.478,1,482,0,4,478,482,469,9,482,482,0,232,723,5,6,4,4,210,250,30,1305,4
1634,0,0.0.0,0,491,5,76,0,76,0,0,76,76,0,0,0,1,1,255,268,255,268,1,1179,1179
1634,0,1.0.0,0,461,2,79,0,79,0,0,79,79,0,0,0,1,1,218,268,218,268,1,1179,1179
1634,0,2.0.0,1,433,0,18,0,18,0,0,18,18,0,0,0,1,1,210,268,210,268,1,1179,1179
1634,0,3.0.0,0,464,3,41,0,41,0,0,41,41,0,0,0,1,1,259,268,259,268,1,1179,1179
1634,0,4.0.0,0,470,4,37,0,37,0,0,37,37,0,0,0,1,1,129,268,129,268,1,1179,1179
1634,0,5.0.0,0,450,1,17,0,17,0,0,17,17,0,0,0,1,1,108,268,108,268,1,1179,1179
1634,1,0.0.18,0,457,2,76,18,94,0,18,94,94,0,0,0,1,2,255,250,255,268,2,1179,1161
1634,1,1.0.18,0,461,3,79,18,97,0,18,97,97,0,0,0,1,2,218,250,218,268,2,1179,1161
1634,1,2.1.18,1,433,0,32,18,50,18,0,50,50,-18,18,18,2,1,192,252,210,252,2,1179,1161
1634,1,3.0.18,0,433,0,41,18,59,0,18,59,59,0,0,0,1,2,259,250,259,268,2,1179,1161
1634,1,4.0.18,0,469,4,37,18,55,0,18,55,55,0,0,0,1,2,129,250,129,268,2,1179,1161
1634,1,5.0.18,0,450,1,17,18,35,0,18,35,35,0,0,0,1,2,108,250,108,268,2,1179,1161
1634,2,0.0.18,0,457,2,76,18,94,0,18,94,94,0,0,18,1,2,255,250,255,268,3,1179,1129
1634,2,1.0.18,0,461,3,79,18,97,0,18,97,97,0,0,18,1,2,218,250,218,268,3,1179,1129
1634,2,2.2.50,1,433,0,36,50,86,50,0,86,86,-50,50,68,3,1,160,143,210,143,3,1179,1129
1634,2,3.0.18,0,433,0,41,18,59,0,18,59,59,0,0,18,1,2,259,250,259,268,3,1179,1129
1634,2,4.0.18,0,469,4,37,18,55,0,18,55,55,0,0,18,1,2,129,250,129,268,3,1179,1129
1634,2,5.0.18,0,450,1,17,18,35,0,18,35,50,0,0,18,1,2,108,250,108,268,3,1179,1129
1634,3,0.0.18,0,457,2,76,18,94,0,18,94,94,0,0,68,1,2,255,250,255,268,4,1179,1093
1634,3,1.0.18,0,461,3,79,18,97,0,18,97,97,0,0,68,1,2,218,250,218,268,4,1179,1093
1634,3,2.3.86,1,433,0,83,86,169,86,0,169,169,-86,86,154,4,1,124,334,210,334,4,1179,1093
1634,3,3.0.18,0,433,0,41,18,59,0,18,59,86,0,0,68,1,2,259,250,259,268,4,1179,1093
1634,3,4.0.18,0,469,4,37,18,55,0,18,55,86,0,0,68,1,2,129,250,129,268,4,1179,1093
1634,3,5.0.18,0,450,1,17,18,35,0,18,35,86,0,0,68,1,2,108,250,108,268,4,1179,1093
1634,4,0.0.18,0,457,2,76,18,94,0,18,94,169,0,0,154,1,2,255,250,255,268,5,1179,1010
1634,4,1.0.18,0,461,3,79,18,97,0,18,97,169,0,0,154,1,2,218,250,218,268,5,1179,1010
1634,4,2.4.169,1,433,0,41,169,210,169,0,210,210,-169,169,323,5,1,41,182,210,182,5,1179,1010
1634,4,3.0.18,0,433,0,41,18,59,0,18,59,169,0,0,154,1,2,259,250,259,268,5,1179,1010
1634,4,4.0.18,0,469,4,37,18,55,0,18,55,169,0,0,154,1,2,129,250,129,268,5,1179,1010
1634,4,5.0.18,0,450,1,17,18,35,0,18,35,169,0,0,154,1,2,108,250,108,268,5,1179,1010
1634,5,0.0.18,0,457,2,76,18,94,0,18,94,210,0,0,323,1,2,255,250,255,268,6,1179,969
1634,5,1.0.18,0,461,3,79,18,97,0,18,97,210,0,0,323,1,2,218,250,218,268,6,1179,969
1634,5,3.0.18,1,433,0,41,18,59,0,18,59,210,0,0,323,1,2,259,250,259,268,6,1179,969
1634,5,4.0.18,0,469,4,37,18,55,0,18,55,210,0,0,323,1,2,129,250,129,268,6,1179,969
1634,5,5.0.18,0,450,1,17,18,35,0,18,35,210,0,0,323,1,2,108,250,108,268,6,1179,969
1634,6,0.0.59,0,433,0,76,59,135,0,59,135,210,0,0,323,1,3,255,209,255,268,7,1179,928
1634,6,1.0.59,0,433,0,79,59,138,0,59,138,210,0,0,323,1,3,218,209,218,268,7,1179,928
1634,6,3.1.59,1,433,0,98,59,157,59,0,157,210,-9,27,332,2,2,218,220,259,252,7,1179,928
1634,6,4.0.59,0,434,1,37,59,96,0,59,96,210,0,0,323,1,3,129,209,129,268,7,1179,928
1634,6,5.0.59,0,433,0,17,59,76,0,59,76,210,0,0,323,1,3,108,209,108,268,7,1179,928
1634,7,0.0.59,0,433,0,76,59,135,0,59,135,210,0,0,332,1,3,255,209,255,268,8,1179,830
1634,7,1.0.59,0,433,0,79,59,138,0,59,138,210,0,0,332,1,3,218,209,218,268,8,1179,830
1634,7,3.2.157,1,433,0,14,157,171,157,0,171,210,-71,121,403,3,2,120,107,259,143,8,1179,830
1634,7,4.0.59,0,434,1,37,59,96,0,59,96,210,0,0,332,1,3,129,209,129,268,8,1179,830
1634,7,5.0.59,0,433,0,17,59,76,0,59,76,210,0,0,332,1,3,108,209,108,268,8,1179,830
1634,8,0.0.59,0,433,0,76,59,135,0,59,135,210,0,0,403,1,3,255,209,255,268,9,1179,816
1634,8,1.0.59,0,433,0,79,59,138,0,59,138,210,0,0,403,1,3,218,209,218,268,9,1179,816
1634,8,3.3.171,1,433,0,92,171,263,171,0,263,263,-2,88,405,4,2,106,251,259,334,9,1179,816
1634,8,4.0.59,0,434,1,37,59,96,0,59,96,210,0,0,403,1,3,129,209,129,268,9,1179,816
1634,8,5.0.59,0,433,0,17,59,76,0,59,76,210,0,0,403,1,3,108,209,108,268,9,1179,816
1634,9,0.0.59,0,433,0,76,59,135,0,59,135,263,0,0,405,1,3,255,209,255,268,10,1179,724
1634,9,1.0.59,0,433,0,79,59,138,0,59,138,263,0,0,405,1,3,218,209,218,268,10,1179,724
1634,9,3.4.263,1,433,0,14,263,277,263,0,277,277,-53,222,458,5,2,14,141,259,182,10,1179,724
1634,9,4.0.59,0,434,1,37,59,96,0,59,96,263,0,0,405,1,3,129,209,129,268,10,1179,724
1634,9,5.0.59,0,433,0,17,59,76,0,59,76,263,0,0,405,1,3,108,209,108,268,10,1179,724
1634,10,0.0.59,0,433,0,76,59,135,0,59,135,277,0,0,458,1,3,255,209,255,268,11,1179,710
1634,10,1.0.59,0,433,0,79,59,138,0,59,138,277,0,0,458,1,3,218,209,218,268,11,1179,710
1634,10,4.0.59,0,434,1,37,59,96,0,59,96,277,0,0,458,1,3,129,209,129,268,11,1179,710
1634,10,5.0.59,1,433,0,17,59,76,0,59,76,277,0,0,458,1,3,108,209,108,268,11,1179,710
1634,11,0.0.76,0,434,1,76,76,152,0,76,152,277,0,0,458,1,4,255,192,255,268,12,1179,693
1634,11,1.0.76,0,433,0,79,76,155,0,76,155,277,0,0,458,1,4,218,192,218,268,12,1179,693
1634,11,4.0.76,0,438,2,37,76,113,0,76,113,277,0,0,458,1,4,129,192,129,268,12,1179,693
1634,11,5.1.157,1,433,0,41,157,198,76,81,198,277,0,27,458,2,3,91,122,108,252,12,1179,693
1634,12,0.0.76,0,435,1,76,76,152,0,76,152,277,0,0,458,1,4,255,192,255,268,13,1179,652
1634,12,1.0.76,0,433,0,79,76,155,0,76,155,277,0,0,458,1,4,218,192,218,268,13,1179,652
1634,12,4.0.76,0,447,2,37,76,113,0,76,113,277,0,0,458,1,4,129,192,129,268,13,1179,652
1634,12,5.2.198,1,433,0,12,198,210,198,0,210,277,-27,148,485,3,3,50,93,108,143,13,1179,652
1634,13,0.0.76,0,435,1,76,76,152,0,76,152,277,0,0,485,1,4,255,192,255,268,14,1179,640
1634,13,1.0.76,0,433,0,79,76,155,0,76,155,277,0,0,485,1,4,218,192,218,268,14,1179,640
1634,13,4.0.76,0,447,2,37,76,113,0,76,113,277,0,0,485,1,4,129,192,129,268,14,1179,640
1634,13,5.3.263,1,465,3,35,263,298,210,53,298,298,0,88,485,4,3,38,159,108,334,14,1179,640
1634,14,0.0.76,0,465,0,76,76,152,0,76,152,298,0,0,485,1,4,255,192,255,268,15,1179,605
1634,14,1.0.76,0,465,0,79,76,155,0,76,155,298,0,0,485,1,4,218,192,218,268,15,1179,605
1634,14,4.0.76,0,465,0,37,76,113,0,76,113,298,0,0,485,1,4,129,192,129,268,15,1179,605
1634,14,5.4.298,1,465,0,3,298,301,298,0,301,301,-21,243,506,5,3,3,127,108,182,15,1179,605
1634,15,0.0.76,1,465,0,76,76,152,0,76,152,301,0,0,506,1,4,255,192,255,268,16,1179,602
1634,15,1.0.76,0,465,0,79,76,155,0,76,155,301,0,0,506,1,4,218,192,218,268,16,1179,602
1634,15,4.0.76,0,465,0,37,76,113,0,76,113,301,0,0,506,1,4,129,192,129,268,16,1179,602
1634,16,0.1.198,1,465,0,35,198,233,152,46,233,301,0,27,506,2,4,179,81,255,252,17,1179,526
1634,16,1.0.152,0,465,0,79,152,231,0,152,231,301,0,0,506,1,5,218,116,218,268,17,1179,526
1634,16,4.0.152,0,466,1,37,152,189,0,152,189,301,0,0,506,1,5,129,116,129,268,17,1179,526
1634,17,0.2.233,1,466,1,43,233,276,233,0,276,301,-23,171,529,3,4,144,81,255,143,18,1179,491
1634,17,1.0.152,0,465,0,79,152,231,0,152,231,301,0,0,506,1,5,218,116,218,268,18,1179,491
1634,17,4.0.152,0,466,1,37,152,189,0,152,189,301,0,0,506,1,5,129,116,129,268,18,1179,491
1634,18,0.3.298,1,466,0,44,298,342,276,22,342,342,0,88,529,4,4,101,124,255,334,19,1179,448
1634,18,1.0.152,0,466,0,79,152,231,0,152,231,301,0,0,529,1,5,218,116,218,268,19,1179,448
1634,18,4.0.152,0,466,0,37,152,189,0,152,189,301,0,0,529,1,5,129,116,129,268,19,1179,448
1634,19,0.4.342,1,466,0,57,342,399,342,0,399,399,-41,284,570,5,4,57,124,255,182,20,1179,404
1634,19,1.0.152,0,466,0,79,152,231,0,152,231,342,0,0,529,1,5,218,116,218,268,20,1179,404
1634,19,4.0.152,0,466,0,37,152,189,0,152,189,342,0,0,529,1,5,129,116,129,268,20,1179,404
1634,20,1.0.152,0,466,0,79,152,231,0,152,231,399,0,0,570,1,5,218,116,218,268,21,1179,347
1634,20,4.0.152,1,466,0,37,152,189,0,152,189,399,0,0,570,1,5,129,116,129,268,21,1179,347
1634,21,1.0.189,1,466,0,79,189,268,0,189,268,399,0,0,570,1,6,218,79,218,268,22,1179,310
1634,21,4.1.233,0,466,0,45,233,278,189,44,278,399,0,27,570,2,5,92,46,129,252,22,1179,310
1634,22,1.1.268,1,466,0,1,268,269,268,0,269,399,-35,62,605,2,5,139,46,218,252,23,1179,231
1634,22,4.1.233,0,466,0,45,233,278,189,44,278,399,0,27,570,2,5,92,46,129,252,23,1179,231
1634,23,1.2.276,1,466,0,33,276,309,269,7,309,399,0,171,605,3,5,138,38,218,143,24,1179,230
1634,23,4.1.269,0,466,0,45,269,314,189,80,314,399,0,62,605,2,6,92,45,129,252,24,1179,230
1634,24,1.3.342,1,466,0,43,342,385,309,33,385,399,0,88,605,4,5,105,80,218,334,25,1179,197
1634,24,4.1.269,0,466,0,45,269,314,189,80,314,399,0,62,605,2,6,92,45,129,252,25,1179,197
1634,25,1.4.399,1,466,0,62,399,461,385,14,461,461,0,284,605,5,5,62,67,218,182,26,1179,154
1634,25,4.1.269,0,466,0,45,269,314,189,80,314,399,0,62,605,2,6,92,45,129,252,26,1179,154
1634,26,4.1.269,1,466,0,45,269,314,189,80,314,461,0,62,605,2,6,92,45,129,252,27,1179,92
1634,27,4.2.314,1,466,0,5,314,319,314,0,319,461,-5,176,610,3,6,47,5,129,143,28,1179,47
1634,28,4.3.385,1,466,0,37,385,422,319,66,422,461,0,88,610,4,6,42,37,129,334,29,1179,42
1634,29,4.4.461,1,466,0,5,461,466,422,39,466,466,0,284,610,5,6,5,5,129,182,30,1179,5
1635,0,0.0.0,0,585,4,89,0,89,0,0,89,89,0,0,0,1,1,199,378,199,378,1,1542,1542
1635,0,1.0.0,1,526,0,54,0,54,0,0,54,54,0,0,0,1,1,317,378,317,378,1,1542,1542
1635,0,2.0.0,0,547,1,63,0,63,0,0,63,63,0,0,0,1,1,237,378,237,378,1,1542,1542
1635,0,3.0.0,0,564,3,93,0,93,0,0,93,93,0,0,0,1,1,317,378,317,378,1,1542,1542
1635,0,4.0.0,0,555,2,58,0,58,0,0,58,58,0,0,0,1,1,264,378,264,378,1,1542,1542
1635,0,5.0.0,0,526,0,21,0,21,0,0,21,21,0,0,0,1,1,208,378,208,378,1,1542,1542
1635,1,0.0.54,0,583,5,89,54,143,0,54,143,143,0,0,0,1,2,199,324,199,378,2,1542,1488
1635,1,1.1.54,1,537,1,69,54,123,54,0,123,123,-54,54,54,2,1,263,255,317,255,2,1542,1488
1635,1,2.0.54,0,542,2,63,54,117,0,54,117,117,0,0,0,1,2,237,324,237,378,2,1542,1488
1635,1,3.0.54,0,556,4,93,54,147,0,54,147,147,0,0,0,1,2,317,324,317,378,2,1542,1488
1635,1,4.0.54,0,552,3,58,54,112,0,54,112,112,0,0,0,1,2,264,324,264,378,2,1542,1488
1635,1,5.0.54,0,526,0,21,54,75,0,54,75,75,0,0,0,1,2,208,324,208,378,2,1542,1488
1635,2,0.0.54,0,583,5,89,54,143,0,54,143,143,0,0,54,1,2,199,324,199,378,3,1542,1419
1635,2,1.2.123,1,541,1,38,123,161,123,0,161,161,-123,123,177,3,1,194,309,317,309,3,1542,1419
1635,2,2.0.54,0,542,2,63,54,117,0,54,117,123,0,0,54,1,2,237,324,237,378,3,1542,1419
1635,2,3.0.54,0,556,4,93,54,147,0,54,147,147,0,0,54,1,2,317,324,317,378,3,1542,1419
1635,2,4.0.54,0,552,3,58,54,112,0,54,112,123,0,0,54,1,2,264,324,264,378,3,1542,1419
1635,2,5.0.54,0,537,0,21,54,75,0,54,75,123,0,0,54,1,2,208,324,208,378,3,1542,1419
1635,3,0.0.54,0,583,4,89,54,143,0,54,143,161,0,0,177,1,2,199,324,199,378,4,1542,1381
1635,3,1.3.161,1,556,3,85,161,246,161,0,246,246,-161,161,338,4,1,156,290,317,290,4,1542,1381
1635,3,2.0.54,0,542,1,63,54,117,0,54,117,161,0,0,177,1,2,237,324,237,378,4,1542,1381
1635,3,3.0.54,0,556,3,93,54,147,0,54,147,161,0,0,177,1,2,317,324,317,378,4,1542,1381
1635,3,4.0.54,0,552,2,58,54,112,0,54,112,161,0,0,177,1,2,264,324,264,378,4,1542,1381
1635,3,5.0.54,0,541,0,21,54,75,0,54,75,161,0,0,177,1,2,208,324,208,378,4,1542,1381
1635,4,0.0.54,0,583,1,89,54,143,0,54,143,246,0,0,338,1,2,199,324,199,378,5,1542,1296
1635,4,1.4.246,1,556,0,71,246,317,246,0,317,317,-246,246,584,5,1,71,310,317,310,5,1542,1296
1635,4,2.0.54,0,556,0,63,54,117,0,54,117,246,0,0,338,1,2,237,324,237,378,5,1542,1296
1635,4,3.0.54,0,556,0,93,54,147,0,54,147,246,0,0,338,1,2,317,324,317,378,5,1542,1296
1635,4,4.0.54,0,556,0,58,54,112,0,54,112,246,0,0,338,1,2,264,324,264,378,5,1542,1296
1635,4,5.0.54,0,556,0,21,54,75,0,54,75,246,0,0,338,1,2,208,324,208,378,5,1542,1296
1635,5,0.0.54,0,583,1,89,54,143,0,54,143,317,0,0,584,1,2,199,324,199,378,6,1542,1225
1635,5,2.0.54,0,556,0,63,54,117,0,54,117,317,0,0,584,1,2,237,324,237,378,6,1542,1225
1635,5,3.0.54,0,556,0,93,54,147,0,54,147,317,0,0,584,1,2,317,324,317,378,6,1542,1225
1635,5,4.0.54,0,556,0,58,54,112,0,54,112,317,0,0,584,1,2,264,324,264,378,6,1542,1225
1635,5,5.0.54,1,556,0,21,54,75,0,54,75,317,0,0,584,1,2,208,324,208,378,6,1542,1225
1635,6,0.0.75,0,583,1,89,75,164,0,75,164,317,0,0,584,1,3,199,303,199,378,7,1542,1204
1635,6,2.0.75,0,556,0,63,75,138,0,75,138,317,0,0,584,1,3,237,303,237,378,7,1542,1204
1635,6,3.0.75,0,556,0,93,75,168,0,75,168,317,0,0,584,1,3,317,303,317,378,7,1542,1204
1635,6,4.0.75,0,556,0,58,75,133,0,75,133,317,0,0,584,1,3,264,303,264,378,7,1542,1204
1635,6,5.1.123,1,556,0,24,123,147,75,48,147,317,0,54,584,2,2,187,186,208,255,7,1542,1204
1635,7,0.0.75,0,583,1,89,75,164,0,75,164,317,0,0,584,1,3,199,303,199,378,8,1542,1180
1635,7,2.0.75,0,556,0,63,75,138,0,75,138,317,0,0,584,1,3,237,303,237,378,8,1542,1180
1635,7,3.0.75,0,556,0,93,75,168,0,75,168,317,0,0,584,1,3,317,303,317,378,8,1542,1180
1635,7,4.0.75,0,556,0,58,75,133,0,75,133,317,0,0,584,1,3,264,303,264,378,8,1542,1180
1635,7,5.2.161,1,556,0,50,161,211,147,14,211,317,0,123,584,3,2,163,271,208,309,8,1542,1180
1635,8,0.0.75,0,583,1,89,75,164,0,75,164,317,0,0,584,1,3,199,303,199,378,9,1542,1130
1635,8,2.0.75,0,556,0,63,75,138,0,75,138,317,0,0,584,1,3,237,303,237,378,9,1542,1130
1635,8,3.0.75,0,556,0,93,75,168,0,75,168,317,0,0,584,1,3,317,303,317,378,9,1542,1130
1635,8,4.0.75,0,556,0,58,75,133,0,75,133,317,0,0,584,1,3,264,303,264,378,9,1542,1130
1635,8,5.3.246,1,556,0,20,246,266,211,35,266,317,0,161,584,4,2,113,205,208,290,9,1542,1130
1635,9,0.0.75,0,583,1,89,75,164,0,75,164,317,0,0,584,1,3,199,303,199,378,10,1542,1110
1635,9,2.0.75,0,556,0,63,75,138,0,75,138,317,0,0,584,1,3,237,303,237,378,10,1542,1110
1635,9,3.0.75,0,556,0,93,75,168,0,75,168,317,0,0,584,1,3,317,303,317,378,10,1542,1110
1635,9,4.0.75,0,556,0,58,75,133,0,75,133,317,0,0,584,1,3,264,303,264,378,10,1542,1110
1635,9,5.4.317,1,556,0,93,317,410,266,51,410,410,0,246,584,5,2,93,239,208,310,10,1542,1110
1635,10,0.0.75,0,583,1,89,75,164,0,75,164,410,0,0,584,1,3,199,303,199,378,11,1542,1017
1635,10,2.0.75,0,556,0,63,75,138,0,75,138,410,0,0,584,1,3,237,303,237,378,11,1542,1017
1635,10,3.0.75,0,556,0,93,75,168,0,75,168,410,0,0,584,1,3,317,303,317,378,11,1542,1017
1635,10,4.0.75,1,556,0,58,75,133,0,75,133,410,0,0,584,1,3,264,303,264,378,11,1542,1017
1635,11,0.0.133,0,580,1,89,133,222,0,133,222,410,0,0,584,1,4,199,245,199,378,12,1542,959
1635,11,2.0.133,0,556,0,63,133,196,0,133,196,410,0,0,584,1,4,237,245,237,378,12,1542,959
1635,11,3.0.133,0,556,0,93,133,226,0,133,226,410,0,0,584,1,4,317,245,317,378,12,1542,959
1635,11,4.1.147,1,556,0,96,147,243,133,14,243,410,0,54,584,2,3,206,162,264,255,12,1542,959
1635,12,0.0.133,0,580,1,89,133,222,0,133,222,410,0,0,584,1,4,199,245,199,378,13,1542,863
1635,12,2.0.133,0,556,0,63,133,196,0,133,196,410,0,0,584,1,4,237,245,237,378,13,1542,863
1635,12,3.0.133,0,556,0,93,133,226,0,133,226,410,0,0,584,1,4,317,245,317,378,13,1542,863
1635,12,4.2.243,1,556,0,6,243,249,243,0,249,410,-32,155,616,3,3,110,221,264,309,13,1542,863
1635,13,0.0.133,0,580,1,89,133,222,0,133,222,410,0,0,616,1,4,199,245,199,378,14,1542,857
1635,13,2.0.133,0,556,0,63,133,196,0,133,196,410,0,0,616,1,4,237,245,237,378,14,1542,857
1635,13,3.0.133,0,556,0,93,133,226,0,133,226,410,0,0,616,1,4,317,245,317,378,14,1542,857
1635,13,4.3.266,1,556,0,30,266,296,249,17,296,410,0,161,616,4,3,104,185,264,290,14,1542,857
1635,14,0.0.133,0,580,1,89,133,222,0,133,222,410,0,0,616,1,4,199,245,199,378,15,1542,827
1635,14,2.0.133,0,556,0,63,133,196,0,133,196,410,0,0,616,1,4,237,245,237,378,15,1542,827
1635,14,3.0.133,0,556,0,93,133,226,0,133,226,410,0,0,616,1,4,317,245,317,378,15,1542,827
1635,14,4.4.410,1,556,0,74,410,484,296,114,484,484,0,246,616,5,3,74,146,264,310,15,1542,827
1635,15,0.0.133,0,580,1,89,133,222,0,133,222,484,0,0,616,1,4,199,245,199,378,16,1542,753
1635,15,2.0.133,0,556,0,63,133,196,0,133,196,484,0,0,616,1,4,237,245,237,378,16,1542,753
1635,15,3.0.133,1,556,0,93,133,226,0,133,226,484,0,0,616,1,4,317,245,317,378,16,1542,753
1635,16,0.0.226,0,556,0,89,226,315,0,226,315,484,0,0,616,1,5,199,152,199,378,17,1542,660
1635,16,2.0.226,0,562,1,63,226,289,0,226,289,484,0,0,616,1,5,237,152,237,378,17,1542,660
1635,16,3.1.243,1,556,0,37,243,280,226,17,280,484,0,54,616,2,4,224,66,317,255,17,1542,660
1635,17,0.0.226,0,556,0,89,226,315,0,226,315,484,0,0,616,1,5,199,152,199,378,18,1542,623
1635,17,2.0.226,1,562,1,63,226,289,0,226,289,484,0,0,616,1,5,237,152,237,378,18,1542,623
1635,17,3.2.280,0,556,0,80,280,360,280,0,360,484,-31,186,647,3,4,187,215,317,309,18,1542,623
1635,18,0.0.289,0,562,0,89,289,378,0,289,378,484,0,0,616,1,6,199,89,199,378,19,1542,560
1635,18,2.1.289,1,562,0,26,289,315,289,0,315,484,-9,63,625,2,5,174,29,237,255,19,1542,560
1635,18,3.2.280,0,562,0,80,280,360,280,0,360,484,-31,186,647,3,4,187,215,317,309,19,1542,560
1635,19,0.0.289,1,562,0,89,289,378,0,289,378,484,0,0,625,1,6,199,89,199,378,20,1542,534
1635,19,2.2.315,0,601,1,89,315,404,315,0,404,484,-66,221,691,3,4,148,215,237,309,20,1542,534
1635,19,3.2.280,0,562,0,80,280,360,280,0,360,484,-31,186,656,3,4,187,215,317,309,20,1542,534
1635,20,0.1.378,1,562,0,3,378,381,378,0,381,484,-63,126,688,2,6,110,3,199,255,21,1542,445
1635,20,2.2.315,0,601,1,89,315,404,315,0,404,484,-66,221,691,3,4,148,215,237,309,21,1542,445
1635,20,3.2.280,0,562,0,80,280,360,280,0,360,484,-31,186,656,3,4,187,215,317,309,21,1542,445
1635,21,0.2.381,0,575,1,46,381,427,381,0,427,484,-132,287,820,3,4,107,215,199,309,22,1542,442
1635,21,2.2.315,0,601,2,89,315,404,315,0,404,484,-66,221,754,3,4,148,215,237,309,22,1542,442
1635,21,3.2.280,1,562,0,80,280,360,280,0,360,484,-31,186,719,3,4,187,215,317,309,22,1542,442
1635,22,0.2.381,0,575,1,46,381,427,381,0,427,484,-21,207,740,3,5,107,135,199,309,23,1542,362
1635,22,2.2.360,0,562,0,89,360,449,315,45,449,484,0,186,719,3,5,148,135,237,309,23,1542,362
1635,22,3.3.360,1,562,0,52,360,412,360,0,412,484,-64,225,783,4,4,107,155,317,290,23,1542,362
1635,23,0.2.381,0,575,1,46,381,427,381,0,427,484,-21,207,804,3,5,107,135,199,309,24,1542,310
1635,23,2.2.360,0,562,0,89,360,449,315,45,449,484,0,186,783,3,5,148,135,237,309,24,1542,310
1635,23,3.4.484,1,562,0,55,484,539,412,72,539,539,0,246,783,5,4,55,72,317,310,24,1542,310
1635,24,0.2.381,0,575,1,46,381,427,381,0,427,539,-21,207,804,3,5,107,135,199,309,25,1542,255
1635,24,2.2.360,1,562,0,89,360,449,315,45,449,539,0,186,783,3,5,148,135,237,309,25,1542,255
1635,25,0.2.449,1,562,0,46,449,495,381,68,495,539,0,186,783,3,6,107,46,199,309,26,1542,166
1635,25,2.3.449,0,562,0,52,449,501,449,0,501,539,-37,262,820,4,5,59,103,237,290,26,1542,166
1635,26,0.3.495,0,605,1,51,495,546,495,0,546,546,-83,308,866,4,5,61,103,199,290,27,1542,120
1635,26,2.3.449,1,562,0,52,449,501,449,0,501,539,-37,262,820,4,5,59,103,237,290,27,1542,120
1635,27,0.3.501,0,562,0,51,501,552,495,6,552,552,0,262,820,4,6,61,51,199,290,28,1542,68
1635,27,2.4.539,1,562,0,7,539,546,501,38,546,546,0,246,820,5,5,7,17,237,310,28,1542,68
1635,28,0.3.501,1,562,0,51,501,552,495,6,552,552,0,262,820,4,6,61,51,199,290,29,1542,61
1635,29,0.4.552,1,562,0,10,552,562,552,0,562,562,-6,252,826,5,6,10,10,199,310,30,1542,10
1636,0,0.0.0,1,533,1,3,0,3,0,0,3,3,0,0,0,1,1,242,195,242,195,1,1312,1312
1636,0,1.0.0,0,560,3,30,0,30,0,0,30,30,0,0,0,1,1,217,195,217,195,1,1312,1312
1636,0,2.0.0,0,530,0,9,0,9,0,0,9,9,0,0,0,1,1,164,195,164,195,1,1312,1312
1636,0,3.0.0,0,577,4,47,0,47,0,0,47,47,0,0,0,1,1,277,195,277,195,1,1312,1312
1636,0,4.0.0,0,606,5,80,0,80,0,0,80,80,0,0,0,1,1,203,195,203,195,1,1312,1312
1636,0,5.0.0,0,556,2,26,0,26,0,0,26,26,0,0,0,1,1,209,195,209,195,1,1312,1312
1636,1,0.1.3,0,595,4,71,3,74,3,0,74,74,-3,3,3,2,1,239,259,242,259,2,1312,1309
1636,1,1.0.3,0,563,2,30,3,33,0,3,33,33,0,0,0,1,2,217,192,217,195,2,1312,1309
1636,1,2.0.3,1,533,0,9,3,12,0,3,12,12,0,0,0,1,2,164,192,164,195,2,1312,1309
1636,1,3.0.3,0,580,3,47,3,50,0,3,50,50,0,0,0,1,2,277,192,277,195,2,1312,1309
1636,1,4.0.3,0,609,5,80,3,83,0,3,83,83,0,0,0,1,2,203,192,203,195,2,1312,1309
1636,1,5.0.3,0,559,1,26,3,29,0,3,29,29,0,0,0,1,2,209,192,209,195,2,1312,1309
1636,2,0.1.3,0,595,3,71,3,74,3,0,74,74,-3,3,3,2,1,239,259,242,259,3,1312,1300
1636,2,1.0.12,0,533,0,30,12,42,0,12,42,42,0,0,0,1,3,217,183,217,195,3,1312,1300
1636,2,2.1.12,0,533,0,20,12,32,12,0,32,32,-12,12,12,2,1,155,259,164,259,3,1312,1300
1636,2,3.0.12,1,550,1,47,12,59,0,12,59,59,0,0,0,1,3,277,183,277,195,3,1312,1300
1636,2,4.0.12,0,561,2,80,12,92,0,12,92,92,0,0,0,1,3,203,183,203,195,3,1312,1300
1636,2,5.0.12,0,533,0,26,12,38,0,12,38,38,0,0,0,1,3,209,183,209,195,3,1312,1300
1636,3,0.1.3,0,595,2,71,3,74,3,0,74,74,-3,3,3,2,1,239,259,242,259,4,1312,1253
1636,3,1.0.59,0,559,1,30,59,89,0,59,89,89,0,0,0,1,4,217,136,217,195,4,1312,1253
1636,3,2.1.12,0,550,0,20,12,32,12,0,32,59,-12,12,12,2,1,155,259,164,259,4,1312,1253
1636,3,3.1.59,0,559,1,75,59,134,59,0,134,134,-59,59,59,2,1,230,259,277,259,4,1312,1253
1636,3,4.0.59,0,559,1,80,59,139,0,59,139,139,0,0,0,1,4,203,136,203,195,4,1312,1253
1636,3,5.0.59,1,550,0,26,59,85,0,59,85,85,0,0,0,1,4,209,136,209,195,4,1312,1253
1636,4,0.1.3,0,595,2,71,3,74,3,0,74,85,-3,3,3,2,1,239,259,242,259,5,1312,1227
1636,4,1.0.85,1,550,0,30,85,115,0,85,115,115,0,0,0,1,5,217,110,217,195,5,1312,1227
1636,4,2.1.12,0,550,0,20,12,32,12,0,32,85,-12,12,12,2,1,155,259,164,259,5,1312,1227
1636,4,3.1.59,0,559,1,75,59,134,59,0,134,134,-59,59,59,2,1,230,259,277,259,5,1312,1227
1636,4,4.0.85,0,550,0,80,85,165,0,85,165,165,0,0,0,1,5,203,110,203,195,5,1312,1227
1636,4,5.1.85,0,550,0,7,85,92,85,0,92,92,-85,85,85,2,1,183,259,209,259,5,1312,1227
1636,5,0.1.3,0,595,2,71,3,74,3,0,74,115,-3,3,3,2,1,239,259,242,259,6,1312,1197
1636,5,1.1.115,0,550,0,37,115,152,115,0,152,152,-115,115,115,2,1,187,259,217,259,6,1312,1197
1636,5,2.1.12,0,550,0,20,12,32,12,0,32,115,-12,12,12,2,1,155,259,164,259,6,1312,1197
1636,5,3.1.59,0,559,1,75,59,134,59,0,134,134,-59,59,59,2,1,230,259,277,259,6,1312,1197
1636,5,4.0.115,1,550,0,80,115,195,0,115,195,195,0,0,0,1,6,203,80,203,195,6,1312,1197
1636,5,5.1.85,0,550,0,7,85,92,85,0,92,115,-85,85,85,2,1,183,259,209,259,6,1312,1197
1636,6,0.1.3,0,595,2,71,3,74,3,0,74,195,-3,3,3,2,1,239,259,242,259,7,1312,1117
1636,6,1.1.115,0,550,0,37,115,152,115,0,152,195,-115,115,115,2,1,187,259,217,259,7,1312,1117
1636,6,2.1.12,1,550,0,20,12,32,12,0,32,195,-12,12,12,2,1,155,259,164,259,7,1312,1117
1636,6,3.1.59,0,559,1,75,59,134,59,0,134,195,-59,59,59,2,1,230,259,277,259,7,1312,1117
1636,6,4.1.195,0,550,0,49,195,244,195,0,244,244,-195,195,195,2,1,123,259,203,259,7,1312,1117
1636,6,5.1.85,0,550,0,7,85,92,85,0,92,195,-85,85,85,2,1,183,259,209,259,7,1312,1117
1636,7,0.1.32,0,568,2,71,32,103,3,29,103,195,0,12,12,2,2,239,239,242,259,8,1312,1097
1636,7,1.1.115,0,550,0,37,115,152,115,0,152,195,-83,95,95,2,2,187,239,217,259,8,1312,1097
1636,7,2.2.32,1,550,0,42,32,74,32,0,74,195,-32,32,44,3,1,135,277,164,277,8,1312,1097
1636,7,3.1.59,0,559,1,75,59,134,59,0,134,195,-27,39,39,2,2,230,239,277,259,8,1312,1097
1636,7,4.1.195,0,550,0,49,195,244,195,0,244,244,-163,175,175,2,2,123,239,203,259,8,1312,1097
1636,7,5.1.85,0,550,0,7,85,92,85,0,92,195,-53,65,65,2,2,183,239,209,259,8,1312,1097
1636,8,0.1.32,0,568,2,71,32,103,3,29,103,195,0,12,44,2,2,239,239,242,259,9,1312,1055
1636,8,1.1.115,0,550,0,37,115,152,115,0,152,195,-83,95,127,2,2,187,239,217,259,9,1312,1055
1636,8,2.3.74,1,550,0,21,74,95,74,0,95,195,-74,74,118,4,1,93,143,164,143,9,1312,1055
1636,8,3.1.59,0,559,1,75,59,134,59,0,134,195,-27,39,71,2,2,230,239,277,259,9,1312,1055
1636,8,4.1.195,0,550,0,49,195,244,195,0,244,244,-163,175,207,2,2,123,239,203,259,9,1312,1055
1636,8,5.1.85,0,550,0,7,85,92,85,0,92,195,-53,65,97,2,2,183,239,209,259,9,1312,1055
1636,9,0.1.32,1,568,2,71,32,103,3,29,103,195,0,12,118,2,2,239,239,242,259,10,1312,1034
1636,9,1.1.115,0,550,0,37,115,152,115,0,152,195,-83,95,201,2,2,187,239,217,259,10,1312,1034
1636,9,2.4.95,0,550,0,72,95,167,95,0,167,195,-95,95,213,5,1,72,438,164,438,10,1312,1034
1636,9,3.1.59,0,559,1,75,59,134,59,0,134,195,-27,39,145,2,2,230,239,277,259,10,1312,1034
1636,9,4.1.195,0,550,0,49,195,244,195,0,244,244,-163,175,281,2,2,123,239,203,259,10,1312,1034
1636,9,5.1.85,0,550,0,7,85,92,85,0,92,195,-53,65,171,2,2,183,239,209,259,10,1312,1034
1636,10,0.2.103,0,575,1,49,103,152,103,0,152,195,-29,61,147,3,2,168,235,242,277,11,1312,963
1636,10,1.1.115,0,568,0,37,115,152,115,0,152,195,-12,24,130,2,3,187,168,217,259,11,1312,963
1636,10,2.4.95,0,568,0,72,95,167,95,0,167,195,-95,95,213,5,1,72,438,164,438,11,1312,963
1636,10,3.1.103,0,575,1,75,103,178,59,44,178,195,0,12,118,2,3,230,168,277,259,11,1312,963
1636,10,4.1.195,0,568,0,49,195,244,195,0,244,244,-92,104,210,2,3,123,168,203,259,11,1312,963
1636,10,5.1.103,1,568,0,7,103,110,85,18,110,195,0,12,118,2,3,183,168,209,259,11,1312,963
1636,11,0.2.103,0,575,1,49,103,152,103,0,152,195,-29,61,147,3,2,168,235,242,277,12,1312,956
1636,11,1.1.115,0,568,0,37,115,152,115,0,152,195,-5,17,123,2,4,187,161,217,259,12,1312,956
1636,11,2.4.95,0,568,0,72,95,167,95,0,167,195,-95,95,213,5,1,72,438,164,438,12,1312,956
1636,11,3.1.110,1,568,0,75,110,185,59,51,185,195,0,12,118,2,4,230,161,277,259,12,1312,956
1636,11,4.1.195,0,568,0,49,195,244,195,0,244,244,-85,97,203,2,4,123,161,203,259,12,1312,956
1636,11,5.2.110,0,568,0,88,110,198,110,0,198,198,-36,68,154,3,2,176,235,209,277,12,1312,956
1636,12,0.2.103,0,575,1,49,103,152,103,0,152,195,-29,61,147,3,2,168,235,242,277,13,1312,881
1636,12,1.1.185,1,568,0,37,185,222,115,70,222,222,0,12,118,2,5,187,86,217,259,13,1312,881
1636,12,2.4.95,0,568,0,72,95,167,95,0,167,195,-95,95,213,5,1,72,438,164,438,13,1312,881
1636,12,3.2.185,0,575,1,48,185,233,185,0,233,233,-111,143,229,3,2,155,235,277,277,13,1312,881
1636,12,4.1.195,0,568,0,49,195,244,195,0,244,244,-10,22,128,2,5,123,86,203,259,13,1312,881
1636,12,5.2.110,0,568,0,88,110,198,110,0,198,198,-36,68,154,3,2,176,235,209,277,13,1312,881
1636,13,0.2.103,0,575,2,49,103,152,103,0,152,222,-29,61,147,3,2,168,235,242,277,14,1312,844
1636,13,1.2.222,0,574,1,43,222,265,222,0,265,265,-148,180,266,3,2,150,235,217,277,14,1312,844
1636,13,2.4.95,0,568,0,72,95,167,95,0,167,222,-95,95,213,5,1,72,438,164,438,14,1312,844
1636,13,3.2.185,0,575,2,48,185,233,185,0,233,233,-111,143,229,3,2,155,235,277,277,14,1312,844
1636,13,4.1.222,1,568,0,49,222,271,195,27,271,271,0,12,118,2,6,123,49,203,259,14,1312,844
1636,13,5.2.110,0,568,0,88,110,198,110,0,198,222,-36,68,154,3,2,176,235,209,277,14,1312,844
1636,14,0.2.103,1,575,2,49,103,152,103,0,152,271,-29,61,147,3,2,168,235,242,277,15,1312,795
1636,14,1.2.222,0,574,1,43,222,265,222,0,265,271,-148,180,266,3,2,150,235,217,277,15,1312,795
1636,14,2.4.95,0,568,0,72,95,167,95,0,167,271,-95,95,213,5,1,72,438,164,438,15,1312,795
1636,14,3.2.185,0,575,2,48,185,233,185,0,233,271,-111,143,229,3,2,155,235,277,277,15,1312,795
1636,14,4.2.271,0,568,0,7,271,278,271,0,278,278,-197,229,315,3,2,74,235,203,277,15,1312,795
1636,14,5.2.110,0,568,0,88,110,198,110,0,198,271,-36,68,154,3,2,176,235,209,277,15,1312,795
1636,15,0.3.152,1,575,0,57,152,209,152,0,209,271,-57,131,204,4,2,119,122,242,143,16,1312,746
1636,15,1.2.222,0,596,1,43,222,265,222,0,265,271,-70,131,217,3,3,150,186,217,277,16,1312,746
1636,15,2.4.95,0,575,0,72,95,167,95,0,167,271,-95,95,242,5,1,72,438,164,438,16,1312,746
1636,15,3.2.185,0,575,0,48,185,233,185,0,233,271,-33,94,180,3,3,155,186,277,277,16,1312,746
1636,15,4.2.271,0,575,0,7,271,278,271,0,278,278,-119,180,266,3,3,74,186,203,277,16,1312,746
1636,15,5.2.152,0,575,0,88,152,240,110,42,240,271,0,61,147,3,3,176,186,209,277,16,1312,746
1636,16,0.4.209,0,575,0,62,209,271,209,0,271,271,-209,209,413,5,1,62,438,242,438,17,1312,689
1636,16,1.2.222,0,596,1,43,222,265,222,0,265,271,-70,131,274,3,3,150,186,217,277,17,1312,689
1636,16,2.4.95,0,575,0,72,95,167,95,0,167,271,-95,95,299,5,1,72,438,164,438,17,1312,689
1636,16,3.2.185,1,575,0,48,185,233,185,0,233,271,-33,94,237,3,3,155,186,277,277,17,1312,689
1636,16,4.2.271,0,575,0,7,271,278,271,0,278,278,-119,180,323,3,3,74,186,203,277,17,1312,689
1636,16,5.2.152,0,575,0,88,152,240,110,42,240,271,0,61,204,3,3,176,186,209,277,17,1312,689
1636,17,0.4.209,0,575,0,62,209,271,209,0,271,271,-209,209,446,5,1,62,438,242,438,18,1312,641
1636,17,1.2.233,0,575,0,43,233,276,222,11,276,276,0,94,237,3,4,150,138,217,277,18,1312,641
1636,17,2.4.95,0,575,0,72,95,167,95,0,167,271,-95,95,332,5,1,72,438,164,438,18,1312,641
1636,17,3.3.233,1,575,0,11,233,244,233,0,244,271,-24,155,261,4,3,107,65,277,143,18,1312,641
1636,17,4.2.271,0,575,0,7,271,278,271,0,278,278,-38,132,275,3,4,74,138,203,277,18,1312,641
1636,17,5.2.233,0,575,0,88,233,321,110,123,321,321,0,94,237,3,4,176,138,209,277,18,1312,641
1636,18,0.4.209,0,575,0,62,209,271,209,0,271,271,-209,209,470,5,1,62,438,242,438,19,1312,630
1636,18,1.2.233,1,575,0,43,233,276,222,11,276,276,0,94,261,3,4,150,138,217,277,19,1312,630
1636,18,2.4.95,0,575,0,72,95,167,95,0,167,271,-95,95,356,5,1,72,438,164,438,19,1312,630
1636,18,3.4.244,0,610,1,96,244,340,244,0,340,340,-244,244,505,5,1,96,438,277,438,19,1312,630
1636,18,4.2.271,0,575,0,7,271,278,271,0,278,278,-38,132,299,3,4,74,138,203,277,19,1312,630
1636,18,5.2.233,0,575,0,88,233,321,110,123,321,321,0,94,261,3,4,176,138,209,277,19,1312,630
1636,19,0.4.209,0,575,0,62,209,271,209,0,271,276,-209,209,470,5,1,62,438,242,438,20,1312,587
1636,19,1.3.276,1,575,0,27,276,303,276,0,303,303,-32,187,293,4,4,107,54,217,143,20,1312,587
1636,19,2.4.95,0,575,0,72,95,167,95,0,167,276,-95,95,356,5,1,72,438,164,438,20,1312,587
1636,19,3.4.244,0,610,1,96,244,340,244,0,340,340,-244,244,505,5,1,96,438,277,438,20,1312,587
1636,19,4.2.276,0,575,0,7,276,283,271,5,283,283,0,94,261,3,5,74,95,203,277,20,1312,587
1636,19,5.2.276,0,575,0,88,276,364,110,166,364,364,0,94,261,3,5,176,95,209,277,20,1312,587
1636,20,0.4.209,0,575,0,62,209,271,209,0,271,303,-209,209,502,5,1,62,438,242,438,21,1312,560
1636,20,1.4.303,0,607,1,80,303,383,303,0,383,383,-303,303,596,5,1,80,438,217,438,21,1312,560
1636,20,2.4.95,0,575,0,72,95,167,95,0,167,303,-95,95,388,5,1,72,438,164,438,21,1312,560
1636,20,3.4.244,0,610,2,96,244,340,244,0,340,340,-244,244,537,5,1,96,438,277,438,21,1312,560
1636,20,4.2.276,1,575,0,7,276,283,271,5,283,303,0,94,293,3,5,74,95,203,277,21,1312,560
1636,20,5.2.276,0,575,0,88,276,364,110,166,364,364,0,94,293,3,5,176,95,209,277,21,1312,560
1636,21,0.4.209,0,575,0,62,209,271,209,0,271,303,-209,209,502,5,1,62,438,242,438,22,1312,553
1636,21,1.4.303,0,607,1,80,303,383,303,0,383,383,-303,303,596,5,1,80,438,217,438,22,1312,553
1636,21,2.4.95,0,575,0,72,95,167,95,0,167,303,-95,95,388,5,1,72,438,164,438,22,1312,553
1636,21,3.4.244,0,610,2,96,244,340,244,0,340,340,-244,244,537,5,1,96,438,277,438,22,1312,553
1636,21,4.3.303,1,575,0,23,303,326,283,20,326,326,0,187,293,4,5,67,27,203,143,22,1312,553
1636,21,5.2.283,0,575,0,88,283,371,110,173,371,371,0,94,293,3,6,176,88,209,277,22,1312,553
1636,22,0.4.209,0,575,0,62,209,271,209,0,271,326,-209,209,502,5,1,62,438,242,438,23,1312,530
1636,22,1.4.303,0,607,1,80,303,383,303,0,383,383,-303,303,596,5,1,80,438,217,438,23,1312,530
1636,22,2.4.95,0,575,0,72,95,167,95,0,167,326,-95,95,388,5,1,72,438,164,438,23,1312,530
1636,22,3.4.244,0,610,2,96,244,340,244,0,340,340,-244,244,537,5,1,96,438,277,438,23,1312,530
1636,22,4.4.326,0,630,3,44,326,370,326,0,370,370,-326,326,619,5,1,44,438,203,438,23,1312,530
1636,22,5.2.283,1,575,0,88,283,371,110,173,371,371,0,94,293,3,6,176,88,209,277,23,1312,530
1636,23,0.4.209,0,575,0,62,209,271,209,0,271,371,-209,209,502,5,1,62,438,242,438,24,1312,442
1636,23,1.4.303,0,607,1,80,303,383,303,0,383,383,-303,303,596,5,1,80,438,217,438,24,1312,442
1636,23,2.4.95,0,575,0,72,95,167,95,0,167,371,-95,95,388,5,1,72,438,164,438,24,1312,442
1636,23,3.4.244,0,610,2,96,244,340,244,0,340,371,-244,244,537,5,1,96,438,277,438,24,1312,442
1636,23,4.4.326,0,630,3,44,326,370,326,0,370,371,-326,326,619,5,1,44,438,203,438,24,1312,442
1636,23,5.3.371,1,575,0,4,371,375,371,0,375,375,-45,232,338,4,6,88,4,209,143,24,1312,442
1636,24,0.4.209,0,575,0,62,209,271,209,0,271,375,-209,209,547,5,1,62,438,242,438,25,1312,438
1636,24,1.4.303,0,607,2,80,303,383,303,0,383,383,-303,303,641,5,1,80,438,217,438,25,1312,438
1636,24,2.4.95,1,575,0,72,95,167,95,0,167,375,-95,95,433,5,1,72,438,164,438,25,1312,438
1636,24,3.4.244,0,610,3,96,244,340,244,0,340,375,-244,244,582,5,1,96,438,277,438,25,1312,438
1636,24,4.4.326,0,630,4,44,326,370,326,0,370,375,-326,326,664,5,1,44,438,203,438,25,1312,438
1636,24,5.4.375,0,583,1,84,375,459,375,0,459,459,-375,375,713,5,1,84,438,209,438,25,1312,438
1636,25,0.4.209,1,575,0,62,209,271,209,0,271,375,-42,137,475,5,2,62,366,242,438,26,1312,366
1636,25,1.4.303,0,607,2,80,303,383,303,0,383,383,-136,231,569,5,2,80,366,217,438,26,1312,366
1636,25,3.4.244,0,610,3,96,244,340,244,0,340,375,-77,172,510,5,2,96,366,277,438,26,1312,366
1636,25,4.4.326,0,630,4,44,326,370,326,0,370,375,-159,254,592,5,2,44,366,203,438,26,1312,366
1636,25,5.4.375,0,583,1,84,375,459,375,0,459,459,-208,303,641,5,2,84,366,209,438,26,1312,366
1636,26,1.4.303,0,607,2,80,303,383,303,0,383,383,-32,169,507,5,3,80,304,217,438,27,1312,304
1636,26,3.4.271,1,575,0,96,271,367,244,27,367,375,0,137,475,5,3,96,304,277,438,27,1312,304
1636,26,4.4.326,0,630,3,44,326,370,326,0,370,375,-55,192,530,5,3,44,304,203,438,27,1312,304
1636,26,5.4.375,0,583,1,84,375,459,375,0,459,459,-104,241,579,5,3,84,304,209,438,27,1312,304
1636,27,1.4.367,0,575,0,80,367,447,303,64,447,447,0,137,475,5,4,80,208,217,438,28,1312,208
1636,27,4.4.367,1,575,0,44,367,411,326,41,411,411,0,137,475,5,4,44,208,203,438,28,1312,208
1636,27,5.4.375,0,583,1,84,375,459,375,0,459,459,-8,145,483,5,4,84,208,209,438,28,1312,208
1636,28,1.4.411,1,575,0,80,411,491,303,108,491,491,0,137,475,5,5,80,164,217,438,29,1312,164
1636,28,5.4.411,0,575,0,84,411,495,375,36,495,495,0,137,475,5,5,84,164,209,438,29,1312,164
1636,29,5.4.491,1,575,0,84,491,575,375,116,575,575,0,137,475,5,6,84,84,209,438,30,1312,84
1637,0,0.0.0,0,442,3,16,0,16,0,0,16,16,0,0,0,1,1,187,112,187,112,1,1184,1184
1637,0,1.0.0,0,432,2,6,0,6,0,0,6,6,0,0,0,1,1,217,112,217,112,1,1184,1184
1637,0,2.0.0,0,481,5,55,0,55,0,0,55,55,0,0,0,1,1,289,112,289,112,1,1184,1184
1637,0,3.0.0,0,427,1,1,0,1,0,0,1,1,0,0,0,1,1,137,112,137,112,1,1184,1184
1637,0,4.0.0,0,426,0,3,0,3,0,0,3,3,0,0,0,1,1,43,112,43,112,1,1184,1184
1637,0,5.0.0,1,457,4,31,0,31,0,0,31,31,0,0,0,1,1,311,112,311,112,1,1184,1184
1637,1,0.0.31,0,473,3,16,31,47,0,31,47,47,0,0,0,1,2,187,81,187,112,2,1184,1153
1637,1,1.0.31,1,463,2,6,31,37,0,31,37,37,0,0,0,1,2,217,81,217,112,2,1184,1153
1637,1,2.0.31,0,512,4,55,31,86,0,31,86,86,0,0,0,1,2,289,81,289,112,2,1184,1153
1637,1,3.0.31,0,458,1,1,31,32,0,31,32,32,0,0,0,1,2,137,81,137,112,2,1184,1153
1637,1,4.0.31,0,457,0,3,31,34,0,31,34,34,0,0,0,1,2,43,81,43,112,2,1184,1153
1637,1,5.1.31,0,544,5,90,31,121,31,0,121,121,-31,31,31,2,1,280,162,311,162,2,1184,1153
1637,2,0.0.37,1,479,3,16,37,53,0,37,53,53,0,0,0,1,3,187,75,187,112,3,1184,1147
1637,2,1.1.37,0,465,2,5,37,42,37,0,42,42,-37,37,37,2,1,211,162,217,162,3,1184,1147
1637,2,2.0.37,0,500,4,55,37,92,0,37,92,92,0,0,0,1,3,289,75,289,112,3,1184,1147
1637,2,3.0.37,0,464,1,1,37,38,0,37,38,38,0,0,0,1,3,137,75,137,112,3,1184,1147
1637,2,4.0.37,0,463,0,3,37,40,0,37,40,40,0,0,0,1,3,43,75,43,112,3,1184,1147
1637,2,5.1.31,0,544,5,90,31,121,31,0,121,121,-31,31,31,2,1,280,162,311,162,3,1184,1147
1637,3,0.1.53,0,500,2,39,53,92,53,0,92,92,-53,53,53,2,1,171,162,187,162,4,1184,1131
1637,3,1.1.37,0,479,0,5,37,42,37,0,42,53,-37,37,37,2,1,211,162,217,162,4,1184,1131
1637,3,2.0.53,0,500,2,55,53,108,0,53,108,108,0,0,0,1,4,289,59,289,112,4,1184,1131
1637,3,3.0.53,1,480,1,1,53,54,0,53,54,54,0,0,0,1,4,137,59,137,112,4,1184,1131
1637,3,4.0.53,0,479,0,3,53,56,0,53,56,56,0,0,0,1,4,43,59,43,112,4,1184,1131
1637,3,5.1.31,0,544,3,90,31,121,31,0,121,121,-31,31,31,2,1,280,162,311,162,4,1184,1131
1637,4,0.1.53,0,500,3,39,53,92,53,0,92,92,-53,53,53,2,1,171,162,187,162,5,1184,1130
1637,4,1.1.37,0,480,0,5,37,42,37,0,42,54,-37,37,37,2,1,211,162,217,162,5,1184,1130
1637,4,2.0.54,1,492,2,55,54,109,0,54,109,109,0,0,0,1,5,289,58,289,112,5,1184,1130
1637,4,3.1.54,0,486,1,14,54,68,54,0,68,68,-54,54,54,2,1,136,162,137,162,5,1184,1130
1637,4,4.0.54,0,480,0,3,54,57,0,54,57,57,0,0,0,1,5,43,58,43,112,5,1184,1130
1637,4,5.1.31,0,544,4,90,31,121,31,0,121,121,-31,31,31,2,1,280,162,311,162,5,1184,1130
1637,5,0.1.53,0,500,1,39,53,92,53,0,92,109,-53,53,53,2,1,171,162,187,162,6,1184,1075
1637,5,1.1.37,0,492,0,5,37,42,37,0,42,109,-37,37,37,2,1,211,162,217,162,6,1184,1075
1637,5,2.1.109,0,503,2,13,109,122,109,0,122,122,-109,109,109,2,1,234,162,289,162,6,1184,1075
1637,5,3.1.54,0,492,0,14,54,68,54,0,68,109,-54,54,54,2,1,136,162,137,162,6,1184,1075
1637,5,4.0.109,1,492,0,3,109,112,0,109,112,112,0,0,0,1,6,43,3,43,112,6,1184,1075
1637,5,5.1.31,0,544,3,90,31,121,31,0,121,121,-31,31,31,2,1,280,162,311,162,6,1184,1075
1637,6,0.1.53,0,500,2,39,53,92,53,0,92,112,-53,53,53,2,1,171,162,187,162,7,1184,1072
1637,6,1.1.37,1,492,0,5,37,42,37,0,42,112,-37,37,37,2,1,211,162,217,162,7,1184,1072
1637,6,2.1.109,0,503,3,13,109,122,109,0,122,122,-109,109,109,2,1,234,162,289,162,7,1184,1072
1637,6,3.1.54,0,492,0,14,54,68,54,0,68,112,-54,54,54,2,1,136,162,137,162,7,1184,1072
1637,6,4.1.112,0,493,1,1,112,113,112,0,113,113,-112,112,112,2,1,40,162,43,162,7,1184,1072
1637,6,5.1.31,0,544,4,90,31,121,31,0,121,121,-31,31,31,2,1,280,162,311,162,7,1184,1072
1637,7,0.1.53,0,500,2,39,53,92,53,0,92,112,-11,48,48,2,2,171,157,187,162,8,1184,1067
1637,7,1.2.42,0,500,2,49,42,91,42,0,91,112,-42,42,79,3,1,206,247,217,247,8,1184,1067
1637,7,2.1.109,1,503,3,13,109,122,109,0,122,122,-67,104,104,2,2,234,157,289,162,8,1184,1067
1637,7,3.1.54,0,492,0,14,54,68,54,0,68,112,-12,49,49,2,2,136,157,137,162,8,1184,1067
1637,7,4.1.112,0,493,1,1,112,113,112,0,113,113,-70,107,107,2,2,40,157,43,162,8,1184,1067
1637,7,5.1.42,0,500,2,90,42,132,31,11,132,132,0,37,37,2,2,280,157,311,162,8,1184,1067
1637,8,0.1.53,1,503,0,39,53,92,53,0,122,122,39,65,65,2,3,171,144,187,162,9,1184,1054
1637,8,1.2.42,0,503,0,49,42,91,42,0,91,122,-42,42,146,3,1,206,247,217,247,9,1184,1054
1637,8,2.2.122,0,508,1,95,122,217,122,0,217,217,-122,122,226,3,1,221,247,289,247,9,1184,1054
1637,8,3.1.54,0,503,0,14,54,68,54,0,122,122,14,90,90,2,3,136,144,137,162,9,1184,1054
1637,8,4.1.122,0,503,0,1,122,123,112,10,123,123,0,104,104,2,3,40,144,43,162,9,1184,1054
1637,8,5.1.122,0,508,1,90,122,212,31,91,212,212,0,104,104,2,3,280,144,311,162,9,1184,1054
1637,9,0.2.92,0,503,0,53,92,145,92,0,145,145,-92,92,157,3,1,132,247,187,247,10,1184,1015
1637,9,1.2.42,0,503,0,49,42,91,42,0,91,122,-42,42,107,3,1,206,247,217,247,10,1184,1015
1637,9,2.2.122,0,508,1,95,122,217,122,0,217,217,-122,122,187,3,1,221,247,289,247,10,1184,1015
1637,9,3.1.92,1,503,0,14,92,106,54,38,122,122,14,51,51,2,4,136,105,137,162,10,1184,1015
1637,9,4.1.122,0,503,0,1,122,123,112,10,123,123,0,65,65,2,4,40,105,43,162,10,1184,1015
1637,9,5.1.122,0,508,1,90,122,212,31,91,212,212,0,65,65,2,4,280,105,311,162,10,1184,1015
1637,10,0.2.92,0,503,0,53,92,145,92,0,145,145,-92,92,143,3,1,132,247,187,247,11,1184,1001
1637,10,1.2.42,0,503,0,49,42,91,42,0,91,122,-42,42,93,3,1,206,247,217,247,11,1184,1001
1637,10,2.2.122,0,508,1,95,122,217,122,0,217,217,-122,122,173,3,1,221,247,289,247,11,1184,1001
1637,10,3.2.106,0,503,0,15,106,121,106,0,121,122,-106,106,157,3,1,122,247,137,247,11,1184,1001
1637,10,4.1.122,0,503,0,1,122,123,112,10,123,123,0,51,51,2,5,40,91,43,162,11,1184,1001
1637,10,5.1.122,1,508,1,90,122,212,31,91,212,212,0,51,51,2,5,280,91,311,162,11,1184,1001
1637,11,0.2.92,0,511,1,53,92,145,92,0,145,212,-92,92,143,3,1,132,247,187,247,12,1184,911
1637,11,1.2.42,0,508,0,49,42,91,42,0,91,212,-42,42,93,3,1,206,247,217,247,12,1184,911
1637,11,2.2.122,0,508,0,95,122,217,122,0,217,217,-122,122,173,3,1,221,247,289,247,12,1184,911
1637,11,3.2.106,0,508,0,15,106,121,106,0,121,212,-106,106,157,3,1,122,247,137,247,12,1184,911
1637,11,4.1.212,1,508,0,1,212,213,112,100,213,213,0,51,51,2,6,40,1,43,162,12,1184,911
1637,11,5.2.212,0,511,1,27,212,239,212,0,239,239,-212,212,263,3,1,190,247,311,247,12,1184,911
1637,12,0.2.92,0,511,1,53,92,145,92,0,145,213,-92,92,143,3,1,132,247,187,247,13,1184,910
1637,12,1.2.42,1,508,0,49,42,91,42,0,91,213,-42,42,93,3,1,206,247,217,247,13,1184,910
1637,12,2.2.122,0,508,0,95,122,217,122,0,217,217,-122,122,173,3,1,221,247,289,247,13,1184,910
1637,12,3.2.106,0,508,0,15,106,121,106,0,121,213,-106,106,157,3,1,122,247,137,247,13,1184,910
1637,12,4.2.213,0,511,1,8,213,221,213,0,221,221,-213,213,264,3,1,39,247,43,247,13,1184,910
1637,12,5.2.212,0,511,1,27,212,239,212,0,239,239,-212,212,263,3,1,190,247,311,247,13,1184,910
1637,13,0.2.92,0,511,1,53,92,145,92,0,145,213,-1,43,94,3,2,132,198,187,247,14,1184,861
1637,13,1.3.91,0,508,0,68,91,159,91,0,159,213,-91,91,184,4,1,157,394,217,394,14,1184,861
1637,13,2.2.122,0,508,0,95,122,217,122,0,217,217,-31,73,124,3,2,221,198,289,247,14,1184,861
1637,13,3.2.106,1,508,0,15,106,121,106,0,121,213,-15,57,108,3,2,122,198,137,247,14,1184,861
1637,13,4.2.213,0,511,1,8,213,221,213,0,221,221,-122,164,215,3,2,39,198,43,247,14,1184,861
1637,13,5.2.212,0,511,1,27,212,239,212,0,239,239,-121,163,214,3,2,190,198,311,247,14,1184,861
1637,14,0.2.121,1,511,1,53,121,174,92,29,174,213,0,57,108,3,3,132,183,187,247,15,1184,846
1637,14,1.3.91,0,508,0,68,91,159,91,0,159,213,-91,91,199,4,1,157,394,217,394,15,1184,846
1637,14,2.2.122,0,508,0,95,122,217,122,0,217,217,-1,58,109,3,3,221,183,289,247,15,1184,846
1637,14,3.3.121,0,530,2,69,121,190,121,0,190,213,-121,121,229,4,1,107,394,137,394,15,1184,846
1637,14,4.2.213,0,511,1,8,213,221,213,0,221,221,-92,149,200,3,3,39,183,43,247,15,1184,846
1637,14,5.2.212,0,511,1,27,212,239,212,0,239,239,-91,148,199,3,3,190,183,311,247,15,1184,846
1637,15,0.3.174,0,536,3,64,174,238,174,0,238,238,-174,174,282,4,1,79,394,187,394,16,1184,793
1637,15,1.3.91,0,511,0,68,91,159,91,0,159,213,-91,91,199,4,1,157,394,217,394,16,1184,793
1637,15,2.2.174,0,522,1,95,174,269,122,52,269,269,0,57,108,3,4,221,130,289,247,16,1184,793
1637,15,3.3.121,0,530,2,69,121,190,121,0,190,213,-121,121,229,4,1,107,394,137,394,16,1184,793
1637,15,4.2.213,0,511,0,8,213,221,213,0,221,221,-39,96,147,3,4,39,130,43,247,16,1184,793
1637,15,5.2.212,1,511,0,27,212,239,212,0,239,239,-38,95,146,3,4,190,130,311,247,16,1184,793
1637,16,0.3.174,0,536,3,64,174,238,174,0,238,239,-174,174,320,4,1,79,394,187,394,17,1184,766
1637,16,1.3.91,0,511,0,68,91,159,91,0,159,239,-91,91,237,4,1,157,394,217,394,17,1184,766
1637,16,2.2.239,1,518,1,95,239,334,122,117,334,334,0,95,146,3,5,221,103,289,247,17,1184,766
1637,16,3.3.121,0,530,2,69,121,190,121,0,190,239,-121,121,267,4,1,107,394,137,394,17,1184,766
1637,16,4.2.239,0,511,0,8,239,247,213,26,247,247,0,95,146,3,5,39,103,43,247,17,1184,766
1637,16,5.3.239,0,511,0,88,239,327,239,0,327,327,-239,239,385,4,1,163,394,311,394,17,1184,766
1637,17,0.3.174,0,536,2,64,174,238,174,0,238,334,-174,174,320,4,1,79,394,187,394,18,1184,671
1637,17,1.3.91,0,518,0,68,91,159,91,0,159,334,-91,91,237,4,1,157,394,217,394,18,1184,671
1637,17,2.3.334,0,518,0,89,334,423,334,0,423,423,-334,334,480,4,1,126,394,289,394,18,1184,671
1637,17,3.3.121,0,530,1,69,121,190,121,0,190,334,-121,121,267,4,1,107,394,137,394,18,1184,671
1637,17,4.2.334,1,518,0,8,334,342,213,121,342,342,0,95,146,3,6,39,8,43,247,18,1184,671
1637,17,5.3.239,0,518,0,88,239,327,239,0,327,334,-239,239,385,4,1,163,394,311,394,18,1184,671
1637,18,0.3.174,0,536,3,64,174,238,174,0,238,342,-174,174,320,4,1,79,394,187,394,19,1184,663
1637,18,1.3.91,1,518,0,68,91,159,91,0,159,342,-91,91,237,4,1,157,394,217,394,19,1184,663
1637,18,2.3.334,0,518,0,89,334,423,334,0,423,423,-334,334,480,4,1,126,394,289,394,19,1184,663
1637,18,3.3.121,0,530,2,69,121,190,121,0,190,342,-121,121,267,4,1,107,394,137,394,19,1184,663
1637,18,4.3.342,0,526,1,16,342,358,342,0,358,358,-342,342,488,4,1,31,394,43,394,19,1184,663
1637,18,5.3.239,0,518,0,88,239,327,239,0,327,342,-239,239,385,4,1,163,394,311,394,19,1184,663
1637,19,0.3.174,0,536,2,64,174,238,174,0,238,342,-15,106,252,4,2,79,326,187,394,20,1184,595
1637,19,1.4.159,1,518,0,89,159,248,159,0,248,342,-159,159,396,5,1,89,269,217,269,20,1184,595
1637,19,2.3.334,0,518,0,89,334,423,334,0,423,423,-175,266,412,4,2,126,326,289,394,20,1184,595
1637,19,3.3.159,0,518,0,69,159,228,121,38,228,342,0,91,237,4,2,107,326,137,394,20,1184,595
1637,19,4.3.342,0,526,1,16,342,358,342,0,358,358,-183,274,420,4,2,31,326,43,394,20,1184,595
1637,19,5.3.239,0,518,0,88,239,327,239,0,327,342,-80,171,317,4,2,163,326,311,394,20,1184,595
1637,20,0.3.174,0,536,2,64,174,238,174,0,238,342,-15,106,411,4,2,79,326,187,394,21,1184,506
1637,20,2.3.334,0,518,0,89,334,423,334,0,423,423,-175,266,571,4,2,126,326,289,394,21,1184,506
1637,20,3.3.159,1,518,0,69,159,228,121,38,228,342,0,91,396,4,2,107,326,137,394,21,1184,506
1637,20,4.3.342,0,526,1,16,342,358,342,0,358,358,-183,274,579,4,2,31,326,43,394,21,1184,506
1637,20,5.3.239,0,518,0,88,239,327,239,0,327,342,-80,171,476,4,2,163,326,311,394,21,1184,506
1637,21,0.3.228,0,521,1,64,228,292,174,54,292,342,0,91,396,4,3,79,257,187,394,22,1184,437
1637,21,2.3.334,0,518,0,89,334,423,334,0,423,423,-106,197,502,4,3,126,257,289,394,22,1184,437
1637,21,3.4.248,1,518,0,38,248,286,228,20,286,342,0,159,396,5,2,38,180,137,269,22,1184,437
1637,21,4.3.342,0,526,2,16,342,358,342,0,358,358,-114,205,510,4,3,31,257,43,394,22,1184,437
1637,21,5.3.239,0,518,0,88,239,327,239,0,327,342,-11,102,407,4,3,163,257,311,394,22,1184,437
1637,22,0.3.228,1,521,1,64,228,292,174,54,292,342,0,91,396,4,3,79,257,187,394,23,1184,399
1637,22,2.3.334,0,518,0,89,334,423,334,0,423,423,-106,197,502,4,3,126,257,289,394,23,1184,399
1637,22,4.3.342,0,526,2,16,342,358,342,0,358,358,-114,205,510,4,3,31,257,43,394,23,1184,399
1637,22,5.3.239,0,518,0,88,239,327,239,0,327,342,-11,102,407,4,3,163,257,311,394,23,1184,399
1637,23,0.4.292,1,521,0,15,292,307,292,0,307,342,-6,165,402,5,3,15,142,187,269,24,1184,335
1637,23,2.3.334,0,601,2,89,334,423,334,0,423,423,-42,133,438,4,4,126,193,289,394,24,1184,335
1637,23,4.3.342,0,572,1,16,342,358,342,0,358,358,-50,141,446,4,4,31,193,43,394,24,1184,335
1637,23,5.3.292,0,521,0,88,292,380,239,53,380,380,0,91,396,4,4,163,193,311,394,24,1184,335
1637,24,2.3.334,0,601,2,89,334,423,334,0,423,423,-42,133,444,4,4,126,193,289,394,25,1184,320
1637,24,4.3.342,0,572,1,16,342,358,342,0,358,358,-50,141,452,4,4,31,193,43,394,25,1184,320
1637,24,5.3.292,1,521,0,88,292,380,239,53,380,380,0,91,402,4,4,163,193,311,394,25,1184,320
1637,25,2.3.380,0,521,0,89,380,469,334,46,469,469,0,91,402,4,5,126,105,289,394,26,1184,232
1637,25,4.3.380,0,522,1,16,380,396,342,38,396,396,0,91,402,4,5,31,105,43,394,26,1184,232
1637,25,5.4.380,1,521,0,75,380,455,380,0,455,455,-73,238,475,5,4,75,127,311,269,26,1184,232
1637,26,2.3.380,1,521,0,89,380,469,334,46,469,469,0,91,475,4,5,126,105,289,394,27,1184,157
1637,26,4.3.380,0,522,1,16,380,396,342,38,396,455,0,91,475,4,5,31,105,43,394,27,1184,157
1637,27,2.4.469,1,521,0,37,469,506,469,0,506,506,-14,252,489,5,5,37,52,289,269,28,1184,68
1637,27,4.3.469,0,521,0,16,469,485,342,127,485,485,0,91,475,4,6,31,16,43,394,28,1184,68
1637,28,4.3.469,1,521,0,16,469,485,342,127,485,506,0,91,489,4,6,31,16,43,394,29,1184,31
1637,29,4.4.506,1,521,0,15,506,521,485,21,521,521,0,252,489,5,6,15,15,43,269,30,1184,15
1638,0,0.0.0,0,539,1,29,0,29,0,0,29,29,0,0,0,1,1,230,224,230,224,1,1450,1450
1638,0,1.0.0,0,602,4,81,0,81,0,0,81,81,0,0,0,1,1,316,224,316,224,1,1450,1450
1638,0,2.0.0,0,537,0,1,0,1,0,0,1,1,0,0,0,1,1,117,224,117,224,1,1450,1450
1638,0,3.0.0,0,575,3,54,0,54,0,0,54,54,0,0,0,1,1,296,224,296,224,1,1450,1450
1638,0,4.0.0,0,537,0,24,0,24,0,0,24,24,0,0,0,1,1,178,224,178,224,1,1450,1450
1638,0,5.0.0,1,572,2,35,0,35,0,0,35,35,0,0,0,1,1,313,224,313,224,1,1450,1450
1638,1,0.0.35,1,574,1,29,35,64,0,35,64,64,0,0,0,1,2,230,189,230,224,2,1450,1415
1638,1,1.0.35,0,608,4,81,35,116,0,35,116,116,0,0,0,1,2,316,189,316,224,2,1450,1415
1638,1,2.0.35,0,572,0,1,35,36,0,35,36,36,0,0,0,1,2,117,189,117,224,2,1450,1415
1638,1,3.0.35,0,588,3,54,35,89,0,35,89,89,0,0,0,1,2,296,189,296,224,2,1450,1415
1638,1,4.0.35,0,572,0,24,35,59,0,35,59,59,0,0,0,1,2,178,189,178,224,2,1450,1415
1638,1,5.1.35,0,586,2,73,35,108,35,0,108,108,-35,35,35,2,1,278,264,313,264,2,1450,1415
1638,2,0.1.64,0,574,0,7,64,71,64,0,71,71,-64,64,64,2,1,201,264,230,264,3,1450,1386
1638,2,1.0.64,0,596,2,81,64,145,0,64,145,145,0,0,0,1,3,316,160,316,224,3,1450,1386
1638,2,2.0.64,0,574,0,1,64,65,0,64,65,65,0,0,0,1,3,117,160,117,224,3,1450,1386
1638,2,3.0.64,1,596,2,54,64,118,0,64,118,118,0,0,0,1,3,296,160,296,224,3,1450,1386
1638,2,4.0.64,0,574,0,24,64,88,0,64,88,88,0,0,0,1,3,178,160,178,224,3,1450,1386
1638,2,5.1.35,0,586,1,73,35,108,35,0,108,108,-35,35,35,2,1,278,264,313,264,3,1450,1386
1638,3,0.1.64,0,596,0,7,64,71,64,0,71,118,-64,64,64,2,1,201,264,230,264,4,1450,1332
1638,3,1.0.118,0,612,2,81,118,199,0,118,199,199,0,0,0,1,4,316,106,316,224,4,1450,1332
1638,3,2.0.118,1,596,0,1,118,119,0,118,119,119,0,0,0,1,4,117,106,117,224,4,1450,1332
1638,3,3.1.118,0,596,0,52,118,170,118,0,170,170,-118,118,118,2,1,242,264,296,264,4,1450,1332
1638,3,4.0.118,0,596,0,24,118,142,0,118,142,142,0,0,0,1,4,178,106,178,224,4,1450,1332
1638,3,5.1.35,0,610,1,73,35,108,35,0,108,118,-35,35,35,2,1,278,264,313,264,4,1450,1332
1638,4,0.1.64,0,596,0,7,64,71,64,0,71,119,-64,64,64,2,1,201,264,230,264,5,1450,1331
1638,4,1.0.119,0,612,2,81,119,200,0,119,200,200,0,0,0,1,5,316,105,316,224,5,1450,1331
1638,4,2.1.119,0,596,0,7,119,126,119,0,126,126,-119,119,119,2,1,116,264,117,264,5,1450,1331
1638,4,3.1.118,0,596,0,52,118,170,118,0,170,170,-118,118,118,2,1,242,264,296,264,5,1450,1331
1638,4,4.0.119,1,596,0,24,119,143,0,119,143,143,0,0,0,1,5,178,105,178,224,5,1450,1331
1638,4,5.1.35,0,611,1,73,35,108,35,0,108,119,-35,35,35,2,1,278,264,313,264,5,1450,1331
1638,5,0.1.64,0,596,0,7,64,71,64,0,71,143,-64,64,64,2,1,201,264,230,264,6,1450,1307
1638,5,1.0.143,1,596,0,81,143,224,0,143,224,224,0,0,0,1,6,316,81,316,224,6,1450,1307
1638,5,2.1.119,0,596,0,7,119,126,119,0,126,143,-119,119,119,2,1,116,264,117,264,6,1450,1307
1638,5,3.1.118,0,596,0,52,118,170,118,0,170,170,-118,118,118,2,1,242,264,296,264,6,1450,1307
1638,5,4.1.143,0,603,1,53,143,196,143,0,196,196,-143,143,143,2,1,154,264,178,264,6,1450,1307
1638,5,5.1.35,0,611,2,73,35,108,35,0,108,143,-35,35,35,2,1,278,264,313,264,6,1450,1307
1638,6,0.1.64,1,596,0,7,64,71,64,0,71,224,-64,64,64,2,1,201,264,230,264,7,1450,1226
1638,6,1.1.224,0,596,0,72,224,296,224,0,296,296,-224,224,224,2,1,235,264,316,264,7,1450,1226
1638,6,2.1.119,0,596,0,7,119,126,119,0,126,224,-119,119,119,2,1,116,264,117,264,7,1450,1226
1638,6,3.1.118,0,596,0,52,118,170,118,0,170,224,-118,118,118,2,1,242,264,296,264,7,1450,1226
1638,6,4.1.143,0,603,1,53,143,196,143,0,196,224,-143,143,143,2,1,154,264,178,264,7,1450,1226
1638,6,5.1.35,0,611,2,73,35,108,35,0,108,224,-35,35,35,2,1,278,264,313,264,7,1450,1226
1638,7,0.2.71,0,596,0,56,71,127,71,0,127,224,-71,71,135,3,1,194,313,230,313,8,1450,1219
1638,7,1.1.224,0,596,0,72,224,296,224,0,296,296,-153,217,217,2,2,235,257,316,264,8,1450,1219
1638,7,2.1.119,0,596,0,7,119,126,119,0,126,224,-48,112,112,2,2,116,257,117,264,8,1450,1219
1638,7,3.1.118,0,596,0,52,118,170,118,0,170,224,-47,111,111,2,2,242,257,296,264,8,1450,1219
1638,7,4.1.143,0,603,1,53,143,196,143,0,196,224,-72,136,136,2,2,154,257,178,264,8,1450,1219
1638,7,5.1.71,1,596,0,73,71,144,35,36,144,224,0,64,64,2,2,278,257,313,264,8,1450,1219
1638,8,0.2.71,0,596,0,56,71,127,71,0,127,224,-71,71,135,3,1,194,313,230,313,9,1450,1146
1638,8,1.1.224,0,596,0,72,224,296,224,0,296,296,-80,144,144,2,3,235,184,316,264,9,1450,1146
1638,8,2.1.144,0,596,0,7,144,151,119,25,151,224,0,64,64,2,3,116,184,117,264,9,1450,1146
1638,8,3.1.144,1,597,1,52,144,196,118,26,196,224,0,64,64,2,3,242,184,296,264,9,1450,1146
1638,8,4.1.144,0,596,0,53,144,197,143,1,197,224,0,64,64,2,3,154,184,178,264,9,1450,1146
1638,8,5.2.144,0,596,0,65,144,209,144,0,209,224,-144,144,208,3,1,205,313,313,313,9,1450,1146
1638,9,0.2.71,0,597,0,56,71,127,71,0,127,224,-71,71,135,3,1,194,313,230,313,10,1450,1094
1638,9,1.1.224,0,613,2,72,224,296,224,0,296,296,-28,92,92,2,4,235,132,316,264,10,1450,1094
1638,9,2.1.196,1,604,1,7,196,203,119,77,203,224,0,64,64,2,4,116,132,117,264,10,1450,1094
1638,9,3.2.196,0,626,3,82,196,278,196,0,278,278,-196,196,260,3,1,190,313,296,313,10,1450,1094
1638,9,4.1.196,0,597,0,53,196,249,143,53,249,249,0,64,64,2,4,154,132,178,264,10,1450,1094
1638,9,5.2.144,0,597,0,65,144,209,144,0,209,224,-144,144,208,3,1,205,313,313,313,10,1450,1094
1638,10,0.2.71,0,604,0,56,71,127,71,0,127,224,-71,71,135,3,1,194,313,230,313,11,1450,1087
1638,10,1.1.224,0,613,1,72,224,296,224,0,296,296,-21,85,85,2,5,235,125,316,264,11,1450,1087
1638,10,2.2.203,0,619,2,48,203,251,203,0,251,251,-203,203,267,3,1,109,313,117,313,11,1450,1087
1638,10,3.2.196,0,626,3,82,196,278,196,0,278,278,-196,196,260,3,1,190,313,296,313,11,1450,1087
1638,10,4.1.203,1,604,0,53,203,256,143,60,256,256,0,64,64,2,5,154,125,178,264,11,1450,1087
1638,10,5.2.144,0,604,0,65,144,209,144,0,209,224,-144,144,208,3,1,205,313,313,313,11,1450,1087
1638,11,0.2.71,0,604,0,56,71,127,71,0,127,256,-71,71,135,3,1,194,313,230,313,12,1450,1034
1638,11,1.1.256,1,604,0,72,256,328,224,32,328,328,0,64,64,2,6,235,72,316,264,12,1450,1034
1638,11,2.2.203,0,619,1,48,203,251,203,0,251,256,-203,203,267,3,1,109,313,117,313,12,1450,1034
1638,11,3.2.196,0,626,2,82,196,278,196,0,278,278,-196,196,260,3,1,190,313,296,313,12,1450,1034
1638,11,4.2.256,0,604,0,8,256,264,256,0,264,264,-256,256,320,3,1,101,313,178,313,12,1450,1034
1638,11,5.2.144,0,604,0,65,144,209,144,0,209,256,-144,144,208,3,1,205,313,313,313,12,1450,1034
1638,12,0.2.71,1,604,0,56,71,127,71,0,127,328,-71,71,135,3,1,194,313,230,313,13,1450,962
1638,12,1.2.328,0,604,0,54,328,382,328,0,382,382,-328,328,392,3,1,163,313,316,313,13,1450,962
1638,12,2.2.203,0,619,1,48,203,251,203,0,251,328,-203,203,267,3,1,109,313,117,313,13,1450,962
1638,12,3.2.196,0,626,2,82,196,278,196,0,278,328,-196,196,260,3,1,190,313,296,313,13,1450,962
1638,12,4.2.256,0,604,0,8,256,264,256,0,264,328,-256,256,320,3,1,101,313,178,313,13,1450,962
1638,12,5.2.144,0,604,0,65,144,209,144,0,209,328,-144,144,208,3,1,205,313,313,313,13,1450,962
1638,13,0.3.127,1,604,0,71,127,198,127,0,198,328,-127,127,262,4,1,138,251,230,251,14,1450,906
1638,13,1.2.328,0,604,0,54,328,382,328,0,382,382,-201,272,336,3,2,163,257,316,313,14,1450,906
1638,13,2.2.203,0,619,1,48,203,251,203,0,251,328,-76,147,211,3,2,109,257,117,313,14,1450,906
1638,13,3.2.196,0,626,2,82,196,278,196,0,278,328,-69,140,204,3,2,190,257,296,313,14,1450,906
1638,13,4.2.256,0,604,0,8,256,264,256,0,264,328,-129,200,264,3,2,101,257,178,313,14,1450,906
1638,13,5.2.144,0,604,0,65,144,209,144,0,209,328,-17,88,152,3,2,205,257,313,313,14,1450,906
1638,14,0.4.198,0,604,0,67,198,265,198,0,265,328,-198,198,460,5,1,67,398,230,398,15,1450,835
1638,14,1.2.328,0,604,0,54,328,382,328,0,382,382,-201,272,463,3,2,163,257,316,313,15,1450,835
1638,14,2.2.203,0,619,1,48,203,251,203,0,251,328,-76,147,338,3,2,109,257,117,313,15,1450,835
1638,14,3.2.196,0,626,2,82,196,278,196,0,278,328,-69,140,331,3,2,190,257,296,313,15,1450,835
1638,14,4.2.256,0,604,0,8,256,264,256,0,264,328,-129,200,391,3,2,101,257,178,313,15,1450,835
1638,14,5.2.144,1,604,0,65,144,209,144,0,209,328,-17,88,279,3,2,205,257,313,313,15,1450,835
1638,15,0.4.198,0,604,0,67,198,265,198,0,265,328,-198,198,477,5,1,67,398,230,398,16,1450,770
1638,15,1.2.328,0,604,0,54,328,382,328,0,382,382,-119,207,398,3,3,163,192,316,313,16,1450,770
1638,15,2.2.209,0,605,1,48,209,257,203,6,257,328,0,88,279,3,3,109,192,117,313,16,1450,770
1638,15,3.2.209,0,613,2,82,209,291,196,13,291,328,0,88,279,3,3,190,192,296,313,16,1450,770
1638,15,4.2.256,0,604,0,8,256,264,256,0,264,328,-47,135,326,3,3,101,192,178,313,16,1450,770
1638,15,5.3.209,1,613,2,73,209,282,209,0,282,328,-11,138,290,4,2,140,180,313,251,16,1450,770
1638,16,0.4.198,0,613,0,67,198,265,198,0,265,328,-198,198,488,5,1,67,398,230,398,17,1450,697
1638,16,1.2.328,0,613,0,54,328,382,328,0,382,382,-119,207,409,3,3,163,192,316,313,17,1450,697
1638,16,2.2.209,0,613,0,48,209,257,203,6,257,328,0,88,290,3,3,109,192,117,313,17,1450,697
1638,16,3.2.209,1,613,0,82,209,291,196,13,291,328,0,88,290,3,3,190,192,296,313,17,1450,697
1638,16,4.2.256,0,613,0,8,256,264,256,0,264,328,-47,135,337,3,3,101,192,178,313,17,1450,697
1638,16,5.4.282,0,613,0,67,282,349,282,0,349,349,-282,282,572,5,1,67,398,313,398,17,1450,697
1638,17,0.4.198,0,613,0,67,198,265,198,0,265,328,-198,198,488,5,1,67,398,230,398,18,1450,615
1638,17,1.2.328,0,613,0,54,328,382,328,0,382,382,-37,125,327,3,4,163,110,316,313,18,1450,615
1638,17,2.2.291,0,613,0,48,291,339,203,88,339,339,0,88,290,3,4,109,110,117,313,18,1450,615
1638,17,3.3.291,1,613,0,29,291,320,291,0,320,328,-9,147,299,4,3,108,107,296,251,18,1450,615
1638,17,4.2.291,0,613,0,8,291,299,256,35,299,328,0,88,290,3,4,101,110,178,313,18,1450,615
1638,17,5.4.282,0,613,0,67,282,349,282,0,349,349,-282,282,572,5,1,67,398,313,398,18,1450,615
1638,18,0.4.198,0,613,0,67,198,265,198,0,265,328,-198,198,497,5,1,67,398,230,398,19,1450,586
1638,18,1.2.328,0,613,0,54,328,382,328,0,382,382,-37,125,336,3,4,163,110,316,313,19,1450,586
1638,18,2.2.291,0,613,0,48,291,339,203,88,339,339,0,88,299,3,4,109,110,117,313,19,1450,586
1638,18,3.4.320,0,651,1,79,320,399,320,0,399,399,-320,320,619,5,1,79,398,296,398,19,1450,586
1638,18,4.2.291,1,613,0,8,291,299,256,35,299,328,0,88,299,3,4,101,110,178,313,19,1450,586
1638,18,5.4.282,0,613,0,67,282,349,282,0,349,349,-282,282,581,5,1,67,398,313,398,19,1450,586
1638,19,0.4.198,0,613,0,67,198,265,198,0,265,328,-198,198,497,5,1,67,398,230,398,20,1450,578
1638,19,1.2.328,0,613,0,54,328,382,328,0,382,382,-29,117,328,3,5,163,102,316,313,20,1450,578
1638,19,2.2.299,0,613,0,48,299,347,203,96,347,347,0,88,299,3,5,109,102,117,313,20,1450,578
1638,19,3.4.320,0,651,1,79,320,399,320,0,399,399,-320,320,619,5,1,79,398,296,398,20,1450,578
1638,19,4.3.320,1,613,0,9,320,329,299,21,329,329,0,147,299,4,4,93,78,178,251,20,1450,578
1638,19,5.4.282,0,613,0,67,282,349,282,0,349,349,-282,282,581,5,1,67,398,313,398,20,1450,578
1638,20,0.4.198,0,613,0,67,198,265,198,0,265,329,-198,198,497,5,1,67,398,230,398,21,1450,569
1638,20,1.2.328,0,613,0,54,328,382,328,0,382,382,-29,117,328,3,5,163,102,316,313,21,1450,569
1638,20,2.2.299,1,613,0,48,299,347,203,96,347,347,0,88,299,3,5,109,102,117,313,21,1450,569
1638,20,3.4.320,0,651,1,79,320,399,320,0,399,399,-320,320,619,5,1,79,398,296,398,21,1450,569
1638,20,4.4.329,0,660,2,84,329,413,329,0,413,413,-329,329,628,5,1,84,398,178,398,21,1450,569
1638,20,5.4.282,0,613,0,67,282,349,282,0,349,349,-282,282,581,5,1,67,398,313,398,21,1450,569
1638,21,0.4.198,0,613,0,67,198,265,198,0,265,347,-198,198,497,5,1,67,398,230,398,22,1450,521
1638,21,1.2.347,1,613,0,54,347,401,328,19,401,401,0,88,299,3,6,163,54,316,313,22,1450,521
1638,21,2.3.347,0,613,0,58,347,405,347,0,405,405,-18,165,317,4,5,61,69,117,251,22,1450,521
1638,21,3.4.320,0,651,1,79,320,399,320,0,399,399,-320,320,619,5,1,79,398,296,398,22,1450,521
1638,21,4.4.329,0,660,2,84,329,413,329,0,413,413,-329,329,628,5,1,84,398,178,398,22,1450,521
1638,21,5.4.282,0,613,0,67,282,349,282,0,349,349,-282,282,581,5,1,67,398,313,398,22,1450,521
1638,22,0.4.198,0,613,0,67,198,265,198,0,265,401,-198,198,497,5,1,67,398,230,398,23,1450,467
1638,22,1.3.401,1,613,0,11,401,412,401,0,412,412,-72,219,371,4,5,109,69,316,251,23,1450,467
1638,22,2.3.347,0,613,0,58,347,405,347,0,405,405,-18,165,317,4,5,61,69,117,251,23,1450,467
1638,22,3.4.320,0,651,1,79,320,399,320,0,399,401,-320,320,619,5,1,79,398,296,398,23,1450,467
1638,22,4.4.329,0,660,2,84,329,413,329,0,413,413,-329,329,628,5,1,84,398,178,398,23,1450,467
1638,22,5.4.282,0,613,0,67,282,349,282,0,349,401,-282,282,581,5,1,67,398,313,398,23,1450,467
1638,23,0.4.198,0,613,0,67,198,265,198,0,265,412,-198,198,569,5,1,67,398,230,398,24,1450,456
1638,23,1.4.412,0,664,3,98,412,510,412,0,510,510,-412,412,783,5,1,98,398,316,398,24,1450,456
1638,23,2.3.412,1,613,0,58,412,470,347,65,470,470,0,219,371,4,6,61,58,117,251,24,1450,456
1638,23,3.4.320,0,651,1,79,320,399,320,0,399,412,-320,320,691,5,1,79,398,296,398,24,1450,456
1638,23,4.4.329,0,660,2,84,329,413,329,0,413,413,-329,329,700,5,1,84,398,178,398,24,1450,456
1638,23,5.4.282,0,613,0,67,282,349,282,0,349,412,-282,282,653,5,1,67,398,313,398,24,1450,456
1638,24,0.4.198,1,613,0,67,198,265,198,0,265,470,-198,198,569,5,1,67,398,230,398,25,1450,398
1638,24,1.4.412,0,664,4,98,412,510,412,0,510,510,-412,412,783,5,1,98,398,316,398,25,1450,398
1638,24,2.4.470,0,650,1,3,470,473,470,0,473,473,-470,470,841,5,1,3,398,117,398,25,1450,398
1638,24,3.4.320,0,651,2,79,320,399,320,0,399,470,-320,320,691,5,1,79,398,296,398,25,1450,398
1638,24,4.4.329,0,660,3,84,329,413,329,0,413,470,-329,329,700,5,1,84,398,178,398,25,1450,398
1638,24,5.4.282,0,613,0,67,282,349,282,0,349,470,-282,282,653,5,1,67,398,313,398,25,1450,398
1638,25,1.4.412,0,664,4,98,412,510,412,0,510,510,-147,345,716,5,2,98,331,316,398,26,1450,331
1638,25,2.4.470,0,650,1,3,470,473,470,0,473,473,-205,403,774,5,2,3,331,117,398,26,1450,331
1638,25,3.4.320,0,651,2,79,320,399,320,0,399,470,-55,253,624,5,2,79,331,296,398,26,1450,331
1638,25,4.4.329,0,660,3,84,329,413,329,0,413,470,-64,262,633,5,2,84,331,178,398,26,1450,331
1638,25,5.4.282,1,613,0,67,282,349,282,0,349,470,-17,215,586,5,2,67,331,313,398,26,1450,331
1638,26,1.4.412,0,676,2,98,412,510,412,0,510,510,-63,278,649,5,3,98,264,316,398,27,1450,264
1638,26,2.4.470,0,650,1,3,470,473,470,0,473,473,-121,336,707,5,3,3,264,117,398,27,1450,264
1638,26,3.4.349,1,613,0,79,349,428,320,29,428,470,0,215,586,5,3,79,264,296,398,27,1450,264
1638,26,4.4.349,0,613,0,84,349,433,329,20,433,470,0,215,586,5,3,84,264,178,398,27,1450,264
1638,27,1.4.428,0,613,0,98,428,526,412,16,526,526,0,215,586,5,4,98,185,316,398,28,1450,185
1638,27,2.4.470,0,655,1,3,470,473,470,0,473,473,-42,257,628,5,4,3,185,117,398,28,1450,185
1638,27,4.4.428,1,613,0,84,428,512,329,99,512,512,0,215,586,5,4,84,185,178,398,28,1450,185
1638,28,1.4.512,0,613,0,98,512,610,412,100,610,610,0,215,586,5,5,98,101,316,398,29,1450,101
1638,28,2.4.512,1,613,0,3,512,515,470,42,515,515,0,215,586,5,5,3,101,117,398,29,1450,101
1638,29,1.4.515,1,613,0,98,515,613,412,103,613,613,0,215,586,5,6,98,98,316,398,30,1450,98
1639,0,0.0.0,0,512,2,42,0,42,0,0,42,42,0,0,0,1,1,273,239,273,239,1,1321,1321
1639,0,1.0.0,0,534,5,57,0,57,0,0,57,57,0,0,0,1,1,217,239,217,239,1,1321,1321
1639,0,2.0.0,0,524,4,47,0,47,0,0,47,47,0,0,0,1,1,243,239,243,239,1,1321,1321
1639,0,3.0.0,1,477,0,7,0,7,0,0,7,7,0,0,0,1,1,255,239,255,239,1,1321,1321
1639,0,4.0.0,0,518,3,46,0,46,0,0,46,46,0,0,0,1,1,117,239,117,239,1,1321,1321
1639,0,5.0.0,0,510,1,40,0,40,0,0,40,40,0,0,0,1,1,216,239,216,239,1,1321,1321
1639,1,0.0.7,1,477,0,42,7,49,0,7,49,49,0,0,0,1,2,273,232,273,239,2,1321,1314
1639,1,1.0.7,0,488,2,57,7,64,0,7,64,64,0,0,0,1,2,217,232,217,239,2,1321,1314
1639,1,2.0.7,0,484,1,47,7,54,0,7,54,54,0,0,0,1,2,243,232,243,239,2,1321,1314
1639,1,3.1.7,0,477,0,90,7,97,7,0,97,97,-7,7,7,2,1,248,365,255,365,2,1321,1314
1639,1,4.0.7,0,477,0,46,7,53,0,7,53,53,0,0,0,1,2,117,232,117,239,2,1321,1314
1639,1,5.0.7,0,477,0,40,7,47,0,7,47,47,0,0,0,1,2,216,232,216,239,2,1321,1314
1639,2,0.1.49,0,519,3,74,49,123,49,0,123,123,-49,49,49,2,1,231,365,273,365,3,1321,1272
1639,2,1.0.49,0,481,1,57,49,106,0,49,106,106,0,0,0,1,3,217,190,217,239,3,1321,1272
1639,2,2.0.49,1,484,2,47,49,96,0,49,96,96,0,0,0,1,3,243,190,243,239,3,1321,1272
1639,2,3.1.7,0,477,0,90,7,97,7,0,97,97,-7,7,7,2,1,248,365,255,365,3,1321,1272
1639,2,4.0.49,0,477,0,46,49,95,0,49,95,95,0,0,0,1,3,117,190,117,239,3,1321,1272
1639,2,5.0.49,0,477,0,40,49,89,0,49,89,89,0,0,0,1,3,216,190,216,239,3,1321,1272
1639,3,0.1.49,0,526,2,74,49,123,49,0,123,123,-49,49,49,2,1,231,365,273,365,4,1321,1225
1639,3,1.0.96,0,500,1,57,96,153,0,96,153,153,0,0,0,1,4,217,143,217,239,4,1321,1225
1639,3,2.1.96,0,616,3,99,96,195,96,0,195,195,-96,96,96,2,1,196,365,243,365,4,1321,1225
1639,3,3.1.7,0,484,0,90,7,97,7,0,97,97,-7,7,7,2,1,248,365,255,365,4,1321,1225
1639,3,4.0.96,0,484,0,46,96,142,0,96,142,142,0,0,0,1,4,117,143,117,239,4,1321,1225
1639,3,5.0.96,1,484,0,40,96,136,0,96,136,136,0,0,0,1,4,216,143,216,239,4,1321,1225
1639,4,0.1.49,0,526,3,74,49,123,49,0,123,136,-49,49,49,2,1,231,365,273,365,5,1321,1185
1639,4,1.0.136,1,493,1,57,136,193,0,136,193,193,0,0,0,1,5,217,103,217,239,5,1321,1185
1639,4,2.1.96,0,616,4,99,96,195,96,0,195,195,-96,96,96,2,1,196,365,243,365,5,1321,1185
1639,4,3.1.7,0,484,0,90,7,97,7,0,97,136,-7,7,7,2,1,248,365,255,365,5,1321,1185
1639,4,4.0.136,0,484,0,46,136,182,0,136,182,182,0,0,0,1,5,117,103,117,239,5,1321,1185
1639,4,5.1.136,0,516,2,56,136,192,136,0,192,192,-136,136,136,2,1,176,365,216,365,5,1321,1185
1639,5,0.1.49,0,532,3,74,49,123,49,0,123,193,-49,49,49,2,1,231,365,273,365,6,1321,1128
1639,5,1.1.193,0,519,2,41,193,234,193,0,234,234,-193,193,193,2,1,160,365,217,365,6,1321,1128
1639,5,2.1.96,0,616,4,99,96,195,96,0,195,195,-96,96,96,2,1,196,365,243,365,6,1321,1128
1639,5,3.1.7,0,493,0,90,7,97,7,0,97,193,-7,7,7,2,1,248,365,255,365,6,1321,1128
1639,5,4.0.193,1,493,0,46,193,239,0,193,239,239,0,0,0,1,6,117,46,117,239,6,1321,1128
1639,5,5.1.136,0,517,1,56,136,192,136,0,192,193,-136,136,136,2,1,176,365,216,365,6,1321,1128
1639,6,0.1.49,0,532,3,74,49,123,49,0,123,239,-49,49,49,2,1,231,365,273,365,7,1321,1082
1639,6,1.1.193,0,519,2,41,193,234,193,0,234,239,-193,193,193,2,1,160,365,217,365,7,1321,1082
1639,6,2.1.96,0,616,4,99,96,195,96,0,195,239,-96,96,96,2,1,196,365,243,365,7,1321,1082
1639,6,3.1.7,1,493,0,90,7,97,7,0,97,239,-7,7,7,2,1,248,365,255,365,7,1321,1082
1639,6,4.1.239,0,493,0,5,239,244,239,0,244,244,-239,239,239,2,1,71,365,117,365,7,1321,1082
1639,6,5.1.136,0,517,1,56,136,192,136,0,192,239,-136,136,136,2,1,176,365,216,365,7,1321,1082
1639,7,0.1.97,0,493,0,74,97,171,49,48,171,239,0,7,7,2,2,231,275,273,365,8,1321,992
1639,7,1.1.193,0,519,2,41,193,234,193,0,234,239,-96,103,103,2,2,160,275,217,365,8,1321,992
1639,7,2.1.97,0,528,3,99,97,196,96,1,196,239,0,7,7,2,2,196,275,243,365,8,1321,992
1639,7,3.2.97,1,493,0,49,97,146,97,0,146,239,-97,97,104,3,1,158,183,255,183,8,1321,992
1639,7,4.1.239,0,493,0,5,239,244,239,0,244,244,-142,149,149,2,2,71,275,117,365,8,1321,992
1639,7,5.1.136,0,517,1,56,136,192,136,0,192,239,-39,46,46,2,2,176,275,216,365,8,1321,992
1639,8,0.1.97,0,493,0,74,97,171,49,48,171,239,0,7,104,2,2,231,275,273,365,9,1321,943
1639,8,1.1.193,0,519,2,41,193,234,193,0,234,239,-96,103,200,2,2,160,275,217,365,9,1321,943
1639,8,2.1.97,0,528,3,99,97,196,96,1,196,239,0,7,104,2,2,196,275,243,365,9,1321,943
1639,8,3.3.146,1,493,0,87,146,233,146,0,233,239,-146,146,250,4,1,109,303,255,303,9,1321,943
1639,8,4.1.239,0,493,0,5,239,244,239,0,244,244,-142,149,246,2,2,71,275,117,365,9,1321,943
1639,8,5.1.136,0,517,1,56,136,192,136,0,192,239,-39,46,143,2,2,176,275,216,365,9,1321,943
1639,9,0.1.97,0,493,0,74,97,171,49,48,171,239,0,7,250,2,2,231,275,273,365,10,1321,856
1639,9,1.1.193,0,519,2,41,193,234,193,0,234,239,-96,103,346,2,2,160,275,217,365,10,1321,856
1639,9,2.1.97,0,528,3,99,97,196,96,1,196,239,0,7,250,2,2,196,275,243,365,10,1321,856
1639,9,3.4.233,1,493,0,22,233,255,233,0,255,255,-233,233,483,5,1,22,231,255,231,10,1321,856
1639,9,4.1.239,0,493,0,5,239,244,239,0,244,244,-142,149,392,2,2,71,275,117,365,10,1321,856
1639,9,5.1.136,0,517,1,56,136,192,136,0,192,239,-39,46,289,2,2,176,275,216,365,10,1321,856
1639,10,0.1.97,1,493,0,74,97,171,49,48,171,255,0,7,483,2,2,231,275,273,365,11,1321,834
1639,10,1.1.193,0,519,2,41,193,234,193,0,234,255,-96,103,579,2,2,160,275,217,365,11,1321,834
1639,10,2.1.97,0,528,3,99,97,196,96,1,196,255,0,7,483,2,2,196,275,243,365,11,1321,834
1639,10,4.1.239,0,493,0,5,239,244,239,0,244,255,-142,149,625,2,2,71,275,117,365,11,1321,834
1639,10,5.1.136,0,517,1,56,136,192,136,0,192,255,-39,46,522,2,2,176,275,216,365,11,1321,834
1639,11,0.2.171,1,493,0,60,171,231,171,0,231,255,-25,122,508,3,2,157,134,273,183,12,1321,760
1639,11,1.1.193,0,519,2,41,193,234,193,0,234,255,-22,29,505,2,3,160,201,217,365,12,1321,760
1639,11,2.1.171,0,508,1,99,171,270,96,75,270,270,0,7,483,2,3,196,201,243,365,12,1321,760
1639,11,4.1.239,0,493,0,5,239,244,239,0,244,255,-68,75,551,2,3,71,201,117,365,12,1321,760
1639,11,5.1.171,0,493,0,56,171,227,136,35,227,255,0,7,483,2,3,176,201,216,365,12,1321,760
1639,12,0.3.233,1,519,2,77,233,310,231,2,310,310,0,146,508,4,2,97,216,273,303,13,1321,700
1639,12,1.1.193,0,519,2,41,193,234,193,0,234,255,-22,29,530,2,3,160,201,217,365,13,1321,700
1639,12,2.1.171,0,508,1,99,171,270,96,75,270,270,0,7,508,2,3,196,201,243,365,13,1321,700
1639,12,4.1.239,0,493,0,5,239,244,239,0,244,255,-68,75,576,2,3,71,201,117,365,13,1321,700
1639,12,5.1.171,0,493,0,56,171,227,136,35,227,255,0,7,508,2,3,176,201,216,365,13,1321,700
1639,13,0.4.310,1,519,0,20,310,330,310,0,330,330,-55,288,563,5,2,20,209,273,231,14,1321,623
1639,13,1.1.193,0,519,0,41,193,234,193,0,234,310,-22,29,530,2,3,160,201,217,365,14,1321,623
1639,13,2.1.171,0,519,0,99,171,270,96,75,270,310,0,7,508,2,3,196,201,243,365,14,1321,623
1639,13,4.1.239,0,519,0,5,239,244,239,0,244,310,-68,75,576,2,3,71,201,117,365,14,1321,623
1639,13,5.1.171,0,519,0,56,171,227,136,35,227,310,0,7,508,2,3,176,201,216,365,14,1321,623
1639,14,1.1.193,0,519,0,41,193,234,193,0,234,330,-22,29,585,2,3,160,201,217,365,15,1321,603
1639,14,2.1.171,0,519,0,99,171,270,96,75,270,330,0,7,563,2,3,196,201,243,365,15,1321,603
1639,14,4.1.239,0,519,0,5,239,244,239,0,244,330,-68,75,631,2,3,71,201,117,365,15,1321,603
1639,14,5.1.171,1,519,0,56,171,227,136,35,227,330,0,7,563,2,3,176,201,216,365,15,1321,603
1639,15,1.1.227,0,519,0,41,227,268,193,34,268,330,0,7,563,2,4,160,145,217,365,16,1321,547
1639,15,2.1.227,0,531,1,99,227,326,96,131,326,330,0,7,563,2,4,196,145,243,365,16,1321,547
1639,15,4.1.239,0,519,0,5,239,244,239,0,244,330,-12,19,575,2,4,71,145,117,365,16,1321,547
1639,15,5.2.231,1,519,0,4,231,235,227,4,235,330,0,122,563,3,3,120,74,216,183,16,1321,547
1639,16,1.1.227,0,519,0,41,227,268,193,34,268,330,0,7,563,2,4,160,145,217,365,17,1321,543
1639,16,2.1.227,0,531,1,99,227,326,96,131,326,330,0,7,563,2,4,196,145,243,365,17,1321,543
1639,16,4.1.239,0,519,0,5,239,244,239,0,244,330,-12,19,575,2,4,71,145,117,365,17,1321,543
1639,16,5.3.310,1,557,2,58,310,368,235,75,368,368,0,146,563,4,3,116,139,216,303,17,1321,543
1639,17,1.1.227,0,557,0,41,227,268,193,34,268,368,0,7,563,2,4,160,145,217,365,18,1321,485
1639,17,2.1.227,0,557,0,99,227,326,96,131,326,368,0,7,563,2,4,196,145,243,365,18,1321,485
1639,17,4.1.239,0,557,0,5,239,244,239,0,244,368,-12,19,575,2,4,71,145,117,365,18,1321,485
1639,17,5.4.368,1,557,0,58,368,426,368,0,426,426,-38,326,601,5,3,58,189,216,231,18,1321,485
1639,18,1.1.227,1,557,0,41,227,268,193,34,268,426,0,7,601,2,4,160,145,217,365,19,1321,427
1639,18,2.1.227,0,557,0,99,227,326,96,131,326,426,0,7,601,2,4,196,145,243,365,19,1321,427
1639,18,4.1.239,0,557,0,5,239,244,239,0,244,426,-12,19,613,2,4,71,145,117,365,19,1321,427
1639,19,1.2.268,1,557,0,59,268,327,268,0,327,426,-33,155,634,3,4,119,70,217,183,20,1321,386
1639,19,2.1.268,0,557,0,99,268,367,96,172,367,426,0,7,601,2,5,196,104,243,365,20,1321,386
1639,19,4.1.268,0,557,0,5,268,273,239,29,273,426,0,7,601,2,5,71,104,117,365,20,1321,386
1639,20,1.3.368,1,557,0,52,368,420,327,41,420,426,0,146,634,4,4,60,81,217,303,21,1321,327
1639,20,2.1.268,0,557,0,99,268,367,96,172,367,426,0,7,634,2,5,196,104,243,365,21,1321,327
1639,20,4.1.268,0,557,0,5,268,273,239,29,273,426,0,7,634,2,5,71,104,117,365,21,1321,327
1639,21,1.4.426,1,557,0,8,426,434,420,6,434,434,0,326,634,5,4,8,131,217,231,22,1321,275
1639,21,2.1.268,0,557,0,99,268,367,96,172,367,426,0,7,634,2,5,196,104,243,365,22,1321,275
1639,21,4.1.268,0,557,0,5,268,273,239,29,273,426,0,7,634,2,5,71,104,117,365,22,1321,275
1639,22,2.1.268,1,557,0,99,268,367,96,172,367,434,0,7,634,2,5,196,104,243,365,23,1321,267
1639,22,4.1.268,0,557,0,5,268,273,239,29,273,434,0,7,634,2,5,71,104,117,365,23,1321,267
1639,23,2.2.367,1,557,0,2,367,369,367,0,369,434,-40,195,674,3,5,97,11,243,183,24,1321,168
1639,23,4.1.367,0,557,0,5,367,372,239,128,372,434,0,7,634,2,6,71,5,117,365,24,1321,168
1639,24,2.3.420,1,570,1,27,420,447,369,51,447,447,0,146,674,4,5,95,29,243,303,25,1321,166
1639,24,4.1.367,0,557,0,5,367,372,239,128,372,434,0,7,674,2,6,71,5,117,365,25,1321,166
1639,25,2.4.447,0,570,0,68,447,515,447,0,515,515,-13,339,687,5,5,68,123,243,231,26,1321,139
1639,25,4.1.367,1,570,0,5,367,372,239,128,372,447,0,7,674,2,6,71,5,117,365,26,1321,139
1639,26,2.4.447,0,570,0,68,447,515,447,0,515,515,-13,339,687,5,5,68,123,243,231,27,1321,134
1639,26,4.2.372,1,570,0,9,372,381,372,0,381,447,-3,198,677,3,6,66,9,117,183,27,1321,134
1639,27,2.4.447,0,570,0,68,447,515,447,0,515,515,-13,339,690,5,5,68,123,243,231,28,1321,125
1639,27,4.3.447,1,570,0,2,447,449,381,66,449,449,0,146,677,4,6,57,2,117,303,28,1321,125
1639,28,2.4.447,1,570,0,68,447,515,447,0,515,515,-13,339,690,5,5,68,123,243,231,29,1321,123
1639,28,4.4.449,0,572,1,55,449,504,449,0,504,504,-15,341,692,5,5,55,123,117,231,29,1321,123
1639,29,4.4.515,1,570,0,55,515,570,449,66,570,570,0,339,690,5,6,55,55,117,231,30,1321,55
1640,0,0.0.0,1,640,4,55,0,55,0,0,55,55,0,0,0,1,1,317,352,317,352,1,1586,1586
1640,0,1.0.0,0,613,0,32,0,32,0,0,32,32,0,0,0,1,1,216,352,216,352,1,1586,1586
1640,0,2.0.0,0,678,5,92,0,92,0,0,92,92,0,0,0,1,1,368,352,368,352,1,1586,1586
1640,0,3.0.0,0,628,3,60,0,60,0,0,60,60,0,0,0,1,1,214,352,214,352,1,1586,1586
1640,0,4.0.0,0,623,1,68,0,68,0,0,68,68,0,0,0,1,1,253,352,253,352,1,1586,1586
1640,0,5.0.0,0,625,2,45,0,45,0,0,45,45,0,0,0,1,1,218,352,218,352,1,1586,1586
1640,1,0.1.55,1,640,0,42,55,97,55,0,97,97,-55,55,55,2,1,262,268,317,268,2,1586,1531
1640,1,1.0.55,0,640,0,32,55,87,0,55,87,87,0,0,0,1,2,216,297,216,352,2,1586,1531
1640,1,2.0.55,0,649,2,92,55,147,0,55,147,147,0,0,0,1,2,368,297,368,352,2,1586,1531
1640,1,3.0.55,0,643,1,60,55,115,0,55,115,115,0,0,0,1,2,214,297,214,352,2,1586,1531
1640,1,4.0.55,0,649,2,68,55,123,0,55,123,123,0,0,0,1,2,253,297,253,352,2,1586,1531
1640,1,5.0.55,0,640,0,45,55,100,0,55,100,100,0,0,0,1,2,218,297,218,352,2,1586,1531
1640,2,0.2.97,1,640,0,63,97,160,97,0,160,160,-97,97,152,3,1,220,250,317,250,3,1586,1489
1640,2,1.0.55,0,640,0,32,55,87,0,55,87,97,0,0,55,1,2,216,297,216,352,3,1586,1489
1640,2,2.0.55,0,649,2,92,55,147,0,55,147,147,0,0,55,1,2,368,297,368,352,3,1586,1489
1640,2,3.0.55,0,643,1,60,55,115,0,55,115,115,0,0,55,1,2,214,297,214,352,3,1586,1489
1640,2,4.0.55,0,649,2,68,55,123,0,55,123,123,0,0,55,1,2,253,297,253,352,3,1586,1489
1640,2,5.0.55,0,640,0,45,55,100,0,55,100,100,0,0,55,1,2,218,297,218,352,3,1586,1489
1640,3,0.3.160,0,640,0,84,160,244,160,0,244,244,-160,160,312,4,1,157,455,317,455,4,1586,1426
1640,3,1.0.55,0,640,0,32,55,87,0,55,87,160,0,0,152,1,2,216,297,216,352,4,1586,1426
1640,3,2.0.55,1,649,2,92,55,147,0,55,147,160,0,0,152,1,2,368,297,368,352,4,1586,1426
1640,3,3.0.55,0,643,1,60,55,115,0,55,115,160,0,0,152,1,2,214,297,214,352,4,1586,1426
1640,3,4.0.55,0,649,2,68,55,123,0,55,123,160,0,0,152,1,2,253,297,253,352,4,1586,1426
1640,3,5.0.55,0,640,0,45,55,100,0,55,100,160,0,0,152,1,2,218,297,218,352,4,1586,1426
1640,4,0.3.160,0,649,0,84,160,244,160,0,244,244,-160,160,312,4,1,157,455,317,455,5,1586,1334
1640,4,1.0.147,1,649,0,32,147,179,0,147,179,179,0,0,152,1,3,216,205,216,352,5,1586,1334
1640,4,2.1.147,0,681,3,93,147,240,147,0,240,240,-50,105,202,2,2,276,226,368,268,5,1586,1334
1640,4,3.0.147,0,667,1,60,147,207,0,147,207,207,0,0,152,1,3,214,205,214,352,5,1586,1334
1640,4,4.0.147,0,682,4,68,147,215,0,147,215,215,0,0,152,1,3,253,205,253,352,5,1586,1334
1640,4,5.0.147,0,669,2,45,147,192,0,147,192,192,0,0,152,1,3,218,205,218,352,5,1586,1334
1640,5,0.3.160,0,649,0,84,160,244,160,0,244,244,-160,160,312,4,1,157,455,317,455,6,1586,1302
1640,5,1.1.179,0,649,0,9,179,188,179,0,188,188,-82,137,234,2,2,184,226,216,268,6,1586,1302
1640,5,2.1.147,0,681,1,93,147,240,147,0,240,240,-50,105,202,2,2,276,226,368,268,6,1586,1302
1640,5,3.0.179,0,649,0,60,179,239,0,179,239,239,0,0,152,1,4,214,173,214,352,6,1586,1302
1640,5,4.0.179,0,649,0,68,179,247,0,179,247,247,0,0,152,1,4,253,173,253,352,6,1586,1302
1640,5,5.0.179,1,649,0,45,179,224,0,179,224,224,0,0,152,1,4,218,173,218,352,6,1586,1302
1640,6,0.3.160,0,649,0,84,160,244,160,0,244,244,-160,160,312,4,1,157,455,317,455,7,1586,1257
1640,6,1.1.179,0,649,0,9,179,188,179,0,188,224,-82,137,234,2,2,184,226,216,268,7,1586,1257
1640,6,2.1.147,0,682,2,93,147,240,147,0,240,240,-50,105,202,2,2,276,226,368,268,7,1586,1257
1640,6,3.0.224,0,649,0,60,224,284,0,224,284,284,0,0,152,1,5,214,128,214,352,7,1586,1257
1640,6,4.0.224,1,649,0,68,224,292,0,224,292,292,0,0,152,1,5,253,128,253,352,7,1586,1257
1640,6,5.1.224,0,658,1,39,224,263,224,0,263,263,-127,182,279,2,2,173,226,218,268,7,1586,1257
1640,7,0.3.160,0,649,0,84,160,244,160,0,244,292,-160,160,312,4,1,157,455,317,455,8,1586,1189
1640,7,1.1.179,0,649,0,9,179,188,179,0,188,292,-82,137,234,2,2,184,226,216,268,8,1586,1189
1640,7,2.1.147,0,682,2,93,147,240,147,0,240,292,-50,105,202,2,2,276,226,368,268,8,1586,1189
1640,7,3.0.292,1,649,0,60,292,352,0,292,352,352,0,0,152,1,6,214,60,214,352,8,1586,1189
1640,7,4.1.292,0,649,0,56,292,348,292,0,348,348,-195,250,347,2,2,185,226,253,268,8,1586,1189
1640,7,5.1.224,0,658,1,39,224,263,224,0,263,292,-127,182,279,2,2,173,226,218,268,8,1586,1189
1640,8,0.3.160,0,649,0,84,160,244,160,0,244,352,-160,160,312,4,1,157,455,317,455,9,1586,1129
1640,8,1.1.179,1,649,0,9,179,188,179,0,188,352,-82,137,234,2,2,184,226,216,268,9,1586,1129
1640,8,2.1.147,0,682,2,93,147,240,147,0,240,352,-50,105,202,2,2,276,226,368,268,9,1586,1129
1640,8,3.1.352,0,649,0,29,352,381,352,0,381,381,-255,310,407,2,2,154,226,214,268,9,1586,1129
1640,8,4.1.292,0,649,0,56,292,348,292,0,348,352,-195,250,347,2,2,185,226,253,268,9,1586,1129
1640,8,5.1.224,0,658,1,39,224,263,224,0,263,352,-127,182,279,2,2,173,226,218,268,9,1586,1129
1640,9,0.3.160,0,649,0,84,160,244,160,0,244,352,-160,160,394,4,1,157,455,317,455,10,1586,1120
1640,9,1.2.188,1,649,0,65,188,253,188,0,253,352,-28,125,262,3,2,175,187,216,250,10,1586,1120
1640,9,2.1.188,0,649,0,93,188,281,147,41,281,352,0,137,234,2,3,276,217,368,268,10,1586,1120
1640,9,3.1.352,0,649,0,29,352,381,352,0,381,381,-164,301,398,2,3,154,217,214,268,10,1586,1120
1640,9,4.1.292,0,649,0,56,292,348,292,0,348,352,-104,241,338,2,3,185,217,253,268,10,1586,1120
1640,9,5.1.224,0,658,1,39,224,263,224,0,263,352,-36,173,270,2,3,173,217,218,268,10,1586,1120
1640,10,0.3.160,0,649,0,84,160,244,160,0,244,352,-160,160,422,4,1,157,455,317,455,11,1586,1055
1640,10,1.3.253,0,649,0,93,253,346,253,0,346,352,-253,253,515,4,1,110,455,216,455,11,1586,1055
1640,10,2.1.188,1,649,0,93,188,281,147,41,281,352,0,137,262,2,3,276,217,368,268,11,1586,1055
1640,10,3.1.352,0,649,0,29,352,381,352,0,381,381,-164,301,426,2,3,154,217,214,268,11,1586,1055
1640,10,4.1.292,0,649,0,56,292,348,292,0,348,352,-104,241,366,2,3,185,217,253,268,11,1586,1055
1640,10,5.1.224,0,658,1,39,224,263,224,0,263,352,-36,173,298,2,3,173,217,218,268,11,1586,1055
1640,11,0.3.160,0,649,0,84,160,244,160,0,244,352,-160,160,422,4,1,157,455,317,455,12,1586,962
1640,11,1.3.253,0,649,0,93,253,346,253,0,346,352,-253,253,515,4,1,110,455,216,455,12,1586,962
1640,11,2.2.281,1,649,0,54,281,335,281,0,335,352,-28,153,290,3,3,183,122,368,250,12,1586,962
1640,11,3.1.352,0,649,0,29,352,381,352,0,381,381,-71,208,333,2,4,154,124,214,268,12,1586,962
1640,11,4.1.292,0,649,0,56,292,348,292,0,348,352,-11,148,273,2,4,185,124,253,268,12,1586,962
1640,11,5.1.281,0,649,0,39,281,320,224,57,320,352,0,137,262,2,4,173,124,218,268,12,1586,962
1640,12,0.3.160,0,649,0,84,160,244,160,0,244,352,-160,160,450,4,1,157,455,317,455,13,1586,908
1640,12,1.3.253,0,649,0,93,253,346,253,0,346,352,-253,253,543,4,1,110,455,216,455,13,1586,908
1640,12,2.3.335,0,723,1,95,335,430,335,0,430,430,-335,335,625,4,1,129,455,368,455,13,1586,908
1640,12,3.1.352,0,649,0,29,352,381,352,0,381,381,-71,208,361,2,4,154,124,214,268,13,1586,908
1640,12,4.1.292,0,649,0,56,292,348,292,0,348,352,-11,148,301,2,4,185,124,253,268,13,1586,908
1640,12,5.1.281,1,649,0,39,281,320,224,57,320,352,0,137,290,2,4,173,124,218,268,13,1586,908
1640,13,0.3.160,0,649,0,84,160,244,160,0,244,352,-160,160,450,4,1,157,455,317,455,14,1586,869
1640,13,1.3.253,0,649,0,93,253,346,253,0,346,352,-253,253,543,4,1,110,455,216,455,14,1586,869
1640,13,2.3.335,0,723,1,95,335,430,335,0,430,430,-335,335,625,4,1,129,455,368,455,14,1586,869
1640,13,3.1.352,0,649,0,29,352,381,352,0,381,381,-32,169,322,2,5,154,85,214,268,14,1586,869
1640,13,4.1.320,0,649,0,56,320,376,292,28,376,376,0,137,290,2,5,185,85,253,268,14,1586,869
1640,13,5.2.335,1,649,0,42,335,377,320,15,377,377,0,153,290,3,4,134,68,218,250,14,1586,869
1640,14,0.3.160,0,649,0,84,160,244,160,0,244,377,-160,160,450,4,1,157,455,317,455,15,1586,827
1640,14,1.3.253,0,649,0,93,253,346,253,0,346,377,-253,253,543,4,1,110,455,216,455,15,1586,827
1640,14,2.3.335,0,723,2,95,335,430,335,0,430,430,-335,335,625,4,1,129,455,368,455,15,1586,827
1640,14,3.1.352,0,649,0,29,352,381,352,0,381,381,-32,169,322,2,5,154,85,214,268,15,1586,827
1640,14,4.1.320,1,649,0,56,320,376,292,28,376,377,0,137,290,2,5,185,85,253,268,15,1586,827
1640,14,5.3.377,0,680,1,43,377,420,377,0,420,420,-377,377,667,4,1,92,455,218,455,15,1586,827
1640,15,0.3.160,0,649,0,84,160,244,160,0,244,377,-160,160,450,4,1,157,455,317,455,16,1586,771
1640,15,1.3.253,0,649,0,93,253,346,253,0,346,377,-253,253,543,4,1,110,455,216,455,16,1586,771
1640,15,2.3.335,0,723,2,95,335,430,335,0,430,430,-335,335,625,4,1,129,455,368,455,16,1586,771
1640,15,3.1.376,0,649,0,29,376,405,352,24,405,405,0,137,290,2,6,154,29,214,268,16,1586,771
1640,15,4.2.377,1,649,0,10,377,387,376,1,387,387,0,153,290,3,5,129,26,253,250,16,1586,771
1640,15,5.3.377,0,680,1,43,377,420,377,0,420,420,-377,377,667,4,1,92,455,218,455,16,1586,771
1640,16,0.3.160,0,649,0,84,160,244,160,0,244,387,-160,160,450,4,1,157,455,317,455,17,1586,761
1640,16,1.3.253,0,649,0,93,253,346,253,0,346,387,-253,253,543,4,1,110,455,216,455,17,1586,761
1640,16,2.3.335,0,723,3,95,335,430,335,0,430,430,-335,335,625,4,1,129,455,368,455,17,1586,761
1640,16,3.1.376,1,649,0,29,376,405,352,24,405,405,0,137,290,2,6,154,29,214,268,17,1586,761
1640,16,4.3.387,0,699,2,94,387,481,387,0,481,481,-387,387,677,4,1,119,455,253,455,17,1586,761
1640,16,5.3.377,0,680,1,43,377,420,377,0,420,420,-377,377,667,4,1,92,455,218,455,17,1586,761
1640,17,0.3.160,0,649,0,84,160,244,160,0,244,405,-160,160,450,4,1,157,455,317,455,18,1586,732
1640,17,1.3.253,0,649,0,93,253,346,253,0,346,405,-253,253,543,4,1,110,455,216,455,18,1586,732
1640,17,2.3.335,0,723,3,95,335,430,335,0,430,430,-335,335,625,4,1,129,455,368,455,18,1586,732
1640,17,3.2.405,1,649,0,16,405,421,405,0,421,421,-18,171,308,3,6,125,16,214,250,18,1586,732
1640,17,4.3.387,0,699,2,94,387,481,387,0,481,481,-387,387,677,4,1,119,455,253,455,18,1586,732
1640,17,5.3.377,0,680,1,43,377,420,377,0,420,420,-377,377,667,4,1,92,455,218,455,18,1586,732
1640,18,0.3.160,1,649,0,84,160,244,160,0,244,421,-160,160,468,4,1,157,455,317,455,19,1586,716
1640,18,1.3.253,0,649,0,93,253,346,253,0,346,421,-253,253,561,4,1,110,455,216,455,19,1586,716
1640,18,2.3.335,0,723,4,95,335,430,335,0,430,430,-335,335,643,4,1,129,455,368,455,19,1586,716
1640,18,3.3.421,0,681,2,46,421,467,421,0,467,467,-421,421,729,4,1,109,455,214,455,19,1586,716
1640,18,4.3.387,0,699,3,94,387,481,387,0,481,481,-387,387,695,4,1,119,455,253,455,19,1586,716
1640,18,5.3.377,0,680,1,43,377,420,377,0,420,421,-377,377,685,4,1,92,455,218,455,19,1586,716
1640,19,0.4.244,1,649,0,73,244,317,244,0,317,421,-244,244,712,5,1,73,261,317,261,20,1586,632
1640,19,1.3.253,0,649,0,93,253,346,253,0,346,421,-9,169,477,4,2,110,371,216,455,20,1586,632
1640,19,2.3.335,0,723,4,95,335,430,335,0,430,430,-91,251,559,4,2,129,371,368,455,20,1586,632
1640,19,3.3.421,0,681,2,46,421,467,421,0,467,467,-177,337,645,4,2,109,371,214,455,20,1586,632
1640,19,4.3.387,0,699,3,94,387,481,387,0,481,481,-143,303,611,4,2,119,371,253,455,20,1586,632
1640,19,5.3.377,0,680,1,43,377,420,377,0,420,421,-133,293,601,4,2,92,371,218,455,20,1586,632
1640,20,1.3.253,1,649,0,93,253,346,253,0,346,421,-9,169,721,4,2,110,371,216,455,21,1586,559
1640,20,2.3.335,0,723,4,95,335,430,335,0,430,430,-91,251,803,4,2,129,371,368,455,21,1586,559
1640,20,3.3.421,0,681,2,46,421,467,421,0,467,467,-177,337,889,4,2,109,371,214,455,21,1586,559
1640,20,4.3.387,0,699,3,94,387,481,387,0,481,481,-143,303,855,4,2,119,371,253,455,21,1586,559
1640,20,5.3.377,0,680,1,43,377,420,377,0,420,421,-133,293,845,4,2,92,371,218,455,21,1586,559
1640,21,1.4.346,1,649,0,17,346,363,346,0,363,421,-29,273,750,5,2,17,188,216,261,22,1586,466
1640,21,2.3.346,0,649,0,95,346,441,335,11,441,441,0,169,721,4,3,129,278,368,455,22,1586,466
1640,21,3.3.421,0,681,2,46,421,467,421,0,467,467,-75,244,796,4,3,109,278,214,455,22,1586,466
1640,21,4.3.387,0,699,3,94,387,481,387,0,481,481,-41,210,762,4,3,119,278,253,455,22,1586,466
1640,21,5.3.377,0,680,1,43,377,420,377,0,420,421,-31,200,752,4,3,92,278,218,455,22,1586,466
1640,22,2.3.346,1,649,0,95,346,441,335,11,441,441,0,169,750,4,3,129,278,368,455,23,1586,449
1640,22,3.3.421,0,681,2,46,421,467,421,0,467,467,-75,244,825,4,3,109,278,214,455,23,1586,449
1640,22,4.3.387,0,699,3,94,387,481,387,0,481,481,-41,210,791,4,3,119,278,253,455,23,1586,449
1640,22,5.3.377,0,680,1,43,377,420,377,0,420,421,-31,200,781,4,3,92,278,218,455,23,1586,449
1640,23,2.4.441,1,649,0,34,441,475,441,0,475,475,-78,351,828,5,3,34,171,368,261,24,1586,354
1640,23,3.3.441,0,649,0,46,441,487,421,20,487,487,0,169,750,4,4,109,183,214,455,24,1586,354
1640,23,4.3.441,0,690,1,94,441,535,387,54,535,535,0,169,750,4,4,119,183,253,455,24,1586,354
1640,23,5.3.441,0,649,0,43,441,484,377,64,484,484,0,169,750,4,4,92,183,218,455,24,1586,354
1640,24,3.3.441,0,649,0,46,441,487,421,20,487,487,0,169,828,4,4,109,183,214,455,25,1586,320
1640,24,4.3.441,0,690,1,94,441,535,387,54,535,535,0,169,828,4,4,119,183,253,455,25,1586,320
1640,24,5.3.441,1,649,0,43,441,484,377,64,484,484,0,169,828,4,4,92,183,218,455,25,1586,320
1640,25,3.3.484,0,649,0,46,484,530,421,63,530,530,0,169,828,4,5,109,140,214,455,26,1586,277
1640,25,4.3.484,0,687,1,94,484,578,387,97,578,578,0,169,828,4,5,119,140,253,455,26,1586,277
1640,25,5.4.484,1,649,0,49,484,533,484,0,533,533,-9,360,837,5,4,49,137,218,261,26,1586,277
1640,26,3.3.484,1,649,0,46,484,530,421,63,530,533,0,169,837,4,5,109,140,214,455,27,1586,228
1640,26,4.3.484,0,687,1,94,484,578,387,97,578,578,0,169,837,4,5,119,140,253,455,27,1586,228
1640,27,3.4.533,1,649,0,63,533,596,530,3,596,596,0,360,837,5,5,63,88,214,261,28,1586,182
1640,27,4.3.530,0,649,0,94,530,624,387,143,624,624,0,169,837,4,6,119,94,253,455,28,1586,182
1640,28,4.3.530,1,649,0,94,530,624,387,143,624,624,0,169,837,4,6,119,94,253,455,29,1586,119
1640,29,4.4.624,1,649,0,25,624,649,624,0,649,649,-28,388,865,5,6,25,25,253,261,30,1586,25
1641,0,0.0.0,0,551,5,68,0,68,0,0,68,68,0,0,0,1,1,262,267,262,267,1,1457,1457
1641,0,1.0.0,1,495,0,8,0,8,0,0,8,8,0,0,0,1,1,217,267,217,267,1,1457,1457
1641,0,2.0.0,0,499,2,38,0,38,0,0,38,38,0,0,0,1,1,294,267,294,267,1,1457,1457
1641,0,3.0.0,0,509,3,14,0,14,0,0,14,14,0,0,0,1,1,174,267,174,267,1,1457,1457
1641,0,4.0.0,0,514,4,90,0,90,0,0,90,90,0,0,0,1,1,291,267,291,267,1,1457,1457
1641,0,5.0.0,0,496,1,49,0,49,0,0,49,49,0,0,0,1,1,219,267,219,267,1,1457,1457
1641,1,0.0.8,0,535,4,68,8,76,0,8,76,76,0,0,0,1,2,262,259,262,267,2,1457,1449
1641,1,1.1.8,0,495,0,76,8,84,8,0,84,84,-8,8,8,2,1,209,271,217,271,2,1457,1449
1641,1,2.0.8,1,507,2,38,8,46,0,8,46,46,0,0,0,1,2,294,259,294,267,2,1457,1449
1641,1,3.0.8,0,509,3,14,8,22,0,8,22,22,0,0,0,1,2,174,259,174,267,2,1457,1449
1641,1,4.0.8,0,495,0,90,8,98,0,8,98,98,0,0,0,1,2,291,259,291,267,2,1457,1449
1641,1,5.0.8,0,504,1,49,8,57,0,8,57,57,0,0,0,1,2,219,259,219,267,2,1457,1449
1641,2,0.0.46,0,517,2,68,46,114,0,46,114,114,0,0,0,1,3,262,221,262,267,3,1457,1411
1641,2,1.1.8,0,517,2,76,8,84,8,0,84,84,-8,8,8,2,1,209,271,217,271,3,1457,1411
1641,2,2.1.46,0,507,0,86,46,132,46,0,132,132,-46,46,46,2,1,256,271,294,271,3,1457,1411
1641,2,3.0.46,1,509,1,14,46,60,0,46,60,60,0,0,0,1,3,174,221,174,267,3,1457,1411
1641,2,4.0.46,0,517,2,90,46,136,0,46,136,136,0,0,0,1,3,291,221,291,267,3,1457,1411
1641,2,5.0.46,0,507,0,49,46,95,0,46,95,95,0,0,0,1,3,219,221,219,267,3,1457,1411
1641,3,0.0.60,0,517,1,68,60,128,0,60,128,128,0,0,0,1,4,262,207,262,267,4,1457,1397
1641,3,1.1.8,0,517,1,76,8,84,8,0,84,84,-8,8,8,2,1,209,271,217,271,4,1457,1397
1641,3,2.1.46,0,509,0,86,46,132,46,0,132,132,-46,46,46,2,1,256,271,294,271,4,1457,1397
1641,3,3.1.60,0,547,2,66,60,126,60,0,126,126,-60,60,60,2,1,160,271,174,271,4,1457,1397
1641,3,4.0.60,0,517,1,90,60,150,0,60,150,150,0,0,0,1,4,291,207,291,267,4,1457,1397
1641,3,5.0.60,1,509,0,49,60,109,0,60,109,109,0,0,0,1,4,219,207,219,267,4,1457,1397
1641,4,0.0.109,1,517,1,68,109,177,0,109,177,177,0,0,0,1,5,262,158,262,267,5,1457,1348
1641,4,1.1.8,0,517,1,76,8,84,8,0,84,109,-8,8,8,2,1,209,271,217,271,5,1457,1348
1641,4,2.1.46,0,509,0,86,46,132,46,0,132,132,-46,46,46,2,1,256,271,294,271,5,1457,1348
1641,4,3.1.60,0,569,3,66,60,126,60,0,126,126,-60,60,60,2,1,160,271,174,271,5,1457,1348
1641,4,4.0.109,0,509,0,90,109,199,0,109,199,199,0,0,0,1,5,291,158,291,267,5,1457,1348
1641,4,5.1.109,0,548,2,23,109,132,109,0,132,132,-109,109,109,2,1,170,271,219,271,5,1457,1348
1641,5,0.1.177,0,530,1,11,177,188,177,0,188,188,-177,177,177,2,1,194,271,262,271,6,1457,1280
1641,5,1.1.8,0,517,0,76,8,84,8,0,84,177,-8,8,8,2,1,209,271,217,271,6,1457,1280
1641,5,2.1.46,0,532,2,86,46,132,46,0,132,177,-46,46,46,2,1,256,271,294,271,6,1457,1280
1641,5,3.1.60,0,569,4,66,60,126,60,0,126,177,-60,60,60,2,1,160,271,174,271,6,1457,1280
1641,5,4.0.177,1,517,0,90,177,267,0,177,267,267,0,0,0,1,6,291,90,291,267,6,1457,1280
1641,5,5.1.109,0,548,3,23,109,132,109,0,132,177,-109,109,109,2,1,170,271,219,271,6,1457,1280
1641,6,0.1.177,0,530,1,11,177,188,177,0,188,267,-177,177,177,2,1,194,271,262,271,7,1457,1190
1641,6,1.1.8,1,517,0,76,8,84,8,0,84,267,-8,8,8,2,1,209,271,217,271,7,1457,1190
1641,6,2.1.46,0,532,2,86,46,132,46,0,132,267,-46,46,46,2,1,256,271,294,271,7,1457,1190
1641,6,3.1.60,0,569,4,66,60,126,60,0,126,267,-60,60,60,2,1,160,271,174,271,7,1457,1190
1641,6,4.1.267,0,517,0,9,267,276,267,0,276,276,-267,267,267,2,1,201,271,291,271,7,1457,1190
1641,6,5.1.109,0,548,3,23,109,132,109,0,132,267,-109,109,109,2,1,170,271,219,271,7,1457,1190
1641,7,0.1.177,0,530,1,11,177,188,177,0,188,267,-93,101,101,2,2,194,195,262,271,8,1457,1114
1641,7,1.2.84,0,517,0,70,84,154,84,0,154,267,-84,84,92,3,1,133,319,217,319,8,1457,1114
1641,7,2.1.84,1,517,0,86,84,170,46,38,170,267,0,8,8,2,2,256,195,294,271,8,1457,1114
1641,7,3.1.84,0,567,3,66,84,150,60,24,150,267,0,8,8,2,2,160,195,174,271,8,1457,1114
1641,7,4.1.267,0,517,0,9,267,276,267,0,276,276,-183,191,191,2,2,201,195,291,271,8,1457,1114
1641,7,5.1.109,0,548,2,23,109,132,109,0,132,267,-25,33,33,2,2,170,195,219,271,8,1457,1114
1641,8,0.1.177,0,530,1,11,177,188,177,0,188,267,-7,15,15,2,3,194,109,262,271,9,1457,1028
1641,8,1.2.84,0,517,0,70,84,154,84,0,154,267,-84,84,92,3,1,133,319,217,319,9,1457,1028
1641,8,2.2.170,0,517,0,8,170,178,170,0,178,267,-170,170,178,3,1,170,319,294,319,9,1457,1028
1641,8,3.1.170,0,539,2,66,170,236,60,110,236,267,0,8,8,2,3,160,109,174,271,9,1457,1028
1641,8,4.1.267,0,517,0,9,267,276,267,0,276,276,-97,105,105,2,3,201,109,291,271,9,1457,1028
1641,8,5.1.170,1,517,0,23,170,193,109,61,193,267,0,8,8,2,3,170,109,219,271,9,1457,1028
1641,9,0.1.193,1,517,0,11,193,204,177,16,204,267,0,8,8,2,4,194,86,262,271,10,1457,1005
1641,9,1.2.84,0,517,0,70,84,154,84,0,154,267,-84,84,92,3,1,133,319,217,319,10,1457,1005
1641,9,2.2.170,0,517,0,8,170,178,170,0,178,267,-170,170,178,3,1,170,319,294,319,10,1457,1005
1641,9,3.1.193,0,517,0,66,193,259,60,133,259,267,0,8,8,2,4,160,86,174,271,10,1457,1005
1641,9,4.1.267,0,517,0,9,267,276,267,0,276,276,-74,82,82,2,4,201,86,291,271,10,1457,1005
1641,9,5.2.193,0,517,0,80,193,273,193,0,273,273,-193,193,201,3,1,147,319,219,319,10,1457,1005
1641,10,0.2.204,0,539,1,67,204,271,204,0,271,271,-204,204,212,3,1,183,319,262,319,11,1457,994
1641,10,1.2.84,0,517,0,70,84,154,84,0,154,267,-84,84,92,3,1,133,319,217,319,11,1457,994
1641,10,2.2.170,0,517,0,8,170,178,170,0,178,267,-170,170,178,3,1,170,319,294,319,11,1457,994
1641,10,3.1.204,1,517,0,66,204,270,60,144,270,270,0,8,8,2,5,160,75,174,271,11,1457,994
1641,10,4.1.267,0,517,0,9,267,276,267,0,276,276,-63,71,71,2,5,201,75,291,271,11,1457,994
1641,10,5.2.193,0,517,0,80,193,273,193,0,273,273,-193,193,201,3,1,147,319,219,319,11,1457,994
1641,11,0.2.204,0,542,1,67,204,271,204,0,271,271,-204,204,212,3,1,183,319,262,319,12,1457,928
1641,11,1.2.84,0,517,0,70,84,154,84,0,154,270,-84,84,92,3,1,133,319,217,319,12,1457,928
1641,11,2.2.170,0,517,0,8,170,178,170,0,178,270,-170,170,178,3,1,170,319,294,319,12,1457,928
1641,11,3.2.270,0,611,2,83,270,353,270,0,353,353,-270,270,278,3,1,94,319,174,319,12,1457,928
1641,11,4.1.270,1,517,0,9,270,279,267,3,279,279,0,8,8,2,6,201,9,291,271,12,1457,928
1641,11,5.2.193,0,517,0,80,193,273,193,0,273,273,-193,193,201,3,1,147,319,219,319,12,1457,928
1641,12,0.2.204,0,542,1,67,204,271,204,0,271,279,-204,204,212,3,1,183,319,262,319,13,1457,919
1641,12,1.2.84,0,517,0,70,84,154,84,0,154,279,-84,84,92,3,1,133,319,217,319,13,1457,919
1641,12,2.2.170,1,517,0,8,170,178,170,0,178,279,-170,170,178,3,1,170,319,294,319,13,1457,919
1641,12,3.2.270,0,611,2,83,270,353,270,0,353,353,-270,270,278,3,1,94,319,174,319,13,1457,919
1641,12,4.2.279,0,517,0,11,279,290,279,0,290,290,-279,279,287,3,1,192,319,291,319,13,1457,919
1641,12,5.2.193,0,517,0,80,193,273,193,0,273,279,-193,193,201,3,1,147,319,219,319,13,1457,919
1641,13,0.2.204,0,542,2,67,204,271,204,0,271,279,-26,196,204,3,2,183,311,262,319,14,1457,911
1641,13,1.2.84,0,517,0,70,84,154,84,0,178,279,70,100,108,3,2,133,311,217,319,14,1457,911
1641,13,2.3.178,1,532,1,64,178,242,178,0,242,279,-178,178,356,4,1,162,310,294,310,14,1457,911
1641,13,3.2.270,0,611,3,83,270,353,270,0,353,353,-92,262,270,3,2,94,311,174,319,14,1457,911
1641,13,4.2.279,0,517,0,11,279,290,279,0,290,290,-101,271,279,3,2,192,311,291,319,14,1457,911
1641,13,5.2.193,0,517,0,80,193,273,193,0,273,279,-15,185,193,3,2,147,311,219,319,14,1457,911
1641,14,0.2.204,0,542,1,67,204,271,204,0,271,279,-26,196,382,3,2,183,311,262,319,15,1457,847
1641,14,1.2.84,0,532,0,70,84,154,84,0,178,279,70,100,286,3,2,133,311,217,319,15,1457,847
1641,14,2.4.242,1,532,0,98,242,340,242,0,340,340,-242,242,598,5,1,98,290,294,290,15,1457,847
1641,14,3.2.270,0,611,2,83,270,353,270,0,353,353,-92,262,448,3,2,94,311,174,319,15,1457,847
1641,14,4.2.279,0,532,0,11,279,290,279,0,290,290,-101,271,457,3,2,192,311,291,319,15,1457,847
1641,14,5.2.193,0,532,0,80,193,273,193,0,273,279,-15,185,371,3,2,147,311,219,319,15,1457,847
1641,15,0.2.204,0,542,1,67,204,271,204,0,271,340,-26,196,624,3,2,183,311,262,319,16,1457,749
1641,15,1.2.84,1,532,0,70,84,154,84,0,178,340,70,100,528,3,2,133,311,217,319,16,1457,749
1641,15,3.2.270,0,611,2,83,270,353,270,0,353,353,-92,262,690,3,2,94,311,174,319,16,1457,749
1641,15,4.2.279,0,532,0,11,279,290,279,0,290,340,-101,271,699,3,2,192,311,291,319,16,1457,749
1641,15,5.2.193,0,532,0,80,193,273,193,0,273,340,-15,185,613,3,2,147,311,219,319,16,1457,749
1641,16,0.2.204,0,542,1,67,204,271,204,0,271,340,-26,126,554,3,3,183,241,262,319,17,1457,679
1641,16,1.3.242,1,532,0,36,242,278,154,88,278,340,0,178,528,4,2,63,246,217,310,17,1457,679
1641,16,3.2.270,0,611,2,83,270,353,270,0,353,353,-92,192,620,3,3,94,241,174,319,17,1457,679
1641,16,4.2.279,0,532,0,11,279,290,279,0,290,340,-101,201,629,3,3,192,241,291,319,17,1457,679
1641,16,5.2.193,0,532,0,80,193,273,193,0,273,340,-15,115,543,3,3,147,241,219,319,17,1457,679
1641,17,0.2.204,0,542,1,67,204,271,204,0,271,340,-26,126,554,3,3,183,241,262,319,18,1457,643
1641,17,1.4.340,1,532,0,27,340,367,278,62,367,367,0,242,528,5,2,27,192,217,290,18,1457,643
1641,17,3.2.270,0,611,2,83,270,353,270,0,353,353,-92,192,620,3,3,94,241,174,319,18,1457,643
1641,17,4.2.279,0,532,0,11,279,290,279,0,290,340,-101,201,629,3,3,192,241,291,319,18,1457,643
1641,17,5.2.193,0,532,0,80,193,273,193,0,273,340,-15,115,543,3,3,147,241,219,319,18,1457,643
1641,18,0.2.204,0,542,1,67,204,271,204,0,271,367,-26,126,554,3,3,183,241,262,319,19,1457,616
1641,18,3.2.270,0,611,2,83,270,353,270,0,353,367,-92,192,620,3,3,94,241,174,319,19,1457,616
1641,18,4.2.279,1,532,0,11,279,290,279,0,290,367,-101,201,629,3,3,192,241,291,319,19,1457,616
1641,18,5.2.193,0,532,0,80,193,273,193,0,273,367,-15,115,543,3,3,147,241,219,319,19,1457,616
1641,19,0.2.204,0,542,1,67,204,271,204,0,290,367,67,134,562,3,4,183,230,262,319,20,1457,605
1641,19,3.2.290,0,542,1,83,290,373,270,20,373,373,0,201,629,3,4,94,230,174,319,20,1457,605
1641,19,4.3.290,1,542,1,87,290,377,290,0,377,377,-12,190,641,4,3,181,210,291,310,20,1457,605
1641,19,5.2.193,0,532,0,80,193,273,193,0,290,367,80,121,549,3,4,147,230,219,319,20,1457,605
1641,20,0.2.204,0,542,0,67,204,271,204,0,290,377,67,134,574,3,4,183,230,262,319,21,1457,518
1641,20,3.2.290,0,542,0,83,290,373,270,20,373,377,0,201,641,3,4,94,230,174,319,21,1457,518
1641,20,4.4.377,1,542,0,94,377,471,377,0,471,471,-10,252,651,5,3,94,165,291,290,21,1457,518
1641,20,5.2.193,0,542,0,80,193,273,193,0,290,377,80,121,561,3,4,147,230,219,319,21,1457,518
1641,21,0.2.204,1,542,0,67,204,271,204,0,290,471,67,134,584,3,4,183,230,262,319,22,1457,424
1641,21,3.2.290,0,542,0,83,290,373,270,20,373,471,0,201,651,3,4,94,230,174,319,22,1457,424
1641,21,5.2.193,0,542,0,80,193,273,193,0,290,471,80,121,571,3,4,147,230,219,319,22,1457,424
1641,22,0.3.377,1,542,0,90,377,467,271,106,467,471,0,190,584,4,4,116,123,262,310,23,1457,357
1641,22,3.2.290,0,542,0,83,290,373,270,20,373,471,0,134,584,3,5,94,163,174,319,23,1457,357
1641,22,5.2.290,0,542,0,80,290,370,193,97,370,471,0,134,584,3,5,147,163,219,319,23,1457,357
1641,23,0.4.471,1,542,0,26,471,497,467,4,497,497,0,252,584,5,4,26,71,262,290,24,1457,267
1641,23,3.2.290,0,542,0,83,290,373,270,20,373,471,0,134,584,3,5,94,163,174,319,24,1457,267
1641,23,5.2.290,0,542,0,80,290,370,193,97,370,471,0,134,584,3,5,147,163,219,319,24,1457,267
1641,24,3.2.290,0,542,0,83,290,373,270,20,373,497,0,134,584,3,5,94,163,174,319,25,1457,241
1641,24,5.2.290,1,542,0,80,290,370,193,97,370,497,0,134,584,3,5,147,163,219,319,25,1457,241
1641,25,3.2.370,0,542,0,83,370,453,270,100,453,497,0,134,584,3,6,94,83,174,319,26,1457,161
1641,25,5.3.467,1,542,0,27,467,494,370,97,494,497,0,190,584,4,5,67,33,219,310,26,1457,161
1641,26,3.2.370,0,542,0,83,370,453,270,100,453,497,0,134,584,3,6,94,83,174,319,27,1457,134
1641,26,5.4.497,1,542,0,40,497,537,494,3,537,537,0,252,584,5,5,40,45,219,290,27,1457,134
1641,27,3.2.370,1,542,0,83,370,453,270,100,453,537,0,134,584,3,6,94,83,174,319,28,1457,94
1641,28,3.3.494,1,542,0,6,494,500,453,41,500,537,0,190,584,4,6,11,6,174,310,29,1457,11
1641,29,3.4.537,1,542,0,5,537,542,500,37,542,542,0,252,584,5,6,5,5,174,290,30,1457,5
1642,0,0.0.0,0,618,3,81,0,81,0,0,81,81,0,0,0,1,1,404,381,404,381,1,1622,1622
1642,0,1.0.0,0,652,5,83,0,83,0,0,83,83,0,0,0,1,1,315,381,315,381,1,1622,1622
1642,0,2.0.0,0,628,4,84,0,84,0,0,84,84,0,0,0,1,1,321,381,321,381,1,1622,1622
1642,0,3.0.0,0,614,1,67,0,67,0,0,67,67,0,0,0,1,1,232,381,232,381,1,1622,1622
1642,0,4.0.0,1,593,0,12,0,12,0,0,12,12,0,0,0,1,1,228,381,228,381,1,1622,1622
1642,0,5.0.0,0,616,2,54,0,54,0,0,54,54,0,0,0,1,1,122,381,122,381,1,1622,1622
1642,1,0.0.12,0,593,0,81,12,93,0,12,93,93,0,0,0,1,2,404,369,404,381,2,1622,1610
1642,1,1.0.12,0,634,4,83,12,95,0,12,95,95,0,0,0,1,2,315,369,315,381,2,1622,1610
1642,1,2.0.12,0,613,1,84,12,96,0,12,96,96,0,0,0,1,2,321,369,321,381,2,1622,1610
1642,1,3.0.12,0,614,2,67,12,79,0,12,79,79,0,0,0,1,2,232,369,232,381,2,1622,1610
1642,1,4.1.12,1,593,0,60,12,72,12,0,72,72,-12,12,12,2,1,216,273,228,273,2,1622,1610
1642,1,5.0.12,0,616,3,54,12,66,0,12,66,66,0,0,0,1,2,122,369,122,381,2,1622,1610
1642,2,0.0.12,0,593,0,81,12,93,0,12,93,93,0,0,12,1,2,404,369,404,381,3,1622,1550
1642,2,1.0.12,0,634,4,83,12,95,0,12,95,95,0,0,12,1,2,315,369,315,381,3,1622,1550
1642,2,2.0.12,0,613,1,84,12,96,0,12,96,96,0,0,12,1,2,321,369,321,381,3,1622,1550
1642,2,3.0.12,0,614,2,67,12,79,0,12,79,79,0,0,12,1,2,232,369,232,381,3,1622,1550
1642,2,4.2.72,1,593,0,11,72,83,72,0,83,83,-72,72,84,3,1,156,285,228,285,3,1622,1550
1642,2,5.0.12,0,616,3,54,12,66,0,12,66,72,0,0,12,1,2,122,369,122,381,3,1622,1550
1642,3,0.0.12,0,593,0,81,12,93,0,12,93,93,0,0,84,1,2,404,369,404,381,4,1622,1539
1642,3,1.0.12,0,634,4,83,12,95,0,12,95,95,0,0,84,1,2,315,369,315,381,4,1622,1539
1642,3,2.0.12,0,613,1,84,12,96,0,12,96,96,0,0,84,1,2,321,369,321,381,4,1622,1539
1642,3,3.0.12,0,614,2,67,12,79,0,12,79,83,0,0,84,1,2,232,369,232,381,4,1622,1539
1642,3,4.3.83,1,593,0,80,83,163,83,0,163,163,-83,83,167,4,1,145,363,228,363,4,1622,1539
1642,3,5.0.12,0,616,3,54,12,66,0,12,66,83,0,0,84,1,2,122,369,122,381,4,1622,1539
1642,4,0.0.12,0,593,0,81,12,93,0,12,93,163,0,0,167,1,2,404,369,404,381,5,1622,1459
1642,4,1.0.12,0,634,4,83,12,95,0,12,95,163,0,0,167,1,2,315,369,315,381,5,1622,1459
1642,4,2.0.12,0,613,1,84,12,96,0,12,96,163,0,0,167,1,2,321,369,321,381,5,1622,1459
1642,4,3.0.12,0,614,2,67,12,79,0,12,79,163,0,0,167,1,2,232,369,232,381,5,1622,1459
1642,4,4.4.163,1,593,0,65,163,228,163,0,228,228,-163,163,330,5,1,65,320,228,320,5,1622,1459
1642,4,5.0.12,0,616,3,54,12,66,0,12,66,163,0,0,167,1,2,122,369,122,381,5,1622,1459
1642,5,0.0.12,1,593,0,81,12,93,0,12,93,228,0,0,330,1,2,404,369,404,381,6,1622,1394
1642,5,1.0.12,0,634,4,83,12,95,0,12,95,228,0,0,330,1,2,315,369,315,381,6,1622,1394
1642,5,2.0.12,0,613,1,84,12,96,0,12,96,228,0,0,330,1,2,321,369,321,381,6,1622,1394
1642,5,3.0.12,0,614,2,67,12,79,0,12,79,228,0,0,330,1,2,232,369,232,381,6,1622,1394
1642,5,5.0.12,0,616,3,54,12,66,0,12,66,228,0,0,330,1,2,122,369,122,381,6,1622,1394
1642,6,0.1.93,1,593,0,78,93,171,93,0,171,228,-21,33,351,2,2,323,213,404,273,7,1622,1313
1642,6,1.0.93,0,593,0,83,93,176,0,93,176,228,0,0,330,1,3,315,288,315,381,7,1622,1313
1642,6,2.0.93,0,593,0,84,93,177,0,93,177,228,0,0,330,1,3,321,288,321,381,7,1622,1313
1642,6,3.0.93,0,594,1,67,93,160,0,93,160,228,0,0,330,1,3,232,288,232,381,7,1622,1313
1642,6,5.0.93,0,613,2,54,93,147,0,93,147,228,0,0,330,1,3,122,288,122,381,7,1622,1313
1642,7,0.2.171,1,593,0,70,171,241,171,0,241,241,-88,160,439,3,2,245,274,404,285,8,1622,1235
1642,7,1.0.93,0,593,0,83,93,176,0,93,176,228,0,0,351,1,3,315,288,315,381,8,1622,1235
1642,7,2.0.93,0,593,0,84,93,177,0,93,177,228,0,0,351,1,3,321,288,321,381,8,1622,1235
1642,7,3.0.93,0,594,1,67,93,160,0,93,160,228,0,0,351,1,3,232,288,232,381,8,1622,1235
1642,7,5.0.93,0,613,2,54,93,147,0,93,147,228,0,0,351,1,3,122,288,122,381,8,1622,1235
1642,8,0.3.241,1,593,0,97,241,338,241,0,338,338,-78,161,517,4,2,175,283,404,363,9,1622,1165
1642,8,1.0.93,0,593,0,83,93,176,0,93,176,241,0,0,439,1,3,315,288,315,381,9,1622,1165
1642,8,2.0.93,0,593,0,84,93,177,0,93,177,241,0,0,439,1,3,321,288,321,381,9,1622,1165
1642,8,3.0.93,0,594,1,67,93,160,0,93,160,241,0,0,439,1,3,232,288,232,381,9,1622,1165
1642,8,5.0.93,0,613,2,54,93,147,0,93,147,241,0,0,439,1,3,122,288,122,381,9,1622,1165
1642,9,0.4.338,1,593,0,78,338,416,338,0,416,416,-110,273,627,5,2,78,255,404,320,10,1622,1068
1642,9,1.0.93,0,593,0,83,93,176,0,93,176,338,0,0,517,1,3,315,288,315,381,10,1622,1068
1642,9,2.0.93,0,593,0,84,93,177,0,93,177,338,0,0,517,1,3,321,288,321,381,10,1622,1068
1642,9,3.0.93,0,594,1,67,93,160,0,93,160,338,0,0,517,1,3,232,288,232,381,10,1622,1068
1642,9,5.0.93,0,613,2,54,93,147,0,93,147,338,0,0,517,1,3,122,288,122,381,10,1622,1068
1642,10,1.0.93,0,593,0,83,93,176,0,93,176,416,0,0,627,1,3,315,288,315,381,11,1622,990
1642,10,2.0.93,1,593,0,84,93,177,0,93,177,416,0,0,627,1,3,321,288,321,381,11,1622,990
1642,10,3.0.93,0,594,1,67,93,160,0,93,160,416,0,0,627,1,3,232,288,232,381,11,1622,990
1642,10,5.0.93,0,613,2,54,93,147,0,93,147,416,0,0,627,1,3,122,288,122,381,11,1622,990
1642,11,1.0.177,0,593,0,83,177,260,0,177,260,416,0,0,627,1,4,315,204,315,381,12,1622,906
1642,11,2.1.177,1,593,0,80,177,257,177,0,257,416,-6,39,633,2,3,237,135,321,273,12,1622,906
1642,11,3.0.177,0,593,0,67,177,244,0,177,244,416,0,0,627,1,4,232,204,232,381,12,1622,906
1642,11,5.0.177,0,613,1,54,177,231,0,177,231,416,0,0,627,1,4,122,204,122,381,12,1622,906
1642,12,1.0.177,0,593,0,83,177,260,0,177,260,416,0,0,633,1,4,315,204,315,381,13,1622,826
1642,12,2.2.257,1,593,0,60,257,317,257,0,317,416,-16,176,649,3,3,157,204,321,285,13,1622,826
1642,12,3.0.177,0,593,0,67,177,244,0,177,244,416,0,0,633,1,4,232,204,232,381,13,1622,826
1642,12,5.0.177,0,613,1,54,177,231,0,177,231,416,0,0,633,1,4,122,204,122,381,13,1622,826
1642,13,1.0.177,0,593,0,83,177,260,0,177,260,416,0,0,649,1,4,315,204,315,381,14,1622,766
1642,13,2.3.338,1,593,0,33,338,371,317,21,371,416,0,161,649,4,3,97,186,321,363,14,1622,766
1642,13,3.0.177,0,593,0,67,177,244,0,177,244,416,0,0,649,1,4,232,204,232,381,14,1622,766
1642,13,5.0.177,0,613,1,54,177,231,0,177,231,416,0,0,649,1,4,122,204,122,381,14,1622,766
1642,14,1.0.177,0,593,0,83,177,260,0,177,260,416,0,0,649,1,4,315,204,315,381,15,1622,733
1642,14,2.4.416,1,593,0,64,416,480,371,45,480,480,0,273,649,5,3,64,177,321,320,15,1622,733
1642,14,3.0.177,0,593,0,67,177,244,0,177,244,416,0,0,649,1,4,232,204,232,381,15,1622,733
1642,14,5.0.177,0,613,1,54,177,231,0,177,231,416,0,0,649,1,4,122,204,122,381,15,1622,733
1642,15,1.0.177,1,593,0,83,177,260,0,177,260,480,0,0,649,1,4,315,204,315,381,16,1622,669
1642,15,3.0.177,0,593,0,67,177,244,0,177,244,480,0,0,649,1,4,232,204,232,381,16,1622,669
1642,15,5.0.177,0,613,1,54,177,231,0,177,231,480,0,0,649,1,4,122,204,122,381,16,1622,669
1642,16,1.1.260,1,593,0,44,260,304,260,0,304,480,-3,42,652,2,4,232,55,315,273,17,1622,586
1642,16,3.0.260,0,593,0,67,260,327,0,260,327,480,0,0,649,1,5,232,121,232,381,17,1622,586
1642,16,5.0.260,0,593,0,54,260,314,0,260,314,480,0,0,649,1,5,122,121,122,381,17,1622,586
1642,17,1.2.317,0,593,0,75,317,392,304,13,392,480,0,176,652,3,4,188,144,315,285,18,1622,542
1642,17,3.0.260,1,593,0,67,260,327,0,260,327,480,0,0,652,1,5,232,121,232,381,18,1622,542
1642,17,5.0.260,0,593,0,54,260,314,0,260,314,480,0,0,652,1,5,122,121,122,381,18,1622,542
1642,18,1.2.317,0,593,0,75,317,392,304,13,392,480,0,176,652,3,4,188,144,315,285,19,1622,475
1642,18,3.1.327,1,593,0,5,327,332,327,0,332,480,-23,65,675,2,5,165,11,232,273,19,1622,475
1642,18,5.0.327,0,593,0,54,327,381,0,327,381,480,0,0,652,1,6,122,54,122,381,19,1622,475
1642,19,1.2.317,0,593,0,75,317,392,304,13,392,480,0,176,675,3,4,188,144,315,285,20,1622,470
1642,19,3.2.332,0,594,1,50,332,382,332,0,382,480,-15,191,690,3,4,160,144,232,285,20,1622,470
1642,19,5.0.327,1,593,0,54,327,381,0,327,381,480,0,0,675,1,6,122,54,122,381,20,1622,470
1642,20,1.2.317,0,593,0,75,317,392,304,13,392,480,0,176,675,3,4,188,144,315,285,21,1622,416
1642,20,3.2.332,0,594,1,50,332,382,332,0,382,480,-15,191,690,3,4,160,144,232,285,21,1622,416
1642,20,5.1.381,1,593,0,6,381,387,381,0,387,480,-49,114,724,2,6,68,6,122,273,21,1622,416
1642,21,1.2.317,1,593,0,75,317,392,304,13,392,480,0,176,724,3,4,188,144,315,285,22,1622,410
1642,21,3.2.332,0,594,1,50,332,382,332,0,382,480,-15,191,739,3,4,160,144,232,285,22,1622,410
1642,21,5.2.387,0,594,1,19,387,406,387,0,406,480,-70,246,794,3,4,62,144,122,285,22,1622,410
1642,22,1.3.392,0,593,0,77,392,469,392,0,469,480,-21,182,745,4,4,113,153,315,363,23,1622,335
1642,22,3.2.392,1,593,0,50,392,442,332,60,442,480,0,176,724,3,5,160,69,232,285,23,1622,335
1642,22,5.2.392,0,593,0,19,392,411,387,5,411,480,0,176,724,3,5,62,69,122,285,23,1622,335
1642,23,1.3.392,0,593,0,77,392,469,392,0,469,480,-21,182,745,4,4,113,153,315,363,24,1622,285
1642,23,3.3.442,0,631,1,64,442,506,442,0,506,506,-71,232,795,4,4,110,153,232,363,24,1622,285
1642,23,5.2.442,1,593,0,19,442,461,387,55,461,480,0,176,724,3,6,62,19,122,285,24,1622,285
1642,24,1.3.392,1,593,0,77,392,469,392,0,469,480,-21,182,745,4,4,113,153,315,363,25,1622,266
1642,24,3.3.442,0,631,1,64,442,506,442,0,506,506,-71,232,795,4,4,110,153,232,363,25,1622,266
1642,24,5.3.461,0,650,2,12,461,473,461,0,473,480,-90,251,814,4,4,43,153,122,363,25,1622,266
1642,25,1.4.480,1,593,0,36,480,516,469,11,516,516,0,273,745,5,4,36,113,315,320,26,1622,189
1642,25,3.3.469,0,610,1,64,469,533,442,27,533,533,0,182,745,4,5,110,76,232,363,26,1622,189
1642,25,5.3.469,0,593,0,12,469,481,461,8,481,481,0,182,745,4,5,43,76,122,363,26,1622,189
1642,26,3.3.469,0,610,1,64,469,533,442,27,533,533,0,182,745,4,5,110,76,232,363,27,1622,153
1642,26,5.3.469,1,593,0,12,469,481,461,8,481,516,0,182,745,4,5,43,76,122,363,27,1622,153
1642,27,3.3.481,0,593,0,64,481,545,442,39,545,545,0,182,745,4,6,110,64,232,363,28,1622,141
1642,27,5.4.516,1,593,0,31,516,547,481,35,547,547,0,273,745,5,5,31,77,122,320,28,1622,141
1642,28,3.3.481,1,593,0,64,481,545,442,39,545,547,0,182,745,4,6,110,64,232,363,29,1622,110
1642,29,3.4.547,1,593,0,46,547,593,545,2,593,593,0,273,745,5,6,46,46,232,320,30,1622,46
1643,0,0.0.0,0,535,5,94,0,94,0,0,94,94,0,0,0,1,1,249,296,249,296,1,1294,1294
1643,0,1.0.0,0,476,1,59,0,59,0,0,59,59,0,0,0,1,1,216,296,216,296,1,1294,1294
1643,0,2.0.0,0,492,4,30,0,30,0,0,30,30,0,0,0,1,1,148,296,148,296,1,1294,1294
1643,0,3.0.0,0,462,0,20,0,20,0,0,20,20,0,0,0,1,1,191,296,191,296,1,1294,1294
1643,0,4.0.0,0,482,2,34,0,34,0,0,34,34,0,0,0,1,1,168,296,168,296,1,1294,1294
1643,0,5.0.0,1,489,3,59,0,59,0,0,59,59,0,0,0,1,1,322,296,322,296,1,1294,1294
1643,1,0.0.59,0,516,2,94,59,153,0,59,153,153,0,0,0,1,2,249,237,249,296,2,1294,1235
1643,1,1.0.59,0,495,1,59,59,118,0,59,118,118,0,0,0,1,2,216,237,216,296,2,1294,1235
1643,1,2.0.59,0,495,1,30,59,89,0,59,89,89,0,0,0,1,2,148,237,148,296,2,1294,1235
1643,1,3.0.59,1,489,0,20,59,79,0,59,79,79,0,0,0,1,2,191,237,191,296,2,1294,1235
1643,1,4.0.59,0,495,1,34,59,93,0,59,93,93,0,0,0,1,2,168,237,168,296,2,1294,1235
1643,1,5.1.59,0,495,1,88,59,147,59,0,147,147,-59,59,59,2,1,263,276,322,276,2,1294,1235
1643,2,0.0.79,0,504,2,94,79,173,0,79,173,173,0,0,0,1,3,249,217,249,296,3,1294,1215
1643,2,1.0.79,0,489,0,59,79,138,0,79,138,138,0,0,0,1,3,216,217,216,296,3,1294,1215
1643,2,2.0.79,0,495,1,30,79,109,0,79,109,109,0,0,0,1,3,148,217,148,296,3,1294,1215
1643,2,3.1.79,0,489,0,43,79,122,79,0,122,122,-79,79,79,2,1,171,276,191,276,3,1294,1215
1643,2,4.0.79,1,495,1,34,79,113,0,79,113,113,0,0,0,1,3,168,217,168,296,3,1294,1215
1643,2,5.1.59,0,495,1,88,59,147,59,0,147,147,-59,59,59,2,1,263,276,322,276,3,1294,1215
1643,3,0.0.113,0,496,1,94,113,207,0,113,207,207,0,0,0,1,4,249,183,249,296,4,1294,1181
1643,3,1.0.113,0,495,0,59,113,172,0,113,172,172,0,0,0,1,4,216,183,216,296,4,1294,1181
1643,3,2.0.113,1,495,0,30,113,143,0,113,143,143,0,0,0,1,4,148,183,148,296,4,1294,1181
1643,3,3.1.79,0,504,2,43,79,122,79,0,122,122,-79,79,79,2,1,171,276,191,276,4,1294,1181
1643,3,4.1.113,0,509,3,13,113,126,113,0,126,126,-113,113,113,2,1,134,276,168,276,4,1294,1181
1643,3,5.1.59,0,495,0,88,59,147,59,0,147,147,-59,59,59,2,1,263,276,322,276,4,1294,1181
1643,4,0.0.143,0,498,1,94,143,237,0,143,237,237,0,0,0,1,5,249,153,249,296,5,1294,1151
1643,4,1.0.143,1,495,0,59,143,202,0,143,202,202,0,0,0,1,5,216,153,216,296,5,1294,1151
1643,4,2.1.143,0,523,3,73,143,216,143,0,216,216,-143,143,143,2,1,118,276,148,276,5,1294,1151
1643,4,3.1.79,0,504,2,43,79,122,79,0,122,143,-79,79,79,2,1,171,276,191,276,5,1294,1151
1643,4,4.1.113,0,536,4,13,113,126,113,0,126,143,-113,113,113,2,1,134,276,168,276,5,1294,1151
1643,4,5.1.59,0,495,0,88,59,147,59,0,147,147,-59,59,59,2,1,263,276,322,276,5,1294,1151
1643,5,0.0.202,1,495,0,94,202,296,0,202,296,296,0,0,0,1,6,249,94,249,296,6,1294,1092
1643,5,1.1.202,0,495,0,13,202,215,202,0,215,215,-202,202,202,2,1,157,276,216,276,6,1294,1092
1643,5,2.1.143,0,523,2,73,143,216,143,0,216,216,-143,143,143,2,1,118,276,148,276,6,1294,1092
1643,5,3.1.79,0,504,1,43,79,122,79,0,122,202,-79,79,79,2,1,171,276,191,276,6,1294,1092
1643,5,4.1.113,0,536,3,13,113,126,113,0,126,202,-113,113,113,2,1,134,276,168,276,6,1294,1092
1643,5,5.1.59,0,495,0,88,59,147,59,0,147,202,-59,59,59,2,1,263,276,322,276,6,1294,1092
1643,6,0.1.296,0,495,0,46,296,342,296,0,342,342,-296,296,296,2,1,155,276,249,276,7,1294,998
1643,6,1.1.202,0,495,0,13,202,215,202,0,215,296,-202,202,202,2,1,157,276,216,276,7,1294,998
1643,6,2.1.143,0,523,2,73,143,216,143,0,216,296,-143,143,143,2,1,118,276,148,276,7,1294,998
1643,6,3.1.79,0,504,1,43,79,122,79,0,122,296,-79,79,79,2,1,171,276,191,276,7,1294,998
1643,6,4.1.113,0,536,3,13,113,126,113,0,126,296,-113,113,113,2,1,134,276,168,276,7,1294,998
1643,6,5.1.59,1,495,0,88,59,147,59,0,147,296,-59,59,59,2,1,263,276,322,276,7,1294,998
1643,7,0.1.296,0,495,0,46,296,342,296,0,342,342,-149,208,208,2,2,155,188,249,276,8,1294,910
1643,7,1.1.202,0,495,0,13,202,215,202,0,215,296,-55,114,114,2,2,157,188,216,276,8,1294,910
1643,7,2.1.147,0,539,1,73,147,220,143,4,220,296,0,59,59,2,2,118,188,148,276,8,1294,910
1643,7,3.1.147,0,495,0,43,147,190,79,68,190,296,0,59,59,2,2,171,188,191,276,8,1294,910
1643,7,4.1.147,0,495,0,13,147,160,113,34,160,296,0,59,59,2,2,134,188,168,276,8,1294,910
1643,7,5.2.147,1,495,0,57,147,204,147,0,204,296,-147,147,206,3,1,175,253,322,253,8,1294,910
1643,8,0.1.296,0,495,0,46,296,342,296,0,342,342,-149,208,355,2,2,155,188,249,276,9,1294,853
1643,8,1.1.202,0,495,0,13,202,215,202,0,215,296,-55,114,261,2,2,157,188,216,276,9,1294,853
1643,8,2.1.147,0,539,1,73,147,220,143,4,220,296,0,59,206,2,2,118,188,148,276,9,1294,853
1643,8,3.1.147,0,495,0,43,147,190,79,68,190,296,0,59,206,2,2,171,188,191,276,9,1294,853
1643,8,4.1.147,0,495,0,13,147,160,113,34,160,296,0,59,206,2,2,134,188,168,276,9,1294,853
1643,8,5.3.204,1,550,2,96,204,300,204,0,300,300,-204,204,410,4,1,118,219,322,219,9,1294,853
1643,9,0.1.296,0,550,0,46,296,342,296,0,342,342,-149,208,559,2,2,155,188,249,276,10,1294,757
1643,9,1.1.202,0,550,0,13,202,215,202,0,215,300,-55,114,465,2,2,157,188,216,276,10,1294,757
1643,9,2.1.147,0,550,0,73,147,220,143,4,220,300,0,59,410,2,2,118,188,148,276,10,1294,757
1643,9,3.1.147,0,550,0,43,147,190,79,68,190,300,0,59,410,2,2,171,188,191,276,10,1294,757
1643,9,4.1.147,0,550,0,13,147,160,113,34,160,300,0,59,410,2,2,134,188,168,276,10,1294,757
1643,9,5.4.300,1,550,0,22,300,322,300,0,322,322,-300,300,710,5,1,22,250,322,250,10,1294,757
1643,10,0.1.296,0,550,0,46,296,342,296,0,342,342,-149,208,859,2,2,155,188,249,276,11,1294,735
1643,10,1.1.202,0,550,0,13,202,215,202,0,215,322,-55,114,765,2,2,157,188,216,276,11,1294,735
1643,10,2.1.147,0,550,0,73,147,220,143,4,220,322,0,59,710,2,2,118,188,148,276,11,1294,735
1643,10,3.1.147,0,550,0,43,147,190,79,68,190,322,0,59,710,2,2,171,188,191,276,11,1294,735
1643,10,4.1.147,1,550,0,13,147,160,113,34,160,322,0,59,710,2,2,134,188,168,276,11,1294,735
1643,11,0.1.296,0,550,0,46,296,342,296,0,342,342,-136,195,846,2,3,155,175,249,276,12,1294,722
1643,11,1.1.202,0,550,0,13,202,215,202,0,215,322,-42,101,752,2,3,157,175,216,276,12,1294,722
1643,11,2.1.160,0,550,0,73,160,233,143,17,233,322,0,59,710,2,3,118,175,148,276,12,1294,722
1643,11,3.1.160,0,550,0,43,160,203,79,81,203,322,0,59,710,2,3,171,175,191,276,12,1294,722
1643,11,4.2.204,1,550,0,12,204,216,160,44,216,322,0,147,710,3,2,121,196,168,253,12,1294,722
1643,12,0.1.296,0,550,0,46,296,342,296,0,342,342,-136,195,846,2,3,155,175,249,276,13,1294,710
1643,12,1.1.202,0,550,0,13,202,215,202,0,215,322,-42,101,752,2,3,157,175,216,276,13,1294,710
1643,12,2.1.160,0,550,0,73,160,233,143,17,233,322,0,59,710,2,3,118,175,148,276,13,1294,710
1643,12,3.1.160,0,550,0,43,160,203,79,81,203,322,0,59,710,2,3,171,175,191,276,13,1294,710
1643,12,4.3.300,1,602,1,74,300,374,216,84,374,374,0,204,710,4,2,109,123,168,219,13,1294,710
1643,13,0.1.296,0,602,0,46,296,342,296,0,342,374,-136,195,846,2,3,155,175,249,276,14,1294,636
1643,13,1.1.202,0,602,0,13,202,215,202,0,215,374,-42,101,752,2,3,157,175,216,276,14,1294,636
1643,13,2.1.160,0,602,0,73,160,233,143,17,233,374,0,59,710,2,3,118,175,148,276,14,1294,636
1643,13,3.1.160,1,602,0,43,160,203,79,81,203,374,0,59,710,2,3,171,175,191,276,14,1294,636
1643,13,4.4.374,0,602,0,35,374,409,374,0,409,409,-52,352,762,5,2,35,228,168,250,14,1294,636
1643,14,0.1.296,0,602,0,46,296,342,296,0,342,374,-93,152,803,2,4,155,132,249,276,15,1294,593
1643,14,1.1.203,0,602,0,13,203,216,202,1,216,374,0,59,710,2,4,157,132,216,276,15,1294,593
1643,14,2.1.203,0,602,0,73,203,276,143,60,276,374,0,59,710,2,4,118,132,148,276,15,1294,593
1643,14,3.2.216,1,602,0,18,216,234,203,13,234,374,0,147,710,3,3,128,184,191,253,15,1294,593
1643,14,4.4.374,0,602,0,35,374,409,374,0,409,409,-52,352,762,5,2,35,228,168,250,15,1294,593
1643,15,0.1.296,0,602,0,46,296,342,296,0,342,374,-93,152,803,2,4,155,132,249,276,16,1294,575
1643,15,1.1.203,0,602,0,13,203,216,202,1,216,374,0,59,710,2,4,157,132,216,276,16,1294,575
1643,15,2.1.203,0,602,0,73,203,276,143,60,276,374,0,59,710,2,4,118,132,148,276,16,1294,575
1643,15,3.3.374,1,602,0,23,374,397,234,140,397,397,0,204,710,4,3,110,49,191,219,16,1294,575
1643,15,4.4.374,0,602,0,35,374,409,374,0,409,409,-52,352,762,5,2,35,228,168,250,16,1294,575
1643,16,0.1.296,0,602,0,46,296,342,296,0,342,397,-93,152,803,2,4,155,132,249,276,17,1294,552
1643,16,1.1.203,1,602,0,13,203,216,202,1,216,397,0,59,710,2,4,157,132,216,276,17,1294,552
1643,16,2.1.203,0,602,0,73,203,276,143,60,276,397,0,59,710,2,4,118,132,148,276,17,1294,552
1643,16,3.4.397,0,625,1,87,397,484,397,0,484,484,-75,375,785,5,2,87,228,191,250,17,1294,552
1643,16,4.4.374,0,602,0,35,374,409,374,0,409,409,-52,352,762,5,2,35,228,168,250,17,1294,552
1643,17,0.1.296,0,602,0,46,296,342,296,0,342,397,-80,139,790,2,5,155,119,249,276,18,1294,539
1643,17,1.2.234,1,602,0,80,234,314,216,18,314,397,0,147,710,3,4,144,166,216,253,18,1294,539
1643,17,2.1.216,0,602,0,73,216,289,143,73,289,397,0,59,710,2,5,118,119,148,276,18,1294,539
1643,17,3.4.397,0,625,1,87,397,484,397,0,484,484,-75,375,785,5,2,87,228,191,250,18,1294,539
1643,17,4.4.374,0,602,0,35,374,409,374,0,409,409,-52,352,762,5,2,35,228,168,250,18,1294,539
1643,18,0.1.296,0,602,0,46,296,342,296,0,342,397,-80,139,790,2,5,155,119,249,276,19,1294,459
1643,18,1.3.397,1,602,0,19,397,416,314,83,416,416,0,204,710,4,4,64,26,216,219,19,1294,459
1643,18,2.1.216,0,602,0,73,216,289,143,73,289,397,0,59,710,2,5,118,119,148,276,19,1294,459
1643,18,3.4.397,0,625,1,87,397,484,397,0,484,484,-75,375,785,5,2,87,228,191,250,19,1294,459
1643,18,4.4.374,0,602,0,35,374,409,374,0,409,409,-52,352,762,5,2,35,228,168,250,19,1294,459
1643,19,0.1.296,0,602,0,46,296,342,296,0,342,416,-80,139,790,2,5,155,119,249,276,20,1294,440
1643,19,1.4.416,0,609,1,45,416,461,416,0,461,461,-94,394,804,5,2,45,228,216,250,20,1294,440
1643,19,2.1.216,1,602,0,73,216,289,143,73,289,416,0,59,710,2,5,118,119,148,276,20,1294,440
1643,19,3.4.397,0,625,2,87,397,484,397,0,484,484,-75,375,785,5,2,87,228,191,250,20,1294,440
1643,19,4.4.374,0,602,0,35,374,409,374,0,409,416,-52,352,762,5,2,35,228,168,250,20,1294,440
1643,20,0.1.296,0,602,0,46,296,342,296,0,342,416,-7,66,717,2,6,155,46,249,276,21,1294,367
1643,20,1.4.416,0,609,1,45,416,461,416,0,461,461,-94,394,804,5,2,45,228,216,250,21,1294,367
1643,20,2.2.314,1,602,0,13,314,327,289,25,327,416,0,147,710,3,5,45,86,148,253,21,1294,367
1643,20,3.4.397,0,625,2,87,397,484,397,0,484,484,-75,375,785,5,2,87,228,191,250,21,1294,367
1643,20,4.4.374,0,602,0,35,374,409,374,0,409,416,-52,352,762,5,2,35,228,168,250,21,1294,367
1643,21,0.1.296,0,602,0,46,296,342,296,0,342,416,-7,66,717,2,6,155,46,249,276,22,1294,354
1643,21,1.4.416,0,609,1,45,416,461,416,0,461,461,-94,394,804,5,2,45,228,216,250,22,1294,354
1643,21,2.3.416,1,602,0,2,416,418,327,89,418,418,0,204,710,4,5,32,7,148,219,22,1294,354
1643,21,3.4.397,0,625,2,87,397,484,397,0,484,484,-75,375,785,5,2,87,228,191,250,22,1294,354
1643,21,4.4.374,0,602,0,35,374,409,374,0,409,416,-52,352,762,5,2,35,228,168,250,22,1294,354
1643,22,0.1.296,1,602,0,46,296,342,296,0,342,418,-7,66,717,2,6,155,46,249,276,23,1294,352
1643,22,1.4.416,0,609,1,45,416,461,416,0,461,461,-94,394,804,5,2,45,228,216,250,23,1294,352
1643,22,2.4.418,0,611,2,30,418,448,418,0,448,448,-96,396,806,5,2,30,228,148,250,23,1294,352
1643,22,3.4.397,0,625,3,87,397,484,397,0,484,484,-75,375,785,5,2,87,228,191,250,23,1294,352
1643,22,4.4.374,0,602,0,35,374,409,374,0,409,418,-52,352,762,5,2,35,228,168,250,23,1294,352
1643,23,0.2.342,1,602,0,73,342,415,342,0,415,418,-15,162,732,3,6,109,73,249,253,24,1294,306
1643,23,1.4.416,0,609,1,45,416,461,416,0,461,461,-94,394,811,5,2,45,228,216,250,24,1294,306
1643,23,2.4.418,0,611,2,30,418,448,418,0,448,448,-96,396,813,5,2,30,228,148,250,24,1294,306
1643,23,3.4.397,0,625,3,87,397,484,397,0,484,484,-75,375,792,5,2,87,228,191,250,24,1294,306
1643,23,4.4.374,0,602,0,35,374,409,374,0,409,418,-52,352,769,5,2,35,228,168,250,24,1294,306
1643,24,0.3.418,1,602,0,5,418,423,415,3,423,423,0,204,732,4,6,36,5,249,219,25,1294,233
1643,24,1.4.416,0,609,1,45,416,461,416,0,461,461,-94,394,826,5,2,45,228,216,250,25,1294,233
1643,24,2.4.418,0,611,2,30,418,448,418,0,448,448,-96,396,828,5,2,30,228,148,250,25,1294,233
1643,24,3.4.397,0,625,3,87,397,484,397,0,484,484,-75,375,807,5,2,87,228,191,250,25,1294,233
1643,24,4.4.374,0,602,0,35,374,409,374,0,409,418,-52,352,784,5,2,35,228,168,250,25,1294,233
1643,25,0.4.423,0,616,3,31,423,454,423,0,454,454,-101,401,833,5,2,31,228,249,250,26,1294,228
1643,25,1.4.416,0,609,1,45,416,461,416,0,461,461,-94,394,826,5,2,45,228,216,250,26,1294,228
1643,25,2.4.418,0,611,2,30,418,448,418,0,448,448,-96,396,828,5,2,30,228,148,250,26,1294,228
1643,25,3.4.397,0,625,4,87,397,484,397,0,484,484,-75,375,807,5,2,87,228,191,250,26,1294,228
1643,25,4.4.374,1,602,0,35,374,409,374,0,409,423,-52,352,784,5,2,35,228,168,250,26,1294,228
1643,26,0.4.423,1,616,3,31,423,454,423,0,454,454,-14,366,798,5,3,31,193,249,250,27,1294,193
1643,26,1.4.416,0,609,1,45,416,461,416,0,461,461,-7,359,791,5,3,45,193,216,250,27,1294,193
1643,26,2.4.418,0,611,2,30,418,448,418,0,448,448,-9,361,793,5,3,30,193,148,250,27,1294,193
1643,26,3.4.409,0,602,0,87,409,496,397,12,496,496,0,352,784,5,3,87,193,191,250,27,1294,193
1643,27,1.4.454,1,616,0,45,454,499,416,38,499,499,0,366,798,5,4,45,162,216,250,28,1294,162
1643,27,2.4.454,0,616,0,30,454,484,418,36,484,484,0,366,798,5,4,30,162,148,250,28,1294,162
1643,27,3.4.454,0,616,0,87,454,541,397,57,541,541,0,366,798,5,4,87,162,191,250,28,1294,162
1643,28,2.4.499,1,616,0,30,499,529,418,81,529,529,0,366,798,5,5,30,117,148,250,29,1294,117
1643,28,3.4.499,0,616,0,87,499,586,397,102,586,586,0,366,798,5,5,87,117,191,250,29,1294,117
1643,29,3.4.529,1,616,0,87,529,616,397,132,616,616,0,366,798,5,6,87,87,191,250,30,1294,87
1644,0,0.0.0,0,601,0,8,0,8,0,0,8,8,0,0,0,1,1,193,311,193,311,1,1762,1762
1644,0,1.0.0,1,615,1,35,0,35,0,0,35,35,0,0,0,1,1,316,311,316,311,1,1762,1762
1644,0,2.0.0,0,640,4,76,0,76,0,0,76,76,0,0,0,1,1,374,311,374,311,1,1762,1762
1644,0,3.0.0,0,641,5,73,0,73,0,0,73,73,0,0,0,1,1,349,311,349,311,1,1762,1762
1644,0,4.0.0,0,639,3,56,0,56,0,0,56,56,0,0,0,1,1,206,311,206,311,1,1762,1762
1644,0,5.0.0,0,627,2,63,0,63,0,0,63,63,0,0,0,1,1,324,311,324,311,1,1762,1762
1644,1,0.0.35,1,615,0,8,35,43,0,35,43,43,0,0,0,1,2,193,276,193,311,2,1762,1727
1644,1,1.1.35,0,629,1,80,35,115,35,0,115,115,-35,35,35,2,1,281,378,316,378,2,1762,1727
1644,1,2.0.35,0,629,1,76,35,111,0,35,111,111,0,0,0,1,2,374,276,374,311,2,1762,1727
1644,1,3.0.35,0,630,2,73,35,108,0,35,108,108,0,0,0,1,2,349,276,349,311,2,1762,1727
1644,1,4.0.35,0,630,2,56,35,91,0,35,91,91,0,0,0,1,2,206,276,206,311,2,1762,1727
1644,1,5.0.35,0,650,3,63,35,98,0,35,98,98,0,0,0,1,2,324,276,324,311,2,1762,1727
1644,2,0.1.43,0,615,0,14,43,57,43,0,57,57,-43,43,43,2,1,185,378,193,378,3,1762,1719
1644,2,1.1.35,0,630,4,80,35,115,35,0,115,115,-35,35,35,2,1,281,378,316,378,3,1762,1719
1644,2,2.0.43,1,615,0,76,43,119,0,43,119,119,0,0,0,1,3,374,268,374,311,3,1762,1719
1644,2,3.0.43,0,619,1,73,43,116,0,43,116,116,0,0,0,1,3,349,268,349,311,3,1762,1719
1644,2,4.0.43,0,622,2,56,43,99,0,43,99,99,0,0,0,1,3,206,268,206,311,3,1762,1719
1644,2,5.0.43,0,623,3,63,43,106,0,43,106,106,0,0,0,1,3,324,268,324,311,3,1762,1719
1644,3,0.1.43,0,615,0,14,43,57,43,0,57,119,-43,43,43,2,1,185,378,193,378,4,1762,1643
1644,3,1.1.35,0,630,2,80,35,115,35,0,115,119,-35,35,35,2,1,281,378,316,378,4,1762,1643
1644,3,2.1.119,0,630,2,67,119,186,119,0,186,186,-119,119,119,2,1,298,378,374,378,4,1762,1643
1644,3,3.0.119,0,615,0,73,119,192,0,119,192,192,0,0,0,1,4,349,192,349,311,4,1762,1643
1644,3,4.0.119,0,622,1,56,119,175,0,119,175,175,0,0,0,1,4,206,192,206,311,4,1762,1643
1644,3,5.0.119,1,622,1,63,119,182,0,119,182,182,0,0,0,1,4,324,192,324,311,4,1762,1643
1644,4,0.1.43,0,622,0,14,43,57,43,0,57,182,-43,43,43,2,1,185,378,193,378,5,1762,1580
1644,4,1.1.35,0,646,2,80,35,115,35,0,115,182,-35,35,35,2,1,281,378,316,378,5,1762,1580
1644,4,2.1.119,0,646,2,67,119,186,119,0,186,186,-119,119,119,2,1,298,378,374,378,5,1762,1580
1644,4,3.0.182,1,622,0,73,182,255,0,182,255,255,0,0,0,1,5,349,129,349,311,5,1762,1580
1644,4,4.0.182,0,630,1,56,182,238,0,182,238,238,0,0,0,1,5,206,129,206,311,5,1762,1580
1644,4,5.1.182,0,654,3,72,182,254,182,0,254,254,-182,182,182,2,1,261,378,324,378,5,1762,1580
1644,5,0.1.43,0,622,0,14,43,57,43,0,57,255,-43,43,43,2,1,185,378,193,378,6,1762,1507
1644,5,1.1.35,0,646,1,80,35,115,35,0,115,255,-35,35,35,2,1,281,378,316,378,6,1762,1507
1644,5,2.1.119,0,646,1,67,119,186,119,0,186,255,-119,119,119,2,1,298,378,374,378,6,1762,1507
1644,5,3.1.255,0,662,3,81,255,336,255,0,336,336,-255,255,255,2,1,276,378,349,378,6,1762,1507
1644,5,4.0.255,1,622,0,56,255,311,0,255,311,311,0,0,0,1,6,206,56,206,311,6,1762,1507
1644,5,5.1.182,0,654,2,72,182,254,182,0,254,255,-182,182,182,2,1,261,378,324,378,6,1762,1507
1644,6,0.1.43,1,622,0,14,43,57,43,0,57,311,-43,43,43,2,1,185,378,193,378,7,1762,1451
1644,6,1.1.35,0,646,1,80,35,115,35,0,115,311,-35,35,35,2,1,281,378,316,378,7,1762,1451
1644,6,2.1.119,0,646,1,67,119,186,119,0,186,311,-119,119,119,2,1,298,378,374,378,7,1762,1451
1644,6,3.1.255,0,662,4,81,255,336,255,0,336,336,-255,255,255,2,1,276,378,349,378,7,1762,1451
1644,6,4.1.311,0,651,2,64,311,375,311,0,375,375,-311,311,311,2,1,150,378,206,378,7,1762,1451
1644,6,5.1.182,0,654,3,72,182,254,182,0,254,311,-182,182,182,2,1,261,378,324,378,7,1762,1451
1644,7,0.2.57,0,622,0,77,57,134,57,0,134,311,-57,57,100,3,1,171,421,193,421,8,1762,1437
1644,7,1.1.57,1,622,0,80,57,137,35,22,137,311,0,43,43,2,2,281,364,316,378,8,1762,1437
1644,7,2.1.119,0,657,3,67,119,186,119,0,186,311,-62,105,105,2,2,298,364,374,378,8,1762,1437
1644,7,3.1.255,0,662,4,81,255,336,255,0,336,336,-198,241,241,2,2,276,364,349,378,8,1762,1437
1644,7,4.1.311,0,651,1,64,311,375,311,0,375,375,-254,297,297,2,2,150,364,206,378,8,1762,1437
1644,7,5.1.182,0,654,2,72,182,254,182,0,254,311,-125,168,168,2,2,261,364,324,378,8,1762,1437
1644,8,0.2.57,0,622,0,77,57,134,57,0,134,311,-57,57,100,3,1,171,421,193,421,9,1762,1357
1644,8,1.2.137,0,622,0,86,137,223,137,0,223,311,-137,137,180,3,1,201,421,316,421,9,1762,1357
1644,8,2.1.137,1,622,0,67,137,204,119,18,204,311,0,43,43,2,3,298,284,374,378,9,1762,1357
1644,8,3.1.255,0,662,3,81,255,336,255,0,336,336,-118,161,161,2,3,276,284,349,378,9,1762,1357
1644,8,4.1.311,0,651,1,64,311,375,311,0,375,375,-174,217,217,2,3,150,284,206,378,9,1762,1357
1644,8,5.1.182,0,654,2,72,182,254,182,0,254,311,-45,88,88,2,3,261,284,324,378,9,1762,1357
1644,9,0.2.57,0,622,0,77,57,134,57,0,134,311,-57,57,100,3,1,171,421,193,421,10,1762,1290
1644,9,1.2.137,0,622,0,86,137,223,137,0,223,311,-137,137,180,3,1,201,421,316,421,10,1762,1290
1644,9,2.2.204,0,675,3,66,204,270,204,0,270,311,-204,204,247,3,1,231,421,374,421,10,1762,1290
1644,9,3.1.255,0,662,2,81,255,336,255,0,336,336,-51,94,94,2,4,276,217,349,378,10,1762,1290
1644,9,4.1.311,0,651,1,64,311,375,311,0,375,375,-107,150,150,2,4,150,217,206,378,10,1762,1290
1644,9,5.1.204,1,622,0,72,204,276,182,22,276,311,0,43,43,2,4,261,217,324,378,10,1762,1290
1644,10,0.2.57,0,622,0,77,57,134,57,0,134,311,-57,57,100,3,1,171,421,193,421,11,1762,1218
1644,10,1.2.137,0,622,0,86,137,223,137,0,223,311,-137,137,180,3,1,201,421,316,421,11,1762,1218
1644,10,2.2.204,0,675,2,66,204,270,204,0,270,311,-204,204,247,3,1,231,421,374,421,11,1762,1218
1644,10,3.1.276,1,622,0,81,276,357,255,21,357,357,0,43,43,2,5,276,145,349,378,11,1762,1218
1644,10,4.1.311,0,651,1,64,311,375,311,0,375,375,-35,78,78,2,5,150,145,206,378,11,1762,1218
1644,10,5.2.276,0,675,2,95,276,371,276,0,371,371,-276,276,319,3,1,189,421,324,421,11,1762,1218
1644,11,0.2.57,0,622,0,77,57,134,57,0,134,357,-57,57,100,3,1,171,421,193,421,12,1762,1137
1644,11,1.2.137,0,622,0,86,137,223,137,0,223,357,-137,137,180,3,1,201,421,316,421,12,1762,1137
1644,11,2.2.204,0,675,1,66,204,270,204,0,270,357,-204,204,247,3,1,231,421,374,421,12,1762,1137
1644,11,3.2.357,0,683,2,84,357,441,357,0,441,441,-357,357,400,3,1,195,421,349,421,12,1762,1137
1644,11,4.1.357,1,622,0,64,357,421,311,46,421,421,0,43,43,2,6,150,64,206,378,12,1762,1137
1644,11,5.2.276,0,675,1,95,276,371,276,0,371,371,-276,276,319,3,1,189,421,324,421,12,1762,1137
1644,12,0.2.57,1,622,0,77,57,134,57,0,134,421,-57,57,100,3,1,171,421,193,421,13,1762,1073
1644,12,1.2.137,0,622,0,86,137,223,137,0,223,421,-137,137,180,3,1,201,421,316,421,13,1762,1073
1644,12,2.2.204,0,675,2,66,204,270,204,0,270,421,-204,204,247,3,1,231,421,374,421,13,1762,1073
1644,12,3.2.357,0,683,3,84,357,441,357,0,441,441,-357,357,400,3,1,195,421,349,421,13,1762,1073
1644,12,4.2.421,0,643,1,13,421,434,421,0,434,434,-421,421,464,3,1,86,421,206,421,13,1762,1073
1644,12,5.2.276,0,675,2,95,276,371,276,0,371,421,-276,276,319,3,1,189,421,324,421,13,1762,1073
1644,13,0.3.134,1,622,0,11,134,145,134,0,145,421,-134,134,234,4,1,94,371,193,371,14,1762,996
1644,13,1.2.137,0,622,0,86,137,223,137,0,223,421,-3,60,103,3,2,201,344,316,421,14,1762,996
1644,13,2.2.204,0,675,2,66,204,270,204,0,270,421,-70,127,170,3,2,231,344,374,421,14,1762,996
1644,13,3.2.357,0,683,3,84,357,441,357,0,441,441,-223,280,323,3,2,195,344,349,421,14,1762,996
1644,13,4.2.421,0,643,1,13,421,434,421,0,434,434,-287,344,387,3,2,86,344,206,421,14,1762,996
1644,13,5.2.276,0,675,2,95,276,371,276,0,371,421,-142,199,242,3,2,189,344,324,421,14,1762,996
1644,14,0.4.145,1,622,0,83,145,228,145,0,228,421,-145,145,379,5,1,83,281,193,281,15,1762,985
1644,14,1.2.137,0,622,0,86,137,223,137,0,223,421,-3,60,237,3,2,201,344,316,421,15,1762,985
1644,14,2.2.204,0,675,2,66,204,270,204,0,270,421,-70,127,304,3,2,231,344,374,421,15,1762,985
1644,14,3.2.357,0,683,3,84,357,441,357,0,441,441,-223,280,457,3,2,195,344,349,421,15,1762,985
1644,14,4.2.421,0,643,1,13,421,434,421,0,434,434,-287,344,521,3,2,86,344,206,421,15,1762,985
1644,14,5.2.276,0,675,2,95,276,371,276,0,371,421,-142,199,376,3,2,189,344,324,421,15,1762,985
1644,15,1.2.137,1,622,0,86,137,223,137,0,223,421,-3,60,382,3,2,201,344,316,421,16,1762,902
1644,15,2.2.204,0,675,2,66,204,270,204,0,270,421,-70,127,449,3,2,231,344,374,421,16,1762,902
1644,15,3.2.357,0,683,3,84,357,441,357,0,441,441,-223,280,602,3,2,195,344,349,421,16,1762,902
1644,15,4.2.421,0,643,1,13,421,434,421,0,434,434,-287,344,666,3,2,86,344,206,421,16,1762,902
1644,15,5.2.276,0,675,2,95,276,371,276,0,371,421,-142,199,521,3,2,189,344,324,421,16,1762,902
1644,16,1.3.223,0,622,0,61,223,284,223,0,284,421,-78,212,460,4,2,115,360,316,371,17,1762,816
1644,16,2.2.223,1,622,0,66,223,289,204,19,289,421,0,60,382,3,3,231,258,374,421,17,1762,816
1644,16,3.2.357,0,683,3,84,357,441,357,0,441,441,-134,194,516,3,3,195,258,349,421,17,1762,816
1644,16,4.2.421,0,643,1,13,421,434,421,0,434,434,-198,258,580,3,3,86,258,206,421,17,1762,816
1644,16,5.2.276,0,676,2,95,276,371,276,0,371,421,-53,113,435,3,3,189,258,324,421,17,1762,816
1644,17,1.3.223,0,622,0,61,223,284,223,0,284,421,-78,212,460,4,2,115,360,316,371,18,1762,750
1644,17,2.3.289,0,622,0,70,289,359,289,0,359,421,-144,278,526,4,2,165,360,374,371,18,1762,750
1644,17,3.2.357,0,683,2,84,357,441,357,0,441,441,-68,128,450,3,4,195,192,349,421,18,1762,750
1644,17,4.2.421,0,643,1,13,421,434,421,0,434,434,-132,192,514,3,4,86,192,206,421,18,1762,750
1644,17,5.2.289,1,622,0,95,289,384,276,13,384,421,0,60,382,3,4,189,192,324,421,18,1762,750
1644,18,1.3.223,0,622,0,61,223,284,223,0,284,421,-78,212,460,4,2,115,360,316,371,19,1762,655
1644,18,2.3.289,0,622,0,70,289,359,289,0,359,421,-144,278,526,4,2,165,360,374,371,19,1762,655
1644,18,3.2.384,1,622,0,84,384,468,357,27,468,468,0,60,382,3,5,195,97,349,421,19,1762,655
1644,18,4.2.421,0,643,1,13,421,434,421,0,434,434,-37,97,419,3,5,86,97,206,421,19,1762,655
1644,18,5.3.384,0,622,0,81,384,465,384,0,465,465,-239,373,621,4,2,94,360,324,371,19,1762,655
1644,19,1.3.223,0,622,0,61,223,284,223,0,284,468,-78,212,460,4,2,115,360,316,371,20,1762,571
1644,19,2.3.289,0,622,0,70,289,359,289,0,359,468,-144,278,526,4,2,165,360,374,371,20,1762,571
1644,19,3.3.468,0,622,0,81,468,549,468,0,549,549,-323,457,705,4,2,111,360,349,371,20,1762,571
1644,19,4.2.468,1,622,0,13,468,481,421,47,481,481,0,60,382,3,6,86,13,206,421,20,1762,571
1644,19,5.3.384,0,622,0,81,384,465,384,0,465,468,-239,373,621,4,2,94,360,324,371,20,1762,571
1644,20,1.3.223,1,622,0,61,223,284,223,0,284,481,-78,212,460,4,2,115,360,316,371,21,1762,558
1644,20,2.3.289,0,622,0,70,289,359,289,0,359,481,-144,278,526,4,2,165,360,374,371,21,1762,558
1644,20,3.3.468,0,622,0,81,468,549,468,0,549,549,-323,457,705,4,2,111,360,349,371,21,1762,558
1644,20,4.3.481,0,659,1,67,481,548,481,0,548,548,-336,470,718,4,2,73,360,206,371,21,1762,558
1644,20,5.3.384,0,622,0,81,384,465,384,0,465,481,-239,373,621,4,2,94,360,324,371,21,1762,558
1644,21,1.4.284,1,622,0,54,284,338,284,0,338,481,-56,201,516,5,2,54,198,316,281,22,1762,497
1644,21,2.3.289,0,622,0,70,289,359,289,0,359,481,-5,217,465,4,3,165,299,374,371,22,1762,497
1644,21,3.3.468,0,622,0,81,468,549,468,0,549,549,-184,396,644,4,3,111,299,349,371,22,1762,497
1644,21,4.3.481,0,659,1,67,481,548,481,0,548,548,-197,409,657,4,3,73,299,206,371,22,1762,497
1644,21,5.3.384,0,622,0,81,384,465,384,0,465,481,-100,312,560,4,3,94,299,324,371,22,1762,497
1644,22,2.3.289,1,622,0,70,289,359,289,0,359,481,-5,217,521,4,3,165,299,374,371,23,1762,443
1644,22,3.3.468,0,622,0,81,468,549,468,0,549,549,-184,396,700,4,3,111,299,349,371,23,1762,443
1644,22,4.3.481,0,659,1,67,481,548,481,0,548,548,-197,409,713,4,3,73,299,206,371,23,1762,443
1644,22,5.3.384,0,622,0,81,384,465,384,0,465,481,-100,312,616,4,3,94,299,324,371,23,1762,443
1644,23,2.4.359,1,622,0,95,359,454,359,0,454,481,-21,222,542,5,3,95,144,374,281,24,1762,373
1644,23,3.3.468,0,622,0,81,468,549,468,0,549,549,-109,326,630,4,4,111,229,349,371,24,1762,373
1644,23,4.3.481,0,659,1,67,481,548,481,0,548,548,-122,339,643,4,4,73,229,206,371,24,1762,373
1644,23,5.3.384,0,622,0,81,384,465,384,0,465,481,-25,242,546,4,4,94,229,324,371,24,1762,373
1644,24,3.3.468,0,622,0,81,468,549,468,0,549,549,-109,326,651,4,4,111,229,349,371,25,1762,278
1644,24,4.3.481,0,659,1,67,481,548,481,0,548,548,-122,339,664,4,4,73,229,206,371,25,1762,278
1644,24,5.3.384,1,622,0,81,384,465,384,0,465,481,-25,242,567,4,4,94,229,324,371,25,1762,278
1644,25,3.3.468,0,622,0,81,468,549,468,0,549,549,-3,245,570,4,5,111,148,349,371,26,1762,197
1644,25,4.3.481,0,659,1,67,481,548,481,0,548,548,-16,258,583,4,5,73,148,206,371,26,1762,197
1644,25,5.4.465,1,622,0,13,465,478,465,0,478,481,-11,233,578,5,4,13,49,324,281,26,1762,197
1644,26,3.3.468,1,622,0,81,468,549,468,0,549,549,-3,245,581,4,5,111,148,349,371,27,1762,184
1644,26,4.3.481,0,659,1,67,481,548,481,0,548,548,-16,258,594,4,5,73,148,206,371,27,1762,184
1644,27,3.4.549,1,622,0,30,549,579,549,0,579,579,-71,304,652,5,5,30,36,349,281,28,1762,103
1644,27,4.3.549,0,622,0,67,549,616,481,68,616,616,0,245,581,4,6,73,67,206,371,28,1762,103
1644,28,4.3.549,1,622,0,67,549,616,481,68,616,616,0,245,652,4,6,73,67,206,371,29,1762,73
1644,29,4.4.616,1,622,0,6,616,622,616,0,622,622,-37,341,689,5,6,6,6,206,281,30,1762,6
1645,0,0.0.0,0,470,2,21,0,21,0,0,21,21,0,0,0,1,1,236,225,236,225,1,1331,1331
1645,0,1.0.0,1,459,1,10,0,10,0,0,10,10,0,0,0,1,1,215,225,215,225,1,1331,1331
1645,0,2.0.0,0,449,0,22,0,22,0,0,22,22,0,0,0,1,1,200,225,200,225,1,1331,1331
1645,0,3.0.0,0,449,0,27,0,27,0,0,27,27,0,0,0,1,1,211,225,211,225,1,1331,1331
1645,0,4.0.0,0,477,3,77,0,77,0,0,77,77,0,0,0,1,1,243,225,243,225,1,1331,1331
1645,0,5.0.0,0,517,4,68,0,68,0,0,68,68,0,0,0,1,1,226,225,226,225,1,1331,1331
1645,1,0.0.10,1,461,1,21,10,31,0,10,31,31,0,0,0,1,2,236,215,236,225,2,1331,1321
1645,1,1.1.10,0,461,1,48,10,58,10,0,58,58,-10,10,10,2,1,205,281,215,281,2,1331,1321
1645,1,2.0.10,0,459,0,22,10,32,0,10,32,32,0,0,0,1,2,200,215,200,225,2,1331,1321
1645,1,3.0.10,0,459,0,27,10,37,0,10,37,37,0,0,0,1,2,211,215,211,225,2,1331,1321
1645,1,4.0.10,0,469,3,77,10,87,0,10,87,87,0,0,0,1,2,243,215,243,225,2,1331,1321
1645,1,5.0.10,0,467,2,68,10,78,0,10,78,78,0,0,0,1,2,226,215,226,225,2,1331,1321
1645,2,0.1.31,0,512,3,81,31,112,31,0,112,112,-31,31,31,2,1,215,281,236,281,3,1331,1300
1645,2,1.1.10,0,461,0,48,10,58,10,0,58,58,-10,10,10,2,1,205,281,215,281,3,1331,1300
1645,2,2.0.31,1,461,0,22,31,53,0,31,53,53,0,0,0,1,3,200,194,200,225,3,1331,1300
1645,2,3.0.31,0,461,0,27,31,58,0,31,58,58,0,0,0,1,3,211,194,211,225,3,1331,1300
1645,2,4.0.31,0,469,1,77,31,108,0,31,108,108,0,0,0,1,3,243,194,243,225,3,1331,1300
1645,2,5.0.31,0,488,2,68,31,99,0,31,99,99,0,0,0,1,3,226,194,226,225,3,1331,1300
1645,3,0.1.31,0,523,2,81,31,112,31,0,112,112,-31,31,31,2,1,215,281,236,281,4,1331,1278
1645,3,1.1.10,0,461,0,48,10,58,10,0,58,58,-10,10,10,2,1,205,281,215,281,4,1331,1278
1645,3,2.1.53,0,480,1,60,53,113,53,0,113,113,-53,53,53,2,1,178,281,200,281,4,1331,1278
1645,3,3.0.53,1,461,0,27,53,80,0,53,80,80,0,0,0,1,4,211,172,211,225,4,1331,1278
1645,3,4.0.53,0,461,0,77,53,130,0,53,130,130,0,0,0,1,4,243,172,243,225,4,1331,1278
1645,3,5.0.53,0,461,0,68,53,121,0,53,121,121,0,0,0,1,4,226,172,226,225,4,1331,1278
1645,4,0.1.31,0,523,3,81,31,112,31,0,112,112,-31,31,31,2,1,215,281,236,281,5,1331,1251
1645,4,1.1.10,0,461,0,48,10,58,10,0,58,80,-10,10,10,2,1,205,281,215,281,5,1331,1251
1645,4,2.1.53,0,480,2,60,53,113,53,0,113,113,-53,53,53,2,1,178,281,200,281,5,1331,1251
1645,4,3.1.80,0,464,1,20,80,100,80,0,100,100,-80,80,80,2,1,184,281,211,281,5,1331,1251
1645,4,4.0.80,0,461,0,77,80,157,0,80,157,157,0,0,0,1,5,243,145,243,225,5,1331,1251
1645,4,5.0.80,1,461,0,68,80,148,0,80,148,148,0,0,0,1,5,226,145,226,225,5,1331,1251
1645,5,0.1.31,0,523,3,81,31,112,31,0,112,148,-31,31,31,2,1,215,281,236,281,6,1331,1183
1645,5,1.1.10,0,461,0,48,10,58,10,0,58,148,-10,10,10,2,1,205,281,215,281,6,1331,1183
1645,5,2.1.53,0,480,2,60,53,113,53,0,113,148,-53,53,53,2,1,178,281,200,281,6,1331,1183
1645,5,3.1.80,0,464,1,20,80,100,80,0,100,148,-80,80,80,2,1,184,281,211,281,6,1331,1183
1645,5,4.0.148,1,461,0,77,148,225,0,148,225,225,0,0,0,1,6,243,77,243,225,6,1331,1183
1645,5,5.1.148,0,461,0,55,148,203,148,0,203,203,-148,148,148,2,1,158,281,226,281,6,1331,1183
1645,6,0.1.31,0,523,3,81,31,112,31,0,112,225,-31,31,31,2,1,215,281,236,281,7,1331,1106
1645,6,1.1.10,1,461,0,48,10,58,10,0,58,225,-10,10,10,2,1,205,281,215,281,7,1331,1106
1645,6,2.1.53,0,480,2,60,53,113,53,0,113,225,-53,53,53,2,1,178,281,200,281,7,1331,1106
1645,6,3.1.80,0,464,1,20,80,100,80,0,100,225,-80,80,80,2,1,184,281,211,281,7,1331,1106
1645,6,4.1.225,0,461,0,17,225,242,225,0,242,242,-225,225,225,2,1,166,281,243,281,7,1331,1106
1645,6,5.1.148,0,461,0,55,148,203,148,0,203,225,-148,148,148,2,1,158,281,226,281,7,1331,1106
1645,7,0.1.58,0,497,2,81,58,139,31,27,139,225,0,10,10,2,2,215,233,236,281,8,1331,1058
1645,7,1.2.58,0,461,0,91,58,149,58,0,149,225,-58,58,68,3,1,157,290,215,290,8,1331,1058
1645,7,2.1.58,0,461,0,60,58,118,53,5,118,225,0,10,10,2,2,178,233,200,281,8,1331,1058
1645,7,3.1.80,1,464,1,20,80,100,80,0,100,225,-22,32,32,2,2,184,233,211,281,8,1331,1058
1645,7,4.1.225,0,461,0,17,225,242,225,0,242,242,-167,177,177,2,2,166,233,243,281,8,1331,1058
1645,7,5.1.148,0,461,0,55,148,203,148,0,203,225,-90,100,100,2,2,158,233,226,281,8,1331,1058
1645,8,0.1.100,1,488,1,81,100,181,31,69,181,225,0,32,32,2,3,215,213,236,281,9,1331,1038
1645,8,1.2.58,0,464,0,91,58,149,58,0,149,225,-58,58,90,3,1,157,290,215,290,9,1331,1038
1645,8,2.1.100,0,464,0,60,100,160,53,47,160,225,0,32,32,2,3,178,213,200,281,9,1331,1038
1645,8,3.2.100,0,502,3,52,100,152,100,0,152,225,-100,100,132,3,1,164,290,211,290,9,1331,1038
1645,8,4.1.225,0,464,0,17,225,242,225,0,242,242,-125,157,157,2,3,166,213,243,281,9,1331,1038
1645,8,5.1.148,0,500,2,55,148,203,148,0,203,225,-48,80,80,2,3,158,213,226,281,9,1331,1038
1645,9,0.2.181,0,521,4,80,181,261,181,0,261,261,-181,181,213,3,1,134,290,236,290,10,1331,957
1645,9,1.2.58,0,488,0,91,58,149,58,0,149,225,-58,58,90,3,1,157,290,215,290,10,1331,957
1645,9,2.1.181,1,488,0,60,181,241,53,128,241,241,0,32,32,2,4,178,132,200,281,10,1331,957
1645,9,3.2.100,0,502,3,52,100,152,100,0,152,225,-100,100,132,3,1,164,290,211,290,10,1331,957
1645,9,4.1.225,0,491,1,17,225,242,225,0,242,242,-44,76,76,2,4,166,132,243,281,10,1331,957
1645,9,5.1.181,0,493,2,55,181,236,148,33,236,236,0,32,32,2,4,158,132,226,281,10,1331,957
1645,10,0.2.181,0,521,2,80,181,261,181,0,261,261,-181,181,213,3,1,134,290,236,290,11,1331,897
1645,10,1.2.58,0,488,0,91,58,149,58,0,149,241,-58,58,90,3,1,157,290,215,290,11,1331,897
1645,10,2.2.241,0,488,0,19,241,260,241,0,260,260,-241,241,273,3,1,118,290,200,290,11,1331,897
1645,10,3.2.100,0,502,1,52,100,152,100,0,152,241,-100,100,132,3,1,164,290,211,290,11,1331,897
1645,10,4.1.241,1,488,0,17,241,258,225,16,258,258,0,32,32,2,5,166,72,243,281,11,1331,897
1645,10,5.1.241,0,488,0,55,241,296,148,93,296,296,0,32,32,2,5,158,72,226,281,11,1331,897
1645,11,0.2.181,0,521,3,80,181,261,181,0,261,261,-181,181,213,3,1,134,290,236,290,12,1331,880
1645,11,1.2.58,0,488,0,91,58,149,58,0,149,258,-58,58,90,3,1,157,290,215,290,12,1331,880
1645,11,2.2.241,0,488,0,19,241,260,241,0,260,260,-241,241,273,3,1,118,290,200,290,12,1331,880
1645,11,3.2.100,0,502,1,52,100,152,100,0,152,258,-100,100,132,3,1,164,290,211,290,12,1331,880
1645,11,4.2.258,0,505,2,14,258,272,258,0,272,272,-258,258,290,3,1,149,290,243,290,12,1331,880
1645,11,5.1.258,1,488,0,55,258,313,148,110,313,313,0,32,32,2,6,158,55,226,281,12,1331,880
1645,12,0.2.181,0,521,3,80,181,261,181,0,261,313,-181,181,213,3,1,134,290,236,290,13,1331,825
1645,12,1.2.58,0,488,0,91,58,149,58,0,149,313,-58,58,90,3,1,157,290,215,290,13,1331,825
1645,12,2.2.241,0,488,0,19,241,260,241,0,260,313,-241,241,273,3,1,118,290,200,290,13,1331,825
1645,12,3.2.100,1,502,1,52,100,152,100,0,152,313,-100,100,132,3,1,164,290,211,290,13,1331,825
1645,12,4.2.258,0,505,2,14,258,272,258,0,272,313,-258,258,290,3,1,149,290,243,290,13,1331,825
1645,12,5.2.313,0,488,0,34,313,347,313,0,347,347,-313,313,345,3,1,103,290,226,290,13,1331,825
1645,13,0.2.181,0,521,2,80,181,261,181,0,261,313,-29,129,161,3,2,134,238,236,290,14,1331,773
1645,13,1.2.152,0,502,0,91,152,243,58,94,243,313,0,100,132,3,2,157,238,215,290,14,1331,773
1645,13,2.2.241,0,537,3,19,241,260,241,0,260,313,-89,189,221,3,2,118,238,200,290,14,1331,773
1645,13,3.3.152,1,502,0,41,152,193,152,0,193,313,-152,152,284,4,1,112,226,211,226,14,1331,773
1645,13,4.2.258,0,505,1,14,258,272,258,0,272,313,-106,206,238,3,2,149,238,243,290,14,1331,773
1645,13,5.2.313,0,502,0,34,313,347,313,0,347,347,-161,261,293,3,2,103,238,226,290,14,1331,773
1645,14,0.2.181,0,521,2,80,181,261,181,0,261,313,-29,129,313,3,2,134,238,236,290,15,1331,732
1645,14,1.2.152,0,502,0,91,152,243,58,94,243,313,0,100,284,3,2,157,238,215,290,15,1331,732
1645,14,2.2.241,0,537,3,19,241,260,241,0,260,313,-89,189,373,3,2,118,238,200,290,15,1331,732
1645,14,3.4.193,1,502,0,71,193,264,193,0,264,313,-193,193,477,5,1,71,309,211,309,15,1331,732
1645,14,4.2.258,0,505,1,14,258,272,258,0,272,313,-106,206,390,3,2,149,238,243,290,15,1331,732
1645,14,5.2.313,0,502,0,34,313,347,313,0,347,347,-161,261,445,3,2,103,238,226,290,15,1331,732
1645,15,0.2.181,0,521,2,80,181,261,181,0,261,313,-29,129,506,3,2,134,238,236,290,16,1331,661
1645,15,1.2.152,1,502,0,91,152,243,58,94,243,313,0,100,477,3,2,157,238,215,290,16,1331,661
1645,15,2.2.241,0,537,3,19,241,260,241,0,260,313,-89,189,566,3,2,118,238,200,290,16,1331,661
1645,15,4.2.258,0,505,1,14,258,272,258,0,272,313,-106,206,583,3,2,149,238,243,290,16,1331,661
1645,15,5.2.313,0,502,0,34,313,347,313,0,347,347,-161,261,638,3,2,103,238,226,290,16,1331,661
1645,16,0.2.243,0,520,2,80,243,323,181,62,323,323,0,100,477,3,3,134,147,236,290,17,1331,570
1645,16,1.3.243,1,502,0,3,243,246,243,0,246,313,-50,202,527,4,2,66,185,215,226,17,1331,570
1645,16,2.2.243,0,502,0,19,243,262,241,2,262,313,0,100,477,3,3,118,147,200,290,17,1331,570
1645,16,4.2.258,0,505,1,14,258,272,258,0,272,313,-15,115,492,3,3,149,147,243,290,17,1331,570
1645,16,5.2.313,0,502,0,34,313,347,313,0,347,347,-70,170,547,3,3,103,147,226,290,17,1331,570
1645,17,0.2.243,0,520,2,80,243,323,181,62,323,323,0,100,527,3,3,134,147,236,290,18,1331,567
1645,17,1.4.264,1,502,0,63,264,327,246,18,327,327,0,193,527,5,2,63,238,215,309,18,1331,567
1645,17,2.2.243,0,502,0,19,243,262,241,2,262,313,0,100,527,3,3,118,147,200,290,18,1331,567
1645,17,4.2.258,0,505,1,14,258,272,258,0,272,313,-15,115,542,3,3,149,147,243,290,18,1331,567
1645,17,5.2.313,0,502,0,34,313,347,313,0,347,347,-70,170,597,3,3,103,147,226,290,18,1331,567
1645,18,0.2.243,0,520,2,80,243,323,181,62,323,327,0,100,527,3,3,134,147,236,290,19,1331,504
1645,18,2.2.243,0,502,0,19,243,262,241,2,262,327,0,100,527,3,3,118,147,200,290,19,1331,504
1645,18,4.2.258,1,505,1,14,258,272,258,0,272,327,-15,115,542,3,3,149,147,243,290,19,1331,504
1645,18,5.2.313,0,502,0,34,313,347,313,0,347,347,-70,170,597,3,3,103,147,226,290,19,1331,504
1645,19,0.2.272,0,507,1,80,272,352,181,91,352,352,0,115,542,3,4,134,133,236,290,20,1331,490
1645,19,2.2.272,1,505,0,19,272,291,241,31,291,327,0,115,542,3,4,118,133,200,290,20,1331,490
1645,19,4.3.272,0,507,1,60,272,332,272,0,332,332,-26,228,568,4,3,135,182,243,226,20,1331,490
1645,19,5.2.313,0,507,1,34,313,347,313,0,347,347,-41,156,583,3,4,103,133,226,290,20,1331,490
1645,20,0.2.291,1,505,0,80,291,371,181,110,371,371,0,115,542,3,5,134,114,236,290,21,1331,471
1645,20,2.3.291,0,505,0,39,291,330,291,0,330,330,-45,247,587,4,3,99,182,200,226,21,1331,471
1645,20,4.3.272,0,507,1,60,272,332,272,0,332,332,-26,228,568,4,3,135,182,243,226,21,1331,471
1645,20,5.2.313,0,507,1,34,313,347,313,0,347,347,-22,137,564,3,5,103,114,226,290,21,1331,471
1645,21,0.3.371,0,507,1,18,371,389,371,0,389,389,-125,327,667,4,3,54,182,236,226,22,1331,391
1645,21,2.3.291,0,505,0,39,291,330,291,0,330,371,-45,247,587,4,3,99,182,200,226,22,1331,391
1645,21,4.3.272,0,507,1,60,272,332,272,0,332,371,-26,228,568,4,3,135,182,243,226,22,1331,391
1645,21,5.2.371,1,505,0,34,371,405,313,58,405,405,0,115,542,3,6,103,34,226,290,22,1331,391
1645,22,0.3.371,0,507,1,18,371,389,371,0,389,405,-125,327,667,4,3,54,182,236,226,23,1331,357
1645,22,2.3.291,0,505,0,39,291,330,291,0,330,405,-45,247,587,4,3,99,182,200,226,23,1331,357
1645,22,4.3.272,1,507,1,60,272,332,272,0,332,405,-26,228,568,4,3,135,182,243,226,23,1331,357
1645,22,5.3.405,0,507,1,65,405,470,405,0,470,470,-159,361,701,4,3,69,182,226,226,23,1331,357
1645,23,0.3.371,0,507,0,18,371,389,371,0,389,405,-39,267,607,4,4,54,122,236,226,24,1331,297
1645,23,2.3.332,1,507,0,39,332,371,291,41,371,405,0,228,568,4,4,99,122,200,226,24,1331,297
1645,23,4.4.332,0,507,0,75,332,407,332,0,407,407,-5,198,573,5,3,75,175,243,309,24,1331,297
1645,23,5.3.405,0,507,0,65,405,470,405,0,470,470,-73,301,641,4,4,69,122,226,226,24,1331,297
1645,24,0.3.371,1,507,0,18,371,389,371,0,389,405,0,228,568,4,5,54,83,236,226,25,1331,258
1645,24,2.4.371,0,546,1,60,371,431,371,0,431,431,-44,237,612,5,3,60,175,200,309,25,1331,258
1645,24,4.4.332,0,507,0,75,332,407,332,0,407,407,-5,198,573,5,3,75,175,243,309,25,1331,258
1645,24,5.3.405,0,507,0,65,405,470,405,0,470,470,-34,262,602,4,5,69,83,226,226,25,1331,258
1645,25,0.4.389,0,564,2,36,389,425,389,0,425,425,-62,255,630,5,3,36,175,236,309,26,1331,240
1645,25,2.4.371,0,546,1,60,371,431,371,0,431,431,-44,237,612,5,3,60,175,200,309,26,1331,240
1645,25,4.4.332,0,507,0,75,332,407,332,0,407,407,-5,198,573,5,3,75,175,243,309,26,1331,240
1645,25,5.3.405,1,507,0,65,405,470,405,0,470,470,-16,244,584,4,6,69,65,226,226,26,1331,240
1645,26,0.4.389,0,564,3,36,389,425,389,0,425,470,-62,255,646,5,3,36,175,236,309,27,1331,175
1645,26,2.4.371,0,546,2,60,371,431,371,0,431,470,-44,237,628,5,3,60,175,200,309,27,1331,175
1645,26,4.4.332,1,507,0,75,332,407,332,0,407,470,-5,198,589,5,3,75,175,243,309,27,1331,175
1645,26,5.4.470,0,510,1,4,470,474,470,0,474,474,-143,336,727,5,3,4,175,226,309,27,1331,175
1645,27,0.4.407,1,507,0,36,407,443,389,18,443,470,0,198,589,5,4,36,100,236,309,28,1331,100
1645,27,2.4.407,0,507,0,60,407,467,371,36,467,470,0,198,589,5,4,60,100,200,309,28,1331,100
1645,27,5.4.470,0,510,1,4,470,474,470,0,474,474,-63,261,652,5,4,4,100,226,309,28,1331,100
1645,28,2.4.443,0,507,0,60,443,503,371,72,503,503,0,198,589,5,5,60,64,200,309,29,1331,64
1645,28,5.4.470,1,534,1,4,470,474,470,0,474,474,-27,225,616,5,5,4,64,226,309,29,1331,64
1645,29,2.4.474,1,534,0,60,474,534,371,103,534,534,0,225,616,5,6,60,60,200,309,30,1331,60
1646,0,0.0.0,1,597,0,34,0,34,0,0,34,34,0,0,0,1,1,282,437,282,437,1,1698,1698
1646,0,1.0.0,0,597,0,85,0,85,0,0,85,85,0,0,0,1,1,313,437,313,437,1,1698,1698
1646,0,2.0.0,0,626,1,67,0,67,0,0,67,67,0,0,0,1,1,227,437,227,437,1,1698,1698
1646,0,3.0.0,0,633,2,80,0,80,0,0,80,80,0,0,0,1,1,269,437,269,437,1,1698,1698
1646,0,4.0.0,0,626,1,99,0,99,0,0,99,99,0,0,0,1,1,280,437,280,437,1,1698,1698
1646,0,5.0.0,0,597,0,72,0,72,0,0,72,72,0,0,0,1,1,327,437,327,437,1,1698,1698
1646,1,0.1.34,1,597,0,50,34,84,34,0,84,84,-34,34,34,2,1,248,284,282,284,2,1698,1664
1646,1,1.0.34,0,597,0,85,34,119,0,34,119,119,0,0,0,1,2,313,403,313,437,2,1698,1664
1646,1,2.0.34,0,623,2,67,34,101,0,34,101,101,0,0,0,1,2,227,403,227,437,2,1698,1664
1646,1,3.0.34,0,598,1,80,34,114,0,34,114,114,0,0,0,1,2,269,403,269,437,2,1698,1664
1646,1,4.0.34,0,597,0,99,34,133,0,34,133,133,0,0,0,1,2,280,403,280,437,2,1698,1664
1646,1,5.0.34,0,597,0,72,34,106,0,34,106,106,0,0,0,1,2,327,403,327,437,2,1698,1664
1646,2,0.2.84,1,597,0,84,84,168,84,0,168,168,-84,84,118,3,1,198,357,282,357,3,1698,1614
1646,2,1.0.34,0,597,0,85,34,119,0,34,119,119,0,0,34,1,2,313,403,313,437,3,1698,1614
1646,2,2.0.34,0,623,2,67,34,101,0,34,101,101,0,0,34,1,2,227,403,227,437,3,1698,1614
1646,2,3.0.34,0,598,1,80,34,114,0,34,114,114,0,0,34,1,2,269,403,269,437,3,1698,1614
1646,2,4.0.34,0,597,0,99,34,133,0,34,133,133,0,0,34,1,2,280,403,280,437,3,1698,1614
1646,2,5.0.34,0,597,0,72,34,106,0,34,106,106,0,0,34,1,2,327,403,327,437,3,1698,1614
1646,3,0.3.168,1,597,0,25,168,193,168,0,193,193,-168,168,286,4,1,114,279,282,279,4,1698,1530
1646,3,1.0.34,0,597,0,85,34,119,0,34,119,168,0,0,118,1,2,313,403,313,437,4,1698,1530
1646,3,2.0.34,0,623,2,67,34,101,0,34,101,168,0,0,118,1,2,227,403,227,437,4,1698,1530
1646,3,3.0.34,0,598,1,80,34,114,0,34,114,168,0,0,118,1,2,269,403,269,437,4,1698,1530
1646,3,4.0.34,0,597,0,99,34,133,0,34,133,168,0,0,118,1,2,280,403,280,437,4,1698,1530
1646,3,5.0.34,0,597,0,72,34,106,0,34,106,168,0,0,118,1,2,327,403,327,437,4,1698,1530
1646,4,0.4.193,1,597,0,89,193,282,193,0,282,282,-193,193,479,5,1,89,341,282,341,5,1698,1505
1646,4,1.0.34,0,597,0,85,34,119,0,34,119,193,0,0,286,1,2,313,403,313,437,5,1698,1505
1646,4,2.0.34,0,623,2,67,34,101,0,34,101,193,0,0,286,1,2,227,403,227,437,5,1698,1505
1646,4,3.0.34,0,598,1,80,34,114,0,34,114,193,0,0,286,1,2,269,403,269,437,5,1698,1505
1646,4,4.0.34,0,597,0,99,34,133,0,34,133,193,0,0,286,1,2,280,403,280,437,5,1698,1505
1646,4,5.0.34,0,597,0,72,34,106,0,34,106,193,0,0,286,1,2,327,403,327,437,5,1698,1505
1646,5,1.0.34,0,597,0,85,34,119,0,34,119,282,0,0,479,1,2,313,403,313,437,6,1698,1416
1646,5,2.0.34,0,623,2,67,34,101,0,34,101,282,0,0,479,1,2,227,403,227,437,6,1698,1416
1646,5,3.0.34,0,598,1,80,34,114,0,34,114,282,0,0,479,1,2,269,403,269,437,6,1698,1416
1646,5,4.0.34,0,597,0,99,34,133,0,34,133,282,0,0,479,1,2,280,403,280,437,6,1698,1416
1646,5,5.0.34,1,597,0,72,34,106,0,34,106,282,0,0,479,1,2,327,403,327,437,6,1698,1416
1646,6,1.0.106,0,597,0,85,106,191,0,106,191,282,0,0,479,1,3,313,331,313,437,7,1698,1344
1646,6,2.0.106,0,618,2,67,106,173,0,106,173,282,0,0,479,1,3,227,331,227,437,7,1698,1344
1646,6,3.0.106,0,598,1,80,106,186,0,106,186,282,0,0,479,1,3,269,331,269,437,7,1698,1344
1646,6,4.0.106,0,597,0,99,106,205,0,106,205,282,0,0,479,1,3,280,331,280,437,7,1698,1344
1646,6,5.1.106,1,597,0,38,106,144,106,0,144,282,-22,56,501,2,2,255,234,327,284,7,1698,1344
1646,7,1.0.106,0,597,0,85,106,191,0,106,191,282,0,0,501,1,3,313,331,313,437,8,1698,1306
1646,7,2.0.106,0,618,2,67,106,173,0,106,173,282,0,0,501,1,3,227,331,227,437,8,1698,1306
1646,7,3.0.106,0,598,1,80,106,186,0,106,186,282,0,0,501,1,3,269,331,269,437,8,1698,1306
1646,7,4.0.106,0,597,0,99,106,205,0,106,205,282,0,0,501,1,3,280,331,280,437,8,1698,1306
1646,7,5.2.168,1,597,0,72,168,240,144,24,240,282,0,84,501,3,2,217,273,327,357,8,1698,1306
1646,8,1.0.106,0,597,0,85,106,191,0,106,191,282,0,0,501,1,3,313,331,313,437,9,1698,1234
1646,8,2.0.106,0,618,2,67,106,173,0,106,173,282,0,0,501,1,3,227,331,227,437,9,1698,1234
1646,8,3.0.106,0,598,1,80,106,186,0,106,186,282,0,0,501,1,3,269,331,269,437,9,1698,1234
1646,8,4.0.106,0,597,0,99,106,205,0,106,205,282,0,0,501,1,3,280,331,280,437,9,1698,1234
1646,8,5.3.240,1,597,0,50,240,290,240,0,290,290,-47,215,548,4,2,145,254,327,279,9,1698,1234
1646,9,1.0.106,0,597,0,85,106,191,0,106,191,290,0,0,548,1,3,313,331,313,437,10,1698,1184
1646,9,2.0.106,0,618,2,67,106,173,0,106,173,290,0,0,548,1,3,227,331,227,437,10,1698,1184
1646,9,3.0.106,0,598,1,80,106,186,0,106,186,290,0,0,548,1,3,269,331,269,437,10,1698,1184
1646,9,4.0.106,0,597,0,99,106,205,0,106,205,290,0,0,548,1,3,280,331,280,437,10,1698,1184
1646,9,5.4.290,1,597,0,95,290,385,290,0,385,385,-8,201,556,5,2,95,252,327,341,10,1698,1184
1646,10,1.0.106,1,597,0,85,106,191,0,106,191,385,0,0,556,1,3,313,331,313,437,11,1698,1089
1646,10,2.0.106,0,618,2,67,106,173,0,106,173,385,0,0,556,1,3,227,331,227,437,11,1698,1089
1646,10,3.0.106,0,598,1,80,106,186,0,106,186,385,0,0,556,1,3,269,331,269,437,11,1698,1089
1646,10,4.0.106,0,597,0,99,106,205,0,106,205,385,0,0,556,1,3,280,331,280,437,11,1698,1089
1646,11,1.1.191,1,597,0,16,191,207,191,0,207,385,-47,103,603,2,3,228,196,313,284,12,1698,1004
1646,11,2.0.191,0,621,2,67,191,258,0,191,258,385,0,0,556,1,4,227,246,227,437,12,1698,1004
1646,11,3.0.191,0,604,1,80,191,271,0,191,271,385,0,0,556,1,4,269,246,269,437,12,1698,1004
1646,11,4.0.191,0,597,0,99,191,290,0,191,290,385,0,0,556,1,4,280,246,280,437,12,1698,1004
1646,12,1.2.240,1,597,0,96,240,336,207,33,336,385,0,84,603,3,3,212,201,313,357,13,1698,988
1646,12,2.0.191,0,621,2,67,191,258,0,191,258,385,0,0,603,1,4,227,246,227,437,13,1698,988
1646,12,3.0.191,0,604,1,80,191,271,0,191,271,385,0,0,603,1,4,269,246,269,437,13,1698,988
1646,12,4.0.191,0,597,0,99,191,290,0,191,290,385,0,0,603,1,4,280,246,280,437,13,1698,988
1646,13,1.3.336,1,597,0,44,336,380,336,0,380,385,-46,261,649,4,3,116,204,313,279,14,1698,892
1646,13,2.0.191,0,621,2,67,191,258,0,191,258,385,0,0,603,1,4,227,246,227,437,14,1698,892
1646,13,3.0.191,0,604,1,80,191,271,0,191,271,385,0,0,603,1,4,269,246,269,437,14,1698,892
1646,13,4.0.191,0,597,0,99,191,290,0,191,290,385,0,0,603,1,4,280,246,280,437,14,1698,892
1646,14,1.4.385,1,597,0,72,385,457,380,5,457,457,0,201,649,5,3,72,157,313,341,15,1698,848
1646,14,2.0.191,0,621,2,67,191,258,0,191,258,385,0,0,649,1,4,227,246,227,437,15,1698,848
1646,14,3.0.191,0,604,1,80,191,271,0,191,271,385,0,0,649,1,4,269,246,269,437,15,1698,848
1646,14,4.0.191,0,597,0,99,191,290,0,191,290,385,0,0,649,1,4,280,246,280,437,15,1698,848
1646,15,2.0.191,0,621,2,67,191,258,0,191,258,457,0,0,649,1,4,227,246,227,437,16,1698,776
1646,15,3.0.191,1,604,1,80,191,271,0,191,271,457,0,0,649,1,4,269,246,269,437,16,1698,776
1646,15,4.0.191,0,597,0,99,191,290,0,191,290,457,0,0,649,1,4,280,246,280,437,16,1698,776
1646,16,2.0.271,1,618,1,67,271,338,0,271,338,457,0,0,649,1,5,227,166,227,437,17,1698,696
1646,16,3.1.271,0,604,0,58,271,329,271,0,329,457,-64,167,713,2,4,189,180,269,284,17,1698,696
1646,16,4.0.271,0,604,0,99,271,370,0,271,370,457,0,0,649,1,5,280,166,280,437,17,1698,696
1646,17,2.1.338,0,618,0,54,338,392,338,0,392,457,-131,234,780,2,4,160,180,227,284,18,1698,629
1646,17,3.1.271,0,618,0,58,271,329,271,0,329,457,-64,167,713,2,4,189,180,269,284,18,1698,629
1646,17,4.0.338,1,618,0,99,338,437,0,338,437,457,0,0,649,1,6,280,99,280,437,18,1698,629
1646,18,2.1.338,0,618,0,54,338,392,338,0,392,457,-131,234,780,2,4,160,180,227,284,19,1698,530
1646,18,3.1.271,1,618,0,58,271,329,271,0,329,457,-64,167,713,2,4,189,180,269,284,19,1698,530
1646,18,4.1.437,0,618,0,68,437,505,437,0,505,505,-230,333,879,2,4,181,180,280,284,19,1698,530
1646,19,2.1.338,0,618,0,54,338,392,338,0,392,457,-9,176,722,2,5,160,122,227,284,20,1698,472
1646,19,3.2.336,1,618,0,19,336,355,329,7,355,457,0,84,713,3,4,131,105,269,357,20,1698,472
1646,19,4.1.437,0,618,0,68,437,505,437,0,505,505,-108,275,821,2,5,181,122,280,284,20,1698,472
1646,20,2.1.338,0,618,0,54,338,392,338,0,392,457,-9,176,722,2,5,160,122,227,284,21,1698,453
1646,20,3.3.380,1,618,0,99,380,479,355,25,479,479,0,261,713,4,4,112,160,269,279,21,1698,453
1646,20,4.1.437,0,618,0,68,437,505,437,0,505,505,-108,275,821,2,5,181,122,280,284,21,1698,453
1646,21,2.1.338,0,618,0,54,338,392,338,0,392,479,-9,176,722,2,5,160,122,227,284,22,1698,354
1646,21,3.4.479,1,618,0,13,479,492,479,0,492,492,-22,223,735,5,4,13,85,269,341,22,1698,354
1646,21,4.1.437,0,618,0,68,437,505,437,0,505,505,-108,275,821,2,5,181,122,280,284,22,1698,354
1646,22,2.1.338,1,618,0,54,338,392,338,0,392,492,-9,176,744,2,5,160,122,227,284,23,1698,341
1646,22,4.1.437,0,618,0,68,437,505,437,0,505,505,-108,275,843,2,5,181,122,280,284,23,1698,341
1646,23,2.2.392,1,618,0,72,392,464,392,0,464,492,-37,121,781,3,5,106,86,227,357,24,1698,287
1646,23,4.1.437,0,618,0,68,437,505,437,0,505,505,-45,221,789,2,6,181,68,280,284,24,1698,287
1646,24,2.3.479,1,618,0,8,479,487,464,15,487,492,0,261,781,4,5,34,61,227,279,25,1698,215
1646,24,4.1.437,0,618,0,68,437,505,437,0,505,505,-45,221,826,2,6,181,68,280,284,25,1698,215
1646,25,2.4.492,1,618,0,26,492,518,487,5,518,518,0,223,781,5,5,26,72,227,341,26,1698,207
1646,25,4.1.437,0,618,0,68,437,505,437,0,505,505,-45,221,826,2,6,181,68,280,284,26,1698,207
1646,26,4.1.437,1,618,0,68,437,505,437,0,505,518,-45,221,826,2,6,181,68,280,284,27,1698,181
1646,27,4.2.505,1,618,0,14,505,519,505,0,519,519,-41,162,867,3,6,113,14,280,357,28,1698,113
1646,28,4.3.519,1,618,0,53,519,572,519,0,572,572,-32,293,899,4,6,99,53,280,279,29,1698,99
1646,29,4.4.572,1,618,0,46,572,618,572,0,618,618,-54,277,953,5,6,46,46,280,341,30,1698,46
1647,0,0.0.0,0,579,4,47,0,47,0,0,47,47,0,0,0,1,1,225,254,225,254,1,1469,1469
1647,0,1.0.0,0,582,5,61,0,61,0,0,61,61,0,0,0,1,1,315,254,315,254,1,1469,1469
1647,0,2.0.0,0,532,0,14,0,14,0,0,14,14,0,0,0,1,1,253,254,253,254,1,1469,1469
1647,0,3.0.0,1,565,3,33,0,33,0,0,33,33,0,0,0,1,1,327,254,327,254,1,1469,1469
1647,0,4.0.0,0,544,1,22,0,22,0,0,22,22,0,0,0,1,1,119,254,119,254,1,1469,1469
1647,0,5.0.0,0,564,2,77,0,77,0,0,77,77,0,0,0,1,1,230,254,230,254,1,1469,1469
1647,1,0.0.33,0,605,3,47,33,80,0,33,80,80,0,0,0,1,2,225,221,225,254,2,1469,1436
1647,1,1.0.33,0,615,4,61,33,94,0,33,94,94,0,0,0,1,2,315,221,315,254,2,1469,1436
1647,1,2.0.33,1,565,0,14,33,47,0,33,47,47,0,0,0,1,2,253,221,253,254,2,1469,1436
1647,1,3.1.33,0,582,2,96,33,129,33,0,129,129,-33,33,33,2,1,294,286,327,286,2,1469,1436
1647,1,4.0.33,0,577,1,22,33,55,0,33,55,55,0,0,0,1,2,119,221,119,254,2,1469,1436
1647,1,5.0.33,0,582,2,77,33,110,0,33,110,110,0,0,0,1,2,230,221,230,254,2,1469,1436
1647,2,0.0.47,0,565,0,47,47,94,0,47,94,94,0,0,0,1,3,225,207,225,254,3,1469,1422
1647,2,1.0.47,1,565,0,61,47,108,0,47,108,108,0,0,0,1,3,315,207,315,254,3,1469,1422
1647,2,2.1.47,0,565,0,47,47,94,47,0,94,94,-47,47,47,2,1,239,286,253,286,3,1469,1422
1647,2,3.1.33,0,582,2,96,33,129,33,0,129,129,-33,33,33,2,1,294,286,327,286,3,1469,1422
1647,2,4.0.47,0,565,0,22,47,69,0,47,69,69,0,0,0,1,3,119,207,119,254,3,1469,1422
1647,2,5.0.47,0,577,1,77,47,124,0,47,124,124,0,0,0,1,3,230,207,230,254,3,1469,1422
1647,3,0.0.108,1,565,0,47,108,155,0,108,155,155,0,0,0,1,4,225,146,225,254,4,1469,1361
1647,3,1.1.108,0,565,0,84,108,192,108,0,192,192,-108,108,108,2,1,254,286,315,286,4,1469,1361
1647,3,2.1.47,0,565,0,47,47,94,47,0,94,108,-47,47,47,2,1,239,286,253,286,4,1469,1361
1647,3,3.1.33,0,622,1,96,33,129,33,0,129,129,-33,33,33,2,1,294,286,327,286,4,1469,1361
1647,3,4.0.108,0,565,0,22,108,130,0,108,130,130,0,0,0,1,4,119,146,119,254,4,1469,1361
1647,3,5.0.108,0,565,0,77,108,185,0,108,185,185,0,0,0,1,4,230,146,230,254,4,1469,1361
1647,4,0.1.155,0,588,1,18,155,173,155,0,173,173,-155,155,155,2,1,178,286,225,286,5,1469,1314
1647,4,1.1.108,0,565,0,84,108,192,108,0,192,192,-108,108,108,2,1,254,286,315,286,5,1469,1314
1647,4,2.1.47,0,565,0,47,47,94,47,0,94,155,-47,47,47,2,1,239,286,253,286,5,1469,1314
1647,4,3.1.33,0,643,2,96,33,129,33,0,129,155,-33,33,33,2,1,294,286,327,286,5,1469,1314
1647,4,4.0.155,1,565,0,22,155,177,0,155,177,177,0,0,0,1,5,119,99,119,254,5,1469,1314
1647,4,5.0.155,0,565,0,77,155,232,0,155,232,232,0,0,0,1,5,230,99,230,254,5,1469,1314
1647,5,0.1.155,0,588,1,18,155,173,155,0,173,177,-155,155,155,2,1,178,286,225,286,6,1469,1292
1647,5,1.1.108,0,565,0,84,108,192,108,0,192,192,-108,108,108,2,1,254,286,315,286,6,1469,1292
1647,5,2.1.47,0,565,0,47,47,94,47,0,94,177,-47,47,47,2,1,239,286,253,286,6,1469,1292
1647,5,3.1.33,0,643,3,96,33,129,33,0,129,177,-33,33,33,2,1,294,286,327,286,6,1469,1292
1647,5,4.1.177,0,596,2,20,177,197,177,0,197,197,-177,177,177,2,1,97,286,119,286,6,1469,1292
1647,5,5.0.177,1,565,0,77,177,254,0,177,254,254,0,0,0,1,6,230,77,230,254,6,1469,1292
1647,6,0.1.155,0,588,2,18,155,173,155,0,173,254,-155,155,155,2,1,178,286,225,286,7,1469,1215
1647,6,1.1.108,0,565,0,84,108,192,108,0,192,254,-108,108,108,2,1,254,286,315,286,7,1469,1215
1647,6,2.1.47,1,565,0,47,47,94,47,0,94,254,-47,47,47,2,1,239,286,253,286,7,1469,1215
1647,6,3.1.33,0,643,4,96,33,129,33,0,129,254,-33,33,33,2,1,294,286,327,286,7,1469,1215
1647,6,4.1.177,0,596,3,20,177,197,177,0,197,254,-177,177,177,2,1,97,286,119,286,7,1469,1215
1647,6,5.1.254,0,569,1,21,254,275,254,0,275,275,-254,254,254,2,1,153,286,230,286,7,1469,1215
1647,7,0.1.155,0,588,2,18,155,173,155,0,173,254,-61,108,108,2,2,178,239,225,286,8,1469,1168
1647,7,1.1.108,0,565,0,84,108,192,108,0,192,254,-14,61,61,2,2,254,239,315,286,8,1469,1168
1647,7,2.2.94,1,565,0,25,94,119,94,0,119,254,-94,94,141,3,1,192,227,253,227,8,1469,1168
1647,7,3.1.94,0,601,4,96,94,190,33,61,190,254,0,47,47,2,2,294,239,327,286,8,1469,1168
1647,7,4.1.177,0,596,3,20,177,197,177,0,197,254,-83,130,130,2,2,97,239,119,286,8,1469,1168
1647,7,5.1.254,0,569,1,21,254,275,254,0,275,275,-160,207,207,2,2,153,239,230,286,8,1469,1168
1647,8,0.1.155,0,588,2,18,155,173,155,0,173,254,-61,108,202,2,2,178,239,225,286,9,1469,1143
1647,8,1.1.108,0,565,0,84,108,192,108,0,192,254,-14,61,155,2,2,254,239,315,286,9,1469,1143
1647,8,2.3.119,1,565,0,76,119,195,119,0,195,254,-119,119,260,4,1,167,332,253,332,9,1469,1143
1647,8,3.1.94,0,601,4,96,94,190,33,61,190,254,0,47,141,2,2,294,239,327,286,9,1469,1143
1647,8,4.1.177,0,596,3,20,177,197,177,0,197,254,-83,130,224,2,2,97,239,119,286,9,1469,1143
1647,8,5.1.254,0,569,1,21,254,275,254,0,275,275,-160,207,301,2,2,153,239,230,286,9,1469,1143
1647,9,0.1.155,0,588,2,18,155,173,155,0,173,254,-61,108,321,2,2,178,239,225,286,10,1469,1067
1647,9,1.1.108,0,565,0,84,108,192,108,0,192,254,-14,61,274,2,2,254,239,315,286,10,1469,1067
1647,9,2.4.195,0,565,0,91,195,286,195,0,286,286,-195,195,455,5,1,91,370,253,370,10,1469,1067
1647,9,3.1.94,1,601,4,96,94,190,33,61,190,254,0,47,260,2,2,294,239,327,286,10,1469,1067
1647,9,4.1.177,0,596,3,20,177,197,177,0,197,254,-83,130,343,2,2,97,239,119,286,10,1469,1067
1647,9,5.1.254,0,569,1,21,254,275,254,0,275,275,-160,207,420,2,2,153,239,230,286,10,1469,1067
1647,10,0.1.190,1,601,0,18,190,208,155,35,208,254,0,47,260,2,3,178,143,225,286,11,1469,971
1647,10,1.1.190,0,613,1,84,190,274,108,82,274,274,0,47,260,2,3,254,143,315,286,11,1469,971
1647,10,2.4.195,0,601,0,91,195,286,195,0,286,286,-195,195,455,5,1,91,370,253,370,11,1469,971
1647,10,3.2.190,0,601,0,86,190,276,190,0,276,276,-71,165,331,3,2,198,202,327,227,11,1469,971
1647,10,4.1.190,0,601,0,20,190,210,177,13,210,254,0,47,260,2,3,97,143,119,286,11,1469,971
1647,10,5.1.254,0,601,0,21,254,275,254,0,275,275,-64,111,324,2,3,153,143,230,286,11,1469,971
1647,11,0.2.208,0,605,1,87,208,295,208,0,295,295,-89,183,349,3,2,160,202,225,227,12,1469,953
1647,11,1.1.208,1,605,1,84,208,292,108,100,292,292,0,47,260,2,4,254,125,315,286,12,1469,953
1647,11,2.4.195,0,601,0,91,195,286,195,0,286,286,-195,195,455,5,1,91,370,253,370,12,1469,953
1647,11,3.2.190,0,601,0,86,190,276,190,0,276,276,-71,165,331,3,2,198,202,327,227,12,1469,953
1647,11,4.1.208,0,601,0,20,208,228,177,31,228,254,0,47,260,2,4,97,125,119,286,12,1469,953
1647,11,5.1.254,0,601,0,21,254,275,254,0,275,275,-46,93,306,2,4,153,125,230,286,12,1469,953
1647,12,0.2.208,0,605,0,87,208,295,208,0,295,295,-89,183,349,3,2,160,202,225,227,13,1469,869
1647,12,1.2.292,0,613,1,3,292,295,292,0,295,295,-173,267,433,3,2,170,202,315,227,13,1469,869
1647,12,2.4.195,0,605,0,91,195,286,195,0,286,292,-195,195,455,5,1,91,370,253,370,13,1469,869
1647,12,3.2.190,0,613,1,86,190,276,190,0,276,292,-71,165,331,3,2,198,202,327,227,13,1469,869
1647,12,4.1.292,0,613,1,20,292,312,177,115,312,312,0,47,260,2,5,97,41,119,286,13,1469,869
1647,12,5.1.292,1,605,0,21,292,313,254,38,313,313,0,47,260,2,5,153,41,230,286,13,1469,869
1647,13,0.2.208,0,605,0,87,208,295,208,0,295,313,-89,183,349,3,2,160,202,225,227,14,1469,848
1647,13,1.2.292,0,613,1,3,292,295,292,0,295,313,-173,267,433,3,2,170,202,315,227,14,1469,848
1647,13,2.4.195,0,605,0,91,195,286,195,0,286,313,-195,195,455,5,1,91,370,253,370,14,1469,848
1647,13,3.2.190,0,613,1,86,190,276,190,0,276,313,-71,165,331,3,2,198,202,327,227,14,1469,848
1647,13,4.1.313,1,605,0,20,313,333,177,136,333,333,0,47,260,2,6,97,20,119,286,14,1469,848
1647,13,5.2.313,0,605,0,11,313,324,313,0,324,324,-194,288,454,3,2,132,202,230,227,14,1469,848
1647,14,0.2.208,0,605,0,87,208,295,208,0,295,333,-89,183,349,3,2,160,202,225,227,15,1469,828
1647,14,1.2.292,1,613,1,3,292,295,292,0,295,333,-173,267,433,3,2,170,202,315,227,15,1469,828
1647,14,2.4.195,0,605,0,91,195,286,195,0,286,333,-195,195,455,5,1,91,370,253,370,15,1469,828
1647,14,3.2.190,0,613,1,86,190,276,190,0,276,333,-71,165,331,3,2,198,202,327,227,15,1469,828
1647,14,4.2.333,0,605,0,15,333,348,333,0,348,348,-214,308,474,3,2,77,202,119,227,15,1469,828
1647,14,5.2.313,0,605,0,11,313,324,313,0,324,333,-194,288,454,3,2,132,202,230,227,15,1469,828
1647,15,0.2.295,0,638,1,87,295,382,208,87,382,382,0,267,433,3,3,160,199,225,227,16,1469,825
1647,15,1.3.295,0,660,2,86,295,381,295,0,381,381,-100,219,533,4,2,167,256,315,332,16,1469,825
1647,15,2.4.195,0,613,0,91,195,286,195,0,286,333,-195,195,628,5,1,91,370,253,370,16,1469,825
1647,15,3.2.190,1,613,0,86,190,276,190,0,295,333,86,181,347,3,3,198,199,327,227,16,1469,825
1647,15,4.2.333,0,613,0,15,333,348,333,0,348,348,-38,305,471,3,3,77,199,119,227,16,1469,825
1647,15,5.2.313,0,613,0,11,313,324,313,0,324,333,-18,285,451,3,3,132,199,230,227,16,1469,825
1647,16,0.2.295,0,638,1,87,295,382,208,87,382,382,0,181,347,3,4,160,113,225,227,17,1469,739
1647,16,1.3.295,0,660,2,86,295,381,295,0,381,381,-100,219,447,4,2,167,256,315,332,17,1469,739
1647,16,2.4.195,0,613,0,91,195,286,195,0,286,333,-195,195,542,5,1,91,370,253,370,17,1469,739
1647,16,3.3.276,0,613,0,58,276,334,276,0,334,334,-81,200,428,4,2,112,256,327,332,17,1469,739
1647,16,4.2.333,0,613,0,15,333,348,333,0,348,348,-38,219,385,3,4,77,113,119,227,17,1469,739
1647,16,5.2.313,1,613,0,11,313,324,313,0,324,333,-18,199,365,3,4,132,113,230,227,17,1469,739
1647,17,0.2.324,1,613,0,87,324,411,208,116,411,411,0,199,365,3,5,160,102,225,227,18,1469,728
1647,17,1.3.295,0,660,2,86,295,381,295,0,381,381,-100,219,465,4,2,167,256,315,332,18,1469,728
1647,17,2.4.195,0,613,0,91,195,286,195,0,286,333,-195,195,560,5,1,91,370,253,370,18,1469,728
1647,17,3.3.276,0,613,0,58,276,334,276,0,334,334,-81,200,446,4,2,112,256,327,332,18,1469,728
1647,17,4.2.333,0,613,0,15,333,348,333,0,348,348,-9,208,374,3,5,77,102,119,227,18,1469,728
1647,17,5.3.324,0,638,1,35,324,359,324,0,359,359,-129,248,494,4,2,121,256,230,332,18,1469,728
1647,18,0.3.411,0,625,1,31,411,442,411,0,442,442,-216,335,581,4,2,73,256,225,332,19,1469,641
1647,18,1.3.295,0,660,3,86,295,381,295,0,381,411,-100,219,465,4,2,167,256,315,332,19,1469,641
1647,18,2.4.195,0,613,0,91,195,286,195,0,286,411,-195,195,560,5,1,91,370,253,370,19,1469,641
1647,18,3.3.276,0,613,0,58,276,334,276,0,334,411,-81,200,446,4,2,112,256,327,332,19,1469,641
1647,18,4.2.411,1,613,0,15,411,426,333,78,426,426,0,199,365,3,6,77,15,119,227,19,1469,641
1647,18,5.3.324,0,638,2,35,324,359,324,0,359,411,-129,248,494,4,2,121,256,230,332,19,1469,641
1647,19,0.3.411,0,625,1,31,411,442,411,0,442,442,-216,335,581,4,2,73,256,225,332,20,1469,626
1647,19,1.3.295,0,660,4,86,295,381,295,0,381,426,-100,219,465,4,2,167,256,315,332,20,1469,626
1647,19,2.4.195,0,613,0,91,195,286,195,0,286,426,-195,195,560,5,1,91,370,253,370,20,1469,626
1647,19,3.3.276,1,613,0,58,276,334,276,0,334,426,-81,200,446,4,2,112,256,327,332,20,1469,626
1647,19,4.3.426,0,645,3,46,426,472,426,0,472,472,-231,350,596,4,2,62,256,119,332,20,1469,626
1647,19,5.3.324,0,638,2,35,324,359,324,0,359,426,-129,248,494,4,2,121,256,230,332,20,1469,626
1647,20,0.3.411,0,625,1,31,411,442,411,0,442,442,-77,277,523,4,3,73,198,225,332,21,1469,568
1647,20,1.3.334,0,645,2,86,334,420,295,39,420,426,0,200,446,4,3,167,198,315,332,21,1469,568
1647,20,2.4.195,0,613,0,91,195,286,195,0,286,426,-195,195,641,5,1,91,370,253,370,21,1469,568
1647,20,3.4.334,0,613,0,54,334,388,334,0,388,426,-334,334,780,5,1,54,370,327,370,21,1469,568
1647,20,4.3.426,0,645,2,46,426,472,426,0,472,472,-92,292,538,4,3,62,198,119,332,21,1469,568
1647,20,5.3.334,1,613,0,35,334,369,324,10,369,426,0,200,446,4,3,121,198,230,332,21,1469,568
1647,21,0.3.411,0,625,1,31,411,442,411,0,442,442,-42,242,488,4,4,73,163,225,332,22,1469,533
1647,21,1.3.369,1,613,0,86,369,455,295,74,455,455,0,200,446,4,4,167,163,315,332,22,1469,533
1647,21,2.4.195,0,613,0,91,195,286,195,0,286,426,-195,195,641,5,1,91,370,253,370,22,1469,533
1647,21,3.4.334,0,613,0,54,334,388,334,0,388,426,-334,334,780,5,1,54,370,327,370,22,1469,533
1647,21,4.3.426,0,670,3,46,426,472,426,0,472,472,-57,257,503,4,4,62,163,119,332,22,1469,533
1647,21,5.4.369,0,648,2,86,369,455,369,0,455,455,-369,369,815,5,1,86,370,230,370,22,1469,533
1647,22,0.3.455,1,613,0,31,455,486,411,44,486,486,0,200,446,4,5,73,77,225,332,23,1469,447
1647,22,1.4.455,0,648,1,81,455,536,455,0,536,536,-455,455,901,5,1,81,370,315,370,23,1469,447
1647,22,2.4.195,0,613,0,91,195,286,195,0,286,455,-195,195,641,5,1,91,370,253,370,23,1469,447
1647,22,3.4.334,0,613,0,54,334,388,334,0,388,455,-334,334,780,5,1,54,370,327,370,23,1469,447
1647,22,4.3.455,0,613,0,46,455,501,426,29,501,501,0,200,446,4,5,62,77,119,332,23,1469,447
1647,22,5.4.369,0,648,1,86,369,455,369,0,455,455,-369,369,815,5,1,86,370,230,370,23,1469,447
1647,23,0.4.486,0,625,1,42,486,528,486,0,528,528,-486,486,932,5,1,42,370,225,370,24,1469,416
1647,23,1.4.455,0,648,2,81,455,536,455,0,536,536,-455,455,901,5,1,81,370,315,370,24,1469,416
1647,23,2.4.195,0,613,0,91,195,286,195,0,286,486,-195,195,641,5,1,91,370,253,370,24,1469,416
1647,23,3.4.334,0,613,0,54,334,388,334,0,388,486,-334,334,780,5,1,54,370,327,370,24,1469,416
1647,23,4.3.486,1,613,0,46,486,532,426,60,532,532,0,200,446,4,6,62,46,119,332,24,1469,416
1647,23,5.4.369,0,648,2,86,369,455,369,0,455,486,-369,369,815,5,1,86,370,230,370,24,1469,416
1647,24,0.4.486,0,625,1,42,486,528,486,0,528,532,-486,486,932,5,1,42,370,225,370,25,1469,370
1647,24,1.4.455,0,648,3,81,455,536,455,0,536,536,-455,455,901,5,1,81,370,315,370,25,1469,370
1647,24,2.4.195,1,613,0,91,195,286,195,0,286,532,-195,195,641,5,1,91,370,253,370,25,1469,370
1647,24,3.4.334,0,613,0,54,334,388,334,0,388,532,-334,334,780,5,1,54,370,327,370,25,1469,370
1647,24,4.4.532,0,629,2,16,532,548,532,0,548,548,-532,532,978,5,1,16,370,119,370,25,1469,370
1647,24,5.4.369,0,648,3,86,369,455,369,0,455,532,-369,369,815,5,1,86,370,230,370,25,1469,370
1647,25,0.4.486,0,625,1,42,486,528,486,0,528,532,-200,395,841,5,2,42,279,225,370,26,1469,279
1647,25,1.4.455,0,648,3,81,455,536,455,0,536,536,-169,364,810,5,2,81,279,315,370,26,1469,279
1647,25,3.4.334,1,613,0,54,334,388,334,0,388,532,-48,243,689,5,2,54,279,327,370,26,1469,279
1647,25,4.4.532,0,629,2,16,532,548,532,0,548,548,-246,441,887,5,2,16,279,119,370,26,1469,279
1647,25,5.4.369,0,648,3,86,369,455,369,0,455,532,-83,278,724,5,2,86,279,230,370,26,1469,279
1647,26,0.4.486,0,625,1,42,486,528,486,0,528,532,-98,341,787,5,3,42,225,225,370,27,1469,225
1647,26,1.4.455,0,680,3,81,455,536,455,0,536,536,-67,310,756,5,3,81,225,315,370,27,1469,225
1647,26,4.4.532,0,629,2,16,532,548,532,0,548,548,-144,387,833,5,3,16,225,119,370,27,1469,225
1647,26,5.4.388,1,613,0,86,388,474,369,19,474,532,0,243,689,5,3,86,225,230,370,27,1469,225
1647,27,0.4.486,0,625,1,42,486,528,486,0,528,532,-12,255,701,5,4,42,139,225,370,28,1469,139
1647,27,1.4.474,1,613,0,81,474,555,455,19,555,555,0,243,689,5,4,81,139,315,370,28,1469,139
1647,27,4.4.532,0,629,2,16,532,548,532,0,548,548,-58,301,747,5,4,16,139,119,370,28,1469,139
1647,28,0.4.555,1,613,0,42,555,597,486,69,597,597,0,243,689,5,5,42,58,225,370,29,1469,58
1647,28,4.4.555,0,613,0,16,555,571,532,23,571,571,0,243,689,5,5,16,58,119,370,29,1469,58
1647,29,4.4.597,1,613,0,16,597,613,532,65,613,613,0,243,689,5,6,16,16,119,370,30,1469,16
1648,0,0.0.0,1,684,4,60,0,60,0,0,60,60,0,0,0,1,1,368,367,368,367,1,1638,1638
1648,0,1.0.0,0,645,0,37,0,37,0,0,37,37,0,0,0,1,1,215,367,215,367,1,1638,1638
1648,0,2.0.0,0,682,3,59,0,59,0,0,59,59,0,0,0,1,1,280,367,280,367,1,1638,1638
1648,0,3.0.0,0,690,5,86,0,86,0,0,86,86,0,0,0,1,1,287,367,287,367,1,1638,1638
1648,0,4.0.0,0,667,1,43,0,43,0,0,43,43,0,0,0,1,1,255,367,255,367,1,1638,1638
1648,0,5.0.0,0,673,2,82,0,82,0,0,82,82,0,0,0,1,1,233,367,233,367,1,1638,1638
1648,1,0.1.60,1,717,2,85,60,145,60,0,145,145,-60,60,60,2,1,308,290,368,290,2,1638,1578
1648,1,1.0.60,0,684,0,37,60,97,0,60,97,97,0,0,0,1,2,215,307,215,367,2,1638,1578
1648,1,2.0.60,0,742,4,59,60,119,0,60,119,119,0,0,0,1,2,280,307,280,367,2,1638,1578
1648,1,3.0.60,0,750,5,86,60,146,0,60,146,146,0,0,0,1,2,287,307,287,367,2,1638,1578
1648,1,4.0.60,0,726,3,43,60,103,0,60,103,103,0,0,0,1,2,255,307,255,367,2,1638,1578
1648,1,5.0.60,0,714,1,82,60,142,0,60,142,142,0,0,0,1,2,233,307,233,367,2,1638,1578
1648,2,0.2.145,1,770,4,91,145,236,145,0,236,236,-145,145,205,3,1,223,295,368,295,3,1638,1493
1648,2,1.0.60,0,731,1,37,60,97,0,60,97,145,0,0,60,1,2,215,307,215,367,3,1638,1493
1648,2,2.0.60,0,742,2,59,60,119,0,60,119,145,0,0,60,1,2,280,307,280,367,3,1638,1493
1648,2,3.0.60,0,750,3,86,60,146,0,60,146,146,0,0,60,1,2,287,307,287,367,3,1638,1493
1648,2,4.0.60,0,731,1,43,60,103,0,60,103,145,0,0,60,1,2,255,307,255,367,3,1638,1493
1648,2,5.0.60,0,717,0,82,60,142,0,60,142,145,0,0,60,1,2,233,307,233,367,3,1638,1493
1648,3,0.3.236,1,772,1,38,236,274,236,0,274,274,-236,236,441,4,1,132,188,368,188,4,1638,1402
1648,3,1.0.60,0,770,0,37,60,97,0,60,97,236,0,0,205,1,2,215,307,215,367,4,1638,1402
1648,3,2.0.60,0,770,0,59,60,119,0,60,119,236,0,0,205,1,2,280,307,280,367,4,1638,1402
1648,3,3.0.60,0,770,0,86,60,146,0,60,146,236,0,0,205,1,2,287,307,287,367,4,1638,1402
1648,3,4.0.60,0,770,0,43,60,103,0,60,103,236,0,0,205,1,2,255,307,255,367,4,1638,1402
1648,3,5.0.60,0,770,0,82,60,142,0,60,142,236,0,0,205,1,2,233,307,233,367,4,1638,1402
1648,4,0.4.274,0,772,0,94,274,368,274,0,368,368,-274,274,715,5,1,94,498,368,498,5,1638,1364
1648,4,1.0.60,0,772,0,37,60,97,0,60,97,274,0,0,441,1,2,215,307,215,367,5,1638,1364
1648,4,2.0.60,0,772,0,59,60,119,0,60,119,274,0,0,441,1,2,280,307,280,367,5,1638,1364
1648,4,3.0.60,0,772,0,86,60,146,0,60,146,274,0,0,441,1,2,287,307,287,367,5,1638,1364
1648,4,4.0.60,1,772,0,43,60,103,0,60,103,274,0,0,441,1,2,255,307,255,367,5,1638,1364
1648,4,5.0.60,0,772,0,82,60,142,0,60,142,274,0,0,441,1,2,233,307,233,367,5,1638,1364
1648,5,0.4.274,0,772,0,94,274,368,274,0,368,368,-274,274,715,5,1,94,498,368,498,6,1638,1321
1648,5,1.0.103,0,772,0,37,103,140,0,103,140,274,0,0,441,1,3,215,264,215,367,6,1638,1321
1648,5,2.0.103,0,772,0,59,103,162,0,103,162,274,0,0,441,1,3,280,264,280,367,6,1638,1321
1648,5,3.0.103,0,772,0,86,103,189,0,103,189,274,0,0,441,1,3,287,264,287,367,6,1638,1321
1648,5,4.1.145,1,772,0,72,145,217,103,42,217,274,0,60,441,2,2,212,205,255,290,6,1638,1321
1648,5,5.0.103,0,772,0,82,103,185,0,103,185,274,0,0,441,1,3,233,264,233,367,6,1638,1321
1648,6,0.4.274,0,772,0,94,274,368,274,0,368,368,-274,274,715,5,1,94,498,368,498,7,1638,1249
1648,6,1.0.103,0,772,0,37,103,140,0,103,140,274,0,0,441,1,3,215,264,215,367,7,1638,1249
1648,6,2.0.103,0,772,0,59,103,162,0,103,162,274,0,0,441,1,3,280,264,280,367,7,1638,1249
1648,6,3.0.103,0,772,0,86,103,189,0,103,189,274,0,0,441,1,3,287,264,287,367,7,1638,1249
1648,6,4.2.236,1,772,0,16,236,252,217,19,252,274,0,145,441,3,2,140,204,255,295,7,1638,1249
1648,6,5.0.103,0,772,0,82,103,185,0,103,185,274,0,0,441,1,3,233,264,233,367,7,1638,1249
1648,7,0.4.274,0,772,0,94,274,368,274,0,368,368,-274,274,715,5,1,94,498,368,498,8,1638,1233
1648,7,1.0.103,0,772,0,37,103,140,0,103,140,274,0,0,441,1,3,215,264,215,367,8,1638,1233
1648,7,2.0.103,0,772,0,59,103,162,0,103,162,274,0,0,441,1,3,280,264,280,367,8,1638,1233
1648,7,3.0.103,0,772,0,86,103,189,0,103,189,274,0,0,441,1,3,287,264,287,367,8,1638,1233
1648,7,4.3.274,1,772,0,39,274,313,252,22,313,313,0,236,441,4,2,124,150,255,188,8,1638,1233
1648,7,5.0.103,0,772,0,82,103,185,0,103,185,274,0,0,441,1,3,233,264,233,367,8,1638,1233
1648,8,0.4.274,0,772,0,94,274,368,274,0,368,368,-274,274,715,5,1,94,498,368,498,9,1638,1194
1648,8,1.0.103,0,772,0,37,103,140,0,103,140,313,0,0,441,1,3,215,264,215,367,9,1638,1194
1648,8,2.0.103,1,772,0,59,103,162,0,103,162,313,0,0,441,1,3,280,264,280,367,9,1638,1194
1648,8,3.0.103,0,772,0,86,103,189,0,103,189,313,0,0,441,1,3,287,264,287,367,9,1638,1194
1648,8,4.4.313,0,811,1,85,313,398,313,0,398,398,-313,313,754,5,1,85,498,255,498,9,1638,1194
1648,8,5.0.103,0,772,0,82,103,185,0,103,185,313,0,0,441,1,3,233,264,233,367,9,1638,1194
1648,9,0.4.274,0,772,0,94,274,368,274,0,368,368,-274,274,715,5,1,94,498,368,498,10,1638,1135
1648,9,1.0.162,0,772,0,37,162,199,0,162,199,313,0,0,441,1,4,215,205,215,367,10,1638,1135
1648,9,2.1.217,1,772,0,41,217,258,162,55,258,313,0,60,441,2,3,221,133,280,290,10,1638,1135
1648,9,3.0.162,0,772,0,86,162,248,0,162,248,313,0,0,441,1,4,287,205,287,367,10,1638,1135
1648,9,4.4.313,0,811,1,85,313,398,313,0,398,398,-313,313,754,5,1,85,498,255,498,10,1638,1135
1648,9,5.0.162,0,772,0,82,162,244,0,162,244,313,0,0,441,1,4,233,205,233,367,10,1638,1135
1648,10,0.4.274,0,772,0,94,274,368,274,0,368,368,-274,274,715,5,1,94,498,368,498,11,1638,1094
1648,10,1.0.162,1,772,0,37,162,199,0,162,199,313,0,0,441,1,4,215,205,215,367,11,1638,1094
1648,10,2.2.258,0,772,0,78,258,336,258,0,336,336,-6,151,447,3,3,180,188,280,295,11,1638,1094
1648,10,3.0.162,0,772,0,86,162,248,0,162,248,313,0,0,441,1,4,287,205,287,367,11,1638,1094
1648,10,4.4.313,0,811,1,85,313,398,313,0,398,398,-313,313,754,5,1,85,498,255,498,11,1638,1094
1648,10,5.0.162,0,772,0,82,162,244,0,162,244,313,0,0,441,1,4,233,205,233,367,11,1638,1094
1648,11,0.4.274,0,772,0,94,274,368,274,0,368,368,-274,274,715,5,1,94,498,368,498,12,1638,1057
1648,11,1.1.258,1,772,0,52,258,310,199,59,310,313,0,60,441,2,4,178,92,215,290,12,1638,1057
1648,11,2.2.258,0,772,0,78,258,336,258,0,336,336,-6,151,447,3,3,180,188,280,295,12,1638,1057
1648,11,3.0.199,0,772,0,86,199,285,0,199,285,313,0,0,441,1,5,287,168,287,367,12,1638,1057
1648,11,4.4.313,0,811,1,85,313,398,313,0,398,398,-313,313,754,5,1,85,498,255,498,12,1638,1057
1648,11,5.0.199,0,772,0,82,199,281,0,199,281,313,0,0,441,1,5,233,168,233,367,12,1638,1057
1648,12,0.4.274,0,772,0,94,274,368,274,0,368,368,-274,274,715,5,1,94,498,368,498,13,1638,1005
1648,12,1.2.310,0,772,0,8,310,318,310,0,318,318,-58,203,499,3,3,126,188,215,295,13,1638,1005
1648,12,2.2.258,0,772,0,78,258,336,258,0,336,336,-6,151,447,3,3,180,188,280,295,13,1638,1005
1648,12,3.0.199,1,772,0,86,199,285,0,199,285,313,0,0,441,1,5,287,168,287,367,13,1638,1005
1648,12,4.4.313,0,811,1,85,313,398,313,0,398,398,-313,313,754,5,1,85,498,255,498,13,1638,1005
1648,12,5.0.199,0,772,0,82,199,281,0,199,281,313,0,0,441,1,5,233,168,233,367,13,1638,1005
1648,13,0.4.274,0,772,0,94,274,368,274,0,368,368,-274,274,715,5,1,94,498,368,498,14,1638,919
1648,13,1.2.310,0,772,0,8,310,318,310,0,318,318,-58,203,499,3,3,126,188,215,295,14,1638,919
1648,13,2.2.258,0,772,0,78,258,336,258,0,336,336,-6,151,447,3,3,180,188,280,295,14,1638,919
1648,13,3.1.310,1,772,0,35,310,345,285,25,345,345,0,60,441,2,5,201,40,287,290,14,1638,919
1648,13,4.4.313,0,811,1,85,313,398,313,0,398,398,-313,313,754,5,1,85,498,255,498,14,1638,919
1648,13,5.0.285,0,772,0,82,285,367,0,285,367,367,0,0,441,1,6,233,82,233,367,14,1638,919
1648,14,0.4.274,0,772,0,94,274,368,274,0,368,368,-274,274,715,5,1,94,498,368,498,15,1638,884
1648,14,1.2.310,0,772,0,8,310,318,310,0,318,345,-58,203,499,3,3,126,188,215,295,15,1638,884
1648,14,2.2.258,0,772,0,78,258,336,258,0,336,345,-6,151,447,3,3,180,188,280,295,15,1638,884
1648,14,3.2.345,0,772,0,53,345,398,345,0,398,398,-93,238,534,3,3,166,188,287,295,15,1638,884
1648,14,4.4.313,0,811,1,85,313,398,313,0,398,398,-313,313,754,5,1,85,498,255,498,15,1638,884
1648,14,5.0.285,1,772,0,82,285,367,0,285,367,367,0,0,441,1,6,233,82,233,367,15,1638,884
1648,15,0.4.274,0,772,0,94,274,368,274,0,368,368,-274,274,715,5,1,94,498,368,498,16,1638,802
1648,15,1.2.310,0,772,0,8,310,318,310,0,318,367,-58,203,499,3,3,126,188,215,295,16,1638,802
1648,15,2.2.258,0,772,0,78,258,336,258,0,336,367,-6,151,447,3,3,180,188,280,295,16,1638,802
1648,15,3.2.345,0,772,0,53,345,398,345,0,398,398,-93,238,534,3,3,166,188,287,295,16,1638,802
1648,15,4.4.313,0,811,1,85,313,398,313,0,398,398,-313,313,754,5,1,85,498,255,498,16,1638,802
1648,15,5.1.367,1,772,0,5,367,372,367,0,372,372,-22,82,463,2,6,151,5,233,290,16,1638,802
1648,16,0.4.274,0,772,0,94,274,368,274,0,368,372,-274,274,737,5,1,94,498,368,498,17,1638,797
1648,16,1.2.310,1,772,0,8,310,318,310,0,318,372,-58,203,521,3,3,126,188,215,295,17,1638,797
1648,16,2.2.258,0,772,0,78,258,336,258,0,336,372,-6,151,469,3,3,180,188,280,295,17,1638,797
1648,16,3.2.345,0,772,0,53,345,398,345,0,398,398,-93,238,556,3,3,166,188,287,295,17,1638,797
1648,16,4.4.313,0,811,1,85,313,398,313,0,398,398,-313,313,776,5,1,85,498,255,498,17,1638,797
1648,16,5.2.372,0,772,0,49,372,421,372,0,421,421,-120,265,583,3,3,146,188,233,295,17,1638,797
1648,17,0.4.274,0,772,0,94,274,368,274,0,368,372,-274,274,795,5,1,94,498,368,498,18,1638,789
1648,17,1.3.318,1,772,0,28,318,346,318,0,346,372,-5,241,526,4,3,118,111,215,188,18,1638,789
1648,17,2.2.318,0,772,0,78,318,396,258,60,396,396,0,203,521,3,4,180,180,280,295,18,1638,789
1648,17,3.2.345,0,772,0,53,345,398,345,0,398,398,-27,230,548,3,4,166,180,287,295,18,1638,789
1648,17,4.4.313,0,811,1,85,313,398,313,0,398,398,-313,313,834,5,1,85,498,255,498,18,1638,789
1648,17,5.2.372,0,772,0,49,372,421,372,0,421,421,-54,257,575,3,4,146,180,233,295,18,1638,789
1648,18,0.4.274,0,772,0,94,274,368,274,0,368,372,-274,274,800,5,1,94,498,368,498,19,1638,761
1648,18,1.4.346,0,844,2,90,346,436,346,0,436,436,-346,346,872,5,1,90,498,215,498,19,1638,761
1648,18,2.2.318,1,772,0,78,318,396,258,60,396,396,0,203,526,3,4,180,180,280,295,19,1638,761
1648,18,3.2.345,0,772,0,53,345,398,345,0,398,398,-27,230,553,3,4,166,180,287,295,19,1638,761
1648,18,4.4.313,0,811,1,85,313,398,313,0,398,398,-313,313,839,5,1,85,498,255,498,19,1638,761
1648,18,5.2.372,0,772,0,49,372,421,372,0,421,421,-54,257,580,3,4,146,180,233,295,19,1638,761
1648,19,0.4.274,0,772,0,94,274,368,274,0,368,396,-274,274,800,5,1,94,498,368,498,20,1638,683
1648,19,1.4.346,0,844,2,90,346,436,346,0,436,436,-346,346,872,5,1,90,498,215,498,20,1638,683
1648,19,2.3.396,1,772,0,45,396,441,396,0,441,441,-50,291,576,4,4,102,83,280,188,20,1638,683
1648,19,3.2.396,0,772,0,53,396,449,345,51,449,449,0,203,526,3,5,166,102,287,295,20,1638,683
1648,19,4.4.313,0,811,1,85,313,398,313,0,398,398,-313,313,839,5,1,85,498,255,498,20,1638,683
1648,19,5.2.396,0,772,0,49,396,445,372,24,445,445,0,203,526,3,5,146,102,233,295,20,1638,683
1648,20,0.4.274,0,772,0,94,274,368,274,0,368,441,-274,274,850,5,1,94,498,368,498,21,1638,638
1648,20,1.4.346,0,844,2,90,346,436,346,0,436,441,-346,346,922,5,1,90,498,215,498,21,1638,638
1648,20,2.4.441,0,845,3,57,441,498,441,0,498,498,-441,441,1017,5,1,57,498,280,498,21,1638,638
1648,20,3.2.396,1,772,0,53,396,449,345,51,449,449,0,203,576,3,5,166,102,287,295,21,1638,638
1648,20,4.4.313,0,811,1,85,313,398,313,0,398,441,-313,313,889,5,1,85,498,255,498,21,1638,638
1648,20,5.2.396,0,772,0,49,396,445,372,24,445,445,0,203,576,3,5,146,102,233,295,21,1638,638
1648,21,0.4.274,0,772,0,94,274,368,274,0,368,449,-274,274,850,5,1,94,498,368,498,22,1638,585
1648,21,1.4.346,0,844,2,90,346,436,346,0,436,449,-346,346,922,5,1,90,498,215,498,22,1638,585
1648,21,2.4.441,0,845,3,57,441,498,441,0,498,498,-441,441,1017,5,1,57,498,280,498,22,1638,585
1648,21,3.3.449,1,772,0,18,449,467,449,0,467,467,-8,299,584,4,5,113,38,287,188,22,1638,585
1648,21,4.4.313,0,811,1,85,313,398,313,0,398,449,-313,313,889,5,1,85,498,255,498,22,1638,585
1648,21,5.2.449,0,772,0,49,449,498,372,77,498,498,0,203,576,3,6,146,49,233,295,22,1638,585
1648,22,0.4.274,0,772,0,94,274,368,274,0,368,467,-274,274,858,5,1,94,498,368,498,23,1638,567
1648,22,1.4.346,0,844,3,90,346,436,346,0,436,467,-346,346,930,5,1,90,498,215,498,23,1638,567
1648,22,2.4.441,0,845,4,57,441,498,441,0,498,498,-441,441,1025,5,1,57,498,280,498,23,1638,567
1648,22,3.4.467,0,781,1,95,467,562,467,0,562,562,-467,467,1051,5,1,95,498,287,498,23,1638,567
1648,22,4.4.313,0,811,2,85,313,398,313,0,398,467,-313,313,897,5,1,85,498,255,498,23,1638,567
1648,22,5.2.449,1,772,0,49,449,498,372,77,498,498,0,203,584,3,6,146,49,233,295,23,1638,567
1648,23,0.4.274,0,772,0,94,274,368,274,0,368,498,-274,274,858,5,1,94,498,368,498,24,1638,518
1648,23,1.4.346,0,844,3,90,346,436,346,0,436,498,-346,346,930,5,1,90,498,215,498,24,1638,518
1648,23,2.4.441,0,845,4,57,441,498,441,0,498,498,-441,441,1025,5,1,57,498,280,498,24,1638,518
1648,23,3.4.467,0,781,1,95,467,562,467,0,562,562,-467,467,1051,5,1,95,498,287,498,24,1638,518
1648,23,4.4.313,0,811,2,85,313,398,313,0,398,498,-313,313,897,5,1,85,498,255,498,24,1638,518
1648,23,5.3.498,1,772,0,20,498,518,498,0,518,518,-31,330,615,4,6,97,20,233,188,24,1638,518
1648,24,0.4.274,1,772,0,94,274,368,274,0,368,518,-274,274,889,5,1,94,498,368,498,25,1638,498
1648,24,1.4.346,0,844,4,90,346,436,346,0,436,518,-346,346,961,5,1,90,498,215,498,25,1638,498
1648,24,2.4.441,0,845,5,57,441,498,441,0,498,518,-441,441,1056,5,1,57,498,280,498,25,1638,498
1648,24,3.4.467,0,781,2,95,467,562,467,0,562,562,-467,467,1082,5,1,95,498,287,498,25,1638,498
1648,24,4.4.313,0,811,3,85,313,398,313,0,398,518,-313,313,928,5,1,85,498,255,498,25,1638,498
1648,24,5.4.518,0,775,1,77,518,595,518,0,595,595,-518,518,1133,5,1,77,498,233,498,25,1638,498
1648,25,1.4.368,0,772,0,90,368,458,346,22,458,518,0,274,889,5,2,90,404,215,498,26,1638,404
1648,25,2.4.441,0,845,3,57,441,498,441,0,498,518,-73,347,962,5,2,57,404,280,498,26,1638,404
1648,25,3.4.467,0,781,2,95,467,562,467,0,562,562,-99,373,988,5,2,95,404,287,498,26,1638,404
1648,25,4.4.368,1,772,0,85,368,453,313,55,453,518,0,274,889,5,2,85,404,255,498,26,1638,404
1648,25,5.4.518,0,775,1,77,518,595,518,0,595,595,-150,424,1039,5,2,77,404,233,498,26,1638,404
1648,26,1.4.453,0,772,0,90,453,543,346,107,543,543,0,274,889,5,3,90,319,215,498,27,1638,319
1648,26,2.4.453,1,772,0,57,453,510,441,12,510,518,0,274,889,5,3,57,319,280,498,27,1638,319
1648,26,3.4.467,0,786,2,95,467,562,467,0,562,562,-14,288,903,5,3,95,319,287,498,27,1638,319
1648,26,5.4.518,0,780,1,77,518,595,518,0,595,595,-65,339,954,5,3,77,319,233,498,27,1638,319
1648,27,1.4.510,1,772,0,90,510,600,346,164,600,600,0,274,889,5,4,90,262,215,498,28,1638,262
1648,27,3.4.510,0,772,0,95,510,605,467,43,605,605,0,274,889,5,4,95,262,287,498,28,1638,262
1648,27,5.4.518,0,780,1,77,518,595,518,0,595,595,-8,282,897,5,4,77,262,233,498,28,1638,262
1648,28,3.4.600,1,772,0,95,600,695,467,133,695,695,0,274,889,5,5,95,172,287,498,29,1638,172
1648,28,5.4.600,0,772,0,77,600,677,518,82,677,677,0,274,889,5,5,77,172,233,498,29,1638,172
1648,29,5.4.695,1,772,0,77,695,772,518,177,772,772,0,274,889,5,6,77,77,233,498,30,1638,77
1649,0,0.0.0,0,533,2,73,0,73,0,0,73,73,0,0,0,1,1,311,283,311,283,1,1404,1404
1649,0,1.0.0,1,505,0,13,0,13,0,0,13,13,0,0,0,1,1,214,283,214,283,1,1404,1404
1649,0,2.0.0,0,505,0,6,0,6,0,0,6,6,0,0,0,1,1,107,283,107,283,1,1404,1404
1649,0,3.0.0,0,529,1,40,0,40,0,0,40,40,0,0,0,1,1,246,283,246,283,1,1404,1404
1649,0,4.0.0,0,529,1,65,0,65,0,0,65,65,0,0,0,1,1,194,283,194,283,1,1404,1404
1649,0,5.0.0,0,563,3,86,0,86,0,0,86,86,0,0,0,1,1,332,283,332,283,1,1404,1404
1649,1,0.0.13,0,517,2,73,13,86,0,13,86,86,0,0,0,1,2,311,270,311,283,2,1404,1391
1649,1,1.1.13,1,505,0,20,13,33,13,0,33,33,-13,13,13,2,1,201,291,214,291,2,1404,1391
1649,1,2.0.13,0,505,0,6,13,19,0,13,19,19,0,0,0,1,2,107,270,107,283,2,1404,1391
1649,1,3.0.13,0,510,1,40,13,53,0,13,53,53,0,0,0,1,2,246,270,246,283,2,1404,1391
1649,1,4.0.13,0,529,3,65,13,78,0,13,78,78,0,0,0,1,2,194,270,194,283,2,1404,1391
1649,1,5.0.13,0,543,4,86,13,99,0,13,99,99,0,0,0,1,2,332,270,332,283,2,1404,1391
1649,2,0.0.13,0,517,2,73,13,86,0,13,86,86,0,0,13,1,2,311,270,311,283,3,1404,1371
1649,2,1.2.33,1,505,0,13,33,46,33,0,46,46,-33,33,46,3,1,181,262,214,262,3,1404,1371
1649,2,2.0.13,0,505,0,6,13,19,0,13,19,33,0,0,13,1,2,107,270,107,283,3,1404,1371
1649,2,3.0.13,0,510,1,40,13,53,0,13,53,53,0,0,13,1,2,246,270,246,283,3,1404,1371
1649,2,4.0.13,0,529,3,65,13,78,0,13,78,78,0,0,13,1,2,194,270,194,283,3,1404,1371
1649,2,5.0.13,0,543,4,86,13,99,0,13,99,99,0,0,13,1,2,332,270,332,283,3,1404,1371
1649,3,0.0.13,0,517,2,73,13,86,0,13,86,86,0,0,46,1,2,311,270,311,283,4,1404,1358
1649,3,1.3.46,1,505,0,69,46,115,46,0,115,115,-46,46,92,4,1,168,239,214,239,4,1404,1358
1649,3,2.0.13,0,505,0,6,13,19,0,13,19,46,0,0,46,1,2,107,270,107,283,4,1404,1358
1649,3,3.0.13,0,510,1,40,13,53,0,13,53,53,0,0,46,1,2,246,270,246,283,4,1404,1358
1649,3,4.0.13,0,529,3,65,13,78,0,13,78,78,0,0,46,1,2,194,270,194,283,4,1404,1358
1649,3,5.0.13,0,543,4,86,13,99,0,13,99,99,0,0,46,1,2,332,270,332,283,4,1404,1358
1649,4,0.0.13,0,517,2,73,13,86,0,13,86,115,0,0,92,1,2,311,270,311,283,5,1404,1289
1649,4,1.4.115,1,505,0,99,115,214,115,0,214,214,-115,115,207,5,1,99,329,214,329,5,1404,1289
1649,4,2.0.13,0,505,0,6,13,19,0,13,19,115,0,0,92,1,2,107,270,107,283,5,1404,1289
1649,4,3.0.13,0,510,1,40,13,53,0,13,53,115,0,0,92,1,2,246,270,246,283,5,1404,1289
1649,4,4.0.13,0,529,3,65,13,78,0,13,78,115,0,0,92,1,2,194,270,194,283,5,1404,1289
1649,4,5.0.13,0,543,4,86,13,99,0,13,99,115,0,0,92,1,2,332,270,332,283,5,1404,1289
1649,5,0.0.13,0,517,2,73,13,86,0,13,86,214,0,0,207,1,2,311,270,311,283,6,1404,1190
1649,5,2.0.13,0,505,0,6,13,19,0,13,19,214,0,0,207,1,2,107,270,107,283,6,1404,1190
1649,5,3.0.13,1,510,1,40,13,53,0,13,53,214,0,0,207,1,2,246,270,246,283,6,1404,1190
1649,5,4.0.13,0,529,3,65,13,78,0,13,78,214,0,0,207,1,2,194,270,194,283,6,1404,1190
1649,5,5.0.13,0,543,4,86,13,99,0,13,99,214,0,0,207,1,2,332,270,332,283,6,1404,1190
1649,6,0.0.53,1,510,0,73,53,126,0,53,126,214,0,0,207,1,3,311,230,311,283,7,1404,1150
1649,6,2.0.53,0,516,1,6,53,59,0,53,59,214,0,0,207,1,3,107,230,107,283,7,1404,1150
1649,6,3.1.53,0,510,0,73,53,126,53,0,126,214,-20,33,227,2,2,206,271,246,291,7,1404,1150
1649,6,4.0.53,0,529,2,65,53,118,0,53,118,214,0,0,207,1,3,194,230,194,283,7,1404,1150
1649,6,5.0.53,0,537,3,86,53,139,0,53,139,214,0,0,207,1,3,332,230,332,283,7,1404,1150
1649,7,0.1.126,0,510,0,53,126,179,126,0,179,214,-93,106,300,2,2,238,271,311,291,8,1404,1077
1649,7,2.0.126,0,510,0,6,126,132,0,126,132,214,0,0,207,1,4,107,157,107,283,8,1404,1077
1649,7,3.1.53,0,510,0,73,53,126,53,0,126,214,-20,33,227,2,2,206,271,246,291,8,1404,1077
1649,7,4.0.126,0,529,2,65,126,191,0,126,191,214,0,0,207,1,4,194,157,194,283,8,1404,1077
1649,7,5.0.126,1,521,1,86,126,212,0,126,212,214,0,0,207,1,4,332,157,332,283,8,1404,1077
1649,8,0.1.126,0,521,0,53,126,179,126,0,179,214,-93,106,300,2,2,238,271,311,291,9,1404,991
1649,8,2.0.212,1,521,0,6,212,218,0,212,218,218,0,0,207,1,5,107,71,107,283,9,1404,991
1649,8,3.1.53,0,521,0,73,53,126,53,0,126,214,-20,33,227,2,2,206,271,246,291,9,1404,991
1649,8,4.0.212,0,521,0,65,212,277,0,212,277,277,0,0,207,1,5,194,71,194,283,9,1404,991
1649,8,5.1.212,0,521,0,87,212,299,212,0,299,299,-179,192,386,2,2,246,271,332,291,9,1404,991
1649,9,0.1.126,0,521,0,53,126,179,126,0,179,218,-93,106,300,2,2,238,271,311,291,10,1404,985
1649,9,2.1.218,0,539,1,34,218,252,218,0,252,252,-185,198,392,2,2,101,271,107,291,10,1404,985
1649,9,3.1.53,0,521,0,73,53,126,53,0,126,218,-20,33,227,2,2,206,271,246,291,10,1404,985
1649,9,4.0.218,1,521,0,65,218,283,0,218,283,283,0,0,207,1,6,194,65,194,283,10,1404,985
1649,9,5.1.212,0,521,0,87,212,299,212,0,299,299,-179,192,386,2,2,246,271,332,291,10,1404,985
1649,10,0.1.126,0,521,0,53,126,179,126,0,179,283,-93,106,300,2,2,238,271,311,291,11,1404,920
1649,10,2.1.218,0,539,1,34,218,252,218,0,252,283,-185,198,392,2,2,101,271,107,291,11,1404,920
1649,10,3.1.53,1,521,0,73,53,126,53,0,126,283,-20,33,227,2,2,206,271,246,291,11,1404,920
1649,10,4.1.283,0,553,2,24,283,307,283,0,307,307,-250,263,457,2,2,129,271,194,291,11,1404,920
1649,10,5.1.212,0,521,0,87,212,299,212,0,299,299,-179,192,386,2,2,246,271,332,291,11,1404,920
1649,11,0.1.126,0,521,0,53,126,179,126,0,179,283,0,33,227,2,3,238,198,311,291,12,1404,847
1649,11,2.1.218,0,539,1,34,218,252,218,0,252,283,-92,125,319,2,3,101,198,107,291,12,1404,847
1649,11,3.2.126,1,521,0,20,126,146,126,0,146,283,-80,113,307,3,2,133,249,246,262,12,1404,847
1649,11,4.1.283,0,553,2,24,283,307,283,0,307,307,-157,190,384,2,3,129,198,194,291,12,1404,847
1649,11,5.1.212,0,521,0,87,212,299,212,0,299,299,-86,119,313,2,3,246,198,332,291,12,1404,847
1649,12,0.1.126,0,521,0,53,126,179,126,0,179,283,0,33,307,2,3,238,198,311,291,13,1404,827
1649,12,2.1.218,0,539,1,34,218,252,218,0,252,283,-92,125,399,2,3,101,198,107,291,13,1404,827
1649,12,3.3.146,1,521,0,76,146,222,146,0,222,283,-31,77,338,4,2,113,170,246,239,13,1404,827
1649,12,4.1.283,0,553,2,24,283,307,283,0,307,307,-157,190,464,2,3,129,198,194,291,13,1404,827
1649,12,5.1.212,0,521,0,87,212,299,212,0,299,299,-86,119,393,2,3,246,198,332,291,13,1404,827
1649,13,0.1.126,0,521,0,53,126,179,126,0,179,283,0,33,338,2,3,238,198,311,291,14,1404,751
1649,13,2.1.218,0,539,1,34,218,252,218,0,252,283,-92,125,430,2,3,101,198,107,291,14,1404,751
1649,13,3.4.222,1,521,0,37,222,259,222,0,259,283,-8,123,346,5,2,37,230,246,329,14,1404,751
1649,13,4.1.283,0,553,2,24,283,307,283,0,307,307,-157,190,495,2,3,129,198,194,291,14,1404,751
1649,13,5.1.212,0,521,0,87,212,299,212,0,299,299,-86,119,424,2,3,246,198,332,291,14,1404,751
1649,14,0.1.126,1,521,0,53,126,179,126,0,179,283,0,33,346,2,3,238,198,311,291,15,1404,714
1649,14,2.1.218,0,539,1,34,218,252,218,0,252,283,-92,125,438,2,3,101,198,107,291,15,1404,714
1649,14,4.1.283,0,553,2,24,283,307,283,0,307,307,-157,190,503,2,3,129,198,194,291,15,1404,714
1649,14,5.1.212,0,521,0,87,212,299,212,0,299,299,-86,119,432,2,3,246,198,332,291,15,1404,714
1649,15,0.2.179,1,521,0,94,179,273,179,0,273,283,-33,146,379,3,3,185,229,311,262,16,1404,661
1649,15,2.1.218,0,539,1,34,218,252,218,0,252,283,-39,72,385,2,4,101,145,107,291,16,1404,661
1649,15,4.1.283,0,553,2,24,283,307,283,0,307,307,-104,137,450,2,4,129,145,194,291,16,1404,661
1649,15,5.1.212,0,521,0,87,212,299,212,0,299,299,-33,66,379,2,4,246,145,332,291,16,1404,661
1649,16,0.3.273,1,521,0,44,273,317,273,0,317,317,-51,128,430,4,3,91,94,311,239,17,1404,567
1649,16,2.1.218,0,539,1,34,218,252,218,0,252,283,-39,72,418,2,4,101,145,107,291,17,1404,567
1649,16,4.1.283,0,553,2,24,283,307,283,0,307,307,-104,137,483,2,4,129,145,194,291,17,1404,567
1649,16,5.1.212,0,521,0,87,212,299,212,0,299,299,-33,66,412,2,4,246,145,332,291,17,1404,567
1649,17,0.4.317,1,521,0,47,317,364,317,0,364,364,-58,181,488,5,3,47,193,311,329,18,1404,523
1649,17,2.1.218,0,539,1,34,218,252,218,0,252,317,-39,72,469,2,4,101,145,107,291,18,1404,523
1649,17,4.1.283,0,553,2,24,283,307,283,0,307,317,-104,137,534,2,4,129,145,194,291,18,1404,523
1649,17,5.1.212,0,521,0,87,212,299,212,0,299,317,-33,66,463,2,4,246,145,332,291,18,1404,523
1649,18,2.1.218,0,539,1,34,218,252,218,0,252,364,-39,72,527,2,4,101,145,107,291,19,1404,476
1649,18,4.1.283,0,553,2,24,283,307,283,0,307,364,-104,137,592,2,4,129,145,194,291,19,1404,476
1649,18,5.1.212,1,521,0,87,212,299,212,0,299,364,-33,66,521,2,4,246,145,332,291,19,1404,476
1649,19,2.1.299,0,536,1,34,299,333,218,81,333,364,0,66,521,2,5,101,58,107,291,20,1404,389
1649,19,4.1.299,1,521,0,24,299,323,283,16,323,364,0,66,521,2,5,129,58,194,291,20,1404,389
1649,19,5.2.299,0,536,1,87,299,386,299,0,386,386,-26,172,547,3,4,159,135,332,262,20,1404,389
1649,20,2.1.323,1,521,0,34,323,357,218,105,357,364,0,66,521,2,6,101,34,107,291,21,1404,365
1649,20,4.2.323,0,521,0,17,323,340,323,0,340,364,-50,196,571,3,4,105,135,194,262,21,1404,365
1649,20,5.2.299,0,536,1,87,299,386,299,0,386,386,-26,172,547,3,4,159,135,332,262,21,1404,365
1649,21,2.2.357,0,547,2,31,357,388,357,0,388,388,-84,230,605,3,4,67,135,107,262,22,1404,331
1649,21,4.2.323,1,521,0,17,323,340,323,0,340,364,-50,196,571,3,4,105,135,194,262,22,1404,331
1649,21,5.2.299,0,536,1,87,299,386,299,0,386,386,-26,172,547,3,4,159,135,332,262,22,1404,331
1649,22,2.2.357,0,547,1,31,357,388,357,0,388,388,-17,213,588,3,5,67,118,107,262,23,1404,314
1649,22,4.3.340,1,521,0,32,340,372,340,0,372,372,-23,151,594,4,4,88,50,194,239,23,1404,314
1649,22,5.2.340,0,521,0,87,340,427,299,41,427,427,0,196,571,3,5,159,118,332,262,23,1404,314
1649,23,2.2.357,0,547,1,31,357,388,357,0,388,388,-17,213,611,3,5,67,118,107,262,24,1404,282
1649,23,4.4.372,1,521,0,56,372,428,372,0,428,428,-8,189,602,5,4,56,146,194,329,24,1404,282
1649,23,5.2.340,0,521,0,87,340,427,299,41,427,427,0,196,594,3,5,159,118,332,262,24,1404,282
1649,24,2.2.357,0,547,1,31,357,388,357,0,388,428,-17,213,619,3,5,67,118,107,262,25,1404,226
1649,24,5.2.340,1,521,0,87,340,427,299,41,427,428,0,196,602,3,5,159,118,332,262,25,1404,226
1649,25,2.2.427,0,521,0,31,427,458,357,70,458,458,0,196,602,3,6,67,31,107,262,26,1404,139
1649,25,5.3.427,1,521,0,4,427,431,427,0,431,431,-55,206,657,4,5,72,18,332,239,26,1404,139
1649,26,2.2.427,0,521,0,31,427,458,357,70,458,458,0,196,657,3,6,67,31,107,262,27,1404,135
1649,26,5.4.431,1,521,0,68,431,499,431,0,499,499,-3,192,660,5,5,68,90,332,329,27,1404,135
1649,27,2.2.427,1,521,0,31,427,458,357,70,458,499,0,196,660,3,6,67,31,107,262,28,1404,67
1649,28,2.3.458,1,521,0,14,458,472,458,0,472,499,-27,233,687,4,6,36,14,107,239,29,1404,36
1649,29,2.4.499,1,521,0,22,499,521,472,27,521,521,0,192,687,5,6,22,22,107,329,30,1404,22
1650,0,0.0.0,0,630,1,86,0,86,0,0,86,86,0,0,0,1,1,355,495,355,495,1,1771,1771
1650,0,1.0.0,0,690,5,87,0,87,0,0,87,87,0,0,0,1,1,214,495,214,495,1,1771,1771
1650,0,2.0.0,1,622,0,51,0,51,0,0,51,51,0,0,0,1,1,331,495,331,495,1,1771,1771
1650,0,3.0.0,0,637,2,93,0,93,0,0,93,93,0,0,0,1,1,306,495,306,495,1,1771,1771
1650,0,4.0.0,0,689,4,87,0,87,0,0,87,87,0,0,0,1,1,231,495,231,495,1,1771,1771
1650,0,5.0.0,0,657,3,91,0,91,0,0,91,91,0,0,0,1,1,334,495,334,495,1,1771,1771
1650,1,0.0.51,0,622,0,86,51,137,0,51,137,137,0,0,0,1,2,355,444,355,495,2,1771,1720
1650,1,1.0.51,0,663,2,87,51,138,0,51,138,138,0,0,0,1,2,214,444,214,495,2,1771,1720
1650,1,2.1.51,1,622,0,28,51,79,51,0,79,79,-51,51,51,2,1,280,295,331,295,2,1771,1720
1650,1,3.0.51,0,622,0,93,51,144,0,51,144,144,0,0,0,1,2,306,444,306,495,2,1771,1720
1650,1,4.0.51,0,646,1,87,51,138,0,51,138,138,0,0,0,1,2,231,444,231,495,2,1771,1720
1650,1,5.0.51,0,622,0,91,51,142,0,51,142,142,0,0,0,1,2,334,444,334,495,2,1771,1720
1650,2,0.0.51,0,622,0,86,51,137,0,51,137,137,0,0,51,1,2,355,444,355,495,3,1771,1692
1650,2,1.0.51,0,663,2,87,51,138,0,51,138,138,0,0,51,1,2,214,444,214,495,3,1771,1692
1650,2,2.2.79,1,622,0,83,79,162,79,0,162,162,-79,79,130,3,1,252,329,331,329,3,1771,1692
1650,2,3.0.51,0,622,0,93,51,144,0,51,144,144,0,0,51,1,2,306,444,306,495,3,1771,1692
1650,2,4.0.51,0,646,1,87,51,138,0,51,138,138,0,0,51,1,2,231,444,231,495,3,1771,1692
1650,2,5.0.51,0,622,0,91,51,142,0,51,142,142,0,0,51,1,2,334,444,334,495,3,1771,1692
1650,3,0.0.51,0,622,0,86,51,137,0,51,137,162,0,0,130,1,2,355,444,355,495,4,1771,1609
1650,3,1.0.51,0,663,2,87,51,138,0,51,138,162,0,0,130,1,2,214,444,214,495,4,1771,1609
1650,3,2.3.162,1,622,0,82,162,244,162,0,244,244,-162,162,292,4,1,169,293,331,293,4,1771,1609
1650,3,3.0.51,0,622,0,93,51,144,0,51,144,162,0,0,130,1,2,306,444,306,495,4,1771,1609
1650,3,4.0.51,0,646,1,87,51,138,0,51,138,162,0,0,130,1,2,231,444,231,495,4,1771,1609
1650,3,5.0.51,0,622,0,91,51,142,0,51,142,162,0,0,130,1,2,334,444,334,495,4,1771,1609
1650,4,0.0.51,0,622,0,86,51,137,0,51,137,244,0,0,292,1,2,355,444,355,495,5,1771,1527
1650,4,1.0.51,0,663,2,87,51,138,0,51,138,244,0,0,292,1,2,214,444,214,495,5,1771,1527
1650,4,2.4.244,1,622,0,87,244,331,244,0,331,331,-244,244,536,5,1,87,359,331,359,5,1771,1527
1650,4,3.0.51,0,622,0,93,51,144,0,51,144,244,0,0,292,1,2,306,444,306,495,5,1771,1527
1650,4,4.0.51,0,646,1,87,51,138,0,51,138,244,0,0,292,1,2,231,444,231,495,5,1771,1527
1650,4,5.0.51,0,622,0,91,51,142,0,51,142,244,0,0,292,1,2,334,444,334,495,5,1771,1527
1650,5,0.0.51,1,622,0,86,51,137,0,51,137,331,0,0,536,1,2,355,444,355,495,6,1771,1440
1650,5,1.0.51,0,663,2,87,51,138,0,51,138,331,0,0,536,1,2,214,444,214,495,6,1771,1440
1650,5,3.0.51,0,622,0,93,51,144,0,51,144,331,0,0,536,1,2,306,444,306,495,6,1771,1440
1650,5,4.0.51,0,646,1,87,51,138,0,51,138,331,0,0,536,1,2,231,444,231,495,6,1771,1440
1650,5,5.0.51,0,622,0,91,51,142,0,51,142,331,0,0,536,1,2,334,444,334,495,6,1771,1440
1650,6,0.1.137,1,622,0,22,137,159,137,0,159,331,-58,109,594,2,2,269,267,355,295,7,1771,1354
1650,6,1.0.137,0,663,2,87,137,224,0,137,224,331,0,0,536,1,3,214,358,214,495,7,1771,1354
1650,6,3.0.137,0,622,0,93,137,230,0,137,230,331,0,0,536,1,3,306,358,306,495,7,1771,1354
1650,6,4.0.137,0,646,1,87,137,224,0,137,224,331,0,0,536,1,3,231,358,231,495,7,1771,1354
1650,6,5.0.137,0,622,0,91,137,228,0,137,228,331,0,0,536,1,3,334,358,334,495,7,1771,1354
1650,7,0.2.162,1,622,0,97,162,259,159,3,259,331,0,79,594,3,2,247,246,355,329,8,1771,1332
1650,7,1.0.137,0,663,2,87,137,224,0,137,224,331,0,0,594,1,3,214,358,214,495,8,1771,1332
1650,7,3.0.137,0,622,0,93,137,230,0,137,230,331,0,0,594,1,3,306,358,306,495,8,1771,1332
1650,7,4.0.137,0,646,1,87,137,224,0,137,224,331,0,0,594,1,3,231,358,231,495,8,1771,1332
1650,7,5.0.137,0,622,0,91,137,228,0,137,228,331,0,0,594,1,3,334,358,334,495,8,1771,1332
1650,8,0.3.259,1,622,0,51,259,310,259,0,310,331,-15,177,609,4,2,150,211,355,293,9,1771,1235
1650,8,1.0.137,0,663,2,87,137,224,0,137,224,331,0,0,594,1,3,214,358,214,495,9,1771,1235
1650,8,3.0.137,0,622,0,93,137,230,0,137,230,331,0,0,594,1,3,306,358,306,495,9,1771,1235
1650,8,4.0.137,0,646,1,87,137,224,0,137,224,331,0,0,594,1,3,231,358,231,495,9,1771,1235
1650,8,5.0.137,0,622,0,91,137,228,0,137,228,331,0,0,594,1,3,334,358,334,495,9,1771,1235
1650,9,0.4.331,1,622,0,99,331,430,310,21,430,430,0,244,609,5,2,99,272,355,359,10,1771,1184
1650,9,1.0.137,0,663,2,87,137,224,0,137,224,331,0,0,609,1,3,214,358,214,495,10,1771,1184
1650,9,3.0.137,0,622,0,93,137,230,0,137,230,331,0,0,609,1,3,306,358,306,495,10,1771,1184
1650,9,4.0.137,0,646,1,87,137,224,0,137,224,331,0,0,609,1,3,231,358,231,495,10,1771,1184
1650,9,5.0.137,0,622,0,91,137,228,0,137,228,331,0,0,609,1,3,334,358,334,495,10,1771,1184
1650,10,1.0.137,0,663,2,87,137,224,0,137,224,430,0,0,609,1,3,214,358,214,495,11,1771,1085
1650,10,3.0.137,0,622,0,93,137,230,0,137,230,430,0,0,609,1,3,306,358,306,495,11,1771,1085
1650,10,4.0.137,0,646,1,87,137,224,0,137,224,430,0,0,609,1,3,231,358,231,495,11,1771,1085
1650,10,5.0.137,1,622,0,91,137,228,0,137,228,430,0,0,609,1,3,334,358,334,495,11,1771,1085
1650,11,1.0.228,0,648,2,87,228,315,0,228,315,430,0,0,609,1,4,214,267,214,495,12,1771,994
1650,11,3.0.228,0,622,0,93,228,321,0,228,321,430,0,0,609,1,4,306,267,306,495,12,1771,994
1650,11,4.0.228,0,630,1,87,228,315,0,228,315,430,0,0,609,1,4,231,267,231,495,12,1771,994
1650,11,5.1.228,1,622,0,70,228,298,228,0,298,430,-69,178,678,2,3,243,245,334,295,12,1771,994
1650,12,1.0.228,0,648,2,87,228,315,0,228,315,430,0,0,678,1,4,214,267,214,495,13,1771,924
1650,12,3.0.228,0,622,0,93,228,321,0,228,321,430,0,0,678,1,4,306,267,306,495,13,1771,924
1650,12,4.0.228,0,630,1,87,228,315,0,228,315,430,0,0,678,1,4,231,267,231,495,13,1771,924
1650,12,5.2.298,1,622,0,26,298,324,298,0,324,430,-39,118,717,3,3,173,149,334,329,13,1771,924
1650,13,1.0.228,0,648,2,87,228,315,0,228,315,430,0,0,717,1,4,214,267,214,495,14,1771,898
1650,13,3.0.228,0,622,0,93,228,321,0,228,321,430,0,0,717,1,4,306,267,306,495,14,1771,898
1650,13,4.0.228,0,630,1,87,228,315,0,228,315,430,0,0,717,1,4,231,267,231,495,14,1771,898
1650,13,5.3.324,1,622,0,88,324,412,324,0,412,430,-14,191,731,4,3,147,160,334,293,14,1771,898
1650,14,1.0.228,0,648,2,87,228,315,0,228,315,430,0,0,731,1,4,214,267,214,495,15,1771,810
1650,14,3.0.228,0,622,0,93,228,321,0,228,321,430,0,0,731,1,4,306,267,306,495,15,1771,810
1650,14,4.0.228,0,630,1,87,228,315,0,228,315,430,0,0,731,1,4,231,267,231,495,15,1771,810
1650,14,5.4.430,1,622,0,59,430,489,412,18,489,489,0,244,731,5,3,59,173,334,359,15,1771,810
1650,15,1.0.228,0,648,2,87,228,315,0,228,315,489,0,0,731,1,4,214,267,214,495,16,1771,751
1650,15,3.0.228,1,622,0,93,228,321,0,228,321,489,0,0,731,1,4,306,267,306,495,16,1771,751
1650,15,4.0.228,0,630,1,87,228,315,0,228,315,489,0,0,731,1,4,231,267,231,495,16,1771,751
1650,16,1.0.321,0,639,1,87,321,408,0,321,408,489,0,0,731,1,5,214,174,214,495,17,1771,658
1650,16,3.1.321,1,622,0,12,321,333,321,0,333,489,-23,201,754,2,4,213,175,306,295,17,1771,658
1650,16,4.0.321,0,622,0,87,321,408,0,321,408,489,0,0,731,1,5,231,174,231,495,17,1771,658
1650,17,1.0.321,0,639,1,87,321,408,0,321,408,489,0,0,754,1,5,214,174,214,495,18,1771,646
1650,17,3.2.333,1,622,0,87,333,420,333,0,420,489,-9,127,763,3,4,201,123,306,329,18,1771,646
1650,17,4.0.321,0,622,0,87,321,408,0,321,408,489,0,0,754,1,5,231,174,231,495,18,1771,646
1650,18,1.0.321,0,639,1,87,321,408,0,321,408,489,0,0,763,1,5,214,174,214,495,19,1771,559
1650,18,3.3.420,1,622,0,35,420,455,420,0,455,489,-8,199,771,4,4,114,72,306,293,19,1771,559
1650,18,4.0.321,0,622,0,87,321,408,0,321,408,489,0,0,763,1,5,231,174,231,495,19,1771,559
1650,19,1.0.321,0,639,1,87,321,408,0,321,408,489,0,0,771,1,5,214,174,214,495,20,1771,524
1650,19,3.4.489,1,622,0,79,489,568,455,34,568,568,0,244,771,5,4,79,114,306,359,20,1771,524
1650,19,4.0.321,0,622,0,87,321,408,0,321,408,489,0,0,771,1,5,231,174,231,495,20,1771,524
1650,20,1.0.321,0,639,1,87,321,408,0,321,408,568,0,0,771,1,5,214,174,214,495,21,1771,445
1650,20,4.0.321,1,622,0,87,321,408,0,321,408,568,0,0,771,1,5,231,174,231,495,21,1771,445
1650,21,1.0.408,1,622,0,87,408,495,0,408,495,568,0,0,771,1,6,214,87,214,495,22,1771,358
1650,21,4.1.408,0,622,0,76,408,484,408,0,484,568,-75,276,846,2,5,144,163,231,295,22,1771,358
1650,22,1.1.495,0,622,0,87,495,582,495,0,582,582,-162,363,933,2,5,127,163,214,295,23,1771,271
1650,22,4.1.408,1,622,0,76,408,484,408,0,484,568,-75,276,846,2,5,144,163,231,295,23,1771,271
1650,23,1.1.495,0,622,0,87,495,582,495,0,582,582,-11,287,857,2,6,127,87,214,295,24,1771,195
1650,23,4.2.484,1,622,0,17,484,501,484,0,501,568,-64,191,910,3,5,68,36,231,329,24,1771,195
1650,24,1.1.495,0,622,0,87,495,582,495,0,582,582,-11,287,921,2,6,127,87,214,295,25,1771,178
1650,24,4.3.501,1,622,0,25,501,526,501,0,526,568,-46,245,956,4,5,51,37,231,293,25,1771,178
1650,25,1.1.495,0,622,0,87,495,582,495,0,582,582,-11,287,967,2,6,127,87,214,295,26,1771,153
1650,25,4.4.568,1,622,0,26,568,594,526,42,594,594,0,244,956,5,5,26,35,231,359,26,1771,153
1650,26,1.1.495,1,622,0,87,495,582,495,0,582,594,-11,287,967,2,6,127,87,214,295,27,1771,127
1650,27,1.2.582,1,622,0,19,582,601,582,0,601,601,-81,272,1048,3,6,40,19,214,329,28,1771,40
1650,28,1.3.601,1,622,0,12,601,613,601,0,613,613,-75,320,1123,4,6,21,12,214,293,29,1771,21
1650,29,1.4.613,1,622,0,9,613,622,613,0,622,622,-19,263,1142,5,6,9,9,214,359,30,1771,9
1651,0,0.0.0,0,606,4,99,0,99,0,0,99,99,0,0,0,1,1,300,410,300,410,1,1545,1545
1651,0,1.0.0,0,581,2,63,0,63,0,0,63,63,0,0,0,1,1,215,410,215,410,1,1545,1545
1651,0,2.0.0,0,588,3,97,0,97,0,0,97,97,0,0,0,1,1,260,410,260,410,1,1545,1545
1651,0,3.0.0,0,562,0,46,0,46,0,0,46,46,0,0,0,1,1,265,410,265,410,1,1545,1545
1651,0,4.0.0,1,562,0,9,0,9,0,0,9,9,0,0,0,1,1,169,410,169,410,1,1545,1545
1651,0,5.0.0,0,580,1,96,0,96,0,0,96,96,0,0,0,1,1,336,410,336,410,1,1545,1545
1651,1,0.0.9,0,591,4,99,9,108,0,9,108,108,0,0,0,1,2,300,401,300,410,2,1545,1536
1651,1,1.0.9,0,573,2,63,9,72,0,9,72,72,0,0,0,1,2,215,401,215,410,2,1545,1536
1651,1,2.0.9,0,588,3,97,9,106,0,9,106,106,0,0,0,1,2,260,401,260,410,2,1545,1536
1651,1,3.0.9,0,562,0,46,9,55,0,9,55,55,0,0,0,1,2,265,401,265,410,2,1545,1536
1651,1,4.1.9,1,562,0,28,9,37,9,0,37,37,-9,9,9,2,1,160,298,169,298,2,1545,1536
1651,1,5.0.9,0,571,1,96,9,105,0,9,105,105,0,0,0,1,2,336,401,336,410,2,1545,1536
1651,2,0.0.9,0,591,4,99,9,108,0,9,108,108,0,0,9,1,2,300,401,300,410,3,1545,1508
1651,2,1.0.9,0,573,2,63,9,72,0,9,72,72,0,0,9,1,2,215,401,215,410,3,1545,1508
1651,2,2.0.9,0,588,3,97,9,106,0,9,106,106,0,0,9,1,2,260,401,260,410,3,1545,1508
1651,2,3.0.9,0,562,0,46,9,55,0,9,55,55,0,0,9,1,2,265,401,265,410,3,1545,1508
1651,2,4.2.37,1,562,0,18,37,55,37,0,55,55,-37,37,46,3,1,132,199,169,199,3,1545,1508
1651,2,5.0.9,0,571,1,96,9,105,0,9,105,105,0,0,9,1,2,336,401,336,410,3,1545,1508
1651,3,0.0.9,0,591,4,99,9,108,0,9,108,108,0,0,46,1,2,300,401,300,410,4,1545,1490
1651,3,1.0.9,0,573,2,63,9,72,0,9,72,72,0,0,46,1,2,215,401,215,410,4,1545,1490
1651,3,2.0.9,0,588,3,97,9,106,0,9,106,106,0,0,46,1,2,260,401,260,410,4,1545,1490
1651,3,3.0.9,0,562,0,46,9,55,0,9,55,55,0,0,46,1,2,265,401,265,410,4,1545,1490
1651,3,4.3.55,1,562,0,18,55,73,55,0,73,73,-55,55,101,4,1,114,347,169,347,4,1545,1490
1651,3,5.0.9,0,571,1,96,9,105,0,9,105,105,0,0,46,1,2,336,401,336,410,4,1545,1490
1651,4,0.0.9,0,591,4,99,9,108,0,9,108,108,0,0,101,1,2,300,401,300,410,5,1545,1472
1651,4,1.0.9,0,573,2,63,9,72,0,9,72,73,0,0,101,1,2,215,401,215,410,5,1545,1472
1651,4,2.0.9,0,588,3,97,9,106,0,9,106,106,0,0,101,1,2,260,401,260,410,5,1545,1472
1651,4,3.0.9,0,562,0,46,9,55,0,9,55,73,0,0,101,1,2,265,401,265,410,5,1545,1472
1651,4,4.4.73,1,562,0,96,73,169,73,0,169,169,-73,73,174,5,1,96,291,169,291,5,1545,1472
1651,4,5.0.9,0,571,1,96,9,105,0,9,105,105,0,0,101,1,2,336,401,336,410,5,1545,1472
1651,5,0.0.9,0,591,4,99,9,108,0,9,108,169,0,0,174,1,2,300,401,300,410,6,1545,1376
1651,5,1.0.9,0,573,2,63,9,72,0,9,72,169,0,0,174,1,2,215,401,215,410,6,1545,1376
1651,5,2.0.9,0,588,3,97,9,106,0,9,106,169,0,0,174,1,2,260,401,260,410,6,1545,1376
1651,5,3.0.9,1,562,0,46,9,55,0,9,55,169,0,0,174,1,2,265,401,265,410,6,1545,1376
1651,5,5.0.9,0,571,1,96,9,105,0,9,105,169,0,0,174,1,2,336,401,336,410,6,1545,1376
1651,6,0.0.55,0,563,1,99,55,154,0,55,154,169,0,0,174,1,3,300,355,300,410,7,1545,1330
1651,6,1.0.55,0,573,2,63,55,118,0,55,118,169,0,0,174,1,3,215,355,215,410,7,1545,1330
1651,6,2.0.55,0,588,3,97,55,152,0,55,152,169,0,0,174,1,3,260,355,260,410,7,1545,1330
1651,6,3.1.55,1,562,0,50,55,105,55,0,105,169,-18,27,192,2,2,219,270,265,298,7,1545,1330
1651,6,5.0.55,0,562,0,96,55,151,0,55,151,169,0,0,174,1,3,336,355,336,410,7,1545,1330
1651,7,0.0.55,0,563,1,99,55,154,0,55,154,169,0,0,192,1,3,300,355,300,410,8,1545,1280
1651,7,1.0.55,0,573,2,63,55,118,0,55,118,169,0,0,192,1,3,215,355,215,410,8,1545,1280
1651,7,2.0.55,0,588,3,97,55,152,0,55,152,169,0,0,192,1,3,260,355,260,410,8,1545,1280
1651,7,3.2.105,1,562,0,54,105,159,105,0,159,169,-50,87,242,3,2,169,181,265,199,8,1545,1280
1651,7,5.0.55,0,562,0,96,55,151,0,55,151,169,0,0,192,1,3,336,355,336,410,8,1545,1280
1651,8,0.0.55,0,563,1,99,55,154,0,55,154,169,0,0,242,1,3,300,355,300,410,9,1545,1226
1651,8,1.0.55,0,573,2,63,55,118,0,55,118,169,0,0,242,1,3,215,355,215,410,9,1545,1226
1651,8,2.0.55,0,588,3,97,55,152,0,55,152,169,0,0,242,1,3,260,355,260,410,9,1545,1226
1651,8,3.3.159,1,562,0,94,159,253,159,0,253,253,-86,141,328,4,2,115,329,265,347,9,1545,1226
1651,8,5.0.55,0,562,0,96,55,151,0,55,151,169,0,0,242,1,3,336,355,336,410,9,1545,1226
1651,9,0.0.55,0,563,1,99,55,154,0,55,154,253,0,0,328,1,3,300,355,300,410,10,1545,1132
1651,9,1.0.55,0,573,2,63,55,118,0,55,118,253,0,0,328,1,3,215,355,215,410,10,1545,1132
1651,9,2.0.55,0,588,3,97,55,152,0,55,152,253,0,0,328,1,3,260,355,260,410,10,1545,1132
1651,9,3.4.253,1,562,0,21,253,274,253,0,274,274,-84,157,412,5,2,21,195,265,291,10,1545,1132
1651,9,5.0.55,0,562,0,96,55,151,0,55,151,253,0,0,328,1,3,336,355,336,410,10,1545,1132
1651,10,0.0.55,0,563,1,99,55,154,0,55,154,274,0,0,412,1,3,300,355,300,410,11,1545,1111
1651,10,1.0.55,0,573,2,63,55,118,0,55,118,274,0,0,412,1,3,215,355,215,410,11,1545,1111
1651,10,2.0.55,0,588,3,97,55,152,0,55,152,274,0,0,412,1,3,260,355,260,410,11,1545,1111
1651,10,5.0.55,1,562,0,96,55,151,0,55,151,274,0,0,412,1,3,336,355,336,410,11,1545,1111
1651,11,0.0.151,0,562,0,99,151,250,0,151,250,274,0,0,412,1,4,300,259,300,410,12,1545,1015
1651,11,1.0.151,0,573,1,63,151,214,0,151,214,274,0,0,412,1,4,215,259,215,410,12,1545,1015
1651,11,2.0.151,0,588,2,97,151,248,0,151,248,274,0,0,412,1,4,260,259,260,410,12,1545,1015
1651,11,5.1.151,1,562,0,53,151,204,151,0,204,274,-46,73,458,2,3,240,220,336,298,12,1545,1015
1651,12,0.0.151,0,562,0,99,151,250,0,151,250,274,0,0,458,1,4,300,259,300,410,13,1545,962
1651,12,1.0.151,0,573,1,63,151,214,0,151,214,274,0,0,458,1,4,215,259,215,410,13,1545,962
1651,12,2.0.151,0,588,2,97,151,248,0,151,248,274,0,0,458,1,4,260,259,260,410,13,1545,962
1651,12,5.2.204,1,562,0,64,204,268,204,0,268,274,-45,132,503,3,3,187,127,336,199,13,1545,962
1651,13,0.0.151,0,562,0,99,151,250,0,151,250,274,0,0,503,1,4,300,259,300,410,14,1545,898
1651,13,1.0.151,0,573,1,63,151,214,0,151,214,274,0,0,503,1,4,215,259,215,410,14,1545,898
1651,13,2.0.151,0,588,2,97,151,248,0,151,248,274,0,0,503,1,4,260,259,260,410,14,1545,898
1651,13,5.3.268,1,562,0,73,268,341,268,0,341,341,-15,156,518,4,3,123,235,336,347,14,1545,898
1651,14,0.0.151,0,562,0,99,151,250,0,151,250,341,0,0,518,1,4,300,259,300,410,15,1545,825
1651,14,1.0.151,0,573,1,63,151,214,0,151,214,341,0,0,518,1,4,215,259,215,410,15,1545,825
1651,14,2.0.151,0,588,2,97,151,248,0,151,248,341,0,0,518,1,4,260,259,260,410,15,1545,825
1651,14,5.4.341,1,562,0,50,341,391,341,0,391,391,-67,224,585,5,3,50,174,336,291,15,1545,825
1651,15,0.0.151,0,562,0,99,151,250,0,151,250,391,0,0,585,1,4,300,259,300,410,16,1545,775
1651,15,1.0.151,1,573,1,63,151,214,0,151,214,391,0,0,585,1,4,215,259,215,410,16,1545,775
1651,15,2.0.151,0,588,2,97,151,248,0,151,248,391,0,0,585,1,4,260,259,260,410,16,1545,775
1651,16,0.0.214,0,573,0,99,214,313,0,214,313,391,0,0,585,1,5,300,196,300,410,17,1545,712
1651,16,1.1.214,1,573,0,56,214,270,214,0,270,391,-10,83,595,2,4,152,167,215,298,17,1545,712
1651,16,2.0.214,0,611,1,97,214,311,0,214,311,391,0,0,585,1,5,260,196,260,410,17,1545,712
1651,17,0.0.214,0,573,0,99,214,313,0,214,313,391,0,0,595,1,5,300,196,300,410,18,1545,656
1651,17,1.2.270,1,573,0,24,270,294,270,0,294,391,-2,134,597,3,4,96,63,215,199,18,1545,656
1651,17,2.0.214,0,611,1,97,214,311,0,214,311,391,0,0,595,1,5,260,196,260,410,18,1545,656
1651,18,0.0.214,0,573,0,99,214,313,0,214,313,391,0,0,597,1,5,300,196,300,410,19,1545,632
1651,18,1.3.341,1,573,0,53,341,394,294,47,394,394,0,156,597,4,4,72,162,215,347,19,1545,632
1651,18,2.0.214,0,611,1,97,214,311,0,214,311,391,0,0,597,1,5,260,196,260,410,19,1545,632
1651,19,0.0.214,0,573,0,99,214,313,0,214,313,394,0,0,597,1,5,300,196,300,410,20,1545,579
1651,19,1.4.394,1,573,0,19,394,413,394,0,413,413,-3,227,600,5,4,19,124,215,291,20,1545,579
1651,19,2.0.214,0,611,1,97,214,311,0,214,311,394,0,0,597,1,5,260,196,260,410,20,1545,579
1651,20,0.0.214,1,573,0,99,214,313,0,214,313,413,0,0,600,1,5,300,196,300,410,21,1545,560
1651,20,2.0.214,0,611,1,97,214,311,0,214,311,413,0,0,600,1,5,260,196,260,410,21,1545,560
1651,21,0.1.313,0,573,0,89,313,402,313,0,402,413,-43,126,643,2,5,201,111,300,298,22,1545,461
1651,21,2.0.313,1,573,0,97,313,410,0,313,410,413,0,0,600,1,6,260,97,260,410,22,1545,461
1651,22,0.1.313,1,573,0,89,313,402,313,0,402,413,-43,126,643,2,5,201,111,300,298,23,1545,364
1651,22,2.1.410,0,573,0,22,410,432,410,0,432,432,-140,223,740,2,5,163,111,260,298,23,1545,364
1651,23,0.2.402,1,573,0,2,402,404,402,0,404,413,-108,242,751,3,5,112,39,300,199,24,1545,275
1651,23,2.1.410,0,573,0,22,410,432,410,0,432,432,-8,134,651,2,6,163,22,260,298,24,1545,275
1651,24,0.3.404,1,573,0,58,404,462,404,0,462,462,-10,166,761,4,5,110,109,300,347,25,1545,273
1651,24,2.1.410,0,573,0,22,410,432,410,0,432,432,-8,134,759,2,6,163,22,260,298,25,1545,273
1651,25,0.4.462,1,573,0,52,462,514,462,0,514,514,-49,276,810,5,5,52,105,300,291,26,1545,215
1651,25,2.1.410,0,573,0,22,410,432,410,0,432,462,-8,134,769,2,6,163,22,260,298,26,1545,215
1651,26,2.1.410,1,573,0,22,410,432,410,0,432,514,-8,134,818,2,6,163,22,260,298,27,1545,163
1651,27,2.2.432,1,573,0,37,432,469,432,0,469,514,-28,270,846,3,6,141,37,260,199,28,1545,141
1651,28,2.3.469,1,573,0,51,469,520,469,0,520,520,-7,173,853,4,6,104,51,260,347,29,1545,104
1651,29,2.4.520,1,573,0,53,520,573,520,0,573,573,-6,282,859,5,6,53,53,260,291,30,1545,53
1652,0,0.0.0,0,451,2,13,0,13,0,0,13,13,0,0,0,1,1,145,226,145,226,1,1216,1216
1652,0,1.0.0,0,446,1,39,0,39,0,0,39,39,0,0,0,1,1,214,226,214,226,1,1216,1216
1652,0,2.0.0,0,446,1,43,0,43,0,0,43,43,0,0,0,1,1,185,226,185,226,1,1216,1216
1652,0,3.0.0,0,497,3,99,0,99,0,0,99,99,0,0,0,1,1,324,226,324,226,1,1216,1216
1652,0,4.0.0,0,446,1,31,0,31,0,0,31,31,0,0,0,1,1,208,226,208,226,1,1216,1216
1652,0,5.0.0,1,442,0,1,0,1,0,0,1,1,0,0,0,1,1,140,226,140,226,1,1216,1216
1652,1,0.0.1,0,442,0,13,1,14,0,1,14,14,0,0,0,1,2,145,225,145,226,2,1216,1215
1652,1,1.0.1,0,444,1,39,1,40,0,1,40,40,0,0,0,1,2,214,225,214,226,2,1216,1215
1652,1,2.0.1,0,446,2,43,1,44,0,1,44,44,0,0,0,1,2,185,225,185,226,2,1216,1215
1652,1,3.0.1,0,475,3,99,1,100,0,1,100,100,0,0,0,1,2,324,225,324,226,2,1216,1215
1652,1,4.0.1,1,446,2,31,1,32,0,1,32,32,0,0,0,1,2,208,225,208,226,2,1216,1215
1652,1,5.1.1,0,442,0,37,1,38,1,0,38,38,-1,1,1,2,1,139,301,140,301,2,1216,1215
1652,2,0.0.32,1,449,2,13,32,45,0,32,45,45,0,0,0,1,3,145,194,145,226,3,1216,1184
1652,2,1.0.32,0,446,0,39,32,71,0,32,71,71,0,0,0,1,3,214,194,214,226,3,1216,1184
1652,2,2.0.32,0,446,0,43,32,75,0,32,75,75,0,0,0,1,3,185,194,185,226,3,1216,1184
1652,2,3.0.32,0,462,3,99,32,131,0,32,131,131,0,0,0,1,3,324,194,324,226,3,1216,1184
1652,2,4.1.32,0,447,1,80,32,112,32,0,112,112,-32,32,32,2,1,177,301,208,301,3,1216,1184
1652,2,5.1.1,0,446,0,37,1,38,1,0,38,38,-1,1,1,2,1,139,301,140,301,3,1216,1184
1652,3,0.1.45,0,449,0,57,45,102,45,0,102,102,-45,45,45,2,1,132,301,145,301,4,1216,1171
1652,3,1.0.45,1,449,0,39,45,84,0,45,84,84,0,0,0,1,4,214,181,214,226,4,1216,1171
1652,3,2.0.45,0,456,1,43,45,88,0,45,88,88,0,0,0,1,4,185,181,185,226,4,1216,1171
1652,3,3.0.45,0,463,3,99,45,144,0,45,144,144,0,0,0,1,4,324,181,324,226,4,1216,1171
1652,3,4.1.32,0,459,2,80,32,112,32,0,112,112,-32,32,32,2,1,177,301,208,301,4,1216,1171
1652,3,5.1.1,0,449,0,37,1,38,1,0,38,45,-1,1,1,2,1,139,301,140,301,4,1216,1171
1652,4,0.1.45,0,449,0,57,45,102,45,0,102,102,-45,45,45,2,1,132,301,145,301,5,1216,1132
1652,4,1.1.84,0,459,2,24,84,108,84,0,108,108,-84,84,84,2,1,175,301,214,301,5,1216,1132
1652,4,2.0.84,1,451,1,43,84,127,0,84,127,127,0,0,0,1,5,185,142,185,226,5,1216,1132
1652,4,3.0.84,0,449,0,99,84,183,0,84,183,183,0,0,0,1,5,324,142,324,226,5,1216,1132
1652,4,4.1.32,0,459,2,80,32,112,32,0,112,112,-32,32,32,2,1,177,301,208,301,5,1216,1132
1652,4,5.1.1,0,449,0,37,1,38,1,0,38,84,-1,1,1,2,1,139,301,140,301,5,1216,1132
1652,5,0.1.45,0,451,0,57,45,102,45,0,102,127,-45,45,45,2,1,132,301,145,301,6,1216,1089
1652,5,1.1.84,0,459,1,24,84,108,84,0,108,127,-84,84,84,2,1,175,301,214,301,6,1216,1089
1652,5,2.1.127,0,451,0,15,127,142,127,0,142,142,-127,127,127,2,1,142,301,185,301,6,1216,1089
1652,5,3.0.127,1,451,0,99,127,226,0,127,226,226,0,0,0,1,6,324,99,324,226,6,1216,1089
1652,5,4.1.32,0,459,1,80,32,112,32,0,112,127,-32,32,32,2,1,177,301,208,301,6,1216,1089
1652,5,5.1.1,0,451,0,37,1,38,1,0,38,127,-1,1,1,2,1,139,301,140,301,6,1216,1089
1652,6,0.1.45,0,451,0,57,45,102,45,0,102,226,-45,45,45,2,1,132,301,145,301,7,1216,990
1652,6,1.1.84,0,459,1,24,84,108,84,0,108,226,-84,84,84,2,1,175,301,214,301,7,1216,990
1652,6,2.1.127,0,451,0,15,127,142,127,0,142,226,-127,127,127,2,1,142,301,185,301,7,1216,990
1652,6,3.1.226,0,451,0,88,226,314,226,0,314,314,-226,226,226,2,1,225,301,324,301,7,1216,990
1652,6,4.1.32,0,459,1,80,32,112,32,0,112,226,-32,32,32,2,1,177,301,208,301,7,1216,990
1652,6,5.1.1,1,451,0,37,1,38,1,0,38,226,-1,1,1,2,1,139,301,140,301,7,1216,990
1652,7,0.1.45,0,451,0,57,45,102,45,0,102,226,-7,8,8,2,2,132,264,145,301,8,1216,953
1652,7,1.1.84,0,459,1,24,84,108,84,0,108,226,-46,47,47,2,2,175,264,214,301,8,1216,953
1652,7,2.1.127,0,451,0,15,127,142,127,0,142,226,-89,90,90,2,2,142,264,185,301,8,1216,953
1652,7,3.1.226,0,451,0,88,226,314,226,0,314,314,-188,189,189,2,2,225,264,324,301,8,1216,953
1652,7,4.1.38,0,459,1,80,38,118,32,6,118,226,0,1,1,2,2,177,264,208,301,8,1216,953
1652,7,5.2.38,1,451,0,3,38,41,38,0,41,226,-38,38,39,3,1,102,167,140,167,8,1216,953
1652,8,0.1.45,0,451,0,57,45,102,45,0,102,226,-7,8,46,2,2,132,264,145,301,9,1216,950
1652,8,1.1.84,0,459,1,24,84,108,84,0,108,226,-46,47,85,2,2,175,264,214,301,9,1216,950
1652,8,2.1.127,0,451,0,15,127,142,127,0,142,226,-89,90,128,2,2,142,264,185,301,9,1216,950
1652,8,3.1.226,0,451,0,88,226,314,226,0,314,314,-188,189,227,2,2,225,264,324,301,9,1216,950
1652,8,4.1.38,0,459,1,80,38,118,32,6,118,226,0,1,39,2,2,177,264,208,301,9,1216,950
1652,8,5.3.41,1,451,0,58,41,99,41,0,99,226,-41,41,80,4,1,99,301,140,301,9,1216,950
1652,9,0.1.45,0,451,0,57,45,102,45,0,102,226,-7,8,87,2,2,132,264,145,301,10,1216,892
1652,9,1.1.84,0,459,1,24,84,108,84,0,108,226,-46,47,126,2,2,175,264,214,301,10,1216,892
1652,9,2.1.127,0,451,0,15,127,142,127,0,142,226,-89,90,169,2,2,142,264,185,301,10,1216,892
1652,9,3.1.226,0,451,0,88,226,314,226,0,314,314,-188,189,268,2,2,225,264,324,301,10,1216,892
1652,9,4.1.38,0,459,1,80,38,118,32,6,118,226,0,1,80,2,2,177,264,208,301,10,1216,892
1652,9,5.4.99,1,451,0,41,99,140,99,0,140,226,-99,99,179,5,1,41,221,140,221,10,1216,892
1652,10,0.1.45,0,451,0,57,45,102,45,0,102,226,-7,8,186,2,2,132,264,145,301,11,1216,851
1652,10,1.1.84,1,459,1,24,84,108,84,0,108,226,-46,47,225,2,2,175,264,214,301,11,1216,851
1652,10,2.1.127,0,451,0,15,127,142,127,0,142,226,-89,90,268,2,2,142,264,185,301,11,1216,851
1652,10,3.1.226,0,451,0,88,226,314,226,0,314,314,-188,189,367,2,2,225,264,324,301,11,1216,851
1652,10,4.1.38,0,459,1,80,38,118,32,6,118,226,0,1,179,2,2,177,264,208,301,11,1216,851
1652,11,0.1.108,0,485,1,57,108,165,45,63,165,226,0,47,225,2,3,132,240,145,301,12,1216,827
1652,11,1.2.108,1,459,0,29,108,137,108,0,137,226,-67,105,292,3,2,151,164,214,167,12,1216,827
1652,11,2.1.127,0,459,0,15,127,142,127,0,142,226,-19,66,244,2,3,142,240,185,301,12,1216,827
1652,11,3.1.226,0,459,0,88,226,314,226,0,314,314,-118,165,343,2,3,225,240,324,301,12,1216,827
1652,11,4.1.108,0,459,0,80,108,188,32,76,188,226,0,47,225,2,3,177,240,208,301,12,1216,827
1652,12,0.1.108,0,485,1,57,108,165,45,63,165,226,0,47,292,2,3,132,240,145,301,13,1216,798
1652,12,1.3.137,1,459,0,94,137,231,137,0,231,231,-38,79,330,4,2,122,243,214,301,13,1216,798
1652,12,2.1.127,0,459,0,15,127,142,127,0,142,226,-19,66,311,2,3,142,240,185,301,13,1216,798
1652,12,3.1.226,0,459,0,88,226,314,226,0,314,314,-118,165,410,2,3,225,240,324,301,13,1216,798
1652,12,4.1.108,0,459,0,80,108,188,32,76,188,226,0,47,292,2,3,177,240,208,301,13,1216,798
1652,13,0.1.108,0,485,1,57,108,165,45,63,165,231,0,47,330,2,3,132,240,145,301,14,1216,704
1652,13,1.4.231,1,459,0,28,231,259,231,0,259,259,-91,190,421,5,2,28,180,214,221,14,1216,704
1652,13,2.1.127,0,459,0,15,127,142,127,0,142,231,-19,66,349,2,3,142,240,185,301,14,1216,704
1652,13,3.1.226,0,459,0,88,226,314,226,0,314,314,-118,165,448,2,3,225,240,324,301,14,1216,704
1652,13,4.1.108,0,459,0,80,108,188,32,76,188,231,0,47,330,2,3,177,240,208,301,14,1216,704
1652,14,0.1.108,0,485,1,57,108,165,45,63,165,259,0,47,421,2,3,132,240,145,301,15,1216,676
1652,14,2.1.127,1,459,0,15,127,142,127,0,142,259,-19,66,440,2,3,142,240,185,301,15,1216,676
1652,14,3.1.226,0,459,0,88,226,314,226,0,314,314,-118,165,539,2,3,225,240,324,301,15,1216,676
1652,14,4.1.108,0,459,0,80,108,188,32,76,188,259,0,47,421,2,3,177,240,208,301,15,1216,676
1652,15,0.1.142,0,504,1,57,142,199,45,97,199,259,0,66,440,2,4,132,225,145,301,16,1216,661
1652,15,2.2.142,1,459,0,89,142,231,142,0,231,259,-5,110,445,3,3,127,135,185,167,16,1216,661
1652,15,3.1.226,0,459,0,88,226,314,226,0,314,314,-84,150,524,2,4,225,225,324,301,16,1216,661
1652,15,4.1.142,0,459,0,80,142,222,32,110,222,259,0,66,440,2,4,177,225,208,301,16,1216,661
1652,16,0.1.142,0,504,1,57,142,199,45,97,199,259,0,66,445,2,4,132,225,145,301,17,1216,572
1652,16,2.3.231,1,459,0,20,231,251,231,0,251,259,0,79,445,4,3,38,149,185,301,17,1216,572
1652,16,3.1.226,0,459,0,88,226,314,226,0,314,314,-84,150,529,2,4,225,225,324,301,17,1216,572
1652,16,4.1.142,0,459,0,80,142,222,32,110,222,259,0,66,445,2,4,177,225,208,301,17,1216,572
1652,17,0.1.142,0,504,1,57,142,199,45,97,199,259,0,66,445,2,4,132,225,145,301,18,1216,552
1652,17,2.4.259,1,459,0,18,259,277,251,8,277,277,0,190,445,5,3,18,152,185,221,18,1216,552
1652,17,3.1.226,0,459,0,88,226,314,226,0,314,314,-84,150,529,2,4,225,225,324,301,18,1216,552
1652,17,4.1.142,0,459,0,80,142,222,32,110,222,259,0,66,445,2,4,177,225,208,301,18,1216,552
1652,18,0.1.142,0,504,1,57,142,199,45,97,199,277,0,66,445,2,4,132,225,145,301,19,1216,534
1652,18,3.1.226,0,459,0,88,226,314,226,0,314,314,-84,150,529,2,4,225,225,324,301,19,1216,534
1652,18,4.1.142,1,459,0,80,142,222,32,110,222,277,0,66,445,2,4,177,225,208,301,19,1216,534
1652,19,0.1.222,0,504,1,57,222,279,45,177,279,279,0,66,445,2,5,132,145,145,301,20,1216,454
1652,19,3.1.226,0,459,0,88,226,314,226,0,314,314,-4,70,449,2,5,225,145,324,301,20,1216,454
1652,19,4.2.231,1,459,0,19,231,250,222,9,250,277,0,110,445,3,4,97,46,208,167,20,1216,454
1652,20,0.1.222,0,504,1,57,222,279,45,177,279,279,0,66,445,2,5,132,145,145,301,21,1216,435
1652,20,3.1.226,0,459,0,88,226,314,226,0,314,314,-4,70,449,2,5,225,145,324,301,21,1216,435
1652,20,4.3.251,1,459,0,12,251,263,250,1,263,277,0,79,445,4,4,78,129,208,301,21,1216,435
1652,21,0.1.222,0,504,1,57,222,279,45,177,279,279,0,66,445,2,5,132,145,145,301,22,1216,423
1652,21,3.1.226,0,459,0,88,226,314,226,0,314,314,-4,70,449,2,5,225,145,324,301,22,1216,423
1652,21,4.4.277,1,459,0,66,277,343,263,14,343,343,0,190,445,5,4,66,134,208,221,22,1216,423
1652,22,0.1.222,1,504,1,57,222,279,45,177,279,343,0,66,445,2,5,132,145,145,301,23,1216,357
1652,22,3.1.226,0,459,0,88,226,314,226,0,314,343,-4,70,449,2,5,225,145,324,301,23,1216,357
1652,23,0.2.279,1,504,0,5,279,284,279,0,284,343,-29,139,474,3,5,75,27,145,167,24,1216,300
1652,23,3.1.279,0,504,0,88,279,367,226,53,367,367,0,66,445,2,6,225,88,324,301,24,1216,300
1652,24,0.3.284,1,504,0,64,284,348,284,0,348,348,-21,100,495,4,5,70,117,145,301,25,1216,295
1652,24,3.1.279,0,504,0,88,279,367,226,53,367,367,0,66,474,2,6,225,88,324,301,25,1216,295
1652,25,0.4.348,1,504,0,6,348,354,348,0,354,354,-5,195,500,5,5,6,68,145,221,26,1216,231
1652,25,3.1.279,0,504,0,88,279,367,226,53,367,367,0,66,495,2,6,225,88,324,301,26,1216,231
1652,26,3.1.279,1,504,0,88,279,367,226,53,367,367,0,66,500,2,6,225,88,324,301,27,1216,225
1652,27,3.2.367,1,504,0,22,367,389,367,0,389,389,-83,222,583,3,6,137,22,324,167,28,1216,137
1652,28,3.3.389,1,504,0,53,389,442,389,0,442,442,-41,141,624,4,6,115,53,324,301,29,1216,115
1652,29,3.4.442,1,504,0,62,442,504,442,0,504,504,-88,283,712,5,6,62,62,324,221,30,1216,62
1653,0,0.0.0,0,423,1,26,0,26,0,0,26,26,0,0,0,1,1,189,241,189,241,1,1187,1187
1653,0,1.0.0,1,435,2,15,0,15,0,0,15,15,0,0,0,1,1,214,241,214,241,1,1187,1187
1653,0,2.0.0,0,470,4,88,0,88,0,0,88,88,0,0,0,1,1,311,241,311,241,1,1187,1187
1653,0,3.0.0,0,473,5,53,0,53,0,0,53,53,0,0,0,1,1,184,241,184,241,1,1187,1187
1653,0,4.0.0,0,444,3,53,0,53,0,0,53,53,0,0,0,1,1,147,241,147,241,1,1187,1187
1653,0,5.0.0,0,420,0,6,0,6,0,0,6,6,0,0,0,1,1,142,241,142,241,1,1187,1187
1653,1,0.0.15,0,438,1,26,15,41,0,15,41,41,0,0,0,1,2,189,226,189,241,2,1187,1172
1653,1,1.1.15,1,460,3,91,15,106,15,0,106,106,-15,15,15,2,1,199,204,214,204,2,1187,1172
1653,1,2.0.15,0,462,4,88,15,103,0,15,103,103,0,0,0,1,2,311,226,311,241,2,1187,1172
1653,1,3.0.15,0,471,5,53,15,68,0,15,68,68,0,0,0,1,2,184,226,184,241,2,1187,1172
1653,1,4.0.15,0,459,2,53,15,68,0,15,68,68,0,0,0,1,2,147,226,147,241,2,1187,1172
1653,1,5.0.15,0,435,0,6,15,21,0,15,21,21,0,0,0,1,2,142,226,142,241,2,1187,1172
1653,2,0.0.15,0,460,0,26,15,41,0,15,41,106,0,0,15,1,2,189,226,189,241,3,1187,1081
1653,2,1.2.106,1,460,0,34,106,140,106,0,140,140,-106,106,121,3,1,108,235,214,235,3,1187,1081
1653,2,2.0.15,0,462,1,88,15,103,0,15,103,106,0,0,15,1,2,311,226,311,241,3,1187,1081
1653,2,3.0.15,0,471,2,53,15,68,0,15,68,106,0,0,15,1,2,184,226,184,241,3,1187,1081
1653,2,4.0.15,0,460,0,53,15,68,0,15,68,106,0,0,15,1,2,147,226,147,241,3,1187,1081
1653,2,5.0.15,0,460,0,6,15,21,0,15,21,106,0,0,15,1,2,142,226,142,241,3,1187,1081
1653,3,0.0.15,0,460,0,26,15,41,0,15,41,140,0,0,121,1,2,189,226,189,241,4,1187,1047
1653,3,1.3.140,1,460,0,37,140,177,140,0,177,177,-140,140,261,4,1,74,256,214,256,4,1187,1047
1653,3,2.0.15,0,462,1,88,15,103,0,15,103,140,0,0,121,1,2,311,226,311,241,4,1187,1047
1653,3,3.0.15,0,471,2,53,15,68,0,15,68,140,0,0,121,1,2,184,226,184,241,4,1187,1047
1653,3,4.0.15,0,460,0,53,15,68,0,15,68,140,0,0,121,1,2,147,226,147,241,4,1187,1047
1653,3,5.0.15,0,460,0,6,15,21,0,15,21,140,0,0,121,1,2,142,226,142,241,4,1187,1047
1653,4,0.0.15,0,460,0,26,15,41,0,15,41,177,0,0,261,1,2,189,226,189,241,5,1187,1010
1653,4,1.4.177,1,460,0,37,177,214,177,0,214,214,-177,177,438,5,1,37,251,214,251,5,1187,1010
1653,4,2.0.15,0,462,1,88,15,103,0,15,103,177,0,0,261,1,2,311,226,311,241,5,1187,1010
1653,4,3.0.15,0,471,2,53,15,68,0,15,68,177,0,0,261,1,2,184,226,184,241,5,1187,1010
1653,4,4.0.15,0,460,0,53,15,68,0,15,68,177,0,0,261,1,2,147,226,147,241,5,1187,1010
1653,4,5.0.15,0,460,0,6,15,21,0,15,21,177,0,0,261,1,2,142,226,142,241,5,1187,1010
1653,5,0.0.15,0,460,0,26,15,41,0,15,41,214,0,0,438,1,2,189,226,189,241,6,1187,973
1653,5,2.0.15,0,462,1,88,15,103,0,15,103,214,0,0,438,1,2,311,226,311,241,6,1187,973
1653,5,3.0.15,0,471,2,53,15,68,0,15,68,214,0,0,438,1,2,184,226,184,241,6,1187,973
1653,5,4.0.15,0,460,0,53,15,68,0,15,68,214,0,0,438,1,2,147,226,147,241,6,1187,973
1653,5,5.0.15,1,460,0,6,15,21,0,15,21,214,0,0,438,1,2,142,226,142,241,6,1187,973
1653,6,0.0.21,0,460,0,26,21,47,0,21,47,214,0,0,438,1,3,189,220,189,241,7,1187,967
1653,6,2.0.21,0,462,1,88,21,109,0,21,109,214,0,0,438,1,3,311,220,311,241,7,1187,967
1653,6,3.0.21,0,471,2,53,21,74,0,21,74,214,0,0,438,1,3,184,220,184,241,7,1187,967
1653,6,4.0.21,0,460,0,53,21,74,0,21,74,214,0,0,438,1,3,147,220,147,241,7,1187,967
1653,6,5.1.106,1,462,1,20,106,126,21,85,126,214,0,15,438,2,2,136,113,142,204,7,1187,967
1653,7,0.0.21,0,462,0,26,21,47,0,21,47,214,0,0,438,1,3,189,220,189,241,8,1187,947
1653,7,2.0.21,0,462,0,88,21,109,0,21,109,214,0,0,438,1,3,311,220,311,241,8,1187,947
1653,7,3.0.21,0,471,1,53,21,74,0,21,74,214,0,0,438,1,3,184,220,184,241,8,1187,947
1653,7,4.0.21,0,462,0,53,21,74,0,21,74,214,0,0,438,1,3,147,220,147,241,8,1187,947
1653,7,5.2.140,1,475,2,41,140,181,126,14,181,214,0,106,438,3,2,116,201,142,235,8,1187,947
1653,8,0.0.21,0,475,0,26,21,47,0,21,47,214,0,0,438,1,3,189,220,189,241,9,1187,906
1653,8,2.0.21,0,475,0,88,21,109,0,21,109,214,0,0,438,1,3,311,220,311,241,9,1187,906
1653,8,3.0.21,0,475,0,53,21,74,0,21,74,214,0,0,438,1,3,184,220,184,241,9,1187,906
1653,8,4.0.21,0,475,0,53,21,74,0,21,74,214,0,0,438,1,3,147,220,147,241,9,1187,906
1653,8,5.3.181,1,475,0,43,181,224,181,0,224,224,-4,144,442,4,2,75,219,142,256,9,1187,906
1653,9,0.0.21,0,475,0,26,21,47,0,21,47,224,0,0,442,1,3,189,220,189,241,10,1187,863
1653,9,2.0.21,0,475,0,88,21,109,0,21,109,224,0,0,442,1,3,311,220,311,241,10,1187,863
1653,9,3.0.21,0,475,0,53,21,74,0,21,74,224,0,0,442,1,3,184,220,184,241,10,1187,863
1653,9,4.0.21,0,475,0,53,21,74,0,21,74,224,0,0,442,1,3,147,220,147,241,10,1187,863
1653,9,5.4.224,1,475,0,32,224,256,224,0,256,256,-10,187,452,5,2,32,214,142,251,10,1187,863
1653,10,0.0.21,1,475,0,26,21,47,0,21,47,256,0,0,452,1,3,189,220,189,241,11,1187,831
1653,10,2.0.21,0,475,0,88,21,109,0,21,109,256,0,0,452,1,3,311,220,311,241,11,1187,831
1653,10,3.0.21,0,475,0,53,21,74,0,21,74,256,0,0,452,1,3,184,220,184,241,11,1187,831
1653,10,4.0.21,0,475,0,53,21,74,0,21,74,256,0,0,452,1,3,147,220,147,241,11,1187,831
1653,11,0.1.126,1,475,0,25,126,151,47,79,151,256,0,15,452,2,3,163,93,189,204,12,1187,805
1653,11,2.0.47,0,477,1,88,47,135,0,47,135,256,0,0,452,1,4,311,194,311,241,12,1187,805
1653,11,3.0.47,0,475,0,53,47,100,0,47,100,256,0,0,452,1,4,184,194,184,241,12,1187,805
1653,11,4.0.47,0,475,0,53,47,100,0,47,100,256,0,0,452,1,4,147,194,147,241,12,1187,805
1653,12,0.2.181,1,475,0,9,181,190,151,30,190,256,0,106,452,3,3,138,160,189,235,13,1187,780
1653,12,2.0.47,0,477,1,88,47,135,0,47,135,256,0,0,452,1,4,311,194,311,241,13,1187,780
1653,12,3.0.47,0,475,0,53,47,100,0,47,100,256,0,0,452,1,4,184,194,184,241,13,1187,780
1653,12,4.0.47,0,475,0,53,47,100,0,47,100,256,0,0,452,1,4,147,194,147,241,13,1187,780
1653,13,0.3.224,1,477,1,71,224,295,190,34,295,295,0,144,452,4,3,129,176,189,256,14,1187,771
1653,13,2.0.47,0,477,1,88,47,135,0,47,135,256,0,0,452,1,4,311,194,311,241,14,1187,771
1653,13,3.0.47,0,475,0,53,47,100,0,47,100,256,0,0,452,1,4,184,194,184,241,14,1187,771
1653,13,4.0.47,0,475,0,53,47,100,0,47,100,256,0,0,452,1,4,147,194,147,241,14,1187,771
1653,14,0.4.295,1,477,0,58,295,353,295,0,353,353,-39,226,491,5,3,58,182,189,251,15,1187,700
1653,14,2.0.47,0,477,0,88,47,135,0,47,135,295,0,0,452,1,4,311,194,311,241,15,1187,700
1653,14,3.0.47,0,477,0,53,47,100,0,47,100,295,0,0,452,1,4,184,194,184,241,15,1187,700
1653,14,4.0.47,0,477,0,53,47,100,0,47,100,295,0,0,452,1,4,147,194,147,241,15,1187,700
1653,15,2.0.47,1,477,0,88,47,135,0,47,135,353,0,0,491,1,4,311,194,311,241,16,1187,642
1653,15,3.0.47,0,477,0,53,47,100,0,47,100,353,0,0,491,1,4,184,194,184,241,16,1187,642
1653,15,4.0.47,0,477,0,53,47,100,0,47,100,353,0,0,491,1,4,147,194,147,241,16,1187,642
1653,16,2.1.151,1,477,0,9,151,160,135,16,160,353,0,15,491,2,4,223,68,311,204,17,1187,554
1653,16,3.0.135,0,477,0,53,135,188,0,135,188,353,0,0,491,1,5,184,106,184,241,17,1187,554
1653,16,4.0.135,0,477,0,53,135,188,0,135,188,353,0,0,491,1,5,147,106,147,241,17,1187,554
1653,17,2.2.190,1,477,0,43,190,233,160,30,233,353,0,106,491,3,4,214,151,311,235,18,1187,545
1653,17,3.0.135,0,477,0,53,135,188,0,135,188,353,0,0,491,1,5,184,106,184,241,18,1187,545
1653,17,4.0.135,0,477,0,53,135,188,0,135,188,353,0,0,491,1,5,147,106,147,241,18,1187,545
1653,18,2.3.295,1,507,1,88,295,383,233,62,383,383,0,144,491,4,4,171,105,311,256,19,1187,502
1653,18,3.0.135,0,477,0,53,135,188,0,135,188,353,0,0,491,1,5,184,106,184,241,19,1187,502
1653,18,4.0.135,0,477,0,53,135,188,0,135,188,353,0,0,491,1,5,147,106,147,241,19,1187,502
1653,19,2.4.383,1,507,0,83,383,466,383,0,466,466,-30,256,521,5,4,83,124,311,251,20,1187,414
1653,19,3.0.135,0,507,0,53,135,188,0,135,188,383,0,0,491,1,5,184,106,184,241,20,1187,414
1653,19,4.0.135,0,507,0,53,135,188,0,135,188,383,0,0,491,1,5,147,106,147,241,20,1187,414
1653,20,3.0.135,1,507,0,53,135,188,0,135,188,466,0,0,521,1,5,184,106,184,241,21,1187,331
1653,20,4.0.135,0,507,0,53,135,188,0,135,188,466,0,0,521,1,5,147,106,147,241,21,1187,331
1653,21,3.1.188,1,507,0,27,188,215,188,0,215,466,-28,43,549,2,5,131,59,184,204,22,1187,278
1653,21,4.0.188,0,507,0,53,188,241,0,188,241,466,0,0,521,1,6,147,53,147,241,22,1187,278
1653,22,3.2.233,0,507,0,88,233,321,215,18,321,466,0,106,549,3,5,104,108,184,235,23,1187,251
1653,22,4.0.188,1,507,0,53,188,241,0,188,241,466,0,0,549,1,6,147,53,147,241,23,1187,251
1653,23,3.2.233,0,507,0,88,233,321,215,18,321,466,0,106,549,3,5,104,108,184,235,24,1187,198
1653,23,4.1.241,1,507,0,32,241,273,241,0,273,466,-26,69,575,2,6,94,32,147,204,24,1187,198
1653,24,3.2.233,0,507,0,88,233,321,215,18,321,466,0,106,575,3,5,104,108,184,235,25,1187,166
1653,24,4.2.273,1,507,0,20,273,293,273,0,293,466,-40,146,615,3,5,62,108,147,235,25,1187,166
1653,25,3.2.293,0,507,0,88,293,381,215,78,381,466,0,146,615,3,6,104,88,184,235,26,1187,146
1653,25,4.3.383,1,507,0,5,383,388,293,90,388,466,0,144,615,4,5,42,17,147,256,26,1187,146
1653,26,3.2.293,0,507,0,88,293,381,215,78,381,466,0,146,615,3,6,104,88,184,235,27,1187,141
1653,26,4.4.466,1,507,0,37,466,503,388,78,503,503,0,256,615,5,5,37,41,147,251,27,1187,141
1653,27,3.2.293,1,507,0,88,293,381,215,78,381,503,0,146,615,3,6,104,88,184,235,28,1187,104
1653,28,3.3.388,1,507,0,12,388,400,381,7,400,503,0,144,615,4,6,16,12,184,256,29,1187,16
1653,29,3.4.503,1,507,0,4,503,507,400,103,507,507,0,256,615,5,6,4,4,184,251,30,1187,4
1654,0,0.0.0,0,562,3,39,0,39,0,0,39,39,0,0,0,1,1,231,255,231,255,1,1450,1450
1654,0,1.0.0,0,607,5,90,0,90,0,0,90,90,0,0,0,1,1,313,255,313,255,1,1450,1450
1654,0,2.0.0,0,546,2,35,0,35,0,0,35,35,0,0,0,1,1,238,255,238,255,1,1450,1450
1654,0,3.0.0,1,541,1,6,0,6,0,0,6,6,0,0,0,1,1,243,255,243,255,1,1450,1450
1654,0,4.0.0,0,585,4,74,0,74,0,0,74,74,0,0,0,1,1,281,255,281,255,1,1450,1450
1654,0,5.0.0,0,536,0,11,0,11,0,0,11,11,0,0,0,1,1,144,255,144,255,1,1450,1450
1654,1,0.0.6,0,541,0,39,6,45,0,6,45,45,0,0,0,1,2,231,249,231,255,2,1450,1444
1654,1,1.0.6,0,542,1,90,6,96,0,6,96,96,0,0,0,1,2,313,249,313,255,2,1450,1444
1654,1,2.0.6,1,545,2,35,6,41,0,6,41,41,0,0,0,1,2,238,249,238,255,2,1450,1444
1654,1,3.1.6,0,541,0,65,6,71,6,0,71,71,-6,6,6,2,1,237,304,243,304,2,1450,1444
1654,1,4.0.6,0,545,2,74,6,80,0,6,80,80,0,0,0,1,2,281,249,281,255,2,1450,1444
1654,1,5.0.6,0,541,0,11,6,17,0,6,17,17,0,0,0,1,2,144,249,144,255,2,1450,1444
1654,2,0.0.41,1,545,0,39,41,80,0,41,80,80,0,0,0,1,3,231,214,231,255,3,1450,1409
1654,2,1.0.41,0,552,2,90,41,131,0,41,131,131,0,0,0,1,3,313,214,313,255,3,1450,1409
1654,2,2.1.41,0,552,2,2,41,43,41,0,43,43,-41,41,41,2,1,203,304,238,304,3,1450,1409
1654,2,3.1.6,0,545,0,65,6,71,6,0,71,71,-6,6,6,2,1,237,304,243,304,3,1450,1409
1654,2,4.0.41,0,555,3,74,41,115,0,41,115,115,0,0,0,1,3,281,214,281,255,3,1450,1409
1654,2,5.0.41,0,549,1,11,41,52,0,41,52,52,0,0,0,1,3,144,214,144,255,3,1450,1409
1654,3,0.1.80,0,545,0,92,80,172,80,0,172,172,-80,80,80,2,1,192,304,231,304,4,1450,1370
1654,3,1.0.80,0,545,0,90,80,170,0,80,170,170,0,0,0,1,4,313,175,313,255,4,1450,1370
1654,3,2.1.41,0,552,1,2,41,43,41,0,43,80,-41,41,41,2,1,203,304,238,304,4,1450,1370
1654,3,3.1.6,0,545,0,65,6,71,6,0,71,80,-6,6,6,2,1,237,304,243,304,4,1450,1370
1654,3,4.0.80,0,552,1,74,80,154,0,80,154,154,0,0,0,1,4,281,175,281,255,4,1450,1370
1654,3,5.0.80,1,545,0,11,80,91,0,80,91,91,0,0,0,1,4,144,175,144,255,4,1450,1370
1654,4,0.1.80,0,545,0,92,80,172,80,0,172,172,-80,80,80,2,1,192,304,231,304,5,1450,1359
1654,4,1.0.91,0,545,0,90,91,181,0,91,181,181,0,0,0,1,5,313,164,313,255,5,1450,1359
1654,4,2.1.41,0,552,2,2,41,43,41,0,43,91,-41,41,41,2,1,203,304,238,304,5,1450,1359
1654,4,3.1.6,0,545,0,65,6,71,6,0,71,91,-6,6,6,2,1,237,304,243,304,5,1450,1359
1654,4,4.0.91,1,552,2,74,91,165,0,91,165,165,0,0,0,1,5,281,164,281,255,5,1450,1359
1654,4,5.1.91,0,549,1,3,91,94,91,0,94,94,-91,91,91,2,1,133,304,144,304,5,1450,1359
1654,5,0.1.80,0,564,2,92,80,172,80,0,172,172,-80,80,80,2,1,192,304,231,304,6,1450,1285
1654,5,1.0.165,1,552,0,90,165,255,0,165,255,255,0,0,0,1,6,313,90,313,255,6,1450,1285
1654,5,2.1.41,0,552,0,2,41,43,41,0,43,165,-41,41,41,2,1,203,304,238,304,6,1450,1285
1654,5,3.1.6,0,552,0,65,6,71,6,0,71,165,-6,6,6,2,1,237,304,243,304,6,1450,1285
1654,5,4.1.165,0,558,1,83,165,248,165,0,248,248,-165,165,165,2,1,207,304,281,304,6,1450,1285
1654,5,5.1.91,0,552,0,3,91,94,91,0,94,165,-91,91,91,2,1,133,304,144,304,6,1450,1285
1654,6,0.1.80,0,564,2,92,80,172,80,0,172,255,-80,80,80,2,1,192,304,231,304,7,1450,1195
1654,6,1.1.255,0,552,0,59,255,314,255,0,314,314,-255,255,255,2,1,223,304,313,304,7,1450,1195
1654,6,2.1.41,1,552,0,2,41,43,41,0,43,255,-41,41,41,2,1,203,304,238,304,7,1450,1195
1654,6,3.1.6,0,552,0,65,6,71,6,0,71,255,-6,6,6,2,1,237,304,243,304,7,1450,1195
1654,6,4.1.165,0,558,1,83,165,248,165,0,248,255,-165,165,165,2,1,207,304,281,304,7,1450,1195
1654,6,5.1.91,0,552,0,3,91,94,91,0,94,255,-91,91,91,2,1,133,304,144,304,7,1450,1195
1654,7,0.1.80,0,572,2,92,80,172,80,0,172,255,-37,78,78,2,2,192,302,231,304,8,1450,1193
1654,7,1.1.255,0,552,0,59,255,314,255,0,314,314,-212,253,253,2,2,223,302,313,304,8,1450,1193
1654,7,2.2.43,1,552,0,95,43,138,43,0,138,255,-43,43,84,3,1,201,302,238,302,8,1450,1193
1654,7,3.1.43,0,552,0,65,43,108,6,37,108,255,0,41,41,2,2,237,302,243,304,8,1450,1193
1654,7,4.1.165,0,558,1,83,165,248,165,0,248,255,-122,163,163,2,2,207,302,281,304,8,1450,1193
1654,7,5.1.91,0,572,2,3,91,94,91,0,94,255,-48,89,89,2,2,133,302,144,304,8,1450,1193
1654,8,0.1.80,0,572,2,92,80,172,80,0,172,255,-37,78,121,2,2,192,302,231,304,9,1450,1098
1654,8,1.1.255,0,552,0,59,255,314,255,0,314,314,-212,253,296,2,2,223,302,313,304,9,1450,1098
1654,8,2.3.138,0,552,0,57,138,195,138,0,195,255,-138,138,222,4,1,106,407,238,407,9,1450,1098
1654,8,3.1.43,1,552,0,65,43,108,6,37,108,255,0,41,84,2,2,237,302,243,304,9,1450,1098
1654,8,4.1.165,0,558,1,83,165,248,165,0,248,255,-122,163,206,2,2,207,302,281,304,9,1450,1098
1654,8,5.1.91,0,572,2,3,91,94,91,0,94,255,-48,89,132,2,2,133,302,144,304,9,1450,1098
1654,9,0.1.108,0,552,0,92,108,200,80,28,200,255,0,41,84,2,3,192,237,231,304,10,1450,1033
1654,9,1.1.255,0,552,0,59,255,314,255,0,314,314,-147,188,231,2,3,223,237,313,304,10,1450,1033
1654,9,2.3.138,0,552,0,57,138,195,138,0,195,255,-138,138,222,4,1,106,407,238,407,10,1450,1033
1654,9,3.2.138,1,552,0,56,138,194,108,30,194,255,0,43,84,3,2,172,207,243,302,10,1450,1033
1654,9,4.1.165,0,558,1,83,165,248,165,0,248,255,-57,98,141,2,3,207,237,281,304,10,1450,1033
1654,9,5.1.108,0,552,0,3,108,111,91,17,111,255,0,41,84,2,3,133,237,144,304,10,1450,1033
1654,10,0.1.108,0,552,0,92,108,200,80,28,200,255,0,41,84,2,3,192,237,231,304,11,1450,977
1654,10,1.1.255,0,552,0,59,255,314,255,0,314,314,-147,188,231,2,3,223,237,313,304,11,1450,977
1654,10,2.3.138,0,552,0,57,138,195,138,0,195,255,-138,138,222,4,1,106,407,238,407,11,1450,977
1654,10,3.3.194,0,608,2,71,194,265,194,0,265,265,-194,194,278,4,1,116,407,243,407,11,1450,977
1654,10,4.1.165,0,558,1,83,165,248,165,0,248,255,-57,98,141,2,3,207,237,281,304,11,1450,977
1654,10,5.1.108,1,552,0,3,108,111,91,17,111,255,0,41,84,2,3,133,237,144,304,11,1450,977
1654,11,0.1.111,0,552,0,92,111,203,80,31,203,255,0,41,84,2,4,192,234,231,304,12,1450,974
1654,11,1.1.255,0,552,0,59,255,314,255,0,314,314,-144,185,228,2,4,223,234,313,304,12,1450,974
1654,11,2.3.138,0,552,0,57,138,195,138,0,195,255,-138,138,222,4,1,106,407,238,407,12,1450,974
1654,11,3.3.194,0,608,3,71,194,265,194,0,265,265,-194,194,278,4,1,116,407,243,407,12,1450,974
1654,11,4.1.165,0,558,1,83,165,248,165,0,248,255,-54,95,138,2,4,207,234,281,304,12,1450,974
1654,11,5.2.194,1,559,2,79,194,273,111,83,273,273,0,43,84,3,3,130,151,144,302,12,1450,974
1654,12,0.1.111,1,559,0,92,111,203,80,31,203,273,0,41,84,2,4,192,234,231,304,13,1450,895
1654,12,1.1.255,0,559,0,59,255,314,255,0,314,314,-144,185,228,2,4,223,234,313,304,13,1450,895
1654,12,2.3.138,0,559,0,57,138,195,138,0,195,273,-138,138,222,4,1,106,407,238,407,13,1450,895
1654,12,3.3.194,0,608,2,71,194,265,194,0,265,273,-194,194,278,4,1,116,407,243,407,13,1450,895
1654,12,4.1.165,0,563,1,83,165,248,165,0,248,273,-54,95,138,2,4,207,234,281,304,13,1450,895
1654,12,5.3.273,0,559,0,27,273,300,273,0,300,300,-273,273,357,4,1,51,407,144,407,13,1450,895
1654,13,0.2.273,1,559,0,12,273,285,203,70,285,285,0,43,84,3,4,100,72,231,302,14,1450,803
1654,13,1.1.255,0,559,0,59,255,314,255,0,314,314,-52,93,136,2,5,223,142,313,304,14,1450,803
1654,13,2.3.138,0,559,0,57,138,195,138,0,195,273,-138,138,222,4,1,106,407,238,407,14,1450,803
1654,13,3.3.194,0,608,2,71,194,265,194,0,265,273,-194,194,278,4,1,116,407,243,407,14,1450,803
1654,13,4.1.203,0,567,1,83,203,286,165,38,286,286,0,41,84,2,5,207,142,281,304,14,1450,803
1654,13,5.3.273,0,559,0,27,273,300,273,0,300,300,-273,273,357,4,1,51,407,144,407,14,1450,803
1654,14,0.3.285,0,571,2,77,285,362,285,0,362,362,-285,285,369,4,1,88,407,231,407,15,1450,791
1654,14,1.1.255,0,559,0,59,255,314,255,0,314,314,-52,93,136,2,5,223,142,313,304,15,1450,791
1654,14,2.3.138,0,559,0,57,138,195,138,0,195,285,-138,138,222,4,1,106,407,238,407,15,1450,791
1654,14,3.3.194,0,608,3,71,194,265,194,0,265,285,-194,194,278,4,1,116,407,243,407,15,1450,791
1654,14,4.1.203,1,567,1,83,203,286,165,38,286,286,0,41,84,2,5,207,142,281,304,15,1450,791
1654,14,5.3.273,0,559,0,27,273,300,273,0,300,300,-273,273,357,4,1,51,407,144,407,15,1450,791
1654,15,0.3.285,0,571,1,77,285,362,285,0,362,362,-285,285,369,4,1,88,407,231,407,16,1450,708
1654,15,1.1.286,0,567,0,59,286,345,255,31,345,345,0,41,84,2,6,223,59,313,304,16,1450,708
1654,15,2.3.138,0,567,0,57,138,195,138,0,195,286,-138,138,222,4,1,106,407,238,407,16,1450,708
1654,15,3.3.194,0,608,2,71,194,265,194,0,265,286,-194,194,278,4,1,116,407,243,407,16,1450,708
1654,15,4.2.286,1,567,0,20,286,306,286,0,306,306,-1,44,85,3,5,124,60,281,302,16,1450,708
1654,15,5.3.273,0,567,0,27,273,300,273,0,300,300,-273,273,357,4,1,51,407,144,407,16,1450,708
1654,16,0.3.285,0,571,2,77,285,362,285,0,362,362,-285,285,370,4,1,88,407,231,407,17,1450,688
1654,16,1.1.286,1,567,0,59,286,345,255,31,345,345,0,41,85,2,6,223,59,313,304,17,1450,688
1654,16,2.3.138,0,567,0,57,138,195,138,0,195,306,-138,138,223,4,1,106,407,238,407,17,1450,688
1654,16,3.3.194,0,608,3,71,194,265,194,0,265,306,-194,194,279,4,1,116,407,243,407,17,1450,688
1654,16,4.3.306,0,569,1,97,306,403,306,0,403,403,-306,306,391,4,1,104,407,281,407,17,1450,688
1654,16,5.3.273,0,567,0,27,273,300,273,0,300,306,-273,273,358,4,1,51,407,144,407,17,1450,688
1654,17,0.3.285,0,571,2,77,285,362,285,0,362,362,-285,285,370,4,1,88,407,231,407,18,1450,629
1654,17,1.2.345,1,567,0,40,345,385,345,0,385,385,-39,83,124,3,6,164,40,313,302,18,1450,629
1654,17,2.3.138,0,567,0,57,138,195,138,0,195,345,-138,138,223,4,1,106,407,238,407,18,1450,629
1654,17,3.3.194,0,608,3,71,194,265,194,0,265,345,-194,194,279,4,1,116,407,243,407,18,1450,629
1654,17,4.3.306,0,569,1,97,306,403,306,0,403,403,-306,306,391,4,1,104,407,281,407,18,1450,629
1654,17,5.3.273,0,567,0,27,273,300,273,0,300,345,-273,273,358,4,1,51,407,144,407,18,1450,629
1654,18,0.3.285,0,571,2,77,285,362,285,0,362,385,-285,285,409,4,1,88,407,231,407,19,1450,589
1654,18,1.3.385,0,567,0,78,385,463,385,0,463,463,-385,385,509,4,1,124,407,313,407,19,1450,589
1654,18,2.3.138,1,567,0,57,138,195,138,0,195,385,-138,138,262,4,1,106,407,238,407,19,1450,589
1654,18,3.3.194,0,608,3,71,194,265,194,0,265,385,-194,194,318,4,1,116,407,243,407,19,1450,589
1654,18,4.3.306,0,569,1,97,306,403,306,0,403,403,-306,306,430,4,1,104,407,281,407,19,1450,589
1654,18,5.3.273,0,567,0,27,273,300,273,0,300,385,-273,273,397,4,1,51,407,144,407,19,1450,589
1654,19,0.3.285,0,571,2,77,285,362,285,0,362,385,-90,228,352,4,2,88,350,231,407,20,1450,532
1654,19,1.3.385,0,567,0,78,385,463,385,0,463,463,-190,328,452,4,2,124,350,313,407,20,1450,532
1654,19,2.4.195,1,567,0,49,195,244,195,0,244,385,-195,195,457,5,1,49,182,238,182,20,1450,532
1654,19,3.3.195,0,567,0,71,195,266,194,1,266,385,0,138,262,4,2,116,350,243,407,20,1450,532
1654,19,4.3.306,0,569,1,97,306,403,306,0,403,403,-111,249,373,4,2,104,350,281,407,20,1450,532
1654,19,5.3.273,0,567,0,27,273,300,273,0,300,385,-78,216,340,4,2,51,350,144,407,20,1450,532
1654,20,0.3.285,0,571,2,77,285,362,285,0,362,385,-90,228,547,4,2,88,350,231,407,21,1450,483
1654,20,1.3.385,0,567,0,78,385,463,385,0,463,463,-190,328,647,4,2,124,350,313,407,21,1450,483
1654,20,3.3.195,1,567,0,71,195,266,194,1,266,385,0,138,457,4,2,116,350,243,407,21,1450,483
1654,20,4.3.306,0,569,1,97,306,403,306,0,403,403,-111,249,568,4,2,104,350,281,407,21,1450,483
1654,20,5.3.273,0,567,0,27,273,300,273,0,300,385,-78,216,535,4,2,51,350,144,407,21,1450,483
1654,21,0.3.285,0,571,2,77,285,362,285,0,362,385,-19,157,476,4,3,88,279,231,407,22,1450,412
1654,21,1.3.385,0,567,0,78,385,463,385,0,463,463,-119,257,576,4,3,124,279,313,407,22,1450,412
1654,21,3.4.266,1,567,0,45,266,311,266,0,311,385,-22,217,479,5,2,45,133,243,182,22,1450,412
1654,21,4.3.306,0,569,1,97,306,403,306,0,403,403,-40,178,497,4,3,104,279,281,407,22,1450,412
1654,21,5.3.273,0,567,0,27,273,300,273,0,300,385,-7,145,464,4,3,51,279,144,407,22,1450,412
1654,22,0.3.285,0,571,2,77,285,362,285,0,362,385,-19,157,498,4,3,88,279,231,407,23,1450,367
1654,22,1.3.385,0,567,0,78,385,463,385,0,463,463,-119,257,598,4,3,124,279,313,407,23,1450,367
1654,22,4.3.306,0,569,1,97,306,403,306,0,403,403,-40,178,519,4,3,104,279,281,407,23,1450,367
1654,22,5.3.273,1,567,0,27,273,300,273,0,300,385,-7,145,486,4,3,51,279,144,407,23,1450,367
1654,23,0.3.300,0,567,0,77,300,377,285,15,377,385,0,145,486,4,4,88,252,231,407,24,1450,340
1654,23,1.3.385,0,567,0,78,385,463,385,0,463,463,-85,230,571,4,4,124,252,313,407,24,1450,340
1654,23,4.3.306,0,569,1,97,306,403,306,0,403,403,-6,151,492,4,4,104,252,281,407,24,1450,340
1654,23,5.4.311,1,567,0,24,311,335,300,11,335,385,0,217,486,5,3,24,88,144,182,24,1450,340
1654,24,0.3.300,1,567,0,77,300,377,285,15,377,385,0,145,486,4,4,88,252,231,407,25,1450,316
1654,24,1.3.385,0,567,0,78,385,463,385,0,463,463,-85,230,571,4,4,124,252,313,407,25,1450,316
1654,24,4.3.306,0,569,1,97,306,403,306,0,403,403,-6,151,492,4,4,104,252,281,407,25,1450,316
1654,25,0.4.377,1,567,0,11,377,388,377,0,388,388,-42,259,528,5,4,11,64,231,182,26,1450,239
1654,25,1.3.385,0,567,0,78,385,463,385,0,463,463,-8,153,494,4,5,124,175,313,407,26,1450,239
1654,25,4.3.377,0,598,1,97,377,474,306,71,474,474,0,145,486,4,5,104,175,281,407,26,1450,239
1654,26,1.3.385,0,567,0,78,385,463,385,0,463,463,-8,153,536,4,5,124,175,313,407,27,1450,228
1654,26,4.3.377,1,598,1,97,377,474,306,71,474,474,0,145,528,4,5,104,175,281,407,27,1450,228
1654,27,1.3.474,0,598,0,78,474,552,385,89,552,552,0,145,528,4,6,124,78,313,407,28,1450,131
1654,27,4.4.474,1,598,0,7,474,481,474,0,481,481,-86,345,614,5,5,7,53,281,182,28,1450,131
1654,28,1.3.474,1,598,0,78,474,552,385,89,552,552,0,145,614,4,6,124,78,313,407,29,1450,124
1654,29,1.4.552,1,598,0,46,552,598,552,0,598,598,-71,416,685,5,6,46,46,313,182,30,1450,46
1655,0,0.0.0,1,552,0,52,0,52,0,0,52,52,0,0,0,1,1,276,367,276,367,1,1421,1421
1655,0,1.0.0,0,552,0,65,0,65,0,0,65,65,0,0,0,1,1,213,367,213,367,1,1421,1421
1655,0,2.0.0,0,590,1,80,0,80,0,0,80,80,0,0,0,1,1,265,367,265,367,1,1421,1421
1655,0,3.0.0,0,552,0,59,0,59,0,0,59,59,0,0,0,1,1,203,367,203,367,1,1421,1421
1655,0,4.0.0,0,552,0,96,0,96,0,0,96,96,0,0,0,1,1,319,367,319,367,1,1421,1421
1655,0,5.0.0,0,552,0,15,0,15,0,0,15,15,0,0,0,1,1,145,367,145,367,1,1421,1421
1655,1,0.1.52,1,552,0,61,52,113,52,0,113,113,-52,52,52,2,1,224,309,276,309,2,1421,1369
1655,1,1.0.52,0,552,0,65,52,117,0,52,117,117,0,0,0,1,2,213,315,213,367,2,1421,1369
1655,1,2.0.52,0,580,1,80,52,132,0,52,132,132,0,0,0,1,2,265,315,265,367,2,1421,1369
1655,1,3.0.52,0,552,0,59,52,111,0,52,111,111,0,0,0,1,2,203,315,203,367,2,1421,1369
1655,1,4.0.52,0,552,0,96,52,148,0,52,148,148,0,0,0,1,2,319,315,319,367,2,1421,1369
1655,1,5.0.52,0,552,0,15,52,67,0,52,67,67,0,0,0,1,2,145,315,145,367,2,1421,1369
1655,2,0.2.113,1,552,0,16,113,129,113,0,129,129,-113,113,165,3,1,163,172,276,172,3,1421,1308
1655,2,1.0.52,0,552,0,65,52,117,0,52,117,117,0,0,52,1,2,213,315,213,367,3,1421,1308
1655,2,2.0.52,0,580,1,80,52,132,0,52,132,132,0,0,52,1,2,265,315,265,367,3,1421,1308
1655,2,3.0.52,0,552,0,59,52,111,0,52,111,113,0,0,52,1,2,203,315,203,367,3,1421,1308
1655,2,4.0.52,0,552,0,96,52,148,0,52,148,148,0,0,52,1,2,319,315,319,367,3,1421,1308
1655,2,5.0.52,0,552,0,15,52,67,0,52,67,113,0,0,52,1,2,145,315,145,367,3,1421,1308
1655,3,0.3.129,1,552,0,84,129,213,129,0,213,213,-129,129,294,4,1,147,262,276,262,4,1421,1292
1655,3,1.0.52,0,552,0,65,52,117,0,52,117,129,0,0,165,1,2,213,315,213,367,4,1421,1292
1655,3,2.0.52,0,580,1,80,52,132,0,52,132,132,0,0,165,1,2,265,315,265,367,4,1421,1292
1655,3,3.0.52,0,552,0,59,52,111,0,52,111,129,0,0,165,1,2,203,315,203,367,4,1421,1292
1655,3,4.0.52,0,552,0,96,52,148,0,52,148,148,0,0,165,1,2,319,315,319,367,4,1421,1292
1655,3,5.0.52,0,552,0,15,52,67,0,52,67,129,0,0,165,1,2,145,315,145,367,4,1421,1292
1655,4,0.4.213,1,552,0,63,213,276,213,0,276,276,-213,213,507,5,1,63,311,276,311,5,1421,1208
1655,4,1.0.52,0,552,0,65,52,117,0,52,117,213,0,0,294,1,2,213,315,213,367,5,1421,1208
1655,4,2.0.52,0,580,1,80,52,132,0,52,132,213,0,0,294,1,2,265,315,265,367,5,1421,1208
1655,4,3.0.52,0,552,0,59,52,111,0,52,111,213,0,0,294,1,2,203,315,203,367,5,1421,1208
1655,4,4.0.52,0,552,0,96,52,148,0,52,148,213,0,0,294,1,2,319,315,319,367,5,1421,1208
1655,4,5.0.52,0,552,0,15,52,67,0,52,67,213,0,0,294,1,2,145,315,145,367,5,1421,1208
1655,5,1.0.52,0,552,0,65,52,117,0,52,117,276,0,0,507,1,2,213,315,213,367,6,1421,1145
1655,5,2.0.52,0,580,1,80,52,132,0,52,132,276,0,0,507,1,2,265,315,265,367,6,1421,1145
1655,5,3.0.52,0,552,0,59,52,111,0,52,111,276,0,0,507,1,2,203,315,203,367,6,1421,1145
1655,5,4.0.52,0,552,0,96,52,148,0,52,148,276,0,0,507,1,2,319,315,319,367,6,1421,1145
1655,5,5.0.52,1,552,0,15,52,67,0,52,67,276,0,0,507,1,2,145,315,145,367,6,1421,1145
1655,6,1.0.67,0,552,0,65,67,132,0,67,132,276,0,0,507,1,3,213,300,213,367,7,1421,1130
1655,6,2.0.67,0,590,1,80,67,147,0,67,147,276,0,0,507,1,3,265,300,265,367,7,1421,1130
1655,6,3.0.67,0,552,0,59,67,126,0,67,126,276,0,0,507,1,3,203,300,203,367,7,1421,1130
1655,6,4.0.67,0,552,0,96,67,163,0,67,163,276,0,0,507,1,3,319,300,319,367,7,1421,1130
1655,6,5.1.113,1,552,0,85,113,198,67,46,198,276,0,52,507,2,2,130,248,145,309,7,1421,1130
1655,7,1.0.67,0,552,0,65,67,132,0,67,132,276,0,0,507,1,3,213,300,213,367,8,1421,1045
1655,7,2.0.67,0,590,1,80,67,147,0,67,147,276,0,0,507,1,3,265,300,265,367,8,1421,1045
1655,7,3.0.67,0,552,0,59,67,126,0,67,126,276,0,0,507,1,3,203,300,203,367,8,1421,1045
1655,7,4.0.67,0,552,0,96,67,163,0,67,163,276,0,0,507,1,3,319,300,319,367,8,1421,1045
1655,7,5.2.198,1,552,0,18,198,216,198,0,216,276,-69,182,576,3,2,45,156,145,172,8,1421,1045
1655,8,1.0.67,0,552,0,65,67,132,0,67,132,276,0,0,576,1,3,213,300,213,367,9,1421,1027
1655,8,2.0.67,0,590,1,80,67,147,0,67,147,276,0,0,576,1,3,265,300,265,367,9,1421,1027
1655,8,3.0.67,0,552,0,59,67,126,0,67,126,276,0,0,576,1,3,203,300,203,367,9,1421,1027
1655,8,4.0.67,0,552,0,96,67,163,0,67,163,276,0,0,576,1,3,319,300,319,367,9,1421,1027
1655,8,5.3.216,1,552,0,12,216,228,216,0,228,276,-3,132,579,4,2,27,178,145,262,9,1421,1027
1655,9,1.0.67,0,552,0,65,67,132,0,67,132,276,0,0,579,1,3,213,300,213,367,10,1421,1015
1655,9,2.0.67,0,590,1,80,67,147,0,67,147,276,0,0,579,1,3,265,300,265,367,10,1421,1015
1655,9,3.0.67,0,552,0,59,67,126,0,67,126,276,0,0,579,1,3,203,300,203,367,10,1421,1015
1655,9,4.0.67,0,552,0,96,67,163,0,67,163,276,0,0,579,1,3,319,300,319,367,10,1421,1015
1655,9,5.4.276,1,552,0,15,276,291,228,48,291,291,0,213,579,5,2,15,248,145,311,10,1421,1015
1655,10,1.0.67,0,552,0,65,67,132,0,67,132,291,0,0,579,1,3,213,300,213,367,11,1421,1000
1655,10,2.0.67,0,590,1,80,67,147,0,67,147,291,0,0,579,1,3,265,300,265,367,11,1421,1000
1655,10,3.0.67,0,552,0,59,67,126,0,67,126,291,0,0,579,1,3,203,300,203,367,11,1421,1000
1655,10,4.0.67,1,552,0,96,67,163,0,67,163,291,0,0,579,1,3,319,300,319,367,11,1421,1000
1655,11,1.0.163,0,554,1,65,163,228,0,163,228,291,0,0,579,1,4,213,204,213,367,12,1421,904
1655,11,2.0.163,0,578,2,80,163,243,0,163,243,291,0,0,579,1,4,265,204,265,367,12,1421,904
1655,11,3.0.163,0,552,0,59,163,222,0,163,222,291,0,0,579,1,4,203,204,203,367,12,1421,904
1655,11,4.1.198,1,552,0,36,198,234,163,35,234,291,0,52,579,2,3,223,163,319,309,12,1421,904
1655,12,1.0.163,0,560,1,65,163,228,0,163,228,291,0,0,579,1,4,213,204,213,367,13,1421,868
1655,12,2.0.163,0,578,2,80,163,243,0,163,243,291,0,0,579,1,4,265,204,265,367,13,1421,868
1655,12,3.0.163,0,552,0,59,163,222,0,163,222,291,0,0,579,1,4,203,204,203,367,13,1421,868
1655,12,4.2.234,1,552,0,21,234,255,234,0,255,291,-18,200,597,3,3,187,138,319,172,13,1421,868
1655,13,1.0.163,0,560,1,65,163,228,0,163,228,291,0,0,597,1,4,213,204,213,367,14,1421,847
1655,13,2.0.163,0,578,2,80,163,243,0,163,243,291,0,0,597,1,4,265,204,265,367,14,1421,847
1655,13,3.0.163,0,552,0,59,163,222,0,163,222,291,0,0,597,1,4,203,204,203,367,14,1421,847
1655,13,4.3.255,1,578,2,90,255,345,255,0,345,345,-27,159,624,4,3,166,166,319,262,14,1421,847
1655,14,1.0.163,0,578,0,65,163,228,0,163,228,345,0,0,624,1,4,213,204,213,367,15,1421,757
1655,14,2.0.163,0,578,0,80,163,243,0,163,243,345,0,0,624,1,4,265,204,265,367,15,1421,757
1655,14,3.0.163,0,578,0,59,163,222,0,163,222,345,0,0,624,1,4,203,204,203,367,15,1421,757
1655,14,4.4.345,1,578,0,76,345,421,345,0,421,421,-54,267,678,5,3,76,233,319,311,15,1421,757
1655,15,1.0.163,0,578,0,65,163,228,0,163,228,421,0,0,678,1,4,213,204,213,367,16,1421,681
1655,15,2.0.163,1,578,0,80,163,243,0,163,243,421,0,0,678,1,4,265,204,265,367,16,1421,681
1655,15,3.0.163,0,578,0,59,163,222,0,163,222,421,0,0,678,1,4,203,204,203,367,16,1421,681
1655,16,1.0.243,0,578,0,65,243,308,0,243,308,421,0,0,678,1,5,213,124,213,367,17,1421,601
1655,16,2.1.243,0,578,0,95,243,338,243,0,338,421,-9,61,687,2,4,185,127,265,309,17,1421,601
1655,16,3.0.243,1,578,0,59,243,302,0,243,302,421,0,0,678,1,5,203,124,203,367,17,1421,601
1655,17,1.0.302,1,578,0,65,302,367,0,302,367,421,0,0,678,1,6,213,65,213,367,18,1421,542
1655,17,2.1.243,0,578,0,95,243,338,243,0,338,421,-9,61,687,2,4,185,127,265,309,18,1421,542
1655,17,3.1.302,0,578,0,4,302,306,302,0,306,421,-68,120,746,2,4,144,127,203,309,18,1421,542
1655,18,1.1.367,0,578,0,28,367,395,367,0,395,421,-133,185,811,2,4,148,127,213,309,19,1421,477
1655,18,2.1.243,0,578,0,95,243,338,243,0,338,421,-9,61,687,2,4,185,127,265,309,19,1421,477
1655,18,3.1.302,1,578,0,4,302,306,302,0,306,421,-68,120,746,2,4,144,127,203,309,19,1421,477
1655,19,1.1.367,0,580,1,28,367,395,367,0,395,421,-61,181,807,2,5,148,123,213,309,20,1421,473
1655,19,2.1.306,0,578,0,95,306,401,243,63,401,421,0,120,746,2,5,185,123,265,309,20,1421,473
1655,19,3.2.306,1,578,0,23,306,329,306,0,329,421,-51,251,797,3,4,140,117,203,172,20,1421,473
1655,20,1.1.367,0,580,1,28,367,395,367,0,395,421,-61,181,858,2,5,148,123,213,309,21,1421,450
1655,20,2.1.306,0,578,0,95,306,401,243,63,401,421,0,120,797,2,5,185,123,265,309,21,1421,450
1655,20,3.3.345,1,578,0,30,345,375,329,16,375,421,0,159,797,4,4,117,76,203,262,21,1421,450
1655,21,1.1.367,0,580,1,28,367,395,367,0,395,421,-61,181,858,2,5,148,123,213,309,22,1421,420
1655,21,2.1.306,0,578,0,95,306,401,243,63,401,421,0,120,797,2,5,185,123,265,309,22,1421,420
1655,21,3.4.421,1,578,0,87,421,508,375,46,508,508,0,267,797,5,4,87,157,203,311,22,1421,420
1655,22,1.1.367,0,580,1,28,367,395,367,0,395,508,-61,181,858,2,5,148,123,213,309,23,1421,333
1655,22,2.1.306,1,578,0,95,306,401,243,63,401,508,0,120,797,2,5,185,123,265,309,23,1421,333
1655,23,1.1.401,1,578,0,28,401,429,367,34,429,508,0,120,797,2,6,148,28,213,309,24,1421,238
1655,23,2.2.401,0,578,0,49,401,450,401,0,450,508,-72,323,869,3,5,90,94,265,172,24,1421,238
1655,24,1.2.429,0,578,0,45,429,474,429,0,474,508,-100,351,897,3,5,120,94,213,172,25,1421,210
1655,24,2.2.401,1,578,0,49,401,450,401,0,450,508,-72,323,869,3,5,90,94,265,172,25,1421,210
1655,25,1.2.450,0,578,0,45,450,495,429,21,495,508,0,323,869,3,6,120,45,213,172,26,1421,161
1655,25,2.3.450,1,578,0,26,450,476,450,0,476,508,-75,234,944,4,5,41,46,265,262,26,1421,161
1655,26,1.2.450,0,578,0,45,450,495,429,21,495,508,0,323,944,3,6,120,45,213,172,27,1421,135
1655,26,2.4.508,1,578,0,15,508,523,476,32,523,523,0,267,944,5,5,15,70,265,311,27,1421,135
1655,27,1.2.450,1,578,0,45,450,495,429,21,495,523,0,323,944,3,6,120,45,213,172,28,1421,120
1655,28,1.3.495,1,578,0,20,495,515,495,0,515,523,-19,253,963,4,6,75,20,213,262,29,1421,75
1655,29,1.4.523,1,578,0,55,523,578,515,8,578,578,0,267,963,5,6,55,55,213,311,30,1421,55
1656,0,0.0.0,0,649,3,65,0,65,0,0,65,65,0,0,0,1,1,220,185,220,185,1,1589,1589
1656,0,1.0.0,0,678,5,41,0,41,0,0,41,41,0,0,0,1,1,312,185,312,185,1,1589,1589
1656,0,2.0.0,0,637,0,27,0,27,0,0,27,27,0,0,0,1,1,290,185,290,185,1,1589,1589
1656,0,3.0.0,1,646,1,13,0,13,0,0,13,13,0,0,0,1,1,262,185,262,185,1,1589,1589
1656,0,4.0.0,0,648,2,19,0,19,0,0,19,19,0,0,0,1,1,258,185,258,185,1,1589,1589
1656,0,5.0.0,0,657,4,20,0,20,0,0,20,20,0,0,0,1,1,247,185,247,185,1,1589,1589
1656,1,0.0.13,0,646,0,65,13,78,0,13,78,78,0,0,0,1,2,220,172,220,185,2,1589,1576
1656,1,1.0.13,0,665,3,41,13,54,0,13,54,54,0,0,0,1,2,312,172,312,185,2,1589,1576
1656,1,2.0.13,1,650,1,27,13,40,0,13,40,40,0,0,0,1,2,290,172,290,185,2,1589,1576
1656,1,3.1.13,0,646,0,42,13,55,13,0,55,55,-13,13,13,2,1,249,410,262,410,2,1589,1576
1656,1,4.0.13,0,661,2,19,13,32,0,13,32,32,0,0,0,1,2,258,172,258,185,2,1589,1576
1656,1,5.0.13,0,665,3,20,13,33,0,13,33,33,0,0,0,1,2,247,172,247,185,2,1589,1576
1656,2,0.0.40,0,650,0,65,40,105,0,40,105,105,0,0,0,1,3,220,145,220,185,3,1589,1549
1656,2,1.0.40,0,650,0,41,40,81,0,40,81,81,0,0,0,1,3,312,145,312,185,3,1589,1549
1656,2,2.1.40,0,650,0,88,40,128,40,0,128,128,-40,40,40,2,1,263,410,290,410,3,1589,1549
1656,2,3.1.13,0,665,1,42,13,55,13,0,55,55,-13,13,13,2,1,249,410,262,410,3,1589,1549
1656,2,4.0.40,1,650,0,19,40,59,0,40,59,59,0,0,0,1,3,258,145,258,185,3,1589,1549
1656,2,5.0.40,0,650,0,20,40,60,0,40,60,60,0,0,0,1,3,247,145,247,185,3,1589,1549
1656,3,0.0.59,0,650,0,65,59,124,0,59,124,124,0,0,0,1,4,220,126,220,185,4,1589,1530
1656,3,1.0.59,1,650,0,41,59,100,0,59,100,100,0,0,0,1,4,312,126,312,185,4,1589,1530
1656,3,2.1.40,0,650,0,88,40,128,40,0,128,128,-40,40,40,2,1,263,410,290,410,4,1589,1530
1656,3,3.1.13,0,665,1,42,13,55,13,0,55,59,-13,13,13,2,1,249,410,262,410,4,1589,1530
1656,3,4.1.59,0,665,1,87,59,146,59,0,146,146,-59,59,59,2,1,239,410,258,410,4,1589,1530
1656,3,5.0.59,0,650,0,20,59,79,0,59,79,79,0,0,0,1,4,247,126,247,185,4,1589,1530
1656,4,0.0.100,0,650,0,65,100,165,0,100,165,165,0,0,0,1,5,220,85,220,185,5,1589,1489
1656,4,1.1.100,0,675,3,95,100,195,100,0,195,195,-100,100,100,2,1,271,410,312,410,5,1589,1489
1656,4,2.1.40,0,650,0,88,40,128,40,0,128,128,-40,40,40,2,1,263,410,290,410,5,1589,1489
1656,4,3.1.13,0,665,2,42,13,55,13,0,55,100,-13,13,13,2,1,249,410,262,410,5,1589,1489
1656,4,4.1.59,0,665,2,87,59,146,59,0,146,146,-59,59,59,2,1,239,410,258,410,5,1589,1489
1656,4,5.0.100,1,659,1,20,100,120,0,100,120,120,0,0,0,1,5,247,85,247,185,5,1589,1489
1656,5,0.0.120,1,659,0,65,120,185,0,120,185,185,0,0,0,1,6,220,65,220,185,6,1589,1469
1656,5,1.1.100,0,675,2,95,100,195,100,0,195,195,-100,100,100,2,1,271,410,312,410,6,1589,1469
1656,5,2.1.40,0,659,0,88,40,128,40,0,128,128,-40,40,40,2,1,263,410,290,410,6,1589,1469
1656,5,3.1.13,0,665,1,42,13,55,13,0,55,120,-13,13,13,2,1,249,410,262,410,6,1589,1469
1656,5,4.1.59,0,665,1,87,59,146,59,0,146,146,-59,59,59,2,1,239,410,258,410,6,1589,1469
1656,5,5.1.120,0,687,3,69,120,189,120,0,189,189,-120,120,120,2,1,227,410,247,410,6,1589,1469
1656,6,0.1.185,0,659,0,29,185,214,185,0,214,214,-185,185,185,2,1,155,410,220,410,7,1589,1404
1656,6,1.1.100,0,675,2,95,100,195,100,0,195,195,-100,100,100,2,1,271,410,312,410,7,1589,1404
1656,6,2.1.40,0,659,0,88,40,128,40,0,128,185,-40,40,40,2,1,263,410,290,410,7,1589,1404
1656,6,3.1.13,1,665,1,42,13,55,13,0,55,185,-13,13,13,2,1,249,410,262,410,7,1589,1404
1656,6,4.1.59,0,665,1,87,59,146,59,0,146,185,-59,59,59,2,1,239,410,258,410,7,1589,1404
1656,6,5.1.120,0,687,3,69,120,189,120,0,189,189,-120,120,120,2,1,227,410,247,410,7,1589,1404
1656,7,0.1.185,0,665,0,29,185,214,185,0,214,214,-130,143,143,2,2,155,368,220,410,8,1589,1362
1656,7,1.1.100,0,675,1,95,100,195,100,0,195,195,-45,58,58,2,2,271,368,312,410,8,1589,1362
1656,7,2.1.55,0,665,0,88,55,143,40,15,143,185,0,13,13,2,2,263,368,290,410,8,1589,1362
1656,7,3.2.55,1,665,0,90,55,145,55,0,145,185,-55,55,68,3,1,207,239,262,239,8,1589,1362
1656,7,4.1.59,0,665,0,87,59,146,59,0,146,185,-4,17,17,2,2,239,368,258,410,8,1589,1362
1656,7,5.1.120,0,687,2,69,120,189,120,0,189,189,-65,78,78,2,2,227,368,247,410,8,1589,1362
1656,8,0.1.185,0,665,0,29,185,214,185,0,214,214,-130,143,198,2,2,155,368,220,410,9,1589,1272
1656,8,1.1.100,0,675,1,95,100,195,100,0,195,195,-45,58,113,2,2,271,368,312,410,9,1589,1272
1656,8,2.1.55,1,665,0,88,55,143,40,15,143,185,0,13,68,2,2,263,368,290,410,9,1589,1272
1656,8,3.3.145,0,665,0,88,145,233,145,0,233,233,-145,145,213,4,1,117,514,262,514,9,1589,1272
1656,8,4.1.59,0,665,0,87,59,146,59,0,146,185,-4,17,72,2,2,239,368,258,410,9,1589,1272
1656,8,5.1.120,0,687,2,69,120,189,120,0,189,189,-65,78,133,2,2,227,368,247,410,9,1589,1272
1656,9,0.1.185,0,665,0,29,185,214,185,0,214,214,-42,55,110,2,3,155,280,220,410,10,1589,1184
1656,9,1.1.143,0,665,0,95,143,238,100,43,238,238,0,13,68,2,3,271,280,312,410,10,1589,1184
1656,9,2.2.145,1,665,0,2,145,147,143,2,147,185,0,55,68,3,2,175,149,290,239,10,1589,1184
1656,9,3.3.145,0,665,0,88,145,233,145,0,233,233,-145,145,213,4,1,117,514,262,514,10,1589,1184
1656,9,4.1.143,0,665,0,87,143,230,59,84,230,230,0,13,68,2,3,239,280,258,410,10,1589,1184
1656,9,5.1.143,0,665,0,69,143,212,120,23,212,212,0,13,68,2,3,227,280,247,410,10,1589,1184
1656,10,0.1.185,0,665,0,29,185,214,185,0,214,214,-42,55,110,2,3,155,280,220,410,11,1589,1182
1656,10,1.1.143,0,665,0,95,143,238,100,43,238,238,0,13,68,2,3,271,280,312,410,11,1589,1182
1656,10,2.3.147,0,667,1,94,147,241,147,0,241,241,-147,147,215,4,1,173,514,290,514,11,1589,1182
1656,10,3.3.145,0,665,0,88,145,233,145,0,233,233,-145,145,213,4,1,117,514,262,514,11,1589,1182
1656,10,4.1.143,1,665,0,87,143,230,59,84,230,230,0,13,68,2,3,239,280,258,410,11,1589,1182
1656,10,5.1.143,0,665,0,69,143,212,120,23,212,212,0,13,68,2,3,227,280,247,410,11,1589,1182
1656,11,0.1.230,0,665,0,29,230,259,185,45,259,259,0,13,68,2,4,155,193,220,410,12,1589,1095
1656,11,1.1.230,0,665,0,95,230,325,100,130,325,325,0,13,68,2,4,271,193,312,410,12,1589,1095
1656,11,2.3.147,0,667,1,94,147,241,147,0,241,241,-147,147,215,4,1,173,514,290,514,12,1589,1095
1656,11,3.3.145,0,665,0,88,145,233,145,0,233,233,-145,145,213,4,1,117,514,262,514,12,1589,1095
1656,11,4.2.230,1,665,0,22,230,252,230,0,252,252,-83,138,151,3,3,152,147,258,239,12,1589,1095
1656,11,5.1.230,0,665,0,69,230,299,120,110,299,299,0,13,68,2,4,227,193,247,410,12,1589,1095
1656,12,0.1.230,1,665,0,29,230,259,185,45,259,259,0,13,151,2,4,155,193,220,410,13,1589,1073
1656,12,1.1.230,0,665,0,95,230,325,100,130,325,325,0,13,151,2,4,271,193,312,410,13,1589,1073
1656,12,2.3.147,0,667,1,94,147,241,147,0,241,252,-147,147,298,4,1,173,514,290,514,13,1589,1073
1656,12,3.3.145,0,665,0,88,145,233,145,0,233,252,-145,145,296,4,1,117,514,262,514,13,1589,1073
1656,12,4.3.252,0,678,2,83,252,335,252,0,335,335,-252,252,403,4,1,130,514,258,514,13,1589,1073
1656,12,5.1.230,0,665,0,69,230,299,120,110,299,299,0,13,151,2,4,227,193,247,410,13,1589,1073
1656,13,0.2.259,1,665,0,19,259,278,259,0,278,278,-7,145,158,3,4,126,125,220,239,14,1589,1044
1656,13,1.1.259,0,665,0,95,259,354,100,159,354,354,0,13,151,2,5,271,164,312,410,14,1589,1044
1656,13,2.3.147,0,667,1,94,147,241,147,0,241,259,-147,147,298,4,1,173,514,290,514,14,1589,1044
1656,13,3.3.145,0,665,0,88,145,233,145,0,233,259,-145,145,296,4,1,117,514,262,514,14,1589,1044
1656,13,4.3.252,0,678,2,83,252,335,252,0,335,335,-252,252,403,4,1,130,514,258,514,14,1589,1044
1656,13,5.1.259,0,665,0,69,259,328,120,139,328,328,0,13,151,2,5,227,164,247,410,14,1589,1044
1656,14,0.3.278,0,704,3,91,278,369,278,0,369,369,-278,278,436,4,1,107,514,220,514,15,1589,1025
1656,14,1.1.259,1,665,0,95,259,354,100,159,354,354,0,13,158,2,5,271,164,312,410,15,1589,1025
1656,14,2.3.147,0,667,1,94,147,241,147,0,241,278,-147,147,305,4,1,173,514,290,514,15,1589,1025
1656,14,3.3.145,0,665,0,88,145,233,145,0,233,278,-145,145,303,4,1,117,514,262,514,15,1589,1025
1656,14,4.3.252,0,678,2,83,252,335,252,0,335,335,-252,252,410,4,1,130,514,258,514,15,1589,1025
1656,14,5.1.259,0,665,0,69,259,328,120,139,328,328,0,13,158,2,5,227,164,247,410,15,1589,1025
1656,15,0.3.278,0,704,3,91,278,369,278,0,369,369,-278,278,436,4,1,107,514,220,514,16,1589,930
1656,15,1.2.354,0,665,0,50,354,404,354,0,404,404,-76,221,234,3,5,176,106,312,239,16,1589,930
1656,15,2.3.147,0,667,1,94,147,241,147,0,241,354,-147,147,305,4,1,173,514,290,514,16,1589,930
1656,15,3.3.145,0,665,0,88,145,233,145,0,233,354,-145,145,303,4,1,117,514,262,514,16,1589,930
1656,15,4.3.252,0,678,2,83,252,335,252,0,335,354,-252,252,410,4,1,130,514,258,514,16,1589,930
1656,15,5.1.354,1,665,0,69,354,423,120,234,423,423,0,13,158,2,6,227,69,247,410,16,1589,930
1656,16,0.3.278,0,704,3,91,278,369,278,0,369,423,-278,278,436,4,1,107,514,220,514,17,1589,861
1656,16,1.2.354,1,665,0,50,354,404,354,0,404,423,-76,221,234,3,5,176,106,312,239,17,1589,861
1656,16,2.3.147,0,667,1,94,147,241,147,0,241,423,-147,147,305,4,1,173,514,290,514,17,1589,861
1656,16,3.3.145,0,665,0,88,145,233,145,0,233,423,-145,145,303,4,1,117,514,262,514,17,1589,861
1656,16,4.3.252,0,678,2,83,252,335,252,0,335,423,-252,252,410,4,1,130,514,258,514,17,1589,861
1656,16,5.2.423,0,665,0,56,423,479,423,0,479,479,-145,290,303,3,5,158,106,247,239,17,1589,861
1656,17,0.3.278,0,704,3,91,278,369,278,0,369,423,-278,278,512,4,1,107,514,220,514,18,1589,811
1656,17,1.3.404,0,739,4,62,404,466,404,0,466,466,-404,404,638,4,1,126,514,312,514,18,1589,811
1656,17,2.3.147,0,667,1,94,147,241,147,0,241,423,-147,147,381,4,1,173,514,290,514,18,1589,811
1656,17,3.3.145,0,665,0,88,145,233,145,0,233,423,-145,145,379,4,1,117,514,262,514,18,1589,811
1656,17,4.3.252,0,678,2,83,252,335,252,0,335,423,-252,252,486,4,1,130,514,258,514,18,1589,811
1656,17,5.2.423,1,665,0,56,423,479,423,0,479,479,-19,240,253,3,6,158,56,247,239,18,1589,811
1656,18,0.3.278,0,704,4,91,278,369,278,0,369,479,-278,278,531,4,1,107,514,220,514,19,1589,755
1656,18,1.3.404,0,739,5,62,404,466,404,0,466,479,-404,404,657,4,1,126,514,312,514,19,1589,755
1656,18,2.3.147,1,667,1,94,147,241,147,0,241,479,-147,147,400,4,1,173,514,290,514,19,1589,755
1656,18,3.3.145,0,665,0,88,145,233,145,0,233,479,-145,145,398,4,1,117,514,262,514,19,1589,755
1656,18,4.3.252,0,678,2,83,252,335,252,0,335,479,-252,252,505,4,1,130,514,258,514,19,1589,755
1656,18,5.3.479,0,682,3,96,479,575,479,0,575,575,-479,479,732,4,1,102,514,247,514,19,1589,755
1656,19,0.3.278,0,704,3,91,278,369,278,0,369,479,-37,184,437,4,2,107,420,220,514,20,1589,661
1656,19,1.3.404,0,739,4,62,404,466,404,0,466,479,-163,310,563,4,2,126,420,312,514,20,1589,661
1656,19,2.4.241,1,667,0,79,241,320,241,0,320,479,-241,241,641,5,1,79,241,290,241,20,1589,661
1656,19,3.3.241,0,667,0,88,241,329,145,96,329,479,0,147,400,4,2,117,420,262,514,20,1589,661
1656,19,4.3.252,0,678,1,83,252,335,252,0,335,479,-11,158,411,4,2,130,420,258,514,20,1589,661
1656,19,5.3.479,0,682,2,96,479,575,479,0,575,575,-238,385,638,4,2,102,420,247,514,20,1589,661
1656,20,0.3.278,0,704,3,91,278,369,278,0,369,479,-37,184,678,4,2,107,420,220,514,21,1589,582
1656,20,1.3.404,0,739,4,62,404,466,404,0,466,479,-163,310,804,4,2,126,420,312,514,21,1589,582
1656,20,3.3.241,1,667,0,88,241,329,145,96,329,479,0,147,641,4,2,117,420,262,514,21,1589,582
1656,20,4.3.252,0,678,1,83,252,335,252,0,335,479,-11,158,652,4,2,130,420,258,514,21,1589,582
1656,20,5.3.479,0,682,2,96,479,575,479,0,575,575,-238,385,879,4,2,102,420,247,514,21,1589,582
1656,21,0.3.329,0,667,0,91,329,420,278,51,420,479,0,147,641,4,3,107,332,220,514,22,1589,494
1656,21,1.3.404,0,742,2,62,404,466,404,0,466,479,-75,222,716,4,3,126,332,312,514,22,1589,494
1656,21,3.4.329,1,667,0,29,329,358,329,0,358,479,-9,250,650,5,2,29,162,262,241,22,1589,494
1656,21,4.3.329,0,667,0,83,329,412,252,77,412,479,0,147,641,4,3,130,332,258,514,22,1589,494
1656,21,5.3.479,0,682,1,96,479,575,479,0,575,575,-150,297,791,4,3,102,332,247,514,22,1589,494
1656,22,0.3.329,0,667,0,91,329,420,278,51,420,479,0,147,650,4,3,107,332,220,514,23,1589,465
1656,22,1.3.404,0,742,2,62,404,466,404,0,466,479,-75,222,725,4,3,126,332,312,514,23,1589,465
1656,22,4.3.329,1,667,0,83,329,412,252,77,412,479,0,147,650,4,3,130,332,258,514,23,1589,465
1656,22,5.3.479,0,682,1,96,479,575,479,0,575,575,-150,297,800,4,3,102,332,247,514,23,1589,465
1656,23,0.3.412,0,667,0,91,412,503,278,134,503,503,0,147,650,4,4,107,249,220,514,24,1589,382
1656,23,1.3.412,0,667,0,62,412,474,404,8,474,479,0,147,650,4,4,126,249,312,514,24,1589,382
1656,23,4.4.412,1,667,0,47,412,459,412,0,459,479,-54,304,704,5,3,47,133,258,241,24,1589,382
1656,23,5.3.479,0,682,1,96,479,575,479,0,575,575,-67,214,717,4,4,102,249,247,514,24,1589,382
1656,24,0.3.412,0,667,0,91,412,503,278,134,503,503,0,147,704,4,4,107,249,220,514,25,1589,335
1656,24,1.3.412,1,667,0,62,412,474,404,8,474,479,0,147,704,4,4,126,249,312,514,25,1589,335
1656,24,5.3.479,0,682,1,96,479,575,479,0,575,575,-67,214,771,4,4,102,249,247,514,25,1589,335
1656,25,0.3.474,0,667,0,91,474,565,278,196,565,565,0,147,704,4,5,107,187,220,514,26,1589,273
1656,25,1.4.474,1,667,0,64,474,538,474,0,538,538,-15,319,719,5,4,64,86,312,241,26,1589,273
1656,25,5.3.479,0,682,1,96,479,575,479,0,575,575,-5,152,709,4,5,102,187,247,514,26,1589,273
1656,26,0.3.474,1,667,0,91,474,565,278,196,565,565,0,147,719,4,5,107,187,220,514,27,1589,209
1656,26,5.3.479,0,682,1,96,479,575,479,0,575,575,-5,152,724,4,5,102,187,247,514,27,1589,209
1656,27,0.4.565,1,667,0,16,565,581,565,0,581,581,-27,346,746,5,5,16,22,220,241,28,1589,118
1656,27,5.3.565,0,667,0,96,565,661,479,86,661,661,0,147,719,4,6,102,96,247,514,28,1589,118
1656,28,5.3.565,1,667,0,96,565,661,479,86,661,661,0,147,746,4,6,102,96,247,514,29,1589,102
1656,29,5.4.661,1,667,0,6,661,667,661,0,667,667,-80,426,826,5,6,6,6,247,241,30,1589,6
1657,0,0.0.0,0,689,5,79,0,79,0,0,79,79,0,0,0,1,1,362,299,362,299,1,1755,1755
1657,0,1.0.0,0,610,0,17,0,17,0,0,17,17,0,0,0,1,1,213,299,213,299,1,1755,1755
1657,0,2.0.0,0,682,4,72,0,72,0,0,72,72,0,0,0,1,1,317,299,317,299,1,1755,1755
1657,0,3.0.0,0,676,3,66,0,66,0,0,66,66,0,0,0,1,1,320,299,320,299,1,1755,1755
1657,0,4.0.0,0,645,2,40,0,40,0,0,40,40,0,0,0,1,1,196,299,196,299,1,1755,1755
1657,0,5.0.0,1,611,1,25,0,25,0,0,25,25,0,0,0,1,1,347,299,347,299,1,1755,1755
1657,1,0.0.25,0,621,3,79,25,104,0,25,104,104,0,0,0,1,2,362,274,362,299,2,1755,1730
1657,1,1.0.25,1,611,0,17,25,42,0,25,42,42,0,0,0,1,2,213,274,213,299,2,1755,1730
1657,1,2.0.25,0,620,2,72,25,97,0,25,97,97,0,0,0,1,2,317,274,317,299,2,1755,1730
1657,1,3.0.25,0,620,2,66,25,91,0,25,91,91,0,0,0,1,2,320,274,320,299,2,1755,1730
1657,1,4.0.25,0,616,1,40,25,65,0,25,65,65,0,0,0,1,2,196,274,196,299,2,1755,1730
1657,1,5.1.25,0,611,0,52,25,77,25,0,77,77,-25,25,25,2,1,322,413,347,413,2,1755,1730
1657,2,0.0.42,1,611,0,79,42,121,0,42,121,121,0,0,0,1,3,362,257,362,299,3,1755,1713
1657,2,1.1.42,0,635,2,63,42,105,42,0,105,105,-42,42,42,2,1,196,413,213,413,3,1755,1713
1657,2,2.0.42,0,611,0,72,42,114,0,42,114,114,0,0,0,1,3,317,257,317,299,3,1755,1713
1657,2,3.0.42,0,611,0,66,42,108,0,42,108,108,0,0,0,1,3,320,257,320,299,3,1755,1713
1657,2,4.0.42,0,616,1,40,42,82,0,42,82,82,0,0,0,1,3,196,257,196,299,3,1755,1713
1657,2,5.1.25,0,611,0,52,25,77,25,0,77,77,-25,25,25,2,1,322,413,347,413,3,1755,1713
1657,3,0.1.121,0,632,1,96,121,217,121,0,217,217,-121,121,121,2,1,283,413,362,413,4,1755,1634
1657,3,1.1.42,0,635,2,63,42,105,42,0,105,121,-42,42,42,2,1,196,413,213,413,4,1755,1634
1657,3,2.0.121,0,611,0,72,121,193,0,121,193,193,0,0,0,1,4,317,178,317,299,4,1755,1634
1657,3,3.0.121,1,611,0,66,121,187,0,121,187,187,0,0,0,1,4,320,178,320,299,4,1755,1634
1657,3,4.0.121,0,611,0,40,121,161,0,121,161,161,0,0,0,1,4,196,178,196,299,4,1755,1634
1657,3,5.1.25,0,611,0,52,25,77,25,0,77,121,-25,25,25,2,1,322,413,347,413,4,1755,1634
1657,4,0.1.121,0,632,1,96,121,217,121,0,217,217,-121,121,121,2,1,283,413,362,413,5,1755,1568
1657,4,1.1.42,0,635,2,63,42,105,42,0,105,187,-42,42,42,2,1,196,413,213,413,5,1755,1568
1657,4,2.0.187,1,611,0,72,187,259,0,187,259,259,0,0,0,1,5,317,112,317,299,5,1755,1568
1657,4,3.1.187,0,656,3,80,187,267,187,0,267,267,-187,187,187,2,1,254,413,320,413,5,1755,1568
1657,4,4.0.187,0,611,0,40,187,227,0,187,227,227,0,0,0,1,5,196,112,196,299,5,1755,1568
1657,4,5.1.25,0,611,0,52,25,77,25,0,77,187,-25,25,25,2,1,322,413,347,413,5,1755,1568
1657,5,0.1.121,0,632,2,96,121,217,121,0,217,259,-121,121,121,2,1,283,413,362,413,6,1755,1496
1657,5,1.1.42,0,635,3,63,42,105,42,0,105,259,-42,42,42,2,1,196,413,213,413,6,1755,1496
1657,5,2.1.259,0,618,1,82,259,341,259,0,341,341,-259,259,259,2,1,245,413,317,413,6,1755,1496
1657,5,3.1.187,0,656,4,80,187,267,187,0,267,267,-187,187,187,2,1,254,413,320,413,6,1755,1496
1657,5,4.0.259,1,611,0,40,259,299,0,259,299,299,0,0,0,1,6,196,40,196,299,6,1755,1496
1657,5,5.1.25,0,611,0,52,25,77,25,0,77,259,-25,25,25,2,1,322,413,347,413,6,1755,1496
1657,6,0.1.121,0,632,2,96,121,217,121,0,217,299,-121,121,121,2,1,283,413,362,413,7,1755,1456
1657,6,1.1.42,0,635,3,63,42,105,42,0,105,299,-42,42,42,2,1,196,413,213,413,7,1755,1456
1657,6,2.1.259,0,618,1,82,259,341,259,0,341,341,-259,259,259,2,1,245,413,317,413,7,1755,1456
1657,6,3.1.187,0,656,5,80,187,267,187,0,267,299,-187,187,187,2,1,254,413,320,413,7,1755,1456
1657,6,4.1.299,0,647,4,40,299,339,299,0,339,339,-299,299,299,2,1,156,413,196,413,7,1755,1456
1657,6,5.1.25,1,611,0,52,25,77,25,0,77,299,-25,25,25,2,1,322,413,347,413,7,1755,1456
1657,7,0.1.121,0,632,2,96,121,217,121,0,217,299,-44,69,69,2,2,283,361,362,413,8,1755,1404
1657,7,1.1.77,0,611,0,63,77,140,42,35,140,299,0,25,25,2,2,196,361,213,413,8,1755,1404
1657,7,2.1.259,0,618,1,82,259,341,259,0,341,341,-182,207,207,2,2,245,361,317,413,8,1755,1404
1657,7,3.1.187,0,656,4,80,187,267,187,0,267,299,-110,135,135,2,2,254,361,320,413,8,1755,1404
1657,7,4.1.299,0,647,3,40,299,339,299,0,339,339,-222,247,247,2,2,156,361,196,413,8,1755,1404
1657,7,5.2.77,1,611,0,93,77,170,77,0,170,299,-77,77,102,3,1,270,306,347,306,8,1755,1404
1657,8,0.1.121,0,632,3,96,121,217,121,0,217,299,-44,69,146,2,2,283,361,362,413,9,1755,1311
1657,8,1.1.77,0,611,0,63,77,140,42,35,140,299,0,25,102,2,2,196,361,213,413,9,1755,1311
1657,8,2.1.259,0,618,1,82,259,341,259,0,341,341,-182,207,284,2,2,245,361,317,413,9,1755,1311
1657,8,3.1.187,0,656,5,80,187,267,187,0,267,299,-110,135,212,2,2,254,361,320,413,9,1755,1311
1657,8,4.1.299,0,647,4,40,299,339,299,0,339,339,-222,247,324,2,2,156,361,196,413,9,1755,1311
1657,8,5.3.170,1,620,2,81,170,251,170,0,251,299,-170,170,272,4,1,177,368,347,368,9,1755,1311
1657,9,0.1.121,0,632,1,96,121,217,121,0,217,299,-44,69,316,2,2,283,361,362,413,10,1755,1230
1657,9,1.1.77,0,620,0,63,77,140,42,35,140,299,0,25,272,2,2,196,361,213,413,10,1755,1230
1657,9,2.1.259,0,620,0,82,259,341,259,0,341,341,-182,207,454,2,2,245,361,317,413,10,1755,1230
1657,9,3.1.187,0,656,3,80,187,267,187,0,267,299,-110,135,382,2,2,254,361,320,413,10,1755,1230
1657,9,4.1.299,0,647,2,40,299,339,299,0,339,339,-222,247,494,2,2,156,361,196,413,10,1755,1230
1657,9,5.4.251,1,620,0,96,251,347,251,0,347,347,-251,251,523,5,1,96,369,347,369,10,1755,1230
1657,10,0.1.121,0,632,1,96,121,217,121,0,217,347,-44,69,567,2,2,283,361,362,413,11,1755,1134
1657,10,1.1.77,1,620,0,63,77,140,42,35,140,347,0,25,523,2,2,196,361,213,413,11,1755,1134
1657,10,2.1.259,0,620,0,82,259,341,259,0,341,347,-182,207,705,2,2,245,361,317,413,11,1755,1134
1657,10,3.1.187,0,656,3,80,187,267,187,0,267,347,-110,135,633,2,2,254,361,320,413,11,1755,1134
1657,10,4.1.299,0,647,2,40,299,339,299,0,339,347,-222,247,745,2,2,156,361,196,413,11,1755,1134
1657,11,0.1.140,0,620,0,96,140,236,121,19,236,347,0,25,523,2,3,283,298,362,413,12,1755,1071
1657,11,1.2.170,1,620,0,56,170,226,140,30,226,347,0,77,523,3,2,133,213,213,306,12,1755,1071
1657,11,2.1.259,0,620,0,82,259,341,259,0,341,347,-119,144,642,2,3,245,298,317,413,12,1755,1071
1657,11,3.1.187,0,656,1,80,187,267,187,0,267,347,-47,72,570,2,3,254,298,320,413,12,1755,1071
1657,11,4.1.299,0,664,2,40,299,339,299,0,339,347,-159,184,682,2,3,156,298,196,413,12,1755,1071
1657,12,0.1.140,0,620,0,96,140,236,121,19,236,347,0,25,523,2,3,283,298,362,413,13,1755,1015
1657,12,1.3.251,1,620,0,4,251,255,226,25,255,347,0,170,523,4,2,77,287,213,368,13,1755,1015
1657,12,2.1.259,0,620,0,82,259,341,259,0,341,347,-119,144,642,2,3,245,298,317,413,13,1755,1015
1657,12,3.1.187,0,656,1,80,187,267,187,0,267,347,-47,72,570,2,3,254,298,320,413,13,1755,1015
1657,12,4.1.299,0,664,2,40,299,339,299,0,339,347,-159,184,682,2,3,156,298,196,413,13,1755,1015
1657,13,0.1.140,0,620,0,96,140,236,121,19,236,347,0,25,523,2,3,283,298,362,413,14,1755,1011
1657,13,1.4.347,1,620,0,73,347,420,255,92,420,420,0,251,523,5,2,73,273,213,369,14,1755,1011
1657,13,2.1.259,0,620,0,82,259,341,259,0,341,347,-119,144,642,2,3,245,298,317,413,14,1755,1011
1657,13,3.1.187,0,656,1,80,187,267,187,0,267,347,-47,72,570,2,3,254,298,320,413,14,1755,1011
1657,13,4.1.299,0,664,2,40,299,339,299,0,339,347,-159,184,682,2,3,156,298,196,413,14,1755,1011
1657,14,0.1.140,1,620,0,96,140,236,121,19,236,420,0,25,523,2,3,283,298,362,413,15,1755,938
1657,14,2.1.259,0,620,0,82,259,341,259,0,341,420,-119,144,642,2,3,245,298,317,413,15,1755,938
1657,14,3.1.187,0,656,1,80,187,267,187,0,267,420,-47,72,570,2,3,254,298,320,413,15,1755,938
1657,14,4.1.299,0,664,2,40,299,339,299,0,339,420,-159,184,682,2,3,156,298,196,413,15,1755,938
1657,15,0.2.236,1,620,0,22,236,258,236,0,258,420,-10,87,533,3,3,187,157,362,306,16,1755,842
1657,15,2.1.259,0,620,0,82,259,341,259,0,341,420,-23,48,546,2,4,245,202,317,413,16,1755,842
1657,15,3.1.236,0,620,0,80,236,316,187,49,316,420,0,25,523,2,4,254,202,320,413,16,1755,842
1657,15,4.1.299,0,664,1,40,299,339,299,0,339,420,-63,88,586,2,4,156,202,196,413,16,1755,842
1657,16,0.3.258,1,620,0,97,258,355,258,0,355,420,-3,173,536,4,3,165,283,362,368,17,1755,820
1657,16,2.1.259,0,620,0,82,259,341,259,0,341,420,-23,48,556,2,4,245,202,317,413,17,1755,820
1657,16,3.1.236,0,620,0,80,236,316,187,49,316,420,0,25,533,2,4,254,202,320,413,17,1755,820
1657,16,4.1.299,0,664,1,40,299,339,299,0,339,420,-63,88,596,2,4,156,202,196,413,17,1755,820
1657,17,0.4.420,1,620,0,68,420,488,355,65,488,488,0,251,536,5,3,68,200,362,369,18,1755,723
1657,17,2.1.259,0,620,0,82,259,341,259,0,341,420,-23,48,559,2,4,245,202,317,413,18,1755,723
1657,17,3.1.236,0,620,0,80,236,316,187,49,316,420,0,25,536,2,4,254,202,320,413,18,1755,723
1657,17,4.1.299,0,664,1,40,299,339,299,0,339,420,-63,88,599,2,4,156,202,196,413,18,1755,723
1657,18,2.1.259,0,620,0,82,259,341,259,0,341,488,-23,48,559,2,4,245,202,317,413,19,1755,655
1657,18,3.1.236,1,620,0,80,236,316,187,49,316,488,0,25,536,2,4,254,202,320,413,19,1755,655
1657,18,4.1.299,0,664,1,40,299,339,299,0,339,488,-63,88,599,2,4,156,202,196,413,19,1755,655
1657,19,2.1.316,0,620,0,82,316,398,259,57,398,488,0,25,536,2,5,245,122,317,413,20,1755,575
1657,19,3.2.316,1,620,0,57,316,373,316,0,373,488,-58,145,594,3,4,174,135,320,306,20,1755,575
1657,19,4.1.316,0,620,0,40,316,356,299,17,356,488,0,25,536,2,5,156,122,196,413,20,1755,575
1657,20,2.1.316,0,620,0,82,316,398,259,57,398,488,0,25,594,2,5,245,122,317,413,21,1755,518
1657,20,3.3.373,1,620,0,47,373,420,373,0,420,488,-18,191,612,4,4,117,186,320,368,21,1755,518
1657,20,4.1.316,0,620,0,40,316,356,299,17,356,488,0,25,594,2,5,156,122,196,413,21,1755,518
1657,21,2.1.316,0,620,0,82,316,398,259,57,398,488,0,25,612,2,5,245,122,317,413,22,1755,471
1657,21,3.4.488,1,620,0,70,488,558,420,68,558,558,0,251,612,5,4,70,132,320,369,22,1755,471
1657,21,4.1.316,0,620,0,40,316,356,299,17,356,488,0,25,612,2,5,156,122,196,413,22,1755,471
1657,22,2.1.316,1,620,0,82,316,398,259,57,398,558,0,25,612,2,5,245,122,317,413,23,1755,401
1657,22,4.1.316,0,620,0,40,316,356,299,17,356,558,0,25,612,2,5,156,122,196,413,23,1755,401
1657,23,2.2.398,1,620,0,55,398,453,398,0,453,558,-25,170,637,3,5,163,78,317,306,24,1755,319
1657,23,4.1.398,0,620,0,40,398,438,299,99,438,558,0,25,612,2,6,156,40,196,413,24,1755,319
1657,24,2.3.453,0,620,0,63,453,516,453,0,516,558,-33,224,670,4,5,108,139,317,368,25,1755,264
1657,24,4.1.398,1,620,0,40,398,438,299,99,438,558,0,25,637,2,6,156,40,196,413,25,1755,264
1657,25,2.3.453,0,620,0,63,453,516,453,0,516,558,-33,224,670,4,5,108,139,317,368,26,1755,224
1657,25,4.2.453,1,620,0,23,453,476,438,15,476,558,0,170,637,3,6,116,23,196,306,26,1755,224
1657,26,2.3.453,1,620,0,63,453,516,453,0,516,558,-33,224,670,4,5,108,139,317,368,27,1755,201
1657,26,4.3.476,0,660,1,76,476,552,476,0,552,558,-56,247,693,4,5,93,139,196,368,27,1755,201
1657,27,2.4.558,1,620,0,45,558,603,516,42,603,603,0,251,670,5,5,45,62,317,369,28,1755,138
1657,27,4.3.516,0,620,0,76,516,592,476,40,592,592,0,224,670,4,6,93,76,196,368,28,1755,138
1657,28,4.3.516,1,620,0,76,516,592,476,40,592,603,0,224,670,4,6,93,76,196,368,29,1755,93
1657,29,4.4.603,1,620,0,17,603,620,592,11,620,620,0,251,670,5,6,17,17,196,369,30,1755,17
1658,0,0.0.0,0,567,5,92,0,92,0,0,92,92,0,0,0,1,1,209,312,209,312,1,1326,1326
1658,0,1.0.0,0,530,4,92,0,92,0,0,92,92,0,0,0,1,1,311,312,311,312,1,1326,1326
1658,0,2.0.0,0,506,2,18,0,18,0,0,18,18,0,0,0,1,1,144,312,144,312,1,1326,1326
1658,0,3.0.0,0,496,1,19,0,19,0,0,19,19,0,0,0,1,1,81,312,81,312,1,1326,1326
1658,0,4.0.0,0,524,3,62,0,62,0,0,62,62,0,0,0,1,1,333,312,333,312,1,1326,1326
1658,0,5.0.0,1,489,0,29,0,29,0,0,29,29,0,0,0,1,1,248,312,248,312,1,1326,1326
1658,1,0.0.29,0,561,4,92,29,121,0,29,121,121,0,0,0,1,2,209,283,209,312,2,1326,1297
1658,1,1.0.29,0,499,2,92,29,121,0,29,121,121,0,0,0,1,2,311,283,311,312,2,1326,1297
1658,1,2.0.29,0,506,3,18,29,47,0,29,47,47,0,0,0,1,2,144,283,144,312,2,1326,1297
1658,1,3.0.29,0,496,1,19,29,48,0,29,48,48,0,0,0,1,2,81,283,81,312,2,1326,1297
1658,1,4.0.29,0,489,0,62,29,91,0,29,91,91,0,0,0,1,2,333,283,333,312,2,1326,1297
1658,1,5.1.29,1,489,0,35,29,64,29,0,64,64,-29,29,29,2,1,219,315,248,315,2,1326,1297
1658,2,0.0.29,0,561,4,92,29,121,0,29,121,121,0,0,29,1,2,209,283,209,312,3,1326,1262
1658,2,1.0.29,0,499,2,92,29,121,0,29,121,121,0,0,29,1,2,311,283,311,312,3,1326,1262
1658,2,2.0.29,0,506,3,18,29,47,0,29,47,64,0,0,29,1,2,144,283,144,312,3,1326,1262
1658,2,3.0.29,0,496,1,19,29,48,0,29,48,64,0,0,29,1,2,81,283,81,312,3,1326,1262
1658,2,4.0.29,0,489,0,62,29,91,0,29,91,91,0,0,29,1,2,333,283,333,312,3,1326,1262
1658,2,5.2.64,1,489,0,32,64,96,64,0,96,96,-64,64,93,3,1,184,175,248,175,3,1326,1262
1658,3,0.0.29,0,561,4,92,29,121,0,29,121,121,0,0,93,1,2,209,283,209,312,4,1326,1230
1658,3,1.0.29,0,499,2,92,29,121,0,29,121,121,0,0,93,1,2,311,283,311,312,4,1326,1230
1658,3,2.0.29,0,506,3,18,29,47,0,29,47,96,0,0,93,1,2,144,283,144,312,4,1326,1230
1658,3,3.0.29,0,496,1,19,29,48,0,29,48,96,0,0,93,1,2,81,283,81,312,4,1326,1230
1658,3,4.0.29,0,489,0,62,29,91,0,29,91,96,0,0,93,1,2,333,283,333,312,4,1326,1230
1658,3,5.3.96,1,489,0,65,96,161,96,0,161,161,-96,96,189,4,1,152,223,248,223,4,1326,1230
1658,4,0.0.29,0,561,4,92,29,121,0,29,121,161,0,0,189,1,2,209,283,209,312,5,1326,1165
1658,4,1.0.29,0,499,2,92,29,121,0,29,121,161,0,0,189,1,2,311,283,311,312,5,1326,1165
1658,4,2.0.29,0,506,3,18,29,47,0,29,47,161,0,0,189,1,2,144,283,144,312,5,1326,1165
1658,4,3.0.29,0,496,1,19,29,48,0,29,48,161,0,0,189,1,2,81,283,81,312,5,1326,1165
1658,4,4.0.29,0,489,0,62,29,91,0,29,91,161,0,0,189,1,2,333,283,333,312,5,1326,1165
1658,4,5.4.161,1,489,0,87,161,248,161,0,248,248,-161,161,350,5,1,87,301,248,301,5,1326,1165
1658,5,0.0.29,0,561,4,92,29,121,0,29,121,248,0,0,350,1,2,209,283,209,312,6,1326,1078
1658,5,1.0.29,0,499,2,92,29,121,0,29,121,248,0,0,350,1,2,311,283,311,312,6,1326,1078
1658,5,2.0.29,0,506,3,18,29,47,0,29,47,248,0,0,350,1,2,144,283,144,312,6,1326,1078
1658,5,3.0.29,0,496,1,19,29,48,0,29,48,248,0,0,350,1,2,81,283,81,312,6,1326,1078
1658,5,4.0.29,1,489,0,62,29,91,0,29,91,248,0,0,350,1,2,333,283,333,312,6,1326,1078
1658,6,0.0.91,0,517,1,92,91,183,0,91,183,248,0,0,350,1,3,209,221,209,312,7,1326,1016
1658,6,1.0.91,0,489,0,92,91,183,0,91,183,248,0,0,350,1,3,311,221,311,312,7,1326,1016
1658,6,2.0.91,1,489,0,18,91,109,0,91,109,248,0,0,350,1,3,144,221,144,312,7,1326,1016
1658,6,3.0.91,0,489,0,19,91,110,0,91,110,248,0,0,350,1,3,81,221,81,312,7,1326,1016
1658,6,4.1.91,0,489,0,91,91,182,91,0,182,248,-27,56,377,2,2,271,280,333,315,7,1326,1016
1658,7,0.0.109,0,535,1,92,109,201,0,109,201,248,0,0,350,1,4,209,203,209,312,8,1326,998
1658,7,1.0.109,1,489,0,92,109,201,0,109,201,248,0,0,350,1,4,311,203,311,312,8,1326,998
1658,7,2.1.109,0,541,2,75,109,184,109,0,184,248,-45,74,395,2,2,126,280,144,315,8,1326,998
1658,7,3.0.109,0,489,0,19,109,128,0,109,128,248,0,0,350,1,4,81,203,81,312,8,1326,998
1658,7,4.1.91,0,489,0,91,91,182,91,0,182,248,-27,56,377,2,2,271,280,333,315,8,1326,998
1658,8,0.0.201,0,489,0,92,201,293,0,201,293,293,0,0,350,1,5,209,111,209,312,9,1326,906
1658,8,1.1.201,0,489,0,31,201,232,201,0,232,248,-137,166,487,2,2,219,280,311,315,9,1326,906
1658,8,2.1.109,0,541,1,75,109,184,109,0,184,248,-45,74,395,2,2,126,280,144,315,9,1326,906
1658,8,3.0.201,1,489,0,19,201,220,0,201,220,248,0,0,350,1,5,81,111,81,312,9,1326,906
1658,8,4.1.91,0,489,0,91,91,182,91,0,182,248,-27,56,377,2,2,271,280,333,315,9,1326,906
1658,9,0.0.220,1,489,0,92,220,312,0,220,312,312,0,0,350,1,6,209,92,209,312,10,1326,887
1658,9,1.1.201,0,489,0,31,201,232,201,0,232,248,-137,166,487,2,2,219,280,311,315,10,1326,887
1658,9,2.1.109,0,541,2,75,109,184,109,0,184,248,-45,74,395,2,2,126,280,144,315,10,1326,887
1658,9,3.1.220,0,491,1,19,220,239,220,0,239,248,-156,185,506,2,2,62,280,81,315,10,1326,887
1658,9,4.1.91,0,489,0,91,91,182,91,0,182,248,-27,56,377,2,2,271,280,333,315,10,1326,887
1658,10,0.1.312,0,489,0,64,312,376,312,0,376,376,-248,277,598,2,2,117,280,209,315,11,1326,795
1658,10,1.1.201,0,489,0,31,201,232,201,0,232,312,-137,166,487,2,2,219,280,311,315,11,1326,795
1658,10,2.1.109,0,541,2,75,109,184,109,0,184,312,-45,74,395,2,2,126,280,144,315,11,1326,795
1658,10,3.1.220,0,491,1,19,220,239,220,0,239,312,-156,185,506,2,2,62,280,81,315,11,1326,795
1658,10,4.1.91,1,489,0,91,91,182,91,0,182,312,-27,56,377,2,2,271,280,333,315,11,1326,795
1658,11,0.1.312,0,489,0,64,312,376,312,0,376,376,-130,186,507,2,3,117,189,209,315,12,1326,704
1658,11,1.1.201,0,489,0,31,201,232,201,0,232,312,-19,75,396,2,3,219,189,311,315,12,1326,704
1658,11,2.1.182,0,510,2,75,182,257,109,73,257,312,0,56,377,2,3,126,189,144,315,12,1326,704
1658,11,3.1.220,0,491,1,19,220,239,220,0,239,312,-38,94,415,2,3,62,189,81,315,12,1326,704
1658,11,4.2.182,1,489,0,24,182,206,182,0,206,312,-86,150,463,3,2,180,143,333,175,12,1326,704
1658,12,0.1.312,0,489,0,64,312,376,312,0,376,376,-130,186,593,2,3,117,189,209,315,13,1326,680
1658,12,1.1.201,0,489,0,31,201,232,201,0,232,312,-19,75,482,2,3,219,189,311,315,13,1326,680
1658,12,2.1.182,0,510,2,75,182,257,109,73,257,312,0,56,463,2,3,126,189,144,315,13,1326,680
1658,12,3.1.220,0,491,1,19,220,239,220,0,239,312,-38,94,501,2,3,62,189,81,315,13,1326,680
1658,12,4.3.206,1,489,0,69,206,275,206,0,275,312,-45,141,508,4,2,156,158,333,223,13,1326,680
1658,13,0.1.312,0,489,0,64,312,376,312,0,376,376,-130,186,638,2,3,117,189,209,315,14,1326,611
1658,13,1.1.201,0,489,0,31,201,232,201,0,232,312,-19,75,527,2,3,219,189,311,315,14,1326,611
1658,13,2.1.182,0,510,2,75,182,257,109,73,257,312,0,56,508,2,3,126,189,144,315,14,1326,611
1658,13,3.1.220,0,491,1,19,220,239,220,0,239,312,-38,94,546,2,3,62,189,81,315,14,1326,611
1658,13,4.4.275,1,489,0,87,275,362,275,0,362,362,-27,188,535,5,2,87,214,333,301,14,1326,611
1658,14,0.1.312,0,489,0,64,312,376,312,0,376,376,-130,186,665,2,3,117,189,209,315,15,1326,524
1658,14,1.1.201,1,489,0,31,201,232,201,0,232,362,-19,75,554,2,3,219,189,311,315,15,1326,524
1658,14,2.1.182,0,510,2,75,182,257,109,73,257,362,0,56,535,2,3,126,189,144,315,15,1326,524
1658,14,3.1.220,0,491,1,19,220,239,220,0,239,362,-38,94,573,2,3,62,189,81,315,15,1326,524
1658,15,0.1.312,0,489,0,64,312,376,312,0,376,376,-80,155,634,2,4,117,158,209,315,16,1326,493
1658,15,1.2.232,1,489,0,61,232,293,232,0,293,362,-26,176,580,3,3,188,119,311,175,16,1326,493
1658,15,2.1.232,0,489,0,75,232,307,109,123,307,362,0,75,554,2,4,126,158,144,315,16,1326,493
1658,15,3.1.232,0,489,0,19,232,251,220,12,251,362,0,75,554,2,4,62,158,81,315,16,1326,493
1658,16,0.1.312,0,489,0,64,312,376,312,0,376,376,-80,155,660,2,4,117,158,209,315,17,1326,432
1658,16,1.3.293,1,489,0,45,293,338,293,0,338,362,-18,159,598,4,3,127,89,311,223,17,1326,432
1658,16,2.1.232,0,489,0,75,232,307,109,123,307,362,0,75,580,2,4,126,158,144,315,17,1326,432
1658,16,3.1.232,0,489,0,19,232,251,220,12,251,362,0,75,580,2,4,62,158,81,315,17,1326,432
1658,17,0.1.312,0,489,0,64,312,376,312,0,376,376,-80,155,678,2,4,117,158,209,315,18,1326,387
1658,17,1.4.362,1,489,0,82,362,444,338,24,444,444,0,188,598,5,3,82,127,311,301,18,1326,387
1658,17,2.1.232,0,489,0,75,232,307,109,123,307,362,0,75,598,2,4,126,158,144,315,18,1326,387
1658,17,3.1.232,0,489,0,19,232,251,220,12,251,362,0,75,598,2,4,62,158,81,315,18,1326,387
1658,18,0.1.312,0,489,0,64,312,376,312,0,376,444,-80,155,678,2,4,117,158,209,315,19,1326,305
1658,18,2.1.232,1,489,0,75,232,307,109,123,307,444,0,75,598,2,4,126,158,144,315,19,1326,305
1658,18,3.1.232,0,489,0,19,232,251,220,12,251,444,0,75,598,2,4,62,158,81,315,19,1326,305
1658,19,0.1.312,0,489,0,64,312,376,312,0,376,444,-5,80,603,2,5,117,83,209,315,20,1326,230
1658,19,2.2.307,1,489,0,8,307,315,307,0,315,444,-14,190,612,3,4,51,58,144,175,20,1326,230
1658,19,3.1.307,0,489,0,19,307,326,220,87,326,444,0,75,598,2,5,62,83,81,315,20,1326,230
1658,20,0.1.312,0,489,0,64,312,376,312,0,376,444,-5,80,617,2,5,117,83,209,315,21,1326,222
1658,20,2.3.338,1,489,0,32,338,370,315,23,370,444,0,159,612,4,4,43,44,144,223,21,1326,222
1658,20,3.1.307,0,489,0,19,307,326,220,87,326,444,0,75,612,2,5,62,83,81,315,21,1326,222
1658,21,0.1.312,0,489,0,64,312,376,312,0,376,444,-5,80,617,2,5,117,83,209,315,22,1326,190
1658,21,2.4.444,1,489,0,11,444,455,370,74,455,455,0,188,612,5,4,11,45,144,301,22,1326,190
1658,21,3.1.307,0,489,0,19,307,326,220,87,326,444,0,75,612,2,5,62,83,81,315,22,1326,190
1658,22,0.1.312,0,489,0,64,312,376,312,0,376,455,-5,80,617,2,5,117,83,209,315,23,1326,179
1658,22,3.1.307,1,489,0,19,307,326,220,87,326,455,0,75,612,2,5,62,83,81,315,23,1326,179
1658,23,0.1.326,0,489,0,64,326,390,312,14,390,455,0,75,612,2,6,117,64,209,315,24,1326,160
1658,23,3.2.326,1,489,0,24,326,350,326,0,350,455,-11,201,623,3,5,43,50,81,175,24,1326,160
1658,24,0.1.326,0,489,0,64,326,390,312,14,390,455,0,75,623,2,6,117,64,209,315,25,1326,136
1658,24,3.3.370,1,489,0,7,370,377,350,20,377,455,0,159,623,4,5,19,12,81,223,25,1326,136
1658,25,0.1.326,0,489,0,64,326,390,312,14,390,455,0,75,623,2,6,117,64,209,315,26,1326,129
1658,25,3.4.455,1,489,0,12,455,467,377,78,467,467,0,188,623,5,5,12,34,81,301,26,1326,129
1658,26,0.1.326,1,489,0,64,326,390,312,14,390,467,0,75,623,2,6,117,64,209,315,27,1326,117
1658,27,0.2.390,1,489,0,26,390,416,390,0,416,467,-40,241,663,3,6,53,26,209,175,28,1326,53
1658,28,0.3.416,1,489,0,5,416,421,416,0,421,467,-39,198,702,4,6,27,5,209,223,29,1326,27
1658,29,0.4.467,1,489,0,22,467,489,421,46,489,489,0,188,702,5,6,22,22,209,301,30,1326,22
1659,0,0.0.0,0,625,0,6,0,6,0,0,6,6,0,0,0,1,1,153,328,153,328,1,1693,1693
1659,0,1.0.0,1,644,1,68,0,68,0,0,68,68,0,0,0,1,1,411,328,411,328,1,1693,1693
1659,0,2.0.0,0,645,2,64,0,64,0,0,64,64,0,0,0,1,1,270,328,270,328,1,1693,1693
1659,0,3.0.0,0,659,4,72,0,72,0,0,72,72,0,0,0,1,1,338,328,338,328,1,1693,1693
1659,0,4.0.0,0,652,3,84,0,84,0,0,84,84,0,0,0,1,1,270,328,270,328,1,1693,1693
1659,0,5.0.0,0,625,0,34,0,34,0,0,34,34,0,0,0,1,1,251,328,251,328,1,1693,1693
1659,1,0.0.68,0,644,0,6,68,74,0,68,74,74,0,0,0,1,2,153,260,153,328,2,1693,1625
1659,1,1.1.68,0,693,3,99,68,167,68,0,167,167,-68,68,68,2,1,343,319,411,319,2,1693,1625
1659,1,2.0.68,0,691,2,64,68,132,0,68,132,132,0,0,0,1,2,270,260,270,328,2,1693,1625
1659,1,3.0.68,0,703,4,72,68,140,0,68,140,140,0,0,0,1,2,338,260,338,328,2,1693,1625
1659,1,4.0.68,0,693,3,84,68,152,0,68,152,152,0,0,0,1,2,270,260,270,328,2,1693,1625
1659,1,5.0.68,1,670,1,34,68,102,0,68,102,102,0,0,0,1,2,251,260,251,328,2,1693,1625
1659,2,0.0.102,1,670,0,6,102,108,0,102,108,108,0,0,0,1,3,153,226,153,328,3,1693,1591
1659,2,1.1.68,0,693,3,99,68,167,68,0,167,167,-68,68,68,2,1,343,319,411,319,3,1693,1591
1659,2,2.0.102,0,678,2,64,102,166,0,102,166,166,0,0,0,1,3,270,226,270,328,3,1693,1591
1659,2,3.0.102,0,678,2,72,102,174,0,102,174,174,0,0,0,1,3,338,226,338,328,3,1693,1591
1659,2,4.0.102,0,677,1,84,102,186,0,102,186,186,0,0,0,1,3,270,226,270,328,3,1693,1591
1659,2,5.1.102,0,670,0,19,102,121,102,0,121,121,-102,102,102,2,1,217,319,251,319,3,1693,1591
1659,3,0.1.108,0,676,2,32,108,140,108,0,140,140,-108,108,108,2,1,147,319,153,319,4,1693,1585
1659,3,1.1.68,0,693,3,99,68,167,68,0,167,167,-68,68,68,2,1,343,319,411,319,4,1693,1585
1659,3,2.0.108,0,670,0,64,108,172,0,108,172,172,0,0,0,1,4,270,220,270,328,4,1693,1585
1659,3,3.0.108,1,670,0,72,108,180,0,108,180,180,0,0,0,1,4,338,220,338,328,4,1693,1585
1659,3,4.0.108,0,674,1,84,108,192,0,108,192,192,0,0,0,1,4,270,220,270,328,4,1693,1585
1659,3,5.1.102,0,670,0,19,102,121,102,0,121,121,-102,102,102,2,1,217,319,251,319,4,1693,1585
1659,4,0.1.108,0,676,1,32,108,140,108,0,140,180,-108,108,108,2,1,147,319,153,319,5,1693,1513
1659,4,1.1.68,0,703,4,99,68,167,68,0,167,180,-68,68,68,2,1,343,319,411,319,5,1693,1513
1659,4,2.0.180,1,670,0,64,180,244,0,180,244,244,0,0,0,1,5,270,148,270,328,5,1693,1513
1659,4,3.1.180,0,701,3,57,180,237,180,0,237,237,-180,180,180,2,1,266,319,338,319,5,1693,1513
1659,4,4.0.180,0,682,2,84,180,264,0,180,264,264,0,0,0,1,5,270,148,270,328,5,1693,1513
1659,4,5.1.102,0,670,0,19,102,121,102,0,121,180,-102,102,102,2,1,217,319,251,319,5,1693,1513
1659,5,0.1.108,0,676,1,32,108,140,108,0,140,244,-108,108,108,2,1,147,319,153,319,6,1693,1449
1659,5,1.1.68,0,703,3,99,68,167,68,0,167,244,-68,68,68,2,1,343,319,411,319,6,1693,1449
1659,5,2.1.244,0,703,3,69,244,313,244,0,313,313,-244,244,244,2,1,206,319,270,319,6,1693,1449
1659,5,3.1.180,0,701,2,57,180,237,180,0,237,244,-180,180,180,2,1,266,319,338,319,6,1693,1449
1659,5,4.0.244,1,670,0,84,244,328,0,244,328,328,0,0,0,1,6,270,84,270,328,6,1693,1449
1659,5,5.1.102,0,670,0,19,102,121,102,0,121,244,-102,102,102,2,1,217,319,251,319,6,1693,1449
1659,6,0.1.108,0,676,1,32,108,140,108,0,140,328,-108,108,108,2,1,147,319,153,319,7,1693,1365
1659,6,1.1.68,1,703,3,99,68,167,68,0,167,328,-68,68,68,2,1,343,319,411,319,7,1693,1365
1659,6,2.1.244,0,703,3,69,244,313,244,0,313,328,-244,244,244,2,1,206,319,270,319,7,1693,1365
1659,6,3.1.180,0,701,2,57,180,237,180,0,237,328,-180,180,180,2,1,266,319,338,319,7,1693,1365
1659,6,4.1.328,0,670,0,43,328,371,328,0,371,371,-328,328,328,2,1,186,319,270,319,7,1693,1365
1659,6,5.1.102,0,670,0,19,102,121,102,0,121,328,-102,102,102,2,1,217,319,251,319,7,1693,1365
1659,7,0.1.167,0,703,0,32,167,199,108,59,199,328,0,68,68,2,2,147,220,153,319,8,1693,1266
1659,7,1.2.167,0,716,1,66,167,233,167,0,233,328,-167,167,235,3,1,244,340,411,340,8,1693,1266
1659,7,2.1.244,0,703,0,69,244,313,244,0,313,328,-77,145,145,2,2,206,220,270,319,8,1693,1266
1659,7,3.1.180,0,749,2,57,180,237,180,0,237,328,-13,81,81,2,2,266,220,338,319,8,1693,1266
1659,7,4.1.328,0,703,0,43,328,371,328,0,371,371,-161,229,229,2,2,186,220,270,319,8,1693,1266
1659,7,5.1.167,1,716,1,19,167,186,102,65,186,328,0,68,68,2,2,217,220,251,319,8,1693,1266
1659,8,0.1.186,0,716,0,32,186,218,108,78,218,328,0,68,68,2,3,147,201,153,319,9,1693,1247
1659,8,1.2.167,0,716,0,66,167,233,167,0,233,328,-167,167,235,3,1,244,340,411,340,9,1693,1247
1659,8,2.1.244,0,716,0,69,244,313,244,0,313,328,-58,126,126,2,3,206,201,270,319,9,1693,1247
1659,8,3.1.186,1,735,2,57,186,243,180,6,243,328,0,68,68,2,3,266,201,338,319,9,1693,1247
1659,8,4.1.328,0,716,0,43,328,371,328,0,371,371,-142,210,210,2,3,186,201,270,319,9,1693,1247
1659,8,5.2.186,0,726,1,70,186,256,186,0,256,328,-186,186,254,3,1,198,340,251,340,9,1693,1247
1659,9,0.1.243,1,735,0,32,243,275,108,135,275,328,0,68,68,2,4,147,144,153,319,10,1693,1190
1659,9,1.2.167,0,749,1,66,167,233,167,0,233,328,-167,167,235,3,1,244,340,411,340,10,1693,1190
1659,9,2.1.244,0,735,0,69,244,313,244,0,313,328,-1,69,69,2,4,206,144,270,319,10,1693,1190
1659,9,3.2.243,0,749,1,91,243,334,243,0,334,334,-243,243,311,3,1,209,340,338,340,10,1693,1190
1659,9,4.1.328,0,735,0,43,328,371,328,0,371,371,-85,153,153,2,4,186,144,270,319,10,1693,1190
1659,9,5.2.186,0,735,0,70,186,256,186,0,256,328,-186,186,254,3,1,198,340,251,340,10,1693,1190
1659,10,0.2.275,0,735,0,29,275,304,275,0,304,328,-275,275,343,3,1,115,340,153,340,11,1693,1158
1659,10,1.2.167,0,749,1,66,167,233,167,0,233,328,-167,167,235,3,1,244,340,411,340,11,1693,1158
1659,10,2.1.275,1,735,0,69,275,344,244,31,344,344,0,68,68,2,5,206,112,270,319,11,1693,1158
1659,10,3.2.243,0,749,1,91,243,334,243,0,334,334,-243,243,311,3,1,209,340,338,340,11,1693,1158
1659,10,4.1.328,0,735,0,43,328,371,328,0,371,371,-53,121,121,2,5,186,112,270,319,11,1693,1158
1659,10,5.2.186,0,735,0,70,186,256,186,0,256,328,-186,186,254,3,1,198,340,251,340,11,1693,1158
1659,11,0.2.275,0,735,0,29,275,304,275,0,304,344,-275,275,343,3,1,115,340,153,340,12,1693,1089
1659,11,1.2.167,0,749,1,66,167,233,167,0,233,344,-167,167,235,3,1,244,340,411,340,12,1693,1089
1659,11,2.2.344,0,735,0,60,344,404,344,0,404,404,-344,344,412,3,1,137,340,270,340,12,1693,1089
1659,11,3.2.243,0,749,1,91,243,334,243,0,334,344,-243,243,311,3,1,209,340,338,340,12,1693,1089
1659,11,4.1.344,1,735,0,43,344,387,328,16,387,387,0,68,68,2,6,186,43,270,319,12,1693,1089
1659,11,5.2.186,0,735,0,70,186,256,186,0,256,344,-186,186,254,3,1,198,340,251,340,12,1693,1089
1659,12,0.2.275,0,735,0,29,275,304,275,0,304,387,-275,275,343,3,1,115,340,153,340,13,1693,1046
1659,12,1.2.167,1,749,1,66,167,233,167,0,233,387,-167,167,235,3,1,244,340,411,340,13,1693,1046
1659,12,2.2.344,0,735,0,60,344,404,344,0,404,404,-344,344,412,3,1,137,340,270,340,13,1693,1046
1659,12,3.2.243,0,749,1,91,243,334,243,0,334,387,-243,243,311,3,1,209,340,338,340,13,1693,1046
1659,12,4.2.387,0,735,0,24,387,411,387,0,411,411,-387,387,455,3,1,143,340,270,340,13,1693,1046
1659,12,5.2.186,0,735,0,70,186,256,186,0,256,387,-186,186,254,3,1,198,340,251,340,13,1693,1046
1659,13,0.2.275,0,749,0,29,275,304,275,0,304,387,-42,209,277,3,2,115,274,153,340,14,1693,980
1659,13,1.3.233,1,749,0,87,233,320,233,0,320,387,-233,233,468,4,1,178,277,411,277,14,1693,980
1659,13,2.2.344,0,749,0,60,344,404,344,0,404,404,-111,278,346,3,2,137,274,270,340,14,1693,980
1659,13,3.2.243,0,749,0,91,243,334,243,0,334,387,-10,177,245,3,2,209,274,338,340,14,1693,980
1659,13,4.2.387,0,749,0,24,387,411,387,0,411,411,-154,321,389,3,2,143,274,270,340,14,1693,980
1659,13,5.2.233,0,749,0,70,233,303,186,47,303,387,0,167,235,3,2,198,274,251,340,14,1693,980
1659,14,0.2.275,0,749,0,29,275,304,275,0,304,387,-42,209,510,3,2,115,274,153,340,15,1693,893
1659,14,1.4.320,0,749,0,91,320,411,320,0,411,411,-320,320,788,5,1,91,429,411,429,15,1693,893
1659,14,2.2.344,0,749,0,60,344,404,344,0,404,404,-111,278,579,3,2,137,274,270,340,15,1693,893
1659,14,3.2.243,0,749,0,91,243,334,243,0,334,387,-10,177,478,3,2,209,274,338,340,15,1693,893
1659,14,4.2.387,0,749,0,24,387,411,387,0,411,411,-154,321,622,3,2,143,274,270,340,15,1693,893
1659,14,5.2.233,1,749,0,70,233,303,186,47,303,387,0,167,468,3,2,198,274,251,340,15,1693,893
1659,15,0.2.303,0,749,0,29,303,332,275,28,332,387,0,167,468,3,3,115,204,153,340,16,1693,823
1659,15,1.4.320,0,749,0,91,320,411,320,0,411,411,-320,320,788,5,1,91,429,411,429,16,1693,823
1659,15,2.2.344,0,749,0,60,344,404,344,0,404,404,-41,208,509,3,3,137,204,270,340,16,1693,823
1659,15,3.2.303,0,749,0,91,303,394,243,60,394,394,0,167,468,3,3,209,204,338,340,16,1693,823
1659,15,4.2.387,0,749,0,24,387,411,387,0,411,411,-84,251,552,3,3,143,204,270,340,16,1693,823
1659,15,5.3.320,1,749,0,50,320,370,303,17,370,387,0,233,468,4,2,128,190,251,277,16,1693,823
1659,16,0.2.303,0,749,0,29,303,332,275,28,332,387,0,167,468,3,3,115,204,153,340,17,1693,773
1659,16,1.4.320,0,749,0,91,320,411,320,0,411,411,-320,320,788,5,1,91,429,411,429,17,1693,773
1659,16,2.2.344,0,749,0,60,344,404,344,0,404,404,-41,208,509,3,3,137,204,270,340,17,1693,773
1659,16,3.2.303,1,749,0,91,303,394,243,60,394,394,0,167,468,3,3,209,204,338,340,17,1693,773
1659,16,4.2.387,0,749,0,24,387,411,387,0,411,411,-84,251,552,3,3,143,204,270,340,17,1693,773
1659,16,5.4.370,0,799,1,78,370,448,370,0,448,448,-370,370,838,5,1,78,429,251,429,17,1693,773
1659,17,0.2.394,0,749,0,29,394,423,275,119,423,423,0,167,468,3,4,115,113,153,340,18,1693,682
1659,17,1.4.320,0,749,0,91,320,411,320,0,411,411,-320,320,788,5,1,91,429,411,429,18,1693,682
1659,17,2.2.394,0,749,0,60,394,454,344,50,454,454,0,167,468,3,4,137,113,270,340,18,1693,682
1659,17,3.3.394,1,749,0,65,394,459,394,0,459,459,-24,257,492,4,3,118,140,338,277,18,1693,682
1659,17,4.2.394,0,749,0,24,394,418,387,7,418,418,0,167,468,3,4,143,113,270,340,18,1693,682
1659,17,5.4.370,0,799,1,78,370,448,370,0,448,448,-370,370,838,5,1,78,429,251,429,18,1693,682
1659,18,0.2.394,1,749,0,29,394,423,275,119,423,459,0,167,492,3,4,115,113,153,340,19,1693,617
1659,18,1.4.320,0,749,0,91,320,411,320,0,411,459,-320,320,812,5,1,91,429,411,429,19,1693,617
1659,18,2.2.394,0,749,0,60,394,454,344,50,454,459,0,167,492,3,4,137,113,270,340,19,1693,617
1659,18,3.4.459,0,797,1,53,459,512,459,0,512,512,-459,459,951,5,1,53,429,338,429,19,1693,617
1659,18,4.2.394,0,749,0,24,394,418,387,7,418,459,0,167,492,3,4,143,113,270,340,19,1693,617
1659,18,5.4.370,0,799,2,78,370,448,370,0,448,459,-370,370,862,5,1,78,429,251,429,19,1693,617
1659,19,0.3.459,1,749,0,12,459,471,423,36,471,471,0,257,492,4,4,86,75,153,277,20,1693,588
1659,19,1.4.320,0,749,0,91,320,411,320,0,411,459,-320,320,812,5,1,91,429,411,429,20,1693,588
1659,19,2.2.423,0,749,0,60,423,483,344,79,483,483,0,167,492,3,5,137,84,270,340,20,1693,588
1659,19,3.4.459,0,797,1,53,459,512,459,0,512,512,-459,459,951,5,1,53,429,338,429,20,1693,588
1659,19,4.2.423,0,749,0,24,423,447,387,36,447,459,0,167,492,3,5,143,84,270,340,20,1693,588
1659,19,5.4.370,0,799,2,78,370,448,370,0,448,459,-370,370,862,5,1,78,429,251,429,20,1693,588
1659,20,0.4.471,0,809,3,74,471,545,471,0,545,545,-471,471,963,5,1,74,429,153,429,21,1693,576
1659,20,1.4.320,0,749,0,91,320,411,320,0,411,471,-320,320,812,5,1,91,429,411,429,21,1693,576
1659,20,2.2.423,0,749,0,60,423,483,344,79,483,483,0,167,492,3,5,137,84,270,340,21,1693,576
1659,20,3.4.459,0,797,1,53,459,512,459,0,512,512,-459,459,951,5,1,53,429,338,429,21,1693,576
1659,20,4.2.423,1,749,0,24,423,447,387,36,447,471,0,167,492,3,5,143,84,270,340,21,1693,576
1659,20,5.4.370,0,799,2,78,370,448,370,0,448,471,-370,370,862,5,1,78,429,251,429,21,1693,576
1659,21,0.4.471,0,809,3,74,471,545,471,0,545,545,-471,471,963,5,1,74,429,153,429,22,1693,552
1659,21,1.4.320,0,749,0,91,320,411,320,0,411,471,-320,320,812,5,1,91,429,411,429,22,1693,552
1659,21,2.2.447,0,749,0,60,447,507,344,103,507,507,0,167,492,3,6,137,60,270,340,22,1693,552
1659,21,3.4.459,0,797,1,53,459,512,459,0,512,512,-459,459,951,5,1,53,429,338,429,22,1693,552
1659,21,4.3.471,1,749,0,62,471,533,447,24,533,533,0,257,492,4,5,119,63,270,277,22,1693,552
1659,21,5.4.370,0,799,2,78,370,448,370,0,448,471,-370,370,862,5,1,78,429,251,429,22,1693,552
1659,22,0.4.471,0,809,4,74,471,545,471,0,545,545,-471,471,963,5,1,74,429,153,429,23,1693,490
1659,22,1.4.320,0,749,0,91,320,411,320,0,411,533,-320,320,812,5,1,91,429,411,429,23,1693,490
1659,22,2.2.447,1,749,0,60,447,507,344,103,507,533,0,167,492,3,6,137,60,270,340,23,1693,490
1659,22,3.4.459,0,797,2,53,459,512,459,0,512,533,-459,459,951,5,1,53,429,338,429,23,1693,490
1659,22,4.4.533,0,793,1,57,533,590,533,0,590,590,-533,533,1025,5,1,57,429,270,429,23,1693,490
1659,22,5.4.370,0,799,3,78,370,448,370,0,448,533,-370,370,862,5,1,78,429,251,429,23,1693,490
1659,23,0.4.471,0,809,4,74,471,545,471,0,545,545,-471,471,963,5,1,74,429,153,429,24,1693,430
1659,23,1.4.320,0,749,0,91,320,411,320,0,411,533,-320,320,812,5,1,91,429,411,429,24,1693,430
1659,23,2.3.533,1,749,0,1,533,534,507,26,534,534,0,257,492,4,6,77,1,270,277,24,1693,430
1659,23,3.4.459,0,797,2,53,459,512,459,0,512,533,-459,459,951,5,1,53,429,338,429,24,1693,430
1659,23,4.4.533,0,793,1,57,533,590,533,0,590,590,-533,533,1025,5,1,57,429,270,429,24,1693,430
1659,23,5.4.370,0,799,3,78,370,448,370,0,448,533,-370,370,862,5,1,78,429,251,429,24,1693,430
1659,24,0.4.471,0,809,5,74,471,545,471,0,545,545,-471,471,963,5,1,74,429,153,429,25,1693,429
1659,24,1.4.320,1,749,0,91,320,411,320,0,411,534,-320,320,812,5,1,91,429,411,429,25,1693,429
1659,24,2.4.534,0,794,2,76,534,610,534,0,610,610,-534,534,1026,5,1,76,429,270,429,25,1693,429
1659,24,3.4.459,0,797,3,53,459,512,459,0,512,534,-459,459,951,5,1,53,429,338,429,25,1693,429
1659,24,4.4.533,0,793,1,57,533,590,533,0,590,590,-533,533,1025,5,1,57,429,270,429,25,1693,429
1659,24,5.4.370,0,799,4,78,370,448,370,0,448,534,-370,370,862,5,1,78,429,251,429,25,1693,429
1659,25,0.4.471,0,809,4,74,471,545,471,0,545,545,-60,380,872,5,2,74,338,153,429,26,1693,338
1659,25,2.4.534,0,794,2,76,534,610,534,0,610,610,-123,443,935,5,2,76,338,270,429,26,1693,338
1659,25,3.4.459,0,797,3,53,459,512,459,0,512,534,-48,368,860,5,2,53,338,338,429,26,1693,338
1659,25,4.4.533,0,793,1,57,533,590,533,0,590,590,-122,442,934,5,2,57,338,270,429,26,1693,338
1659,25,5.4.411,1,749,0,78,411,489,370,41,489,534,0,320,812,5,2,78,338,251,429,26,1693,338
1659,26,0.4.489,0,749,0,74,489,563,471,18,563,563,0,320,812,5,3,74,260,153,429,27,1693,260
1659,26,2.4.534,0,794,2,76,534,610,534,0,610,610,-45,365,857,5,3,76,260,270,429,27,1693,260
1659,26,3.4.489,1,749,0,53,489,542,459,30,542,542,0,320,812,5,3,53,260,338,429,27,1693,260
1659,26,4.4.533,0,793,1,57,533,590,533,0,590,590,-44,364,856,5,3,57,260,270,429,27,1693,260
1659,27,0.4.542,0,749,0,74,542,616,471,71,616,616,0,320,812,5,4,74,207,153,429,28,1693,207
1659,27,2.4.542,0,749,0,76,542,618,534,8,618,618,0,320,812,5,4,76,207,270,429,28,1693,207
1659,27,4.4.542,1,749,0,57,542,599,533,9,599,599,0,320,812,5,4,57,207,270,429,28,1693,207
1659,28,0.4.599,0,749,0,74,599,673,471,128,673,673,0,320,812,5,5,74,150,153,429,29,1693,150
1659,28,2.4.599,1,749,0,76,599,675,534,65,675,675,0,320,812,5,5,76,150,270,429,29,1693,150
1659,29,0.4.675,1,749,0,74,675,749,471,204,749,749,0,320,812,5,6,74,74,153,429,30,1693,74
1660,0,0.0.0,0,448,2,19,0,19,0,0,19,19,0,0,0,1,1,98,143,98,143,1,1167,1167
1660,0,1.0.0,0,473,5,43,0,43,0,0,43,43,0,0,0,1,1,212,143,212,143,1,1167,1167
1660,0,2.0.0,0,434,1,10,0,10,0,0,10,10,0,0,0,1,1,196,143,196,143,1,1167,1167
1660,0,3.0.0,1,450,3,26,0,26,0,0,26,26,0,0,0,1,1,298,143,298,143,1,1167,1167
1660,0,4.0.0,0,430,0,6,0,6,0,0,6,6,0,0,0,1,1,209,143,209,143,1,1167,1167
1660,0,5.0.0,0,467,4,39,0,39,0,0,39,39,0,0,0,1,1,154,143,154,143,1,1167,1167
1660,1,0.0.26,0,450,0,19,26,45,0,26,45,45,0,0,0,1,2,98,117,98,143,2,1167,1141
1660,1,1.0.26,0,450,0,43,26,69,0,26,69,69,0,0,0,1,2,212,117,212,143,2,1167,1141
1660,1,2.0.26,0,450,0,10,26,36,0,26,36,36,0,0,0,1,2,196,117,196,143,2,1167,1141
1660,1,3.1.26,0,450,0,95,26,121,26,0,121,121,-26,26,26,2,1,272,322,298,322,2,1167,1141
1660,1,4.0.26,1,450,0,6,26,32,0,26,32,32,0,0,0,1,2,209,117,209,143,2,1167,1141
1660,1,5.0.26,0,450,0,39,26,65,0,26,65,65,0,0,0,1,2,154,117,154,143,2,1167,1141
1660,2,0.0.32,0,450,0,19,32,51,0,32,51,51,0,0,0,1,3,98,111,98,143,3,1167,1135
1660,2,1.0.32,0,450,0,43,32,75,0,32,75,75,0,0,0,1,3,212,111,212,143,3,1167,1135
1660,2,2.0.32,1,450,0,10,32,42,0,32,42,42,0,0,0,1,3,196,111,196,143,3,1167,1135
1660,2,3.1.26,0,450,0,95,26,121,26,0,121,121,-26,26,26,2,1,272,322,298,322,3,1167,1135
1660,2,4.1.32,0,456,1,95,32,127,32,0,127,127,-32,32,32,2,1,203,322,209,322,3,1167,1135
1660,2,5.0.32,0,450,0,39,32,71,0,32,71,71,0,0,0,1,3,154,111,154,143,3,1167,1135
1660,3,0.0.42,0,450,0,19,42,61,0,42,61,61,0,0,0,1,4,98,101,98,143,4,1167,1125
1660,3,1.0.42,1,453,1,43,42,85,0,42,85,85,0,0,0,1,4,212,101,212,143,4,1167,1125
1660,3,2.1.42,0,466,3,62,42,104,42,0,104,104,-42,42,42,2,1,186,322,196,322,4,1167,1125
1660,3,3.1.26,0,450,0,95,26,121,26,0,121,121,-26,26,26,2,1,272,322,298,322,4,1167,1125
1660,3,4.1.32,0,456,2,95,32,127,32,0,127,127,-32,32,32,2,1,203,322,209,322,4,1167,1125
1660,3,5.0.42,0,450,0,39,42,81,0,42,81,81,0,0,0,1,4,154,101,154,143,4,1167,1125
1660,4,0.0.85,1,464,1,19,85,104,0,85,104,104,0,0,0,1,5,98,58,98,143,5,1167,1082
1660,4,1.1.85,0,515,3,67,85,152,85,0,152,152,-85,85,85,2,1,169,322,212,322,5,1167,1082
1660,4,2.1.42,0,466,2,62,42,104,42,0,104,104,-42,42,42,2,1,186,322,196,322,5,1167,1082
1660,4,3.1.26,0,453,0,95,26,121,26,0,121,121,-26,26,26,2,1,272,322,298,322,5,1167,1082
1660,4,4.1.32,0,466,2,95,32,127,32,0,127,127,-32,32,32,2,1,203,322,209,322,5,1167,1082
1660,4,5.0.85,0,453,0,39,85,124,0,85,124,124,0,0,0,1,5,154,58,154,143,5,1167,1082
1660,5,0.1.104,0,466,1,1,104,105,104,0,105,105,-104,104,104,2,1,79,322,98,322,6,1167,1063
1660,5,1.1.85,0,515,3,67,85,152,85,0,152,152,-85,85,85,2,1,169,322,212,322,6,1167,1063
1660,5,2.1.42,0,466,1,62,42,104,42,0,104,104,-42,42,42,2,1,186,322,196,322,6,1167,1063
1660,5,3.1.26,0,464,0,95,26,121,26,0,121,121,-26,26,26,2,1,272,322,298,322,6,1167,1063
1660,5,4.1.32,0,469,2,95,32,127,32,0,127,127,-32,32,32,2,1,203,322,209,322,6,1167,1063
1660,5,5.0.104,1,464,0,39,104,143,0,104,143,143,0,0,0,1,6,154,39,154,143,6,1167,1063
1660,6,0.1.104,0,466,1,1,104,105,104,0,105,143,-104,104,104,2,1,79,322,98,322,7,1167,1024
1660,6,1.1.85,0,515,4,67,85,152,85,0,152,152,-85,85,85,2,1,169,322,212,322,7,1167,1024
1660,6,2.1.42,0,466,1,62,42,104,42,0,104,143,-42,42,42,2,1,186,322,196,322,7,1167,1024
1660,6,3.1.26,1,464,0,95,26,121,26,0,121,143,-26,26,26,2,1,272,322,298,322,7,1167,1024
1660,6,4.1.32,0,469,2,95,32,127,32,0,127,143,-32,32,32,2,1,203,322,209,322,7,1167,1024
1660,6,5.1.143,0,471,3,2,143,145,143,0,145,145,-143,143,143,2,1,115,322,154,322,7,1167,1024
1660,7,0.1.121,0,464,0,1,121,122,104,17,122,143,0,26,26,2,2,79,227,98,322,8,1167,929
1660,7,1.1.121,0,464,0,67,121,188,85,36,188,188,0,26,26,2,2,169,227,212,322,8,1167,929
1660,7,2.1.121,0,464,0,62,121,183,42,79,183,183,0,26,26,2,2,186,227,196,322,8,1167,929
1660,7,3.2.121,1,464,0,58,121,179,121,0,179,179,-121,121,147,3,1,177,210,298,210,8,1167,929
1660,7,4.1.121,0,464,0,95,121,216,32,89,216,216,0,26,26,2,2,203,227,209,322,8,1167,929
1660,7,5.1.143,0,471,1,2,143,145,143,0,145,145,-22,48,48,2,2,115,227,154,322,8,1167,929
1660,8,0.1.121,0,464,0,1,121,122,104,17,122,179,0,26,147,2,2,79,227,98,322,9,1167,871
1660,8,1.1.121,0,464,0,67,121,188,85,36,188,188,0,26,147,2,2,169,227,212,322,9,1167,871
1660,8,2.1.121,0,464,0,62,121,183,42,79,183,183,0,26,147,2,2,186,227,196,322,9,1167,871
1660,8,3.3.179,1,464,0,24,179,203,179,0,203,203,-179,179,326,4,1,119,231,298,231,9,1167,871
1660,8,4.1.121,0,464,0,95,121,216,32,89,216,216,0,26,147,2,2,203,227,209,322,9,1167,871
1660,8,5.1.143,0,471,1,2,143,145,143,0,145,179,-22,48,169,2,2,115,227,154,322,9,1167,871
1660,9,0.1.121,0,464,0,1,121,122,104,17,122,203,0,26,326,2,2,79,227,98,322,10,1167,847
1660,9,1.1.121,0,464,0,67,121,188,85,36,188,203,0,26,326,2,2,169,227,212,322,10,1167,847
1660,9,2.1.121,0,464,0,62,121,183,42,79,183,203,0,26,326,2,2,186,227,196,322,10,1167,847
1660,9,3.4.203,1,464,0,95,203,298,203,0,298,298,-203,203,529,5,1,95,261,298,261,10,1167,847
1660,9,4.1.121,0,464,0,95,121,216,32,89,216,216,0,26,326,2,2,203,227,209,322,10,1167,847
1660,9,5.1.143,0,471,1,2,143,145,143,0,145,203,-22,48,348,2,2,115,227,154,322,10,1167,847
1660,10,0.1.121,0,464,0,1,121,122,104,17,122,298,0,26,529,2,2,79,227,98,322,11,1167,752
1660,10,1.1.121,0,464,0,67,121,188,85,36,188,298,0,26,529,2,2,169,227,212,322,11,1167,752
1660,10,2.1.121,1,464,0,62,121,183,42,79,183,298,0,26,529,2,2,186,227,196,322,11,1167,752
1660,10,4.1.121,0,464,0,95,121,216,32,89,216,298,0,26,529,2,2,203,227,209,322,11,1167,752
1660,10,5.1.143,0,471,1,2,143,145,143,0,145,298,-22,48,551,2,2,115,227,154,322,11,1167,752
1660,11,0.1.183,0,464,0,1,183,184,104,79,184,298,0,26,529,2,3,79,165,98,322,12,1167,690
1660,11,1.1.183,0,473,1,67,183,250,85,98,250,298,0,26,529,2,3,169,165,212,322,12,1167,690
1660,11,2.2.183,1,464,0,14,183,197,183,0,197,298,-4,125,533,3,2,124,152,196,210,12,1167,690
1660,11,4.1.183,0,464,0,95,183,278,32,151,278,298,0,26,529,2,3,203,165,209,322,12,1167,690
1660,11,5.1.183,0,464,0,2,183,185,143,40,185,298,0,26,529,2,3,115,165,154,322,12,1167,690
1660,12,0.1.183,0,464,0,1,183,184,104,79,184,298,0,26,533,2,3,79,165,98,322,13,1167,676
1660,12,1.1.183,0,473,1,67,183,250,85,98,250,298,0,26,533,2,3,169,165,212,322,13,1167,676
1660,12,2.3.203,1,464,0,69,203,272,197,6,272,298,0,179,533,4,2,110,207,196,231,13,1167,676
1660,12,4.1.183,0,464,0,95,183,278,32,151,278,298,0,26,533,2,3,203,165,209,322,13,1167,676
1660,12,5.1.183,0,464,0,2,183,185,143,40,185,298,0,26,533,2,3,115,165,154,322,13,1167,676
1660,13,0.1.183,0,464,0,1,183,184,104,79,184,298,0,26,533,2,3,79,165,98,322,14,1167,607
1660,13,1.1.183,0,473,1,67,183,250,85,98,250,298,0,26,533,2,3,169,165,212,322,14,1167,607
1660,13,2.4.298,1,464,0,41,298,339,272,26,339,339,0,203,533,5,2,41,166,196,261,14,1167,607
1660,13,4.1.183,0,464,0,95,183,278,32,151,278,298,0,26,533,2,3,203,165,209,322,14,1167,607
1660,13,5.1.183,0,464,0,2,183,185,143,40,185,298,0,26,533,2,3,115,165,154,322,14,1167,607
1660,14,0.1.183,0,464,0,1,183,184,104,79,184,339,0,26,533,2,3,79,165,98,322,15,1167,566
1660,14,1.1.183,0,473,1,67,183,250,85,98,250,339,0,26,533,2,3,169,165,212,322,15,1167,566
1660,14,4.1.183,0,464,0,95,183,278,32,151,278,339,0,26,533,2,3,203,165,209,322,15,1167,566
1660,14,5.1.183,1,464,0,2,183,185,143,40,185,339,0,26,533,2,3,115,165,154,322,15,1167,566
1660,15,0.1.185,0,464,0,1,185,186,104,81,186,339,0,26,533,2,4,79,163,98,322,16,1167,564
1660,15,1.1.185,0,464,0,67,185,252,85,100,252,339,0,26,533,2,4,169,163,212,322,16,1167,564
1660,15,4.1.185,0,464,0,95,185,280,32,153,280,339,0,26,533,2,4,203,163,209,322,16,1167,564
1660,15,5.2.197,1,464,0,9,197,206,185,12,206,339,0,125,533,3,3,113,138,154,210,16,1167,564
1660,16,0.1.185,0,464,0,1,185,186,104,81,186,339,0,26,533,2,4,79,163,98,322,17,1167,555
1660,16,1.1.185,0,464,0,67,185,252,85,100,252,339,0,26,533,2,4,169,163,212,322,17,1167,555
1660,16,4.1.185,0,464,0,95,185,280,32,153,280,339,0,26,533,2,4,203,163,209,322,17,1167,555
1660,16,5.3.272,1,464,0,35,272,307,206,66,307,339,0,179,533,4,3,104,138,154,231,17,1167,555
1660,17,0.1.185,0,464,0,1,185,186,104,81,186,339,0,26,533,2,4,79,163,98,322,18,1167,520
1660,17,1.1.185,0,464,0,67,185,252,85,100,252,339,0,26,533,2,4,169,163,212,322,18,1167,520
1660,17,4.1.185,0,464,0,95,185,280,32,153,280,339,0,26,533,2,4,203,163,209,322,18,1167,520
1660,17,5.4.339,1,464,0,69,339,408,307,32,408,408,0,203,533,5,3,69,125,154,261,18,1167,520
1660,18,0.1.185,1,464,0,1,185,186,104,81,186,408,0,26,533,2,4,79,163,98,322,19,1167,451
1660,18,1.1.185,0,464,0,67,185,252,85,100,252,408,0,26,533,2,4,169,163,212,322,19,1167,451
1660,18,4.1.185,0,464,0,95,185,280,32,153,280,408,0,26,533,2,4,203,163,209,322,19,1167,451
1660,19,0.2.206,1,464,0,33,206,239,186,20,239,408,0,125,533,3,4,78,129,98,210,20,1167,450
1660,19,1.1.186,0,464,0,67,186,253,85,101,253,408,0,26,533,2,5,169,162,212,322,20,1167,450
1660,19,4.1.186,0,464,0,95,186,281,32,154,281,408,0,26,533,2,5,203,162,209,322,20,1167,450
1660,20,0.3.307,1,464,0,18,307,325,239,68,325,408,0,179,533,4,4,45,103,98,231,21,1167,417
1660,20,1.1.186,0,464,0,67,186,253,85,101,253,408,0,26,533,2,5,169,162,212,322,21,1167,417
1660,20,4.1.186,0,464,0,95,186,281,32,154,281,408,0,26,533,2,5,203,162,209,322,21,1167,417
1660,21,0.4.408,1,464,0,27,408,435,325,83,435,435,0,203,533,5,4,27,56,98,261,22,1167,399
1660,21,1.1.186,0,464,0,67,186,253,85,101,253,408,0,26,533,2,5,169,162,212,322,22,1167,399
1660,21,4.1.186,0,464,0,95,186,281,32,154,281,408,0,26,533,2,5,203,162,209,322,22,1167,399
1660,22,1.1.186,0,464,0,67,186,253,85,101,253,435,0,26,533,2,5,169,162,212,322,23,1167,372
1660,22,4.1.186,1,464,0,95,186,281,32,154,281,435,0,26,533,2,5,203,162,209,322,23,1167,372
1660,23,1.1.281,1,464,0,67,281,348,85,196,348,435,0,26,533,2,6,169,67,212,322,24,1167,277
1660,23,4.2.281,0,464,0,25,281,306,281,0,306,435,-42,167,575,3,5,108,96,209,210,24,1167,277
1660,24,1.2.348,0,464,0,71,348,419,348,0,419,435,-109,234,642,3,5,102,96,212,210,25,1167,210
1660,24,4.2.281,1,464,0,25,281,306,281,0,306,435,-42,167,575,3,5,108,96,209,210,25,1167,210
1660,25,1.2.348,0,464,0,71,348,419,348,0,419,435,-42,209,617,3,6,102,71,212,210,26,1167,185
1660,25,4.3.325,1,464,0,56,325,381,306,19,381,435,0,179,575,4,5,83,85,209,231,26,1167,185
1660,26,1.2.348,0,464,0,71,348,419,348,0,419,435,-42,209,617,3,6,102,71,212,210,27,1167,129
1660,26,4.4.435,1,464,0,27,435,462,381,54,462,462,0,203,575,5,5,27,29,209,261,27,1167,129
1660,27,1.2.348,1,464,0,71,348,419,348,0,419,462,-42,209,617,3,6,102,71,212,210,28,1167,102
1660,28,1.3.419,1,464,0,29,419,448,419,0,448,462,-38,217,655,4,6,31,29,212,231,29,1167,31
1660,29,1.4.462,1,464,0,2,462,464,448,14,464,464,0,203,655,5,6,2,2,212,261,30,1167,2
1661,0,0.0.0,0,467,1,32,0,32,0,0,32,32,0,0,0,1,1,240,257,240,257,1,1435,1435
1661,0,1.0.0,0,471,2,19,0,19,0,0,19,19,0,0,0,1,1,212,257,212,257,1,1435,1435
1661,0,2.0.0,0,519,5,56,0,56,0,0,56,56,0,0,0,1,1,223,257,223,257,1,1435,1435
1661,0,3.0.0,0,514,4,79,0,79,0,0,79,79,0,0,0,1,1,259,257,259,257,1,1435,1435
1661,0,4.0.0,1,463,0,28,0,28,0,0,28,28,0,0,0,1,1,247,257,247,257,1,1435,1435
1661,0,5.0.0,0,496,3,43,0,43,0,0,43,43,0,0,0,1,1,254,257,254,257,1,1435,1435
1661,1,0.0.28,0,463,0,32,28,60,0,28,60,60,0,0,0,1,2,240,229,240,257,2,1435,1407
1661,1,1.0.28,1,463,0,19,28,47,0,28,47,47,0,0,0,1,2,212,229,212,257,2,1435,1407
1661,1,2.0.28,0,493,2,56,28,84,0,28,84,84,0,0,0,1,2,223,229,223,257,2,1435,1407
1661,1,3.0.28,0,495,3,79,28,107,0,28,107,107,0,0,0,1,2,259,229,259,257,2,1435,1407
1661,1,4.1.28,0,463,0,47,28,75,28,0,75,75,-28,28,28,2,1,219,324,247,324,2,1435,1407
1661,1,5.0.28,0,478,1,43,28,71,0,28,71,71,0,0,0,1,2,254,229,254,257,2,1435,1407
1661,2,0.0.47,1,465,1,32,47,79,0,47,79,79,0,0,0,1,3,240,210,240,257,3,1435,1388
1661,2,1.1.47,0,495,4,35,47,82,47,0,82,82,-47,47,47,2,1,193,324,212,324,3,1435,1388
1661,2,2.0.47,0,488,3,56,47,103,0,47,103,103,0,0,0,1,3,223,210,223,257,3,1435,1388
1661,2,3.0.47,0,479,2,79,47,126,0,47,126,126,0,0,0,1,3,259,210,259,257,3,1435,1388
1661,2,4.1.28,0,463,0,47,28,75,28,0,75,75,-28,28,28,2,1,219,324,247,324,3,1435,1388
1661,2,5.0.47,0,463,0,43,47,90,0,47,90,90,0,0,0,1,3,254,210,254,257,3,1435,1388
1661,3,0.1.79,0,478,2,68,79,147,79,0,147,147,-79,79,79,2,1,208,324,240,324,4,1435,1356
1661,3,1.1.47,0,499,3,35,47,82,47,0,82,82,-47,47,47,2,1,193,324,212,324,4,1435,1356
1661,3,2.0.79,0,465,0,56,79,135,0,79,135,135,0,0,0,1,4,223,178,223,257,4,1435,1356
1661,3,3.0.79,0,469,1,79,79,158,0,79,158,158,0,0,0,1,4,259,178,259,257,4,1435,1356
1661,3,4.1.28,0,465,0,47,28,75,28,0,75,79,-28,28,28,2,1,219,324,247,324,4,1435,1356
1661,3,5.0.79,1,465,0,43,79,122,0,79,122,122,0,0,0,1,4,254,178,254,257,4,1435,1356
1661,4,0.1.79,0,478,2,68,79,147,79,0,147,147,-79,79,79,2,1,208,324,240,324,5,1435,1313
1661,4,1.1.47,0,501,3,35,47,82,47,0,82,122,-47,47,47,2,1,193,324,212,324,5,1435,1313
1661,4,2.0.122,1,465,0,56,122,178,0,122,178,178,0,0,0,1,5,223,135,223,257,5,1435,1313
1661,4,3.0.122,0,465,0,79,122,201,0,122,201,201,0,0,0,1,5,259,135,259,257,5,1435,1313
1661,4,4.1.28,0,465,0,47,28,75,28,0,75,122,-28,28,28,2,1,219,324,247,324,5,1435,1313
1661,4,5.1.122,0,475,1,84,122,206,122,0,206,206,-122,122,122,2,1,211,324,254,324,5,1435,1313
1661,5,0.1.79,0,478,2,68,79,147,79,0,147,178,-79,79,79,2,1,208,324,240,324,6,1435,1257
1661,5,1.1.47,0,505,3,35,47,82,47,0,82,178,-47,47,47,2,1,193,324,212,324,6,1435,1257
1661,5,2.1.178,0,511,4,56,178,234,178,0,234,234,-178,178,178,2,1,167,324,223,324,6,1435,1257
1661,5,3.0.178,1,465,0,79,178,257,0,178,257,257,0,0,0,1,6,259,79,259,257,6,1435,1257
1661,5,4.1.28,0,465,0,47,28,75,28,0,75,178,-28,28,28,2,1,219,324,247,324,6,1435,1257
1661,5,5.1.122,0,475,1,84,122,206,122,0,206,206,-122,122,122,2,1,211,324,254,324,6,1435,1257
1661,6,0.1.79,0,478,2,68,79,147,79,0,147,257,-79,79,79,2,1,208,324,240,324,7,1435,1178
1661,6,1.1.47,0,505,3,35,47,82,47,0,82,257,-47,47,47,2,1,193,324,212,324,7,1435,1178
1661,6,2.1.178,0,511,4,56,178,234,178,0,234,257,-178,178,178,2,1,167,324,223,324,7,1435,1178
1661,6,3.1.257,0,513,5,34,257,291,257,0,291,291,-257,257,257,2,1,180,324,259,324,7,1435,1178
1661,6,4.1.28,1,465,0,47,28,75,28,0,75,257,-28,28,28,2,1,219,324,247,324,7,1435,1178
1661,6,5.1.122,0,475,1,84,122,206,122,0,206,257,-122,122,122,2,1,211,324,254,324,7,1435,1178
1661,7,0.1.79,0,478,2,68,79,147,79,0,147,257,-4,32,32,2,2,208,277,240,324,8,1435,1131
1661,7,1.1.75,0,465,0,35,75,110,47,28,110,257,0,28,28,2,2,193,277,212,324,8,1435,1131
1661,7,2.1.178,0,511,3,56,178,234,178,0,234,257,-103,131,131,2,2,167,277,223,324,8,1435,1131
1661,7,3.1.257,0,513,4,34,257,291,257,0,291,291,-182,210,210,2,2,180,277,259,324,8,1435,1131
1661,7,4.2.75,1,465,0,26,75,101,75,0,101,257,-75,75,103,3,1,172,278,247,278,8,1435,1131
1661,7,5.1.122,0,475,1,84,122,206,122,0,206,257,-47,75,75,2,2,211,277,254,324,8,1435,1131
1661,8,0.1.79,0,478,2,68,79,147,79,0,147,257,-4,32,107,2,2,208,277,240,324,9,1435,1105
1661,8,1.1.75,0,465,0,35,75,110,47,28,110,257,0,28,103,2,2,193,277,212,324,9,1435,1105
1661,8,2.1.178,0,511,3,56,178,234,178,0,234,257,-103,131,206,2,2,167,277,223,324,9,1435,1105
1661,8,3.1.257,0,513,4,34,257,291,257,0,291,291,-182,210,285,2,2,180,277,259,324,9,1435,1105
1661,8,4.3.101,1,465,0,49,101,150,101,0,150,257,-101,101,204,4,1,146,285,247,285,9,1435,1105
1661,8,5.1.122,0,475,1,84,122,206,122,0,206,257,-47,75,150,2,2,211,277,254,324,9,1435,1105
1661,9,0.1.79,0,478,2,68,79,147,79,0,147,257,-4,32,208,2,2,208,277,240,324,10,1435,1056
1661,9,1.1.75,0,465,0,35,75,110,47,28,110,257,0,28,204,2,2,193,277,212,324,10,1435,1056
1661,9,2.1.178,0,511,3,56,178,234,178,0,234,257,-103,131,307,2,2,167,277,223,324,10,1435,1056
1661,9,3.1.257,0,513,4,34,257,291,257,0,291,291,-182,210,386,2,2,180,277,259,324,10,1435,1056
1661,9,4.4.150,1,465,0,97,150,247,150,0,247,257,-150,150,354,5,1,97,291,247,291,10,1435,1056
1661,9,5.1.122,0,475,1,84,122,206,122,0,206,257,-47,75,251,2,2,211,277,254,324,10,1435,1056
1661,10,0.1.79,0,478,2,68,79,147,79,0,147,257,-4,32,358,2,2,208,277,240,324,11,1435,959
1661,10,1.1.75,1,465,0,35,75,110,47,28,110,257,0,28,354,2,2,193,277,212,324,11,1435,959
1661,10,2.1.178,0,511,3,56,178,234,178,0,234,257,-103,131,457,2,2,167,277,223,324,11,1435,959
1661,10,3.1.257,0,513,4,34,257,291,257,0,291,291,-182,210,536,2,2,180,277,259,324,11,1435,959
1661,10,5.1.122,0,475,1,84,122,206,122,0,206,257,-47,75,401,2,2,211,277,254,324,11,1435,959
1661,11,0.1.110,0,465,0,68,110,178,79,31,178,257,0,28,354,2,3,208,242,240,324,12,1435,924
1661,11,1.2.110,1,465,0,77,110,187,110,0,187,257,-9,84,363,3,2,158,252,212,278,12,1435,924
1661,11,2.1.178,0,511,2,56,178,234,178,0,234,257,-68,96,422,2,3,167,242,223,324,12,1435,924
1661,11,3.1.257,0,513,3,34,257,291,257,0,291,291,-147,175,501,2,3,180,242,259,324,12,1435,924
1661,11,5.1.122,0,475,1,84,122,206,122,0,206,257,-12,40,366,2,3,211,242,254,324,12,1435,924
1661,12,0.1.110,0,465,0,68,110,178,79,31,178,257,0,28,363,2,3,208,242,240,324,13,1435,847
1661,12,1.3.187,1,465,0,70,187,257,187,0,257,257,-37,138,400,4,2,81,236,212,285,13,1435,847
1661,12,2.1.178,0,511,2,56,178,234,178,0,234,257,-68,96,431,2,3,167,242,223,324,13,1435,847
1661,12,3.1.257,0,513,3,34,257,291,257,0,291,291,-147,175,510,2,3,180,242,259,324,13,1435,847
1661,12,5.1.122,0,475,1,84,122,206,122,0,206,257,-12,40,375,2,3,211,242,254,324,13,1435,847
1661,13,0.1.110,0,465,0,68,110,178,79,31,178,257,0,28,400,2,3,208,242,240,324,14,1435,777
1661,13,1.4.257,1,465,0,11,257,268,257,0,268,268,-10,160,410,5,2,11,194,212,291,14,1435,777
1661,13,2.1.178,0,511,2,56,178,234,178,0,234,257,-68,96,468,2,3,167,242,223,324,14,1435,777
1661,13,3.1.257,0,513,3,34,257,291,257,0,291,291,-147,175,547,2,3,180,242,259,324,14,1435,777
1661,13,5.1.122,0,475,1,84,122,206,122,0,206,257,-12,40,412,2,3,211,242,254,324,14,1435,777
1661,14,0.1.110,1,465,0,68,110,178,79,31,178,268,0,28,410,2,3,208,242,240,324,15,1435,766
1661,14,2.1.178,0,511,2,56,178,234,178,0,234,268,-68,96,478,2,3,167,242,223,324,15,1435,766
1661,14,3.1.257,0,513,3,34,257,291,257,0,291,291,-147,175,557,2,3,180,242,259,324,15,1435,766
1661,14,5.1.122,0,475,1,84,122,206,122,0,206,268,-12,40,422,2,3,211,242,254,324,15,1435,766
1661,15,0.2.187,1,465,0,36,187,223,178,9,223,268,0,84,410,3,3,140,175,240,278,16,1435,698
1661,15,2.1.178,0,511,1,56,178,234,178,0,234,268,0,28,410,2,4,167,174,223,324,16,1435,698
1661,15,3.1.257,0,513,2,34,257,291,257,0,291,291,-79,107,489,2,4,180,174,259,324,16,1435,698
1661,15,5.1.178,0,465,0,84,178,262,122,56,262,268,0,28,410,2,4,211,174,254,324,16,1435,698
1661,16,0.3.257,1,465,0,25,257,282,223,34,282,282,0,138,410,4,3,104,166,240,285,17,1435,662
1661,16,2.1.178,0,511,1,56,178,234,178,0,234,268,0,28,410,2,4,167,174,223,324,17,1435,662
1661,16,3.1.257,0,513,2,34,257,291,257,0,291,291,-79,107,489,2,4,180,174,259,324,17,1435,662
1661,16,5.1.178,0,465,0,84,178,262,122,56,262,268,0,28,410,2,4,211,174,254,324,17,1435,662
1661,17,0.4.282,1,465,0,79,282,361,282,0,361,361,-14,174,424,5,3,79,183,240,291,18,1435,637
1661,17,2.1.178,0,511,1,56,178,234,178,0,234,282,0,28,410,2,4,167,174,223,324,18,1435,637
1661,17,3.1.257,0,513,2,34,257,291,257,0,291,291,-79,107,489,2,4,180,174,259,324,18,1435,637
1661,17,5.1.178,0,465,0,84,178,262,122,56,262,282,0,28,410,2,4,211,174,254,324,18,1435,637
1661,18,2.1.178,0,511,1,56,178,234,178,0,234,361,0,28,424,2,4,167,174,223,324,19,1435,558
1661,18,3.1.257,0,513,2,34,257,291,257,0,291,361,-79,107,503,2,4,180,174,259,324,19,1435,558
1661,18,5.1.178,1,465,0,84,178,262,122,56,262,361,0,28,424,2,4,211,174,254,324,19,1435,558
1661,19,2.1.262,0,506,1,56,262,318,178,84,318,361,0,28,424,2,5,167,90,223,324,20,1435,474
1661,19,3.1.262,0,465,0,34,262,296,257,5,296,361,0,28,424,2,5,180,90,259,324,20,1435,474
1661,19,5.2.262,1,465,0,47,262,309,262,0,309,361,-39,123,463,3,4,127,139,254,278,20,1435,474
1661,20,2.1.262,0,506,1,56,262,318,178,84,318,361,0,28,463,2,5,167,90,223,324,21,1435,427
1661,20,3.1.262,0,465,0,34,262,296,257,5,296,361,0,28,463,2,5,180,90,259,324,21,1435,427
1661,20,5.3.309,1,465,0,20,309,329,309,0,329,361,-27,165,490,4,4,80,141,254,285,21,1435,427
1661,21,2.1.262,0,506,1,56,262,318,178,84,318,361,0,28,490,2,5,167,90,223,324,22,1435,407
1661,21,3.1.262,0,465,0,34,262,296,257,5,296,361,0,28,490,2,5,180,90,259,324,22,1435,407
1661,21,5.4.361,1,465,0,60,361,421,329,32,421,421,0,174,490,5,4,60,104,254,291,22,1435,407
1661,22,2.1.262,1,506,1,56,262,318,178,84,318,421,0,28,490,2,5,167,90,223,324,23,1435,347
1661,22,3.1.262,0,465,0,34,262,296,257,5,296,421,0,28,490,2,5,180,90,259,324,23,1435,347
1661,23,2.2.318,0,538,1,66,318,384,318,0,384,421,-9,132,499,3,5,111,92,223,278,24,1435,291
1661,23,3.1.318,1,506,0,34,318,352,257,61,352,421,0,28,490,2,6,180,34,259,324,24,1435,291
1661,24,2.2.318,0,538,1,66,318,384,318,0,384,421,-9,132,499,3,5,111,92,223,278,25,1435,257
1661,24,3.2.352,1,506,0,26,352,378,352,0,378,421,-43,166,533,3,5,146,92,259,278,25,1435,257
1661,25,2.2.378,1,506,0,66,378,444,318,60,444,444,0,166,533,3,6,111,66,223,278,26,1435,231
1661,25,3.3.378,0,506,0,83,378,461,378,0,461,461,-49,214,582,4,5,120,121,259,285,26,1435,231
1661,26,2.3.444,0,602,1,38,444,482,444,0,482,482,-115,280,648,4,5,45,121,223,285,27,1435,165
1661,26,3.3.378,1,506,0,83,378,461,378,0,461,461,-49,214,582,4,5,120,121,259,285,27,1435,165
1661,27,2.3.461,0,506,0,38,461,499,444,17,499,499,0,214,582,4,6,45,38,223,285,28,1435,82
1661,27,3.4.461,1,506,0,37,461,498,461,0,498,498,-40,214,622,5,5,37,44,259,291,28,1435,82
1661,28,2.3.461,1,506,0,38,461,499,444,17,499,499,0,214,622,4,6,45,38,223,285,29,1435,45
1661,29,2.4.499,1,506,0,7,499,506,499,0,506,506,-1,215,623,5,6,7,7,223,291,30,1435,7
1662,0,0.0.0,0,551,2,45,0,45,0,0,45,45,0,0,0,1,1,183,271,183,271,1,1403,1403
1662,0,1.0.0,0,581,5,94,0,94,0,0,94,94,0,0,0,1,1,212,271,212,271,1,1403,1403
1662,0,2.0.0,0,506,0,2,0,2,0,0,2,2,0,0,0,1,1,150,271,150,271,1,1403,1403
1662,0,3.0.0,1,538,1,32,0,32,0,0,32,32,0,0,0,1,1,316,271,316,271,1,1403,1403
1662,0,4.0.0,0,556,4,50,0,50,0,0,50,50,0,0,0,1,1,285,271,285,271,1,1403,1403
1662,0,5.0.0,0,554,3,48,0,48,0,0,48,48,0,0,0,1,1,257,271,257,271,1,1403,1403
1662,1,0.0.32,0,544,1,45,32,77,0,32,77,77,0,0,0,1,2,183,239,183,271,2,1403,1371
1662,1,1.0.32,0,544,1,94,32,126,0,32,126,126,0,0,0,1,2,212,239,212,271,2,1403,1371
1662,1,2.0.32,1,538,0,2,32,34,0,32,34,34,0,0,0,1,2,150,239,150,271,2,1403,1371
1662,1,3.1.32,0,544,1,72,32,104,32,0,104,104,-32,32,32,2,1,284,326,316,326,2,1403,1371
1662,1,4.0.32,0,544,1,50,32,82,0,32,82,82,0,0,0,1,2,285,239,285,271,2,1403,1371
1662,1,5.0.32,0,544,1,48,32,80,0,32,80,80,0,0,0,1,2,257,239,257,271,2,1403,1371
1662,2,0.0.34,0,538,0,45,34,79,0,34,79,79,0,0,0,1,3,183,237,183,271,3,1403,1369
1662,2,1.0.34,0,538,0,94,34,128,0,34,128,128,0,0,0,1,3,212,237,212,271,3,1403,1369
1662,2,2.1.34,0,538,0,49,34,83,34,0,83,83,-34,34,34,2,1,148,326,150,326,3,1403,1369
1662,2,3.1.32,0,544,1,72,32,104,32,0,104,104,-32,32,32,2,1,284,326,316,326,3,1403,1369
1662,2,4.0.34,1,538,0,50,34,84,0,34,84,84,0,0,0,1,3,285,237,285,271,3,1403,1369
1662,2,5.0.34,0,538,0,48,34,82,0,34,82,82,0,0,0,1,3,257,237,257,271,3,1403,1369
1662,3,0.0.84,0,538,0,45,84,129,0,84,129,129,0,0,0,1,4,183,187,183,271,4,1403,1319
1662,3,1.0.84,0,544,1,94,84,178,0,84,178,178,0,0,0,1,4,212,187,212,271,4,1403,1319
1662,3,2.1.34,0,538,0,49,34,83,34,0,83,84,-34,34,34,2,1,148,326,150,326,4,1403,1319
1662,3,3.1.32,0,544,1,72,32,104,32,0,104,104,-32,32,32,2,1,284,326,316,326,4,1403,1319
1662,3,4.1.84,0,583,2,99,84,183,84,0,183,183,-84,84,84,2,1,235,326,285,326,4,1403,1319
1662,3,5.0.84,1,538,0,48,84,132,0,84,132,132,0,0,0,1,4,257,187,257,271,4,1403,1319
1662,4,0.0.132,1,538,0,45,132,177,0,132,177,177,0,0,0,1,5,183,139,183,271,5,1403,1271
1662,4,1.0.132,0,538,0,94,132,226,0,132,226,226,0,0,0,1,5,212,139,212,271,5,1403,1271
1662,4,2.1.34,0,538,0,49,34,83,34,0,83,132,-34,34,34,2,1,148,326,150,326,5,1403,1271
1662,4,3.1.32,0,544,1,72,32,104,32,0,104,132,-32,32,32,2,1,284,326,316,326,5,1403,1271
1662,4,4.1.84,0,583,3,99,84,183,84,0,183,183,-84,84,84,2,1,235,326,285,326,5,1403,1271
1662,4,5.1.132,0,559,2,67,132,199,132,0,199,199,-132,132,132,2,1,209,326,257,326,5,1403,1271
1662,5,0.1.177,0,538,0,36,177,213,177,0,213,213,-177,177,177,2,1,138,326,183,326,6,1403,1226
1662,5,1.0.177,1,538,0,94,177,271,0,177,271,271,0,0,0,1,6,212,94,212,271,6,1403,1226
1662,5,2.1.34,0,538,0,49,34,83,34,0,83,177,-34,34,34,2,1,148,326,150,326,6,1403,1226
1662,5,3.1.32,0,544,1,72,32,104,32,0,104,177,-32,32,32,2,1,284,326,316,326,6,1403,1226
1662,5,4.1.84,0,583,3,99,84,183,84,0,183,183,-84,84,84,2,1,235,326,285,326,6,1403,1226
1662,5,5.1.132,0,559,2,67,132,199,132,0,199,199,-132,132,132,2,1,209,326,257,326,6,1403,1226
1662,6,0.1.177,0,538,0,36,177,213,177,0,213,271,-177,177,177,2,1,138,326,183,326,7,1403,1132
1662,6,1.1.271,0,538,0,3,271,274,271,0,274,274,-271,271,271,2,1,118,326,212,326,7,1403,1132
1662,6,2.1.34,0,538,0,49,34,83,34,0,83,271,-34,34,34,2,1,148,326,150,326,7,1403,1132
1662,6,3.1.32,1,544,1,72,32,104,32,0,104,271,-32,32,32,2,1,284,326,316,326,7,1403,1132
1662,6,4.1.84,0,583,3,99,84,183,84,0,183,271,-84,84,84,2,1,235,326,285,326,7,1403,1132
1662,6,5.1.132,0,559,2,67,132,199,132,0,199,271,-132,132,132,2,1,209,326,257,326,7,1403,1132
1662,7,0.1.177,0,544,0,36,177,213,177,0,213,271,-73,105,105,2,2,138,254,183,326,8,1403,1060
1662,7,1.1.271,0,544,0,3,271,274,271,0,274,274,-167,199,199,2,2,118,254,212,326,8,1403,1060
1662,7,2.1.104,1,544,0,49,104,153,34,70,153,271,0,32,32,2,2,148,254,150,326,8,1403,1060
1662,7,3.2.104,0,544,0,92,104,196,104,0,196,271,-104,104,136,3,1,212,345,316,345,8,1403,1060
1662,7,4.1.104,0,559,1,99,104,203,84,20,203,271,0,32,32,2,2,235,254,285,326,8,1403,1060
1662,7,5.1.132,0,559,1,67,132,199,132,0,199,271,-28,60,60,2,2,209,254,257,326,8,1403,1060
1662,8,0.1.177,0,544,0,36,177,213,177,0,213,271,-24,56,56,2,3,138,205,183,326,9,1403,1011
1662,8,1.1.271,0,544,0,3,271,274,271,0,274,274,-118,150,150,2,3,118,205,212,326,9,1403,1011
1662,8,2.2.153,0,556,1,20,153,173,153,0,173,271,-153,153,185,3,1,99,345,150,345,9,1403,1011
1662,8,3.2.104,0,544,0,92,104,196,104,0,196,271,-104,104,136,3,1,212,345,316,345,9,1403,1011
1662,8,4.1.153,1,544,0,99,153,252,84,69,252,271,0,32,32,2,3,235,205,285,326,9,1403,1011
1662,8,5.1.153,0,544,0,67,153,220,132,21,220,271,0,32,32,2,3,209,205,257,326,9,1403,1011
1662,9,0.1.252,0,551,1,36,252,288,177,75,288,288,0,32,32,2,4,138,106,183,326,10,1403,912
1662,9,1.1.271,0,544,0,3,271,274,271,0,274,274,-19,51,51,2,4,118,106,212,326,10,1403,912
1662,9,2.2.153,0,556,2,20,153,173,153,0,173,271,-153,153,185,3,1,99,345,150,345,10,1403,912
1662,9,3.2.104,0,544,0,92,104,196,104,0,196,271,-104,104,136,3,1,212,345,316,345,10,1403,912
1662,9,4.2.252,0,544,0,27,252,279,252,0,279,279,-252,252,284,3,1,136,345,285,345,10,1403,912
1662,9,5.1.252,1,558,3,67,252,319,132,120,319,319,0,32,32,2,4,209,106,257,326,10,1403,912
1662,10,0.1.319,0,558,0,36,319,355,177,142,355,355,0,32,32,2,5,138,39,183,326,11,1403,845
1662,10,1.1.319,1,558,0,3,319,322,271,48,322,322,0,32,32,2,5,118,39,212,326,11,1403,845
1662,10,2.2.153,0,558,0,20,153,173,153,0,173,319,-153,153,185,3,1,99,345,150,345,11,1403,845
1662,10,3.2.104,0,558,0,92,104,196,104,0,196,319,-104,104,136,3,1,212,345,316,345,11,1403,845
1662,10,4.2.252,0,558,0,27,252,279,252,0,279,319,-252,252,284,3,1,136,345,285,345,11,1403,845
1662,10,5.2.319,0,558,0,85,319,404,319,0,404,404,-319,319,351,3,1,142,345,257,345,11,1403,845
1662,11,0.1.322,1,558,0,36,322,358,177,145,358,358,0,32,32,2,6,138,36,183,326,12,1403,842
1662,11,1.2.322,0,585,1,82,322,404,322,0,404,404,-322,322,354,3,1,115,345,212,345,12,1403,842
1662,11,2.2.153,0,558,0,20,153,173,153,0,173,322,-153,153,185,3,1,99,345,150,345,12,1403,842
1662,11,3.2.104,0,558,0,92,104,196,104,0,196,322,-104,104,136,3,1,212,345,316,345,12,1403,842
1662,11,4.2.252,0,558,0,27,252,279,252,0,279,322,-252,252,284,3,1,136,345,285,345,12,1403,842
1662,11,5.2.319,0,558,0,85,319,404,319,0,404,404,-319,319,351,3,1,142,345,257,345,12,1403,842
1662,12,0.2.358,0,597,2,39,358,397,358,0,397,397,-358,358,390,3,1,102,345,183,345,13,1403,806
1662,12,1.2.322,0,585,1,82,322,404,322,0,404,404,-322,322,354,3,1,115,345,212,345,13,1403,806
1662,12,2.2.153,0,558,0,20,153,173,153,0,173,358,-153,153,185,3,1,99,345,150,345,13,1403,806
1662,12,3.2.104,1,558,0,92,104,196,104,0,196,358,-104,104,136,3,1,212,345,316,345,13,1403,806
1662,12,4.2.252,0,558,0,27,252,279,252,0,279,358,-252,252,284,3,1,136,345,285,345,13,1403,806
1662,12,5.2.319,0,558,0,85,319,404,319,0,404,404,-319,319,351,3,1,142,345,257,345,13,1403,806
1662,13,0.2.358,0,597,3,39,358,397,358,0,397,397,-162,266,298,3,2,102,253,183,345,14,1403,714
1662,13,1.2.322,0,585,2,82,322,404,322,0,404,404,-126,230,262,3,2,115,253,212,345,14,1403,714
1662,13,2.2.196,0,558,0,20,196,216,153,43,216,358,0,104,136,3,2,99,253,150,345,14,1403,714
1662,13,3.3.196,1,559,1,42,196,238,196,0,238,358,-196,196,332,4,1,120,140,316,140,14,1403,714
1662,13,4.2.252,0,558,0,27,252,279,252,0,279,358,-56,160,192,3,2,136,253,285,345,14,1403,714
1662,13,5.2.319,0,558,0,85,319,404,319,0,404,404,-123,227,259,3,2,142,253,257,345,14,1403,714
1662,14,0.2.358,0,597,2,39,358,397,358,0,397,397,-162,266,494,3,2,102,253,183,345,15,1403,672
1662,14,1.2.322,0,585,1,82,322,404,322,0,404,404,-126,230,458,3,2,115,253,212,345,15,1403,672
1662,14,2.2.196,0,559,0,20,196,216,153,43,216,358,0,104,332,3,2,99,253,150,345,15,1403,672
1662,14,3.4.238,1,559,0,78,238,316,238,0,316,358,-238,238,570,5,1,78,321,316,321,15,1403,672
1662,14,4.2.252,0,559,0,27,252,279,252,0,279,358,-56,160,388,3,2,136,253,285,345,15,1403,672
1662,14,5.2.319,0,559,0,85,319,404,319,0,404,404,-123,227,455,3,2,142,253,257,345,15,1403,672
1662,15,0.2.358,0,597,2,39,358,397,358,0,397,397,-162,266,732,3,2,102,253,183,345,16,1403,594
1662,15,1.2.322,0,585,1,82,322,404,322,0,404,404,-126,230,696,3,2,115,253,212,345,16,1403,594
1662,15,2.2.196,1,559,0,20,196,216,153,43,216,358,0,104,570,3,2,99,253,150,345,16,1403,594
1662,15,4.2.252,0,559,0,27,252,279,252,0,279,358,-56,160,626,3,2,136,253,285,345,16,1403,594
1662,15,5.2.319,0,559,0,85,319,404,319,0,404,404,-123,227,693,3,2,142,253,257,345,16,1403,594
1662,16,0.2.358,0,597,2,39,358,397,358,0,397,397,-142,246,712,3,3,102,233,183,345,17,1403,574
1662,16,1.2.322,0,585,1,82,322,404,322,0,404,404,-106,210,676,3,3,115,233,212,345,17,1403,574
1662,16,2.3.238,1,559,0,7,238,245,216,22,245,358,0,196,570,4,2,79,98,150,140,17,1403,574
1662,16,4.2.252,0,559,0,27,252,279,252,0,279,358,-36,140,606,3,3,136,233,285,345,17,1403,574
1662,16,5.2.319,0,559,0,85,319,404,319,0,404,404,-103,207,673,3,3,142,233,257,345,17,1403,574
1662,17,0.2.358,0,597,2,39,358,397,358,0,397,397,-142,246,712,3,3,102,233,183,345,18,1403,567
1662,17,1.2.322,0,585,1,82,322,404,322,0,404,404,-106,210,676,3,3,115,233,212,345,18,1403,567
1662,17,2.4.316,1,559,0,72,316,388,245,71,388,388,0,238,570,5,2,72,243,150,321,18,1403,567
1662,17,4.2.252,0,559,0,27,252,279,252,0,279,358,-36,140,606,3,3,136,233,285,345,18,1403,567
1662,17,5.2.319,0,559,0,85,319,404,319,0,404,404,-103,207,673,3,3,142,233,257,345,18,1403,567
1662,18,0.2.358,0,597,2,39,358,397,358,0,397,397,-142,246,712,3,3,102,233,183,345,19,1403,495
1662,18,1.2.322,0,585,1,82,322,404,322,0,404,404,-106,210,676,3,3,115,233,212,345,19,1403,495
1662,18,4.2.252,1,559,0,27,252,279,252,0,279,388,-36,140,606,3,3,136,233,285,345,19,1403,495
1662,18,5.2.319,0,559,0,85,319,404,319,0,404,404,-103,207,673,3,3,142,233,257,345,19,1403,495
1662,19,0.2.358,0,597,2,39,358,397,358,0,397,397,-79,219,685,3,4,102,206,183,345,20,1403,468
1662,19,1.2.322,0,585,1,82,322,404,322,0,404,404,-43,183,649,3,4,115,206,212,345,20,1403,468
1662,19,4.3.279,1,559,0,42,279,321,279,0,321,388,-34,230,640,4,3,109,91,285,140,20,1403,468
1662,19,5.2.319,0,559,0,85,319,404,319,0,404,404,-40,180,646,3,4,142,206,257,345,20,1403,468
1662,20,0.2.358,0,597,2,39,358,397,358,0,397,397,-79,219,719,3,4,102,206,183,345,21,1403,426
1662,20,1.2.322,0,585,1,82,322,404,322,0,404,404,-43,183,683,3,4,115,206,212,345,21,1403,426
1662,20,4.4.388,1,559,0,67,388,455,321,67,455,455,0,238,640,5,3,67,171,285,321,21,1403,426
1662,20,5.2.319,0,559,0,85,319,404,319,0,404,404,-40,180,680,3,4,142,206,257,345,21,1403,426
1662,21,0.2.358,0,597,2,39,358,397,358,0,397,455,-79,219,719,3,4,102,206,183,345,22,1403,359
1662,21,1.2.322,0,585,1,82,322,404,322,0,404,455,-43,183,683,3,4,115,206,212,345,22,1403,359
1662,21,5.2.319,1,559,0,85,319,404,319,0,404,455,-40,180,680,3,4,142,206,257,345,22,1403,359
1662,22,0.2.404,0,559,0,39,404,443,358,46,443,455,0,180,680,3,5,102,121,183,345,23,1403,274
1662,22,1.2.404,0,588,1,82,404,486,322,82,486,486,0,180,680,3,5,115,121,212,345,23,1403,274
1662,22,5.3.404,1,559,0,5,404,409,404,0,409,455,-83,313,763,4,4,57,49,257,140,23,1403,274
1662,23,0.2.404,0,559,0,39,404,443,358,46,443,455,0,180,763,3,5,102,121,183,345,24,1403,269
1662,23,1.2.404,0,588,1,82,404,486,322,82,486,486,0,180,763,3,5,115,121,212,345,24,1403,269
1662,23,5.4.455,1,559,0,52,455,507,409,46,507,507,0,238,763,5,4,52,104,257,321,24,1403,269
1662,24,0.2.404,1,559,0,39,404,443,358,46,443,507,0,180,763,3,5,102,121,183,345,25,1403,217
1662,24,1.2.404,0,588,1,82,404,486,322,82,486,507,0,180,763,3,5,115,121,212,345,25,1403,217
1662,25,0.3.443,1,559,0,31,443,474,443,0,474,507,-34,347,797,4,5,63,44,183,140,26,1403,178
1662,25,1.2.443,0,559,0,82,443,525,322,121,525,525,0,180,763,3,6,115,82,212,345,26,1403,178
1662,26,0.4.507,1,559,0,32,507,539,474,33,539,539,0,238,797,5,5,32,52,183,321,27,1403,147
1662,26,1.2.443,0,559,0,82,443,525,322,121,525,525,0,180,797,3,6,115,82,212,345,27,1403,147
1662,27,1.2.443,1,559,0,82,443,525,322,121,525,539,0,180,797,3,6,115,82,212,345,28,1403,115
1662,28,1.3.525,1,559,0,13,525,538,525,0,538,539,-51,398,848,4,6,33,13,212,140,29,1403,33
1662,29,1.4.539,1,559,0,20,539,559,538,1,559,559,0,238,848,5,6,20,20,212,321,30,1403,20
1663,0,0.0.0,0,533,1,58,0,58,0,0,58,58,0,0,0,1,1,227,384,227,384,1,1471,1471
1663,0,1.0.0,0,563,3,70,0,70,0,0,70,70,0,0,0,1,1,311,384,311,384,1,1471,1471
1663,0,2.0.0,1,533,1,47,0,47,0,0,47,47,0,0,0,1,1,275,384,275,384,1,1471,1471
1663,0,3.0.0,0,587,4,85,0,85,0,0,85,85,0,0,0,1,1,177,384,177,384,1,1471,1471
1663,0,4.0.0,0,549,2,71,0,71,0,0,71,71,0,0,0,1,1,222,384,222,384,1,1471,1471
1663,0,5.0.0,0,522,0,53,0,53,0,0,53,53,0,0,0,1,1,259,384,259,384,1,1471,1471
1663,1,0.0.47,0,533,0,58,47,105,0,47,105,105,0,0,0,1,2,227,337,227,384,2,1471,1424
1663,1,1.0.47,0,538,1,70,47,117,0,47,117,117,0,0,0,1,2,311,337,311,384,2,1471,1424
1663,1,2.1.47,1,533,0,43,47,90,47,0,90,90,-47,47,47,2,1,228,231,275,231,2,1471,1424
1663,1,3.0.47,0,587,3,85,47,132,0,47,132,132,0,0,0,1,2,177,337,177,384,2,1471,1424
1663,1,4.0.47,0,549,2,71,47,118,0,47,118,118,0,0,0,1,2,222,337,222,384,2,1471,1424
1663,1,5.0.47,0,533,0,53,47,100,0,47,100,100,0,0,0,1,2,259,337,259,384,2,1471,1424
1663,2,0.0.47,0,533,0,58,47,105,0,47,105,105,0,0,47,1,2,227,337,227,384,3,1471,1381
1663,2,1.0.47,0,538,1,70,47,117,0,47,117,117,0,0,47,1,2,311,337,311,384,3,1471,1381
1663,2,2.2.90,1,533,0,72,90,162,90,0,162,162,-90,90,137,3,1,185,313,275,313,3,1471,1381
1663,2,3.0.47,0,587,3,85,47,132,0,47,132,132,0,0,47,1,2,177,337,177,384,3,1471,1381
1663,2,4.0.47,0,549,2,71,47,118,0,47,118,118,0,0,47,1,2,222,337,222,384,3,1471,1381
1663,2,5.0.47,0,533,0,53,47,100,0,47,100,100,0,0,47,1,2,259,337,259,384,3,1471,1381
1663,3,0.0.47,0,533,0,58,47,105,0,47,105,162,0,0,137,1,2,227,337,227,384,4,1471,1309
1663,3,1.0.47,0,538,1,70,47,117,0,47,117,162,0,0,137,1,2,311,337,311,384,4,1471,1309
1663,3,2.3.162,1,533,0,75,162,237,162,0,237,237,-162,162,299,4,1,113,291,275,291,4,1471,1309
1663,3,3.0.47,0,587,3,85,47,132,0,47,132,162,0,0,137,1,2,177,337,177,384,4,1471,1309
1663,3,4.0.47,0,549,2,71,47,118,0,47,118,162,0,0,137,1,2,222,337,222,384,4,1471,1309
1663,3,5.0.47,0,533,0,53,47,100,0,47,100,162,0,0,137,1,2,259,337,259,384,4,1471,1309
1663,4,0.0.47,0,533,0,58,47,105,0,47,105,237,0,0,299,1,2,227,337,227,384,5,1471,1234
1663,4,1.0.47,0,538,1,70,47,117,0,47,117,237,0,0,299,1,2,311,337,311,384,5,1471,1234
1663,4,2.4.237,1,533,0,38,237,275,237,0,275,275,-237,237,536,5,1,38,252,275,252,5,1471,1234
1663,4,3.0.47,0,587,3,85,47,132,0,47,132,237,0,0,299,1,2,177,337,177,384,5,1471,1234
1663,4,4.0.47,0,549,2,71,47,118,0,47,118,237,0,0,299,1,2,222,337,222,384,5,1471,1234
1663,4,5.0.47,0,533,0,53,47,100,0,47,100,237,0,0,299,1,2,259,337,259,384,5,1471,1234
1663,5,0.0.47,0,533,0,58,47,105,0,47,105,275,0,0,536,1,2,227,337,227,384,6,1471,1196
1663,5,1.0.47,1,538,1,70,47,117,0,47,117,275,0,0,536,1,2,311,337,311,384,6,1471,1196
1663,5,3.0.47,0,587,3,85,47,132,0,47,132,275,0,0,536,1,2,177,337,177,384,6,1471,1196
1663,5,4.0.47,0,549,2,71,47,118,0,47,118,275,0,0,536,1,2,222,337,222,384,6,1471,1196
1663,5,5.0.47,0,533,0,53,47,100,0,47,100,275,0,0,536,1,2,259,337,259,384,6,1471,1196
1663,6,0.0.117,0,538,0,58,117,175,0,117,175,275,0,0,536,1,3,227,267,227,384,7,1471,1126
1663,6,1.1.117,1,538,0,71,117,188,117,0,188,275,-27,74,563,2,2,241,188,311,231,7,1471,1126
1663,6,3.0.117,0,571,3,85,117,202,0,117,202,275,0,0,536,1,3,177,267,177,384,7,1471,1126
1663,6,4.0.117,0,553,2,71,117,188,0,117,188,275,0,0,536,1,3,222,267,222,384,7,1471,1126
1663,6,5.0.117,0,547,1,53,117,170,0,117,170,275,0,0,536,1,3,259,267,259,384,7,1471,1126
1663,7,0.0.117,0,538,0,58,117,175,0,117,175,275,0,0,563,1,3,227,267,227,384,8,1471,1055
1663,7,1.2.188,1,553,2,87,188,275,188,0,275,275,-26,116,589,3,2,170,241,311,313,8,1471,1055
1663,7,3.0.117,0,571,3,85,117,202,0,117,202,275,0,0,563,1,3,177,267,177,384,8,1471,1055
1663,7,4.0.117,0,553,2,71,117,188,0,117,188,275,0,0,563,1,3,222,267,222,384,8,1471,1055
1663,7,5.0.117,0,548,1,53,117,170,0,117,170,275,0,0,563,1,3,259,267,259,384,8,1471,1055
1663,8,0.0.117,0,553,0,58,117,175,0,117,175,275,0,0,589,1,3,227,267,227,384,9,1471,968
1663,8,1.3.275,1,553,0,54,275,329,275,0,329,329,-38,200,627,4,2,83,216,311,291,9,1471,968
1663,8,3.0.117,0,571,1,85,117,202,0,117,202,275,0,0,589,1,3,177,267,177,384,9,1471,968
1663,8,4.0.117,0,553,0,71,117,188,0,117,188,275,0,0,589,1,3,222,267,222,384,9,1471,968
1663,8,5.0.117,0,553,0,53,117,170,0,117,170,275,0,0,589,1,3,259,267,259,384,9,1471,968
1663,9,0.0.117,0,553,0,58,117,175,0,117,175,329,0,0,627,1,3,227,267,227,384,10,1471,914
1663,9,1.4.329,1,553,0,29,329,358,329,0,358,358,-54,291,681,5,2,29,214,311,252,10,1471,914
1663,9,3.0.117,0,571,1,85,117,202,0,117,202,329,0,0,627,1,3,177,267,177,384,10,1471,914
1663,9,4.0.117,0,553,0,71,117,188,0,117,188,329,0,0,627,1,3,222,267,222,384,10,1471,914
1663,9,5.0.117,0,553,0,53,117,170,0,117,170,329,0,0,627,1,3,259,267,259,384,10,1471,914
1663,10,0.0.117,0,553,0,58,117,175,0,117,175,358,0,0,681,1,3,227,267,227,384,11,1471,885
1663,10,3.0.117,0,571,1,85,117,202,0,117,202,358,0,0,681,1,3,177,267,177,384,11,1471,885
1663,10,4.0.117,0,553,0,71,117,188,0,117,188,358,0,0,681,1,3,222,267,222,384,11,1471,885
1663,10,5.0.117,1,553,0,53,117,170,0,117,170,358,0,0,681,1,3,259,267,259,384,11,1471,885
1663,11,0.0.170,0,556,1,58,170,228,0,170,228,358,0,0,681,1,4,227,214,227,384,12,1471,832
1663,11,3.0.170,0,585,2,85,170,255,0,170,255,358,0,0,681,1,4,177,214,177,384,12,1471,832
1663,11,4.0.170,0,553,0,71,170,241,0,170,241,358,0,0,681,1,4,222,214,222,384,12,1471,832
1663,11,5.1.188,1,553,0,51,188,239,170,18,239,358,0,74,681,2,3,206,117,259,231,12,1471,832
1663,12,0.0.170,0,556,1,58,170,228,0,170,228,358,0,0,681,1,4,227,214,227,384,13,1471,781
1663,12,3.0.170,0,585,3,85,170,255,0,170,255,358,0,0,681,1,4,177,214,177,384,13,1471,781
1663,12,4.0.170,0,553,0,71,170,241,0,170,241,358,0,0,681,1,4,222,214,222,384,13,1471,781
1663,12,5.2.275,1,558,2,24,275,299,239,36,299,358,0,116,681,3,3,155,154,259,313,13,1471,781
1663,13,0.0.170,0,566,1,58,170,228,0,170,228,358,0,0,681,1,4,227,214,227,384,14,1471,757
1663,13,3.0.170,0,587,2,85,170,255,0,170,255,358,0,0,681,1,4,177,214,177,384,14,1471,757
1663,13,4.0.170,0,558,0,71,170,241,0,170,241,358,0,0,681,1,4,222,214,222,384,14,1471,757
1663,13,5.3.329,1,602,3,88,329,417,299,30,417,417,0,200,681,4,3,131,162,259,291,14,1471,757
1663,14,0.0.170,0,602,0,58,170,228,0,170,228,417,0,0,681,1,4,227,214,227,384,15,1471,669
1663,14,3.0.170,0,602,0,85,170,255,0,170,255,417,0,0,681,1,4,177,214,177,384,15,1471,669
1663,14,4.0.170,0,602,0,71,170,241,0,170,241,417,0,0,681,1,4,222,214,222,384,15,1471,669
1663,14,5.4.417,1,602,0,43,417,460,417,0,460,460,-59,350,740,5,3,43,185,259,252,15,1471,669
1663,15,0.0.170,1,602,0,58,170,228,0,170,228,460,0,0,740,1,4,227,214,227,384,16,1471,626
1663,15,3.0.170,0,602,0,85,170,255,0,170,255,460,0,0,740,1,4,177,214,177,384,16,1471,626
1663,15,4.0.170,0,602,0,71,170,241,0,170,241,460,0,0,740,1,4,222,214,222,384,16,1471,626
1663,16,0.1.239,1,602,0,4,239,243,228,11,243,460,0,74,740,2,4,169,66,227,231,17,1471,568
1663,16,3.0.228,0,602,0,85,228,313,0,228,313,460,0,0,740,1,5,177,156,177,384,17,1471,568
1663,16,4.0.228,0,602,0,71,228,299,0,228,299,460,0,0,740,1,5,222,156,222,384,17,1471,568
1663,17,0.2.299,1,602,0,43,299,342,243,56,342,460,0,116,740,3,4,165,130,227,313,18,1471,564
1663,17,3.0.228,0,602,0,85,228,313,0,228,313,460,0,0,740,1,5,177,156,177,384,18,1471,564
1663,17,4.0.228,0,602,0,71,228,299,0,228,299,460,0,0,740,1,5,222,156,222,384,18,1471,564
1663,18,0.3.417,1,602,0,38,417,455,342,75,455,460,0,200,740,4,4,122,74,227,291,19,1471,521
1663,18,3.0.228,0,602,0,85,228,313,0,228,313,460,0,0,740,1,5,177,156,177,384,19,1471,521
1663,18,4.0.228,0,602,0,71,228,299,0,228,299,460,0,0,740,1,5,222,156,222,384,19,1471,521
1663,19,0.4.460,1,602,0,84,460,544,455,5,544,544,0,350,740,5,4,84,142,227,252,20,1471,483
1663,19,3.0.228,0,602,0,85,228,313,0,228,313,460,0,0,740,1,5,177,156,177,384,20,1471,483
1663,19,4.0.228,0,602,0,71,228,299,0,228,299,460,0,0,740,1,5,222,156,222,384,20,1471,483
1663,20,3.0.228,0,602,0,85,228,313,0,228,313,544,0,0,740,1,5,177,156,177,384,21,1471,399
1663,20,4.0.228,1,602,0,71,228,299,0,228,299,544,0,0,740,1,5,222,156,222,384,21,1471,399
1663,21,3.0.299,0,602,0,85,299,384,0,299,384,544,0,0,740,1,6,177,85,177,384,22,1471,328
1663,21,4.1.299,1,602,0,51,299,350,299,0,350,544,-56,130,796,2,5,151,62,222,231,22,1471,328
1663,22,3.0.299,0,602,0,85,299,384,0,299,384,544,0,0,796,1,6,177,85,177,384,23,1471,277
1663,22,4.2.350,1,602,0,27,350,377,350,0,377,544,-8,124,804,3,5,100,87,222,313,23,1471,277
1663,23,3.0.299,0,602,0,85,299,384,0,299,384,544,0,0,804,1,6,177,85,177,384,24,1471,250
1663,23,4.3.455,1,602,0,35,455,490,377,78,490,544,0,200,804,4,5,73,36,222,291,24,1471,250
1663,24,3.0.299,0,602,0,85,299,384,0,299,384,544,0,0,804,1,6,177,85,177,384,25,1471,215
1663,24,4.4.544,1,602,0,38,544,582,490,54,582,582,0,350,804,5,5,38,58,222,252,25,1471,215
1663,25,3.0.299,1,602,0,85,299,384,0,299,384,582,0,0,804,1,6,177,85,177,384,26,1471,177
1663,26,3.1.384,1,602,0,11,384,395,384,0,395,582,-34,164,838,2,6,92,11,177,231,27,1471,92
1663,27,3.2.395,1,602,0,60,395,455,395,0,455,582,-18,142,856,3,6,81,60,177,313,28,1471,81
1663,28,3.3.490,1,602,0,1,490,491,455,35,491,582,0,200,856,4,6,21,1,177,291,29,1471,21
1663,29,3.4.582,1,602,0,20,582,602,491,91,602,602,0,350,856,5,6,20,20,177,252,30,1471,20
1664,0,0.0.0,0,550,3,71,0,71,0,0,71,71,0,0,0,1,1,271,399,271,399,1,1442,1442
1664,0,1.0.0,1,526,2,46,0,46,0,0,46,46,0,0,0,1,1,311,399,311,399,1,1442,1442
1664,0,2.0.0,0,564,4,93,0,93,0,0,93,93,0,0,0,1,1,203,399,203,399,1,1442,1442
1664,0,3.0.0,0,505,0,39,0,39,0,0,39,39,0,0,0,1,1,236,399,236,399,1,1442,1442
1664,0,4.0.0,0,565,5,93,0,93,0,0,93,93,0,0,0,1,1,161,399,161,399,1,1442,1442
1664,0,5.0.0,0,506,1,57,0,57,0,0,57,57,0,0,0,1,1,260,399,260,399,1,1442,1442
1664,1,0.0.46,0,526,0,71,46,117,0,46,117,117,0,0,0,1,2,271,353,271,399,2,1442,1396
1664,1,1.1.46,1,526,0,39,46,85,46,0,85,85,-46,46,46,2,1,265,234,311,234,2,1442,1396
1664,1,2.0.46,0,541,1,93,46,139,0,46,139,139,0,0,0,1,2,203,353,203,399,2,1442,1396
1664,1,3.0.46,0,526,0,39,46,85,0,46,85,85,0,0,0,1,2,236,353,236,399,2,1442,1396
1664,1,4.0.46,0,526,0,93,46,139,0,46,139,139,0,0,0,1,2,161,353,161,399,2,1442,1396
1664,1,5.0.46,0,526,0,57,46,103,0,46,103,103,0,0,0,1,2,260,353,260,399,2,1442,1396
1664,2,0.0.46,0,526,0,71,46,117,0,46,117,117,0,0,46,1,2,271,353,271,399,3,1442,1357
1664,2,1.2.85,1,526,0,93,85,178,85,0,178,178,-85,85,131,3,1,226,282,311,282,3,1442,1357
1664,2,2.0.46,0,541,1,93,46,139,0,46,139,139,0,0,46,1,2,203,353,203,399,3,1442,1357
1664,2,3.0.46,0,526,0,39,46,85,0,46,85,85,0,0,46,1,2,236,353,236,399,3,1442,1357
1664,2,4.0.46,0,526,0,93,46,139,0,46,139,139,0,0,46,1,2,161,353,161,399,3,1442,1357
1664,2,5.0.46,0,526,0,57,46,103,0,46,103,103,0,0,46,1,2,260,353,260,399,3,1442,1357
1664,3,0.0.46,0,526,0,71,46,117,0,46,117,178,0,0,131,1,2,271,353,271,399,4,1442,1264
1664,3,1.3.178,1,526,0,95,178,273,178,0,273,273,-178,178,309,4,1,133,345,311,345,4,1442,1264
1664,3,2.0.46,0,541,1,93,46,139,0,46,139,178,0,0,131,1,2,203,353,203,399,4,1442,1264
1664,3,3.0.46,0,526,0,39,46,85,0,46,85,178,0,0,131,1,2,236,353,236,399,4,1442,1264
1664,3,4.0.46,0,526,0,93,46,139,0,46,139,178,0,0,131,1,2,161,353,161,399,4,1442,1264
1664,3,5.0.46,0,526,0,57,46,103,0,46,103,178,0,0,131,1,2,260,353,260,399,4,1442,1264
1664,4,0.0.46,0,526,0,71,46,117,0,46,117,273,0,0,309,1,2,271,353,271,399,5,1442,1169
1664,4,1.4.273,1,526,0,38,273,311,273,0,311,311,-273,273,582,5,1,38,182,311,182,5,1442,1169
1664,4,2.0.46,0,541,1,93,46,139,0,46,139,273,0,0,309,1,2,203,353,203,399,5,1442,1169
1664,4,3.0.46,0,526,0,39,46,85,0,46,85,273,0,0,309,1,2,236,353,236,399,5,1442,1169
1664,4,4.0.46,0,526,0,93,46,139,0,46,139,273,0,0,309,1,2,161,353,161,399,5,1442,1169
1664,4,5.0.46,0,526,0,57,46,103,0,46,103,273,0,0,309,1,2,260,353,260,399,5,1442,1169
1664,5,0.0.46,0,526,0,71,46,117,0,46,117,311,0,0,582,1,2,271,353,271,399,6,1442,1131
1664,5,2.0.46,0,541,1,93,46,139,0,46,139,311,0,0,582,1,2,203,353,203,399,6,1442,1131
1664,5,3.0.46,1,526,0,39,46,85,0,46,85,311,0,0,582,1,2,236,353,236,399,6,1442,1131
1664,5,4.0.46,0,526,0,93,46,139,0,46,139,311,0,0,582,1,2,161,353,161,399,6,1442,1131
1664,5,5.0.46,0,526,0,57,46,103,0,46,103,311,0,0,582,1,2,260,353,260,399,6,1442,1131
1664,6,0.0.85,0,526,0,71,85,156,0,85,156,311,0,0,582,1,3,271,314,271,399,7,1442,1092
1664,6,2.0.85,0,541,1,93,85,178,0,85,178,311,0,0,582,1,3,203,314,203,399,7,1442,1092
1664,6,3.1.85,1,526,0,49,85,134,85,0,134,311,0,46,582,2,2,197,195,236,234,7,1442,1092
1664,6,4.0.85,0,526,0,93,85,178,0,85,178,311,0,0,582,1,3,161,314,161,399,7,1442,1092
1664,6,5.0.85,0,526,0,57,85,142,0,85,142,311,0,0,582,1,3,260,314,260,399,7,1442,1092
1664,7,0.0.85,0,526,0,71,85,156,0,85,156,311,0,0,582,1,3,271,314,271,399,8,1442,1043
1664,7,2.0.85,0,541,1,93,85,178,0,85,178,311,0,0,582,1,3,203,314,203,399,8,1442,1043
1664,7,3.2.178,1,526,0,27,178,205,134,44,205,311,0,85,582,3,2,148,189,236,282,8,1442,1043
1664,7,4.0.85,0,526,0,93,85,178,0,85,178,311,0,0,582,1,3,161,314,161,399,8,1442,1043
1664,7,5.0.85,0,526,0,57,85,142,0,85,142,311,0,0,582,1,3,260,314,260,399,8,1442,1043
1664,8,0.0.85,0,526,0,71,85,156,0,85,156,311,0,0,582,1,3,271,314,271,399,9,1442,1016
1664,8,2.0.85,0,541,1,93,85,178,0,85,178,311,0,0,582,1,3,203,314,203,399,9,1442,1016
1664,8,3.3.273,1,526,0,60,273,333,205,68,333,333,0,178,582,4,2,121,250,236,345,9,1442,1016
1664,8,4.0.85,0,526,0,93,85,178,0,85,178,311,0,0,582,1,3,161,314,161,399,9,1442,1016
1664,8,5.0.85,0,526,0,57,85,142,0,85,142,311,0,0,582,1,3,260,314,260,399,9,1442,1016
1664,9,0.0.85,0,526,0,71,85,156,0,85,156,333,0,0,582,1,3,271,314,271,399,10,1442,956
1664,9,2.0.85,0,541,1,93,85,178,0,85,178,333,0,0,582,1,3,203,314,203,399,10,1442,956
1664,9,3.4.333,1,526,0,61,333,394,333,0,394,394,-22,295,604,5,2,61,144,236,182,10,1442,956
1664,9,4.0.85,0,526,0,93,85,178,0,85,178,333,0,0,582,1,3,161,314,161,399,10,1442,956
1664,9,5.0.85,0,526,0,57,85,142,0,85,142,333,0,0,582,1,3,260,314,260,399,10,1442,956
1664,10,0.0.85,0,526,0,71,85,156,0,85,156,394,0,0,604,1,3,271,314,271,399,11,1442,895
1664,10,2.0.85,0,541,1,93,85,178,0,85,178,394,0,0,604,1,3,203,314,203,399,11,1442,895
1664,10,4.0.85,0,526,0,93,85,178,0,85,178,394,0,0,604,1,3,161,314,161,399,11,1442,895
1664,10,5.0.85,1,526,0,57,85,142,0,85,142,394,0,0,604,1,3,260,314,260,399,11,1442,895
1664,11,0.0.142,0,526,0,71,142,213,0,142,213,394,0,0,604,1,4,271,257,271,399,12,1442,838
1664,11,2.0.142,0,541,1,93,142,235,0,142,235,394,0,0,604,1,4,203,257,203,399,12,1442,838
1664,11,4.0.142,0,526,0,93,142,235,0,142,235,394,0,0,604,1,4,161,257,161,399,12,1442,838
1664,11,5.1.142,1,526,0,34,142,176,142,0,176,394,-8,54,612,2,3,203,146,260,234,12,1442,838
1664,12,0.0.142,0,526,0,71,142,213,0,142,213,394,0,0,612,1,4,271,257,271,399,13,1442,804
1664,12,2.0.142,0,541,1,93,142,235,0,142,235,394,0,0,612,1,4,203,257,203,399,13,1442,804
1664,12,4.0.142,0,526,0,93,142,235,0,142,235,394,0,0,612,1,4,161,257,161,399,13,1442,804
1664,12,5.2.205,1,526,0,62,205,267,176,29,267,394,0,85,612,3,3,169,162,260,282,13,1442,804
1664,13,0.0.142,0,526,0,71,142,213,0,142,213,394,0,0,612,1,4,271,257,271,399,14,1442,742
1664,13,2.0.142,0,541,1,93,142,235,0,142,235,394,0,0,612,1,4,203,257,203,399,14,1442,742
1664,13,4.0.142,0,526,0,93,142,235,0,142,235,394,0,0,612,1,4,161,257,161,399,14,1442,742
1664,13,5.3.333,1,526,0,73,333,406,267,66,406,406,0,178,612,4,3,107,190,260,345,14,1442,742
1664,14,0.0.142,0,526,0,71,142,213,0,142,213,406,0,0,612,1,4,271,257,271,399,15,1442,669
1664,14,2.0.142,0,541,1,93,142,235,0,142,235,406,0,0,612,1,4,203,257,203,399,15,1442,669
1664,14,4.0.142,0,526,0,93,142,235,0,142,235,406,0,0,612,1,4,161,257,161,399,15,1442,669
1664,14,5.4.406,1,526,0,34,406,440,406,0,440,440,-12,307,624,5,3,34,83,260,182,15,1442,669
1664,15,0.0.142,1,526,0,71,142,213,0,142,213,440,0,0,624,1,4,271,257,271,399,16,1442,635
1664,15,2.0.142,0,541,1,93,142,235,0,142,235,440,0,0,624,1,4,203,257,203,399,16,1442,635
1664,15,4.0.142,0,526,0,93,142,235,0,142,235,440,0,0,624,1,4,161,257,161,399,16,1442,635
1664,16,0.1.213,1,526,0,71,213,284,213,0,284,440,-37,91,661,2,4,200,112,271,234,17,1442,564
1664,16,2.0.213,0,526,0,93,213,306,0,213,306,440,0,0,624,1,5,203,186,203,399,17,1442,564
1664,16,4.0.213,0,526,0,93,213,306,0,213,306,440,0,0,624,1,5,161,186,161,399,17,1442,564
1664,17,0.2.284,1,526,0,46,284,330,284,0,330,440,-17,102,678,3,4,129,100,271,282,18,1442,493
1664,17,2.0.213,0,526,0,93,213,306,0,213,306,440,0,0,661,1,5,203,186,203,399,18,1442,493
1664,17,4.0.213,0,526,0,93,213,306,0,213,306,440,0,0,661,1,5,161,186,161,399,18,1442,493
1664,18,0.3.406,1,526,0,45,406,451,330,76,451,451,0,178,678,4,4,83,117,271,345,19,1442,447
1664,18,2.0.213,0,526,0,93,213,306,0,213,306,440,0,0,678,1,5,203,186,203,399,19,1442,447
1664,18,4.0.213,0,526,0,93,213,306,0,213,306,440,0,0,678,1,5,161,186,161,399,19,1442,447
1664,19,0.4.451,1,526,0,38,451,489,451,0,489,489,-11,318,689,5,4,38,49,271,182,20,1442,402
1664,19,2.0.213,0,526,0,93,213,306,0,213,306,451,0,0,678,1,5,203,186,203,399,20,1442,402
1664,19,4.0.213,0,526,0,93,213,306,0,213,306,451,0,0,678,1,5,161,186,161,399,20,1442,402
1664,20,2.0.213,1,526,0,93,213,306,0,213,306,489,0,0,689,1,5,203,186,203,399,21,1442,364
1664,20,4.0.213,0,526,0,93,213,306,0,213,306,489,0,0,689,1,5,161,186,161,399,21,1442,364
1664,21,2.1.306,1,526,0,37,306,343,306,0,343,489,-22,113,711,2,5,110,41,203,234,22,1442,271
1664,21,4.0.306,0,526,0,93,306,399,0,306,399,489,0,0,689,1,6,161,93,161,399,22,1442,271
1664,22,2.2.343,1,526,0,26,343,369,343,0,369,489,-13,115,724,3,5,73,54,203,282,23,1442,234
1664,22,4.0.306,0,526,0,93,306,399,0,306,399,489,0,0,711,1,6,161,93,161,399,23,1442,234
1664,23,2.3.451,1,531,1,44,451,495,369,82,495,495,0,178,724,4,5,47,72,203,345,24,1442,208
1664,23,4.0.306,0,526,0,93,306,399,0,306,399,489,0,0,724,1,6,161,93,161,399,24,1442,208
1664,24,2.4.495,1,531,0,3,495,498,495,0,498,498,-6,324,730,5,5,3,11,203,182,25,1442,164
1664,24,4.0.306,0,531,0,93,306,399,0,306,399,495,0,0,724,1,6,161,93,161,399,25,1442,164
1664,25,4.0.306,1,531,0,93,306,399,0,306,399,498,0,0,730,1,6,161,93,161,399,26,1442,161
1664,26,4.1.399,1,531,0,4,399,403,399,0,403,498,-56,169,786,2,6,68,4,161,234,27,1442,68
1664,27,4.2.403,1,531,0,28,403,431,403,0,431,498,-34,149,820,3,6,64,28,161,282,28,1442,64
1664,28,4.3.495,1,531,0,28,495,523,431,64,523,523,0,178,820,4,6,36,28,161,345,29,1442,36
1664,29,4.4.523,1,531,0,8,523,531,523,0,531,531,-25,349,845,5,6,8,8,161,182,30,1442,8
1665,0,0.0.0,0,528,2,84,0,84,0,0,84,84,0,0,0,1,1,315,314,315,314,1,1411,1411
1665,0,1.0.0,0,473,0,21,0,21,0,0,21,21,0,0,0,1,1,211,314,211,314,1,1411,1411
1665,0,2.0.0,0,473,0,39,0,39,0,0,39,39,0,0,0,1,1,228,314,228,314,1,1411,1411
1665,0,3.0.0,0,537,3,92,0,92,0,0,92,92,0,0,0,1,1,295,314,295,314,1,1411,1411
1665,0,4.0.0,1,473,0,16,0,16,0,0,16,16,0,0,0,1,1,199,314,199,314,1,1411,1411
1665,0,5.0.0,0,517,1,62,0,62,0,0,62,62,0,0,0,1,1,163,314,163,314,1,1411,1411
1665,1,0.0.16,0,483,1,84,16,100,0,16,100,100,0,0,0,1,2,315,298,315,314,2,1411,1395
1665,1,1.0.16,0,473,0,21,16,37,0,16,37,37,0,0,0,1,2,211,298,211,314,2,1411,1395
1665,1,2.0.16,0,473,0,39,16,55,0,16,55,55,0,0,0,1,2,228,298,228,314,2,1411,1395
1665,1,3.0.16,0,531,3,92,16,108,0,16,108,108,0,0,0,1,2,295,298,295,314,2,1411,1395
1665,1,4.1.16,1,473,0,55,16,71,16,0,71,71,-16,16,16,2,1,183,236,199,236,2,1411,1395
1665,1,5.0.16,0,517,2,62,16,78,0,16,78,78,0,0,0,1,2,163,298,163,314,2,1411,1395
1665,2,0.0.16,0,483,1,84,16,100,0,16,100,100,0,0,16,1,2,315,298,315,314,3,1411,1340
1665,2,1.0.16,0,473,0,21,16,37,0,16,37,71,0,0,16,1,2,211,298,211,314,3,1411,1340
1665,2,2.0.16,0,473,0,39,16,55,0,16,55,71,0,0,16,1,2,228,298,228,314,3,1411,1340
1665,2,3.0.16,0,531,3,92,16,108,0,16,108,108,0,0,16,1,2,295,298,295,314,3,1411,1340
1665,2,4.2.71,1,473,0,29,71,100,71,0,100,100,-71,71,87,3,1,128,350,199,350,3,1411,1340
1665,2,5.0.16,0,517,2,62,16,78,0,16,78,78,0,0,16,1,2,163,298,163,314,3,1411,1340
1665,3,0.0.16,0,483,1,84,16,100,0,16,100,100,0,0,87,1,2,315,298,315,314,4,1411,1311
1665,3,1.0.16,0,473,0,21,16,37,0,16,37,100,0,0,87,1,2,211,298,211,314,4,1411,1311
1665,3,2.0.16,0,473,0,39,16,55,0,16,55,100,0,0,87,1,2,228,298,228,314,4,1411,1311
1665,3,3.0.16,0,531,3,92,16,108,0,16,108,108,0,0,87,1,2,295,298,295,314,4,1411,1311
1665,3,4.3.100,1,473,0,21,100,121,100,0,121,121,-100,100,187,4,1,99,200,199,200,4,1411,1311
1665,3,5.0.16,0,517,2,62,16,78,0,16,78,100,0,0,87,1,2,163,298,163,314,4,1411,1311
1665,4,0.0.16,0,483,1,84,16,100,0,16,100,121,0,0,187,1,2,315,298,315,314,5,1411,1290
1665,4,1.0.16,0,473,0,21,16,37,0,16,37,121,0,0,187,1,2,211,298,211,314,5,1411,1290
1665,4,2.0.16,0,473,0,39,16,55,0,16,55,121,0,0,187,1,2,228,298,228,314,5,1411,1290
1665,4,3.0.16,0,531,3,92,16,108,0,16,108,121,0,0,187,1,2,295,298,295,314,5,1411,1290
1665,4,4.4.121,1,473,0,78,121,199,121,0,199,199,-121,121,308,5,1,78,311,199,311,5,1411,1290
1665,4,5.0.16,0,517,2,62,16,78,0,16,78,121,0,0,187,1,2,163,298,163,314,5,1411,1290
1665,5,0.0.16,0,483,1,84,16,100,0,16,100,199,0,0,308,1,2,315,298,315,314,6,1411,1212
1665,5,1.0.16,1,473,0,21,16,37,0,16,37,199,0,0,308,1,2,211,298,211,314,6,1411,1212
1665,5,2.0.16,0,473,0,39,16,55,0,16,55,199,0,0,308,1,2,228,298,228,314,6,1411,1212
1665,5,3.0.16,0,531,3,92,16,108,0,16,108,199,0,0,308,1,2,295,298,295,314,6,1411,1212
1665,5,5.0.16,0,517,2,62,16,78,0,16,78,199,0,0,308,1,2,163,298,163,314,6,1411,1212
1665,6,0.0.37,0,485,1,84,37,121,0,37,121,199,0,0,308,1,3,315,277,315,314,7,1411,1191
1665,6,1.1.71,1,473,0,7,71,78,37,34,78,199,0,16,308,2,2,190,181,211,236,7,1411,1191
1665,6,2.0.37,0,473,0,39,37,76,0,37,76,199,0,0,308,1,3,228,277,228,314,7,1411,1191
1665,6,3.0.37,0,513,2,92,37,129,0,37,129,199,0,0,308,1,3,295,277,295,314,7,1411,1191
1665,6,5.0.37,0,517,3,62,37,99,0,37,99,199,0,0,308,1,3,163,277,163,314,7,1411,1191
1665,7,0.0.37,0,485,1,84,37,121,0,37,121,199,0,0,308,1,3,315,277,315,314,8,1411,1184
1665,7,1.2.100,0,485,1,98,100,198,78,22,198,199,0,71,308,3,2,183,321,211,350,8,1411,1184
1665,7,2.0.37,1,473,0,39,37,76,0,37,76,199,0,0,308,1,3,228,277,228,314,8,1411,1184
1665,7,3.0.37,0,513,2,92,37,129,0,37,129,199,0,0,308,1,3,295,277,295,314,8,1411,1184
1665,7,5.0.37,0,517,3,62,37,99,0,37,99,199,0,0,308,1,3,163,277,163,314,8,1411,1184
1665,8,0.0.76,0,473,0,84,76,160,0,76,160,199,0,0,308,1,4,315,238,315,314,9,1411,1145
1665,8,1.2.100,0,487,1,98,100,198,78,22,198,199,0,71,308,3,2,183,321,211,350,9,1411,1145
1665,8,2.1.78,1,473,0,30,78,108,76,2,108,199,0,16,308,2,3,189,174,228,236,9,1411,1145
1665,8,3.0.76,0,513,2,92,76,168,0,76,168,199,0,0,308,1,4,295,238,295,314,9,1411,1145
1665,8,5.0.76,0,517,3,62,76,138,0,76,138,199,0,0,308,1,4,163,238,163,314,9,1411,1145
1665,9,0.0.76,1,473,0,84,76,160,0,76,160,199,0,0,308,1,4,315,238,315,314,10,1411,1115
1665,9,1.2.100,0,487,1,98,100,198,78,22,198,199,0,71,308,3,2,183,321,211,350,10,1411,1115
1665,9,2.2.108,0,473,0,78,108,186,108,0,186,199,-8,79,316,3,2,159,321,228,350,10,1411,1115
1665,9,3.0.76,0,513,2,92,76,168,0,76,168,199,0,0,308,1,4,295,238,295,314,10,1411,1115
1665,9,5.0.76,0,517,3,62,76,138,0,76,138,199,0,0,308,1,4,163,238,163,314,10,1411,1115
1665,10,0.1.160,1,473,0,40,160,200,160,0,200,200,-52,68,360,2,4,231,144,315,236,11,1411,1031
1665,10,1.2.100,0,487,1,98,100,198,78,22,198,199,0,71,308,3,2,183,321,211,350,11,1411,1031
1665,10,2.2.108,0,473,0,78,108,186,108,0,186,199,-8,79,316,3,2,159,321,228,350,11,1411,1031
1665,10,3.0.160,0,473,0,92,160,252,0,160,252,252,0,0,308,1,5,295,154,295,314,11,1411,1031
1665,10,5.0.160,0,517,2,62,160,222,0,160,222,222,0,0,308,1,5,163,154,163,314,11,1411,1031
1665,11,0.2.200,0,473,0,50,200,250,200,0,250,250,-100,171,460,3,2,191,321,315,350,12,1411,991
1665,11,1.2.100,0,487,1,98,100,198,78,22,198,200,0,71,360,3,2,183,321,211,350,12,1411,991
1665,11,2.2.108,0,473,0,78,108,186,108,0,186,200,-8,79,368,3,2,159,321,228,350,12,1411,991
1665,11,3.0.160,1,473,0,92,160,252,0,160,252,252,0,0,360,1,5,295,154,295,314,12,1411,991
1665,11,5.0.160,0,517,2,62,160,222,0,160,222,222,0,0,360,1,5,163,154,163,314,12,1411,991
1665,12,0.2.200,0,473,0,50,200,250,200,0,250,252,-100,171,460,3,2,191,321,315,350,13,1411,899
1665,12,1.2.100,0,487,1,98,100,198,78,22,198,252,0,71,360,3,2,183,321,211,350,13,1411,899
1665,12,2.2.108,0,473,0,78,108,186,108,0,186,252,-8,79,368,3,2,159,321,228,350,13,1411,899
1665,12,3.1.252,0,473,0,87,252,339,252,0,339,339,-52,120,412,2,5,203,104,295,236,13,1411,899
1665,12,5.0.252,1,473,0,62,252,314,0,252,314,314,0,0,360,1,6,163,62,163,314,13,1411,899
1665,13,0.2.200,0,473,0,50,200,250,200,0,250,314,-100,171,460,3,2,191,321,315,350,14,1411,837
1665,13,1.2.100,0,487,1,98,100,198,78,22,198,314,0,71,360,3,2,183,321,211,350,14,1411,837
1665,13,2.2.108,0,473,0,78,108,186,108,0,186,314,-8,79,368,3,2,159,321,228,350,14,1411,837
1665,13,3.1.252,1,473,0,87,252,339,252,0,339,339,-52,120,412,2,5,203,104,295,236,14,1411,837
1665,13,5.1.314,0,534,2,17,314,331,314,0,331,331,-114,182,474,2,5,101,104,163,236,14,1411,837
1665,14,0.2.200,0,473,0,50,200,250,200,0,250,339,-100,171,512,3,2,191,321,315,350,15,1411,750
1665,14,1.2.100,0,487,1,98,100,198,78,22,198,339,0,71,412,3,2,183,321,211,350,15,1411,750
1665,14,2.2.108,0,473,0,78,108,186,108,0,186,339,-8,79,420,3,2,159,321,228,350,15,1411,750
1665,14,3.2.339,0,520,2,94,339,433,339,0,433,433,-239,310,651,3,2,116,321,295,350,15,1411,750
1665,14,5.1.339,1,473,0,17,339,356,314,25,356,356,0,120,412,2,6,101,17,163,236,15,1411,750
1665,15,0.2.200,0,473,0,50,200,250,200,0,250,356,-100,171,512,3,2,191,321,315,350,16,1411,733
1665,15,1.2.100,0,487,1,98,100,198,78,22,198,356,0,71,412,3,2,183,321,211,350,16,1411,733
1665,15,2.2.108,1,473,0,78,108,186,108,0,186,356,-8,79,420,3,2,159,321,228,350,16,1411,733
1665,15,3.2.339,0,520,2,94,339,433,339,0,433,433,-239,310,651,3,2,116,321,295,350,16,1411,733
1665,15,5.2.356,0,473,0,1,356,357,356,0,357,357,-256,327,668,3,2,84,321,163,350,16,1411,733
1665,16,0.2.200,0,473,0,50,200,250,200,0,250,356,-14,93,434,3,3,191,243,315,350,17,1411,655
1665,16,1.2.186,0,503,1,98,186,284,78,108,284,356,0,79,420,3,3,183,243,211,350,17,1411,655
1665,16,2.3.186,1,473,0,13,186,199,186,0,199,356,-65,165,485,4,2,81,179,228,200,17,1411,655
1665,16,3.2.339,0,520,2,94,339,433,339,0,433,433,-153,232,573,3,3,116,243,295,350,17,1411,655
1665,16,5.2.356,0,473,0,1,356,357,356,0,357,357,-170,249,590,3,3,84,243,163,350,17,1411,655
1665,17,0.2.200,0,473,0,50,200,250,200,0,250,356,-14,93,499,3,3,191,243,315,350,18,1411,642
1665,17,1.2.186,0,503,1,98,186,284,78,108,284,356,0,79,485,3,3,183,243,211,350,18,1411,642
1665,17,2.4.199,1,473,0,68,199,267,199,0,267,356,0,121,485,5,2,68,233,228,311,18,1411,642
1665,17,3.2.339,0,520,2,94,339,433,339,0,433,433,-153,232,638,3,3,116,243,295,350,18,1411,642
1665,17,5.2.356,0,473,0,1,356,357,356,0,357,357,-170,249,655,3,3,84,243,163,350,18,1411,642
1665,18,0.2.200,1,473,0,50,200,250,200,0,250,356,-14,93,499,3,3,191,243,315,350,19,1411,574
1665,18,1.2.186,0,503,1,98,186,284,78,108,284,356,0,79,485,3,3,183,243,211,350,19,1411,574
1665,18,3.2.339,0,520,2,94,339,433,339,0,433,433,-153,232,638,3,3,116,243,295,350,19,1411,574
1665,18,5.2.356,0,473,0,1,356,357,356,0,357,357,-170,249,655,3,3,84,243,163,350,19,1411,574
1665,19,0.3.250,1,473,0,51,250,301,250,0,301,356,-51,216,550,4,3,141,166,315,200,20,1411,524
1665,19,1.2.250,0,473,0,98,250,348,78,172,348,356,0,93,499,3,4,183,193,211,350,20,1411,524
1665,19,3.2.339,0,617,1,94,339,433,339,0,433,433,-89,182,588,3,4,116,193,295,350,20,1411,524
1665,19,5.2.356,0,473,0,1,356,357,356,0,357,357,-106,199,605,3,4,84,193,163,350,20,1411,524
1665,20,0.4.301,1,473,0,90,301,391,301,0,391,391,-34,155,584,5,3,90,165,315,311,21,1411,473
1665,20,1.2.250,0,473,0,98,250,348,78,172,348,356,0,93,550,3,4,183,193,211,350,21,1411,473
1665,20,3.2.339,0,617,1,94,339,433,339,0,433,433,-89,182,639,3,4,116,193,295,350,21,1411,473
1665,20,5.2.356,0,473,0,1,356,357,356,0,357,357,-106,199,656,3,4,84,193,163,350,21,1411,473
1665,21,1.2.250,1,473,0,98,250,348,78,172,348,391,0,93,584,3,4,183,193,211,350,22,1411,383
1665,21,3.2.339,0,617,1,94,339,433,339,0,433,433,-89,182,673,3,4,116,193,295,350,22,1411,383
1665,21,5.2.356,0,473,0,1,356,357,356,0,357,391,-106,199,690,3,4,84,193,163,350,22,1411,383
1665,22,1.3.348,1,473,0,38,348,386,348,0,386,391,-47,263,631,4,4,85,115,211,200,23,1411,285
1665,22,3.2.348,0,529,1,94,348,442,339,9,442,442,0,93,584,3,5,116,95,295,350,23,1411,285
1665,22,5.2.356,0,473,0,1,356,357,356,0,357,391,-8,101,592,3,5,84,95,163,350,23,1411,285
1665,23,1.4.391,1,473,0,47,391,438,386,5,438,438,0,155,631,5,4,47,75,211,311,24,1411,247
1665,23,3.2.348,0,529,1,94,348,442,339,9,442,442,0,93,631,3,5,116,95,295,350,24,1411,247
1665,23,5.2.356,0,473,0,1,356,357,356,0,357,391,-8,101,639,3,5,84,95,163,350,24,1411,247
1665,24,3.2.348,0,529,1,94,348,442,339,9,442,442,0,93,631,3,5,116,95,295,350,25,1411,200
1665,24,5.2.356,1,473,0,1,356,357,356,0,357,438,-8,101,639,3,5,84,95,163,350,25,1411,200
1665,25,3.2.357,0,473,0,94,357,451,339,18,451,451,0,101,639,3,6,116,94,295,350,26,1411,199
1665,25,5.3.386,1,473,0,58,386,444,357,29,444,444,0,263,639,4,5,83,77,163,200,26,1411,199
1665,26,3.2.357,0,473,0,94,357,451,339,18,451,451,0,101,639,3,6,116,94,295,350,27,1411,141
1665,26,5.4.444,1,473,0,25,444,469,444,0,469,469,-6,161,645,5,5,25,28,163,311,27,1411,141
1665,27,3.2.357,1,473,0,94,357,451,339,18,451,469,0,101,645,3,6,116,94,295,350,28,1411,116
1665,28,3.3.451,1,473,0,19,451,470,451,0,470,470,-7,270,652,4,6,22,19,295,200,29,1411,22
1665,29,3.4.470,1,473,0,3,470,473,470,0,473,473,-1,162,653,5,6,3,3,295,311,30,1411,3
1666,0,0.0.0,0,607,4,97,0,97,0,0,97,97,0,0,0,1,1,259,427,259,427,1,1478,1478
1666,0,1.0.0,0,590,1,96,0,96,0,0,96,96,0,0,0,1,1,309,427,309,427,1,1478,1478
1666,0,2.0.0,0,589,0,85,0,85,0,0,85,85,0,0,0,1,1,256,427,256,427,1,1478,1478
1666,0,3.0.0,1,589,0,45,0,45,0,0,45,45,0,0,0,1,1,254,427,254,427,1,1478,1478
1666,0,4.0.0,0,591,2,37,0,37,0,0,37,37,0,0,0,1,1,136,427,136,427,1,1478,1478
1666,0,5.0.0,0,594,3,67,0,67,0,0,67,67,0,0,0,1,1,264,427,264,427,1,1478,1478
1666,1,0.0.45,0,607,3,97,45,142,0,45,142,142,0,0,0,1,2,259,382,259,427,2,1478,1433
1666,1,1.0.45,0,597,2,96,45,141,0,45,141,141,0,0,0,1,2,309,382,309,427,2,1478,1433
1666,1,2.0.45,0,589,0,85,45,130,0,45,130,130,0,0,0,1,2,256,382,256,427,2,1478,1433
1666,1,3.1.45,1,589,0,26,45,71,45,0,71,71,-45,45,45,2,1,209,238,254,238,2,1478,1433
1666,1,4.0.45,0,591,1,37,45,82,0,45,82,82,0,0,0,1,2,136,382,136,427,2,1478,1433
1666,1,5.0.45,0,589,0,67,45,112,0,45,112,112,0,0,0,1,2,264,382,264,427,2,1478,1433
1666,2,0.0.45,0,607,3,97,45,142,0,45,142,142,0,0,45,1,2,259,382,259,427,3,1478,1407
1666,2,1.0.45,0,597,2,96,45,141,0,45,141,141,0,0,45,1,2,309,382,309,427,3,1478,1407
1666,2,2.0.45,0,589,0,85,45,130,0,45,130,130,0,0,45,1,2,256,382,256,427,3,1478,1407
1666,2,3.2.71,1,589,0,61,71,132,71,0,132,132,-71,71,116,3,1,183,219,254,219,3,1478,1407
1666,2,4.0.45,0,591,1,37,45,82,0,45,82,82,0,0,45,1,2,136,382,136,427,3,1478,1407
1666,2,5.0.45,0,589,0,67,45,112,0,45,112,112,0,0,45,1,2,264,382,264,427,3,1478,1407
1666,3,0.0.45,0,607,3,97,45,142,0,45,142,142,0,0,116,1,2,259,382,259,427,4,1478,1346
1666,3,1.0.45,0,597,2,96,45,141,0,45,141,141,0,0,116,1,2,309,382,309,427,4,1478,1346
1666,3,2.0.45,0,589,0,85,45,130,0,45,130,132,0,0,116,1,2,256,382,256,427,4,1478,1346
1666,3,3.3.132,1,589,0,77,132,209,132,0,209,209,-132,132,248,4,1,122,352,254,352,4,1478,1346
1666,3,4.0.45,0,591,1,37,45,82,0,45,82,132,0,0,116,1,2,136,382,136,427,4,1478,1346
1666,3,5.0.45,0,589,0,67,45,112,0,45,112,132,0,0,116,1,2,264,382,264,427,4,1478,1346
1666,4,0.0.45,0,607,3,97,45,142,0,45,142,209,0,0,248,1,2,259,382,259,427,5,1478,1269
1666,4,1.0.45,0,597,2,96,45,141,0,45,141,209,0,0,248,1,2,309,382,309,427,5,1478,1269
1666,4,2.0.45,0,589,0,85,45,130,0,45,130,209,0,0,248,1,2,256,382,256,427,5,1478,1269
1666,4,3.4.209,1,589,0,45,209,254,209,0,254,254,-209,209,457,5,1,45,242,254,242,5,1478,1269
1666,4,4.0.45,0,591,1,37,45,82,0,45,82,209,0,0,248,1,2,136,382,136,427,5,1478,1269
1666,4,5.0.45,0,589,0,67,45,112,0,45,112,209,0,0,248,1,2,264,382,264,427,5,1478,1269
1666,5,0.0.45,0,607,3,97,45,142,0,45,142,254,0,0,457,1,2,259,382,259,427,6,1478,1224
1666,5,1.0.45,0,597,2,96,45,141,0,45,141,254,0,0,457,1,2,309,382,309,427,6,1478,1224
1666,5,2.0.45,0,589,0,85,45,130,0,45,130,254,0,0,457,1,2,256,382,256,427,6,1478,1224
1666,5,4.0.45,0,591,1,37,45,82,0,45,82,254,0,0,457,1,2,136,382,136,427,6,1478,1224
1666,5,5.0.45,1,589,0,67,45,112,0,45,112,254,0,0,457,1,2,264,382,264,427,6,1478,1224
1666,6,0.0.112,0,600,1,97,112,209,0,112,209,254,0,0,457,1,3,259,315,259,427,7,1478,1157
1666,6,1.0.112,0,589,0,96,112,208,0,112,208,254,0,0,457,1,3,309,315,309,427,7,1478,1157
1666,6,2.0.112,0,589,0,85,112,197,0,112,197,254,0,0,457,1,3,256,315,256,427,7,1478,1157
1666,6,4.0.112,0,589,0,37,112,149,0,112,149,254,0,0,457,1,3,136,315,136,427,7,1478,1157
1666,6,5.1.112,1,589,0,99,112,211,112,0,211,254,-41,86,498,2,2,197,212,264,238,7,1478,1157
1666,7,0.0.112,0,600,1,97,112,209,0,112,209,254,0,0,498,1,3,259,315,259,427,8,1478,1058
1666,7,1.0.112,0,589,0,96,112,208,0,112,208,254,0,0,498,1,3,309,315,309,427,8,1478,1058
1666,7,2.0.112,0,589,0,85,112,197,0,112,197,254,0,0,498,1,3,256,315,256,427,8,1478,1058
1666,7,4.0.112,0,589,0,37,112,149,0,112,149,254,0,0,498,1,3,136,315,136,427,8,1478,1058
1666,7,5.2.211,1,589,0,39,211,250,211,0,250,254,-79,150,577,3,2,98,158,264,219,8,1478,1058
1666,8,0.0.112,0,600,1,97,112,209,0,112,209,254,0,0,577,1,3,259,315,259,427,9,1478,1019
1666,8,1.0.112,0,589,0,96,112,208,0,112,208,254,0,0,577,1,3,309,315,309,427,9,1478,1019
1666,8,2.0.112,0,589,0,85,112,197,0,112,197,254,0,0,577,1,3,256,315,256,427,9,1478,1019
1666,8,4.0.112,0,589,0,37,112,149,0,112,149,254,0,0,577,1,3,136,315,136,427,9,1478,1019
1666,8,5.3.250,1,589,0,43,250,293,250,0,293,293,-41,173,618,4,2,59,275,264,352,9,1478,1019
1666,9,0.0.112,0,600,1,97,112,209,0,112,209,293,0,0,618,1,3,259,315,259,427,10,1478,976
1666,9,1.0.112,0,589,0,96,112,208,0,112,208,293,0,0,618,1,3,309,315,309,427,10,1478,976
1666,9,2.0.112,0,589,0,85,112,197,0,112,197,293,0,0,618,1,3,256,315,256,427,10,1478,976
1666,9,4.0.112,0,589,0,37,112,149,0,112,149,293,0,0,618,1,3,136,315,136,427,10,1478,976
1666,9,5.4.293,1,589,0,16,293,309,293,0,309,309,-39,248,657,5,2,16,197,264,242,10,1478,976
1666,10,0.0.112,0,600,1,97,112,209,0,112,209,309,0,0,657,1,3,259,315,259,427,11,1478,960
1666,10,1.0.112,1,589,0,96,112,208,0,112,208,309,0,0,657,1,3,309,315,309,427,11,1478,960
1666,10,2.0.112,0,589,0,85,112,197,0,112,197,309,0,0,657,1,3,256,315,256,427,11,1478,960
1666,10,4.0.112,0,589,0,37,112,149,0,112,149,309,0,0,657,1,3,136,315,136,427,11,1478,960
1666,11,0.0.208,0,598,1,97,208,305,0,208,305,309,0,0,657,1,4,259,219,259,427,12,1478,864
1666,11,1.1.211,1,589,0,74,211,285,208,3,285,309,0,86,657,2,3,213,113,309,238,12,1478,864
1666,11,2.0.208,0,589,0,85,208,293,0,208,293,309,0,0,657,1,4,256,219,256,427,12,1478,864
1666,11,4.0.208,0,589,0,37,208,245,0,208,245,309,0,0,657,1,4,136,219,136,427,12,1478,864
1666,12,0.0.208,0,598,1,97,208,305,0,208,305,309,0,0,657,1,4,259,219,259,427,13,1478,790
1666,12,1.2.285,1,589,0,4,285,289,285,0,289,309,-35,185,692,3,3,139,119,309,219,13,1478,790
1666,12,2.0.208,0,589,0,85,208,293,0,208,293,309,0,0,657,1,4,256,219,256,427,13,1478,790
1666,12,4.0.208,0,589,0,37,208,245,0,208,245,309,0,0,657,1,4,136,219,136,427,13,1478,790
1666,13,0.0.208,0,598,1,97,208,305,0,208,305,309,0,0,692,1,4,259,219,259,427,14,1478,786
1666,13,1.3.293,1,589,0,79,293,372,289,4,372,372,0,173,692,4,3,135,232,309,352,14,1478,786
1666,13,2.0.208,0,589,0,85,208,293,0,208,293,309,0,0,692,1,4,256,219,256,427,14,1478,786
1666,13,4.0.208,0,589,0,37,208,245,0,208,245,309,0,0,692,1,4,136,219,136,427,14,1478,786
1666,14,0.0.208,0,598,1,97,208,305,0,208,305,372,0,0,692,1,4,259,219,259,427,15,1478,707
1666,14,1.4.372,1,589,0,56,372,428,372,0,428,428,-63,311,755,5,3,56,181,309,242,15,1478,707
1666,14,2.0.208,0,589,0,85,208,293,0,208,293,372,0,0,692,1,4,256,219,256,427,15,1478,707
1666,14,4.0.208,0,589,0,37,208,245,0,208,245,372,0,0,692,1,4,136,219,136,427,15,1478,707
1666,15,0.0.208,0,598,1,97,208,305,0,208,305,428,0,0,755,1,4,259,219,259,427,16,1478,651
1666,15,2.0.208,1,589,0,85,208,293,0,208,293,428,0,0,755,1,4,256,219,256,427,16,1478,651
1666,15,4.0.208,0,589,0,37,208,245,0,208,245,428,0,0,755,1,4,136,219,136,427,16,1478,651
1666,16,0.0.293,0,596,1,97,293,390,0,293,390,428,0,0,755,1,5,259,134,259,427,17,1478,566
1666,16,2.1.293,1,589,0,24,293,317,293,0,317,428,-8,94,763,2,4,171,39,256,238,17,1478,566
1666,16,4.0.293,0,589,0,37,293,330,0,293,330,428,0,0,755,1,5,136,134,136,427,17,1478,566
1666,17,0.0.293,0,596,1,97,293,390,0,293,390,428,0,0,763,1,5,259,134,259,427,18,1478,542
1666,17,2.2.317,1,589,0,32,317,349,317,0,349,428,-28,213,791,3,4,147,115,256,219,18,1478,542
1666,17,4.0.293,0,589,0,37,293,330,0,293,330,428,0,0,763,1,5,136,134,136,427,18,1478,542
1666,18,0.0.293,0,596,1,97,293,390,0,293,390,428,0,0,791,1,5,259,134,259,427,19,1478,510
1666,18,2.3.372,1,589,0,81,372,453,349,23,453,453,0,173,791,4,4,115,153,256,352,19,1478,510
1666,18,4.0.293,0,589,0,37,293,330,0,293,330,428,0,0,791,1,5,136,134,136,427,19,1478,510
1666,19,0.0.293,0,596,1,97,293,390,0,293,390,453,0,0,791,1,5,259,134,259,427,20,1478,429
1666,19,2.4.453,1,589,0,34,453,487,453,0,487,487,-25,336,816,5,4,34,125,256,242,20,1478,429
1666,19,4.0.293,0,589,0,37,293,330,0,293,330,453,0,0,791,1,5,136,134,136,427,20,1478,429
1666,20,0.0.293,0,596,1,97,293,390,0,293,390,487,0,0,816,1,5,259,134,259,427,21,1478,395
1666,20,4.0.293,1,589,0,37,293,330,0,293,330,487,0,0,816,1,5,136,134,136,427,21,1478,395
1666,21,0.0.330,0,589,0,97,330,427,0,330,427,487,0,0,816,1,6,259,97,259,427,22,1478,358
1666,21,4.1.330,1,589,0,7,330,337,330,0,337,487,-13,107,829,2,5,99,15,136,238,22,1478,358
1666,22,0.0.330,0,589,0,97,330,427,0,330,427,487,0,0,829,1,6,259,97,259,427,23,1478,351
1666,22,4.2.349,1,589,0,30,349,379,337,12,379,487,0,213,829,3,5,92,83,136,219,23,1478,351
1666,23,0.0.330,0,589,0,97,330,427,0,330,427,487,0,0,829,1,6,259,97,259,427,24,1478,321
1666,23,4.3.453,1,589,0,14,453,467,379,74,467,487,0,173,829,4,5,62,72,136,352,24,1478,321
1666,24,0.0.330,0,589,0,97,330,427,0,330,427,487,0,0,829,1,6,259,97,259,427,25,1478,307
1666,24,4.4.487,1,589,0,48,487,535,467,20,535,535,0,336,829,5,5,48,91,136,242,25,1478,307
1666,25,0.0.330,1,589,0,97,330,427,0,330,427,535,0,0,829,1,6,259,97,259,427,26,1478,259
1666,26,0.1.427,1,589,0,8,427,435,427,0,435,535,-90,197,919,2,6,162,8,259,238,27,1478,162
1666,27,0.2.435,1,589,0,53,435,488,435,0,488,535,-56,269,975,3,6,154,53,259,219,28,1478,154
1666,28,0.3.488,1,589,0,58,488,546,488,0,546,546,-21,194,996,4,6,101,58,259,352,29,1478,101
1666,29,0.4.546,1,589,0,43,546,589,546,0,589,589,-11,347,1007,5,6,43,43,259,242,30,1478,43
1667,0,0.0.0,1,543,0,11,0,11,0,0,11,11,0,0,0,1,1,302,342,302,342,1,1544,1544
1667,0,1.0.0,0,571,2,72,0,72,0,0,72,72,0,0,0,1,1,210,342,210,342,1,1544,1544
1667,0,2.0.0,0,548,1,31,0,31,0,0,31,31,0,0,0,1,1,281,342,281,342,1,1544,1544
1667,0,3.0.0,0,597,3,98,0,98,0,0,98,98,0,0,0,1,1,313,342,313,342,1,1544,1544
1667,0,4.0.0,0,602,4,59,0,59,0,0,59,59,0,0,0,1,1,173,342,173,342,1,1544,1544
1667,0,5.0.0,0,614,5,71,0,71,0,0,71,71,0,0,0,1,1,265,342,265,342,1,1544,1544
1667,1,0.1.11,1,543,0,75,11,86,11,0,86,86,-11,11,11,2,1,291,341,302,341,2,1544,1533
1667,1,1.0.11,0,543,0,72,11,83,0,11,83,83,0,0,0,1,2,210,331,210,342,2,1544,1533
1667,1,2.0.11,0,557,1,31,11,42,0,11,42,42,0,0,0,1,2,281,331,281,342,2,1544,1533
1667,1,3.0.11,0,577,3,98,11,109,0,11,109,109,0,0,0,1,2,313,331,313,342,2,1544,1533
1667,1,4.0.11,0,570,2,59,11,70,0,11,70,70,0,0,0,1,2,173,331,173,342,2,1544,1533
1667,1,5.0.11,0,577,3,71,11,82,0,11,82,82,0,0,0,1,2,265,331,265,342,2,1544,1533
1667,2,0.2.86,1,543,0,57,86,143,86,0,143,143,-86,86,97,3,1,216,285,302,285,3,1544,1458
1667,2,1.0.11,0,543,0,72,11,83,0,11,83,86,0,0,11,1,2,210,331,210,342,3,1544,1458
1667,2,2.0.11,0,557,1,31,11,42,0,11,42,86,0,0,11,1,2,281,331,281,342,3,1544,1458
1667,2,3.0.11,0,577,3,98,11,109,0,11,109,109,0,0,11,1,2,313,331,313,342,3,1544,1458
1667,2,4.0.11,0,570,2,59,11,70,0,11,70,86,0,0,11,1,2,173,331,173,342,3,1544,1458
1667,2,5.0.11,0,577,3,71,11,82,0,11,82,86,0,0,11,1,2,265,331,265,342,3,1544,1458
1667,3,0.3.143,1,577,3,64,143,207,143,0,207,207,-143,143,240,4,1,159,206,302,206,4,1544,1401
1667,3,1.0.11,0,543,0,72,11,83,0,11,83,143,0,0,97,1,2,210,331,210,342,4,1544,1401
1667,3,2.0.11,0,557,1,31,11,42,0,11,42,143,0,0,97,1,2,281,331,281,342,4,1544,1401
1667,3,3.0.11,0,577,3,98,11,109,0,11,109,143,0,0,97,1,2,313,331,313,342,4,1544,1401
1667,3,4.0.11,0,570,2,59,11,70,0,11,70,143,0,0,97,1,2,173,331,173,342,4,1544,1401
1667,3,5.0.11,0,577,3,71,11,82,0,11,82,143,0,0,97,1,2,265,331,265,342,4,1544,1401
1667,4,0.4.207,1,577,0,95,207,302,207,0,302,302,-207,207,447,5,1,95,370,302,370,5,1544,1337
1667,4,1.0.11,0,577,0,72,11,83,0,11,83,207,0,0,240,1,2,210,331,210,342,5,1544,1337
1667,4,2.0.11,0,577,0,31,11,42,0,11,42,207,0,0,240,1,2,281,331,281,342,5,1544,1337
1667,4,3.0.11,0,577,0,98,11,109,0,11,109,207,0,0,240,1,2,313,331,313,342,5,1544,1337
1667,4,4.0.11,0,577,0,59,11,70,0,11,70,207,0,0,240,1,2,173,331,173,342,5,1544,1337
1667,4,5.0.11,0,577,0,71,11,82,0,11,82,207,0,0,240,1,2,265,331,265,342,5,1544,1337
1667,5,1.0.11,0,577,0,72,11,83,0,11,83,302,0,0,447,1,2,210,331,210,342,6,1544,1242
1667,5,2.0.11,1,577,0,31,11,42,0,11,42,302,0,0,447,1,2,281,331,281,342,6,1544,1242
1667,5,3.0.11,0,577,0,98,11,109,0,11,109,302,0,0,447,1,2,313,331,313,342,6,1544,1242
1667,5,4.0.11,0,577,0,59,11,70,0,11,70,302,0,0,447,1,2,173,331,173,342,6,1544,1242
1667,5,5.0.11,0,577,0,71,11,82,0,11,82,302,0,0,447,1,2,265,331,265,342,6,1544,1242
1667,6,1.0.42,0,577,0,72,42,114,0,42,114,302,0,0,447,1,3,210,300,210,342,7,1544,1211
1667,6,2.1.86,1,577,0,17,86,103,42,44,103,302,0,11,447,2,2,250,266,281,341,7,1544,1211
1667,6,3.0.42,0,577,0,98,42,140,0,42,140,302,0,0,447,1,3,313,300,313,342,7,1544,1211
1667,6,4.0.42,0,577,0,59,42,101,0,42,101,302,0,0,447,1,3,173,300,173,342,7,1544,1211
1667,6,5.0.42,0,577,0,71,42,113,0,42,113,302,0,0,447,1,3,265,300,265,342,7,1544,1211
1667,7,1.0.42,0,577,0,72,42,114,0,42,114,302,0,0,447,1,3,210,300,210,342,8,1544,1194
1667,7,2.2.143,1,577,0,84,143,227,103,40,227,302,0,86,447,3,2,233,228,281,285,8,1544,1194
1667,7,3.0.42,0,577,0,98,42,140,0,42,140,302,0,0,447,1,3,313,300,313,342,8,1544,1194
1667,7,4.0.42,0,577,0,59,42,101,0,42,101,302,0,0,447,1,3,173,300,173,342,8,1544,1194
1667,7,5.0.42,0,577,0,71,42,113,0,42,113,302,0,0,447,1,3,265,300,265,342,8,1544,1194
1667,8,1.0.42,0,577,0,72,42,114,0,42,114,302,0,0,447,1,3,210,300,210,342,9,1544,1110
1667,8,2.3.227,1,577,0,50,227,277,227,0,277,302,-20,163,467,4,2,149,142,281,206,9,1544,1110
1667,8,3.0.42,0,577,0,98,42,140,0,42,140,302,0,0,447,1,3,313,300,313,342,9,1544,1110
1667,8,4.0.42,0,577,0,59,42,101,0,42,101,302,0,0,447,1,3,173,300,173,342,9,1544,1110
1667,8,5.0.42,0,577,0,71,42,113,0,42,113,302,0,0,447,1,3,265,300,265,342,9,1544,1110
1667,9,1.0.42,0,577,0,72,42,114,0,42,114,302,0,0,467,1,3,210,300,210,342,10,1544,1060
1667,9,2.4.302,1,577,0,99,302,401,277,25,401,401,0,207,467,5,2,99,275,281,370,10,1544,1060
1667,9,3.0.42,0,577,0,98,42,140,0,42,140,302,0,0,467,1,3,313,300,313,342,10,1544,1060
1667,9,4.0.42,0,577,0,59,42,101,0,42,101,302,0,0,467,1,3,173,300,173,342,10,1544,1060
1667,9,5.0.42,0,577,0,71,42,113,0,42,113,302,0,0,467,1,3,265,300,265,342,10,1544,1060
1667,10,1.0.42,0,577,0,72,42,114,0,42,114,401,0,0,467,1,3,210,300,210,342,11,1544,961
1667,10,3.0.42,0,577,0,98,42,140,0,42,140,401,0,0,467,1,3,313,300,313,342,11,1544,961
1667,10,4.0.42,0,577,0,59,42,101,0,42,101,401,0,0,467,1,3,173,300,173,342,11,1544,961
1667,10,5.0.42,1,577,0,71,42,113,0,42,113,401,0,0,467,1,3,265,300,265,342,11,1544,961
1667,11,1.0.113,0,577,0,72,113,185,0,113,185,401,0,0,467,1,4,210,229,210,342,12,1544,890
1667,11,3.0.113,1,577,0,98,113,211,0,113,211,401,0,0,467,1,4,313,229,313,342,12,1544,890
1667,11,4.0.113,0,577,0,59,113,172,0,113,172,401,0,0,467,1,4,173,229,173,342,12,1544,890
1667,11,5.1.113,0,577,0,83,113,196,113,0,196,401,-10,21,477,2,3,194,249,265,341,12,1544,890
1667,12,1.0.211,1,577,0,72,211,283,0,211,283,401,0,0,467,1,5,210,131,210,342,13,1544,792
1667,12,3.1.211,0,577,0,64,211,275,211,0,275,401,-108,119,575,2,3,215,249,313,341,13,1544,792
1667,12,4.0.211,0,577,0,59,211,270,0,211,270,401,0,0,467,1,5,173,131,173,342,13,1544,792
1667,12,5.1.113,0,577,0,83,113,196,113,0,196,401,-10,21,477,2,3,194,249,265,341,13,1544,792
1667,13,1.1.283,0,577,0,43,283,326,283,0,326,401,-180,191,647,2,3,138,249,210,341,14,1544,720
1667,13,3.1.211,0,577,0,64,211,275,211,0,275,401,-108,119,575,2,3,215,249,313,341,14,1544,720
1667,13,4.0.283,1,577,0,59,283,342,0,283,342,401,0,0,467,1,6,173,59,173,342,14,1544,720
1667,13,5.1.113,0,577,0,83,113,196,113,0,196,401,-10,21,477,2,3,194,249,265,341,14,1544,720
1667,14,1.1.283,0,577,0,43,283,326,283,0,326,401,-180,191,647,2,3,138,249,210,341,15,1544,661
1667,14,3.1.211,0,577,0,64,211,275,211,0,275,401,-108,119,575,2,3,215,249,313,341,15,1544,661
1667,14,4.1.342,0,577,0,59,342,401,342,0,401,401,-239,250,706,2,3,114,249,173,341,15,1544,661
1667,14,5.1.113,1,577,0,83,113,196,113,0,196,401,-10,21,477,2,3,194,249,265,341,15,1544,661
1667,15,1.1.283,0,577,0,43,283,326,283,0,326,401,-87,108,564,2,4,138,166,210,341,16,1544,578
1667,15,3.1.211,0,577,0,64,211,275,211,0,275,401,-15,36,492,2,4,215,166,313,341,16,1544,578
1667,15,4.1.342,0,577,0,59,342,401,342,0,401,401,-146,167,623,2,4,114,166,173,341,16,1544,578
1667,15,5.2.227,1,577,0,77,227,304,196,31,304,401,0,86,477,3,3,111,144,265,285,16,1544,578
1667,16,1.1.283,0,577,0,43,283,326,283,0,326,401,-87,108,564,2,4,138,166,210,341,17,1544,501
1667,16,3.1.211,0,577,0,64,211,275,211,0,275,401,-15,36,492,2,4,215,166,313,341,17,1544,501
1667,16,4.1.342,0,577,0,59,342,401,342,0,401,401,-146,167,623,2,4,114,166,173,341,17,1544,501
1667,16,5.3.304,1,577,0,27,304,331,304,0,331,401,-27,190,504,4,3,34,92,265,206,17,1544,501
1667,17,1.1.283,0,577,0,43,283,326,283,0,326,401,-87,108,591,2,4,138,166,210,341,18,1544,474
1667,17,3.1.211,0,577,0,64,211,275,211,0,275,401,-15,36,519,2,4,215,166,313,341,18,1544,474
1667,17,4.1.342,0,577,0,59,342,401,342,0,401,401,-146,167,650,2,4,114,166,173,341,18,1544,474
1667,17,5.4.401,1,577,0,7,401,408,331,70,408,408,0,207,504,5,3,7,176,265,370,18,1544,474
1667,18,1.1.283,0,577,0,43,283,326,283,0,326,408,-87,108,591,2,4,138,166,210,341,19,1544,467
1667,18,3.1.211,1,577,0,64,211,275,211,0,275,408,-15,36,519,2,4,215,166,313,341,19,1544,467
1667,18,4.1.342,0,577,0,59,342,401,342,0,401,408,-146,167,650,2,4,114,166,173,341,19,1544,467
1667,19,1.1.283,0,577,0,43,283,326,283,0,326,408,-8,44,527,2,5,138,102,210,341,20,1544,403
1667,19,3.2.304,1,577,0,28,304,332,275,29,332,408,0,86,519,3,4,151,67,313,285,20,1544,403
1667,19,4.1.342,0,577,0,59,342,401,342,0,401,408,-67,103,586,2,5,114,102,173,341,20,1544,403
1667,20,1.1.283,0,577,0,43,283,326,283,0,326,408,-8,44,527,2,5,138,102,210,341,21,1544,375
1667,20,3.3.332,1,577,0,37,332,369,332,0,369,408,-1,191,520,4,4,123,65,313,206,21,1544,375
1667,20,4.1.342,0,577,0,59,342,401,342,0,401,408,-67,103,586,2,5,114,102,173,341,21,1544,375
1667,21,1.1.283,0,577,0,43,283,326,283,0,326,408,-8,44,528,2,5,138,102,210,341,22,1544,338
1667,21,3.4.408,1,577,0,86,408,494,369,39,494,494,0,207,520,5,4,86,169,313,370,22,1544,338
1667,21,4.1.342,0,577,0,59,342,401,342,0,401,408,-67,103,587,2,5,114,102,173,341,22,1544,338
1667,22,1.1.283,1,577,0,43,283,326,283,0,326,494,-8,44,528,2,5,138,102,210,341,23,1544,252
1667,22,4.1.342,0,577,0,59,342,401,342,0,401,494,-67,103,587,2,5,114,102,173,341,23,1544,252
1667,23,1.2.332,1,577,0,9,332,341,326,6,341,494,0,86,528,3,5,95,39,210,285,24,1544,209
1667,23,4.1.342,0,577,0,59,342,401,342,0,401,494,-16,60,544,2,6,114,59,173,341,24,1544,209
1667,24,1.3.369,1,577,0,21,369,390,341,28,390,494,0,191,528,4,5,86,28,210,206,25,1544,200
1667,24,4.1.342,0,577,0,59,342,401,342,0,401,494,-16,60,544,2,6,114,59,173,341,25,1544,200
1667,25,1.4.494,1,577,0,65,494,559,390,104,559,559,0,207,528,5,5,65,83,210,370,26,1544,179
1667,25,4.1.342,0,577,0,59,342,401,342,0,401,494,-16,60,544,2,6,114,59,173,341,26,1544,179
1667,26,4.1.342,1,577,0,59,342,401,342,0,401,559,-16,60,544,2,6,114,59,173,341,27,1544,114
1667,27,4.2.401,1,577,0,30,401,431,401,0,431,559,-60,146,604,3,6,55,30,173,285,28,1544,55
1667,28,4.3.431,1,577,0,7,431,438,431,0,438,559,-41,232,645,4,6,25,7,173,206,29,1544,25
1667,29,4.4.559,1,577,0,18,559,577,438,121,577,577,0,207,645,5,6,18,18,173,370,30,1544,18
1668,0,0.0.0,1,560,0,24,0,24,0,0,24,24,0,0,0,1,1,246,357,246,357,1,1514,1514
1668,0,1.0.0,0,571,1,48,0,48,0,0,48,48,0,0,0,1,1,211,357,211,357,1,1514,1514
1668,0,2.0.0,0,578,2,76,0,76,0,0,76,76,0,0,0,1,1,207,357,207,357,1,1514,1514
1668,0,3.0.0,0,612,3,52,0,52,0,0,52,52,0,0,0,1,1,273,357,273,357,1,1514,1514
1668,0,4.0.0,0,621,4,81,0,81,0,0,81,81,0,0,0,1,1,310,357,310,357,1,1514,1514
1668,0,5.0.0,0,578,2,76,0,76,0,0,76,76,0,0,0,1,1,267,357,267,357,1,1514,1514
1668,1,0.1.24,1,560,0,43,24,67,24,0,67,67,-24,24,24,2,1,222,145,246,145,2,1514,1490
1668,1,1.0.24,0,560,0,48,24,72,0,24,72,72,0,0,0,1,2,211,333,211,357,2,1514,1490
1668,1,2.0.24,0,578,1,76,24,100,0,24,100,100,0,0,0,1,2,207,333,207,357,2,1514,1490
1668,1,3.0.24,0,602,3,52,24,76,0,24,76,76,0,0,0,1,2,273,333,273,357,2,1514,1490
1668,1,4.0.24,0,612,4,81,24,105,0,24,105,105,0,0,0,1,2,310,333,310,357,2,1514,1490
1668,1,5.0.24,0,593,2,76,24,100,0,24,100,100,0,0,0,1,2,267,333,267,357,2,1514,1490
1668,2,0.2.67,1,582,2,60,67,127,67,0,127,127,-67,67,91,3,1,179,254,246,254,3,1514,1447
1668,2,1.0.24,0,560,0,48,24,72,0,24,72,72,0,0,24,1,2,211,333,211,357,3,1514,1447
1668,2,2.0.24,0,578,1,76,24,100,0,24,100,100,0,0,24,1,2,207,333,207,357,3,1514,1447
1668,2,3.0.24,0,602,4,52,24,76,0,24,76,76,0,0,24,1,2,273,333,273,357,3,1514,1447
1668,2,4.0.24,0,612,5,81,24,105,0,24,105,105,0,0,24,1,2,310,333,310,357,3,1514,1447
1668,2,5.0.24,0,593,3,76,24,100,0,24,100,100,0,0,24,1,2,267,333,267,357,3,1514,1447
1668,3,0.3.127,1,597,2,71,127,198,127,0,198,198,-127,127,218,4,1,119,359,246,359,4,1514,1387
1668,3,1.0.24,0,597,2,48,24,72,0,24,72,127,0,0,91,1,2,211,333,211,357,4,1514,1387
1668,3,2.0.24,0,582,0,76,24,100,0,24,100,127,0,0,91,1,2,207,333,207,357,4,1514,1387
1668,3,3.0.24,0,602,3,52,24,76,0,24,76,127,0,0,91,1,2,273,333,273,357,4,1514,1387
1668,3,4.0.24,0,612,4,81,24,105,0,24,105,127,0,0,91,1,2,310,333,310,357,4,1514,1387
1668,3,5.0.24,0,593,1,76,24,100,0,24,100,127,0,0,91,1,2,267,333,267,357,4,1514,1387
1668,4,0.4.198,1,597,0,48,198,246,198,0,246,246,-198,198,416,5,1,48,399,246,399,5,1514,1316
1668,4,1.0.24,0,597,0,48,24,72,0,24,72,198,0,0,218,1,2,211,333,211,357,5,1514,1316
1668,4,2.0.24,0,597,0,76,24,100,0,24,100,198,0,0,218,1,2,207,333,207,357,5,1514,1316
1668,4,3.0.24,0,602,1,52,24,76,0,24,76,198,0,0,218,1,2,273,333,273,357,5,1514,1316
1668,4,4.0.24,0,612,2,81,24,105,0,24,105,198,0,0,218,1,2,310,333,310,357,5,1514,1316
1668,4,5.0.24,0,597,0,76,24,100,0,24,100,198,0,0,218,1,2,267,333,267,357,5,1514,1316
1668,5,1.0.24,0,597,0,48,24,72,0,24,72,246,0,0,416,1,2,211,333,211,357,6,1514,1268
1668,5,2.0.24,0,597,0,76,24,100,0,24,100,246,0,0,416,1,2,207,333,207,357,6,1514,1268
1668,5,3.0.24,1,602,1,52,24,76,0,24,76,246,0,0,416,1,2,273,333,273,357,6,1514,1268
1668,5,4.0.24,0,612,2,81,24,105,0,24,105,246,0,0,416,1,2,310,333,310,357,6,1514,1268
1668,5,5.0.24,0,597,0,76,24,100,0,24,100,246,0,0,416,1,2,267,333,267,357,6,1514,1268
1668,6,1.0.76,0,612,1,48,76,124,0,76,124,246,0,0,416,1,3,211,281,211,357,7,1514,1216
1668,6,2.0.76,0,621,2,76,76,152,0,76,152,246,0,0,416,1,3,207,281,207,357,7,1514,1216
1668,6,3.1.76,1,602,0,3,76,79,76,0,79,246,-9,33,425,2,2,221,102,273,145,7,1514,1216
1668,6,4.0.76,0,649,3,81,76,157,0,76,157,246,0,0,416,1,3,310,281,310,357,7,1514,1216
1668,6,5.0.76,0,602,0,76,76,152,0,76,152,246,0,0,416,1,3,267,281,267,357,7,1514,1216
1668,7,1.0.76,0,612,1,48,76,124,0,76,124,246,0,0,425,1,3,211,281,211,357,8,1514,1213
1668,7,2.0.76,0,621,2,76,76,152,0,76,152,246,0,0,425,1,3,207,281,207,357,8,1514,1213
1668,7,3.2.127,1,602,0,95,127,222,79,48,222,246,0,67,425,3,2,218,194,273,254,8,1514,1213
1668,7,4.0.76,0,649,3,81,76,157,0,76,157,246,0,0,425,1,3,310,281,310,357,8,1514,1213
1668,7,5.0.76,0,602,0,76,76,152,0,76,152,246,0,0,425,1,3,267,281,267,357,8,1514,1213
1668,8,1.0.76,0,629,1,48,76,124,0,76,124,246,0,0,425,1,3,211,281,211,357,9,1514,1118
1668,8,2.0.76,0,629,1,76,76,152,0,76,152,246,0,0,425,1,3,207,281,207,357,9,1514,1118
1668,8,3.3.222,1,668,3,95,222,317,222,0,317,317,-24,151,449,4,2,123,288,273,359,9,1514,1118
1668,8,4.0.76,0,652,2,81,76,157,0,76,157,246,0,0,425,1,3,310,281,310,357,9,1514,1118
1668,8,5.0.76,0,602,0,76,76,152,0,76,152,246,0,0,425,1,3,267,281,267,357,9,1514,1118
1668,9,1.0.76,0,668,0,48,76,124,0,76,124,317,0,0,449,1,3,211,281,211,357,10,1514,1023
1668,9,2.0.76,0,668,0,76,76,152,0,76,152,317,0,0,449,1,3,207,281,207,357,10,1514,1023
1668,9,3.4.317,1,668,0,28,317,345,317,0,345,345,-71,269,520,5,2,28,351,273,399,10,1514,1023
1668,9,4.0.76,0,668,0,81,76,157,0,76,157,317,0,0,449,1,3,310,281,310,357,10,1514,1023
1668,9,5.0.76,0,668,0,76,76,152,0,76,152,317,0,0,449,1,3,267,281,267,357,10,1514,1023
1668,10,1.0.76,0,668,0,48,76,124,0,76,124,345,0,0,520,1,3,211,281,211,357,11,1514,995
1668,10,2.0.76,0,668,0,76,76,152,0,76,152,345,0,0,520,1,3,207,281,207,357,11,1514,995
1668,10,4.0.76,1,668,0,81,76,157,0,76,157,345,0,0,520,1,3,310,281,310,357,11,1514,995
1668,10,5.0.76,0,668,0,76,76,152,0,76,152,345,0,0,520,1,3,267,281,267,357,11,1514,995
1668,11,1.0.157,0,671,1,48,157,205,0,157,205,345,0,0,520,1,4,211,200,211,357,12,1514,914
1668,11,2.0.157,0,668,0,76,157,233,0,157,233,345,0,0,520,1,4,207,200,207,357,12,1514,914
1668,11,4.1.157,1,668,0,11,157,168,157,0,168,345,-78,111,598,2,3,229,99,310,145,12,1514,914
1668,11,5.0.157,0,668,0,76,157,233,0,157,233,345,0,0,520,1,4,267,200,267,357,12,1514,914
1668,12,1.0.157,0,671,1,48,157,205,0,157,205,345,0,0,598,1,4,211,200,211,357,13,1514,903
1668,12,2.0.157,0,668,0,76,157,233,0,157,233,345,0,0,598,1,4,207,200,207,357,13,1514,903
1668,12,4.2.222,1,668,0,31,222,253,168,54,253,345,0,67,598,3,3,218,99,310,254,13,1514,903
1668,12,5.0.157,0,668,0,76,157,233,0,157,233,345,0,0,598,1,4,267,200,267,357,13,1514,903
1668,13,1.0.157,0,671,1,48,157,205,0,157,205,345,0,0,598,1,4,211,200,211,357,14,1514,872
1668,13,2.0.157,0,668,0,76,157,233,0,157,233,345,0,0,598,1,4,207,200,207,357,14,1514,872
1668,13,4.3.317,1,739,2,99,317,416,253,64,416,416,0,151,598,4,3,187,193,310,359,14,1514,872
1668,13,5.0.157,0,668,0,76,157,233,0,157,233,345,0,0,598,1,4,267,200,267,357,14,1514,872
1668,14,1.0.157,1,739,0,48,157,205,0,157,205,416,0,0,598,1,4,211,200,211,357,15,1514,773
1668,14,2.0.157,0,739,0,76,157,233,0,157,233,416,0,0,598,1,4,207,200,207,357,15,1514,773
1668,14,4.4.416,0,739,0,88,416,504,416,0,504,504,-71,340,669,5,3,88,323,310,399,15,1514,773
1668,14,5.0.157,0,739,0,76,157,233,0,157,233,416,0,0,598,1,4,267,200,267,357,15,1514,773
1668,15,1.1.205,1,739,0,11,205,216,205,0,216,416,-37,148,635,2,4,163,88,211,145,16,1514,725
1668,15,2.0.205,0,739,0,76,205,281,0,205,281,416,0,0,598,1,5,207,152,207,357,16,1514,725
1668,15,4.4.416,0,739,0,88,416,504,416,0,504,504,-71,340,669,5,3,88,323,310,399,16,1514,725
1668,15,5.0.205,0,739,0,76,205,281,0,205,281,416,0,0,598,1,5,267,152,267,357,16,1514,725
1668,16,1.2.253,1,739,0,15,253,268,216,37,268,416,0,67,635,3,4,152,68,211,254,17,1514,714
1668,16,2.0.205,0,739,0,76,205,281,0,205,281,416,0,0,635,1,5,207,152,207,357,17,1514,714
1668,16,4.4.416,0,739,0,88,416,504,416,0,504,504,-71,340,706,5,3,88,323,310,399,17,1514,714
1668,16,5.0.205,0,739,0,76,205,281,0,205,281,416,0,0,635,1,5,267,152,267,357,17,1514,714
1668,17,1.3.416,1,739,0,63,416,479,268,148,479,479,0,151,635,4,4,137,94,211,359,18,1514,699
1668,17,2.0.205,0,739,0,76,205,281,0,205,281,416,0,0,635,1,5,207,152,207,357,18,1514,699
1668,17,4.4.416,0,739,0,88,416,504,416,0,504,504,-71,340,706,5,3,88,323,310,399,18,1514,699
1668,17,5.0.205,0,739,0,76,205,281,0,205,281,416,0,0,635,1,5,267,152,267,357,18,1514,699
1668,18,1.4.479,0,802,1,74,479,553,479,0,553,553,-134,403,769,5,3,74,323,211,399,19,1514,636
1668,18,2.0.205,0,739,0,76,205,281,0,205,281,479,0,0,635,1,5,207,152,207,357,19,1514,636
1668,18,4.4.416,0,739,0,88,416,504,416,0,504,504,-71,340,706,5,3,88,323,310,399,19,1514,636
1668,18,5.0.205,1,739,0,76,205,281,0,205,281,479,0,0,635,1,5,267,152,267,357,19,1514,636
1668,19,1.4.479,0,802,1,74,479,553,479,0,553,553,-134,403,769,5,3,74,323,211,399,20,1514,560
1668,19,2.0.281,1,739,0,76,281,357,0,281,357,479,0,0,635,1,6,207,76,207,357,20,1514,560
1668,19,4.4.416,0,739,0,88,416,504,416,0,504,504,-71,340,706,5,3,88,323,310,399,20,1514,560
1668,19,5.1.281,0,739,0,66,281,347,281,0,347,479,-65,213,700,2,5,191,77,267,145,20,1514,560
1668,20,1.4.479,0,802,1,74,479,553,479,0,553,553,-134,403,769,5,3,74,323,211,399,21,1514,484
1668,20,2.1.357,0,739,0,11,357,368,357,0,368,479,-141,289,776,2,5,131,77,207,145,21,1514,484
1668,20,4.4.416,0,739,0,88,416,504,416,0,504,504,-71,340,706,5,3,88,323,310,399,21,1514,484
1668,20,5.1.281,1,739,0,66,281,347,281,0,347,479,-65,213,700,2,5,191,77,267,145,21,1514,484
1668,21,1.4.479,0,802,1,74,479,553,479,0,553,553,-134,403,834,5,3,74,323,211,399,22,1514,418
1668,21,2.1.357,0,739,0,11,357,368,357,0,368,479,-10,223,710,2,6,131,11,207,145,22,1514,418
1668,21,4.4.416,0,739,0,88,416,504,416,0,504,504,-71,340,771,5,3,88,323,310,399,22,1514,418
1668,21,5.2.347,1,739,0,16,347,363,347,0,363,479,-79,146,779,3,5,125,53,267,254,22,1514,418
1668,22,1.4.479,0,802,1,74,479,553,479,0,553,553,-134,403,913,5,3,74,323,211,399,23,1514,402
1668,22,2.1.357,0,739,0,11,357,368,357,0,368,479,-10,223,789,2,6,131,11,207,145,23,1514,402
1668,22,4.4.416,0,739,0,88,416,504,416,0,504,504,-71,340,850,5,3,88,323,310,399,23,1514,402
1668,22,5.3.479,1,739,0,12,479,491,363,116,491,491,0,151,779,4,5,109,31,267,359,23,1514,402
1668,23,1.4.479,0,802,1,74,479,553,479,0,553,553,-134,403,913,5,3,74,323,211,399,24,1514,390
1668,23,2.1.357,1,739,0,11,357,368,357,0,368,491,-10,223,789,2,6,131,11,207,145,24,1514,390
1668,23,4.4.416,0,739,0,88,416,504,416,0,504,504,-71,340,850,5,3,88,323,310,399,24,1514,390
1668,23,5.4.491,0,814,2,97,491,588,491,0,588,588,-146,415,925,5,3,97,323,267,399,24,1514,390
1668,24,1.4.479,0,802,1,74,479,553,479,0,553,553,-134,403,923,5,3,74,323,211,399,25,1514,379
1668,24,2.2.368,1,739,0,37,368,405,368,0,405,491,-5,151,794,3,6,120,37,207,254,25,1514,379
1668,24,4.4.416,0,739,0,88,416,504,416,0,504,504,-71,340,860,5,3,88,323,310,399,25,1514,379
1668,24,5.4.491,0,814,2,97,491,588,491,0,588,588,-146,415,935,5,3,97,323,267,399,25,1514,379
1668,25,1.4.479,0,802,1,74,479,553,479,0,553,553,-134,403,928,5,3,74,323,211,399,26,1514,342
1668,25,2.3.491,1,739,0,19,491,510,405,86,510,510,0,151,794,4,6,83,19,207,359,26,1514,342
1668,25,4.4.416,0,739,0,88,416,504,416,0,504,504,-71,340,865,5,3,88,323,310,399,26,1514,342
1668,25,5.4.491,0,814,2,97,491,588,491,0,588,588,-146,415,940,5,3,97,323,267,399,26,1514,342
1668,26,1.4.479,0,802,2,74,479,553,479,0,553,553,-134,403,928,5,3,74,323,211,399,27,1514,323
1668,26,2.4.510,0,745,1,64,510,574,510,0,574,574,-165,434,959,5,3,64,323,207,399,27,1514,323
1668,26,4.4.416,1,739,0,88,416,504,416,0,504,510,-71,340,865,5,3,88,323,310,399,27,1514,323
1668,26,5.4.491,0,814,3,97,491,588,491,0,588,588,-146,415,940,5,3,97,323,267,399,27,1514,323
1668,27,1.4.504,1,739,0,74,504,578,479,25,578,578,0,340,865,5,4,74,235,211,399,28,1514,235
1668,27,2.4.510,0,745,1,64,510,574,510,0,574,574,-6,346,871,5,4,64,235,207,399,28,1514,235
1668,27,5.4.504,0,739,0,97,504,601,491,13,601,601,0,340,865,5,4,97,235,267,399,28,1514,235
1668,28,2.4.578,1,739,0,64,578,642,510,68,642,642,0,340,865,5,5,64,161,207,399,29,1514,161
1668,28,5.4.578,0,739,0,97,578,675,491,87,675,675,0,340,865,5,5,97,161,267,399,29,1514,161
1668,29,5.4.642,1,739,0,97,642,739,491,151,739,739,0,340,865,5,6,97,97,267,399,30,1514,97
1669,0,0.0.0,0,558,4,37,0,37,0,0,37,37,0,0,0,1,1,190,174,190,174,1,1483,1483
1669,0,1.0.0,0,545,3,24,0,24,0,0,24,24,0,0,0,1,1,210,174,210,174,1,1483,1483
1669,0,2.0.0,0,533,2,23,0,23,0,0,23,23,0,0,0,1,1,234,174,234,174,1,1483,1483
1669,0,3.0.0,0,524,1,6,0,6,0,0,6,6,0,0,0,1,1,232,174,232,174,1,1483,1483
1669,0,4.0.0,1,521,0,3,0,3,0,0,3,3,0,0,0,1,1,249,174,249,174,1,1483,1483
1669,0,5.0.0,0,602,5,81,0,81,0,0,81,81,0,0,0,1,1,368,174,368,174,1,1483,1483
1669,1,0.0.3,0,539,3,37,3,40,0,3,40,40,0,0,0,1,2,190,171,190,174,2,1483,1480
1669,1,1.0.3,0,528,2,24,3,27,0,3,27,27,0,0,0,1,2,210,171,210,174,2,1483,1480
1669,1,2.0.3,0,527,1,23,3,26,0,3,26,26,0,0,0,1,2,234,171,234,174,2,1483,1480
1669,1,3.0.3,1,521,0,6,3,9,0,3,9,9,0,0,0,1,2,232,171,232,174,2,1483,1480
1669,1,4.1.3,0,521,0,63,3,66,3,0,66,66,-3,3,3,2,1,246,246,249,246,2,1483,1480
1669,1,5.0.3,0,545,4,81,3,84,0,3,84,84,0,0,0,1,2,368,171,368,174,2,1483,1480
1669,2,0.0.9,0,536,3,37,9,46,0,9,46,46,0,0,0,1,3,190,165,190,174,3,1483,1474
1669,2,1.0.9,0,528,2,24,9,33,0,9,33,33,0,0,0,1,3,210,165,210,174,3,1483,1474
1669,2,2.0.9,1,527,1,23,9,32,0,9,32,32,0,0,0,1,3,234,165,234,174,3,1483,1474
1669,2,3.1.9,0,527,1,41,9,50,9,0,50,50,-9,9,9,2,1,226,246,232,246,3,1483,1474
1669,2,4.1.3,0,521,0,63,3,66,3,0,66,66,-3,3,3,2,1,246,246,249,246,3,1483,1474
1669,2,5.0.9,0,521,0,81,9,90,0,9,90,90,0,0,0,1,3,368,165,368,174,3,1483,1474
1669,3,0.0.32,0,536,1,37,32,69,0,32,69,69,0,0,0,1,4,190,142,190,174,4,1483,1451
1669,3,1.0.32,1,536,1,24,32,56,0,32,56,56,0,0,0,1,4,210,142,210,174,4,1483,1451
1669,3,2.1.32,0,542,2,4,32,36,32,0,36,36,-32,32,32,2,1,211,246,234,246,4,1483,1451
1669,3,3.1.9,0,527,0,41,9,50,9,0,50,50,-9,9,9,2,1,226,246,232,246,4,1483,1451
1669,3,4.1.3,0,527,0,63,3,66,3,0,66,66,-3,3,3,2,1,246,246,249,246,4,1483,1451
1669,3,5.0.32,0,527,0,81,32,113,0,32,113,113,0,0,0,1,4,368,142,368,174,4,1483,1451
1669,4,0.0.56,0,536,0,37,56,93,0,56,93,93,0,0,0,1,5,190,118,190,174,5,1483,1427
1669,4,1.1.56,0,559,3,78,56,134,56,0,134,134,-56,56,56,2,1,186,246,210,246,5,1483,1427
1669,4,2.1.32,0,542,2,4,32,36,32,0,36,56,-32,32,32,2,1,211,246,234,246,5,1483,1427
1669,4,3.1.9,0,536,0,41,9,50,9,0,50,56,-9,9,9,2,1,226,246,232,246,5,1483,1427
1669,4,4.1.3,0,539,1,63,3,66,3,0,66,66,-3,3,3,2,1,246,246,249,246,5,1483,1427
1669,4,5.0.56,1,536,0,81,56,137,0,56,137,137,0,0,0,1,5,368,118,368,174,5,1483,1427
1669,5,0.0.137,1,536,0,37,137,174,0,137,174,174,0,0,0,1,6,190,37,190,174,6,1483,1346
1669,5,1.1.56,0,559,4,78,56,134,56,0,134,137,-56,56,56,2,1,186,246,210,246,6,1483,1346
1669,5,2.1.32,0,542,2,4,32,36,32,0,36,137,-32,32,32,2,1,211,246,234,246,6,1483,1346
1669,5,3.1.9,0,536,0,41,9,50,9,0,50,137,-9,9,9,2,1,226,246,232,246,6,1483,1346
1669,5,4.1.3,0,539,1,63,3,66,3,0,66,137,-3,3,3,2,1,246,246,249,246,6,1483,1346
1669,5,5.1.137,0,543,3,49,137,186,137,0,186,186,-137,137,137,2,1,287,246,368,246,6,1483,1346
1669,6,0.1.174,0,539,1,11,174,185,174,0,185,185,-174,174,174,2,1,153,246,190,246,7,1483,1309
1669,6,1.1.56,0,559,4,78,56,134,56,0,134,174,-56,56,56,2,1,186,246,210,246,7,1483,1309
1669,6,2.1.32,1,542,2,4,32,36,32,0,36,174,-32,32,32,2,1,211,246,234,246,7,1483,1309
1669,6,3.1.9,0,536,0,41,9,50,9,0,50,174,-9,9,9,2,1,226,246,232,246,7,1483,1309
1669,6,4.1.3,0,539,1,63,3,66,3,0,66,174,-3,3,3,2,1,246,246,249,246,7,1483,1309
1669,6,5.1.137,0,543,3,49,137,186,137,0,186,186,-137,137,137,2,1,287,246,368,246,7,1483,1309
1669,7,0.1.174,0,556,2,11,174,185,174,0,185,185,-138,170,170,2,2,153,242,190,246,8,1483,1305
1669,7,1.1.56,0,559,3,78,56,134,56,0,134,174,-20,52,52,2,2,186,242,210,246,8,1483,1305
1669,7,2.2.36,0,542,0,90,36,126,36,0,126,174,-36,36,68,3,1,207,321,234,321,8,1483,1305
1669,7,3.1.36,1,542,0,41,36,77,9,27,77,174,0,32,32,2,2,226,242,232,246,8,1483,1305
1669,7,4.1.36,0,550,1,63,36,99,3,33,99,174,0,32,32,2,2,246,242,249,246,8,1483,1305
1669,7,5.1.137,0,562,4,49,137,186,137,0,186,186,-101,133,133,2,2,287,242,368,246,8,1483,1305
1669,8,0.1.174,0,556,2,11,174,185,174,0,185,185,-97,129,129,2,3,153,201,190,246,9,1483,1264
1669,8,1.1.77,0,542,0,78,77,155,56,21,155,174,0,32,32,2,3,186,201,210,246,9,1483,1264
1669,8,2.2.36,0,542,0,90,36,126,36,0,126,174,-36,36,68,3,1,207,321,234,321,9,1483,1264
1669,8,3.2.77,0,554,1,62,77,139,77,0,139,174,-77,77,109,3,1,185,321,232,321,9,1483,1264
1669,8,4.1.77,1,554,1,63,77,140,3,74,140,174,0,32,32,2,3,246,201,249,246,9,1483,1264
1669,8,5.1.137,0,566,3,49,137,186,137,0,186,186,-60,92,92,2,3,287,201,368,246,9,1483,1264
1669,9,0.1.174,0,563,1,11,174,185,174,0,185,185,-34,66,66,2,4,153,138,190,246,10,1483,1201
1669,9,1.1.140,0,563,1,78,140,218,56,84,218,218,0,32,32,2,4,186,138,210,246,10,1483,1201
1669,9,2.2.36,0,566,2,90,36,126,36,0,126,174,-36,36,68,3,1,207,321,234,321,10,1483,1201
1669,9,3.2.77,0,554,0,62,77,139,77,0,139,174,-77,77,109,3,1,185,321,232,321,10,1483,1201
1669,9,4.2.140,0,554,0,32,140,172,140,0,172,174,-140,140,172,3,1,183,321,249,321,10,1483,1201
1669,9,5.1.140,1,554,0,49,140,189,137,3,189,189,0,32,32,2,4,287,138,368,246,10,1483,1201
1669,10,0.1.189,1,565,1,11,189,200,174,15,200,200,0,32,32,2,5,153,89,190,246,11,1483,1152
1669,10,1.1.189,0,554,0,78,189,267,56,133,267,267,0,32,32,2,5,186,89,210,246,11,1483,1152
1669,10,2.2.36,0,566,2,90,36,126,36,0,126,189,-36,36,68,3,1,207,321,234,321,11,1483,1152
1669,10,3.2.77,0,554,0,62,77,139,77,0,139,189,-77,77,109,3,1,185,321,232,321,11,1483,1152
1669,10,4.2.140,0,554,0,32,140,172,140,0,172,189,-140,140,172,3,1,183,321,249,321,11,1483,1152
1669,10,5.2.189,0,554,0,54,189,243,189,0,243,243,-189,189,221,3,1,238,321,368,321,11,1483,1152
1669,11,0.2.200,0,583,2,63,200,263,200,0,263,263,-200,200,232,3,1,142,321,190,321,12,1483,1141
1669,11,1.1.200,1,565,0,78,200,278,56,144,278,278,0,32,32,2,6,186,78,210,246,12,1483,1141
1669,11,2.2.36,0,571,1,90,36,126,36,0,126,200,-36,36,68,3,1,207,321,234,321,12,1483,1141
1669,11,3.2.77,0,565,0,62,77,139,77,0,139,200,-77,77,109,3,1,185,321,232,321,12,1483,1141
1669,11,4.2.140,0,565,0,32,140,172,140,0,172,200,-140,140,172,3,1,183,321,249,321,12,1483,1141
1669,11,5.2.189,0,565,0,54,189,243,189,0,243,243,-189,189,221,3,1,238,321,368,321,12,1483,1141
1669,12,0.2.200,0,583,2,63,200,263,200,0,263,278,-200,200,232,3,1,142,321,190,321,13,1483,1063
1669,12,1.2.278,0,565,0,20,278,298,278,0,298,298,-278,278,310,3,1,108,321,210,321,13,1483,1063
1669,12,2.2.36,1,571,1,90,36,126,36,0,126,278,-36,36,68,3,1,207,321,234,321,13,1483,1063
1669,12,3.2.77,0,565,0,62,77,139,77,0,139,278,-77,77,109,3,1,185,321,232,321,13,1483,1063
1669,12,4.2.140,0,565,0,32,140,172,140,0,172,278,-140,140,172,3,1,183,321,249,321,13,1483,1063
1669,12,5.2.189,0,565,0,54,189,243,189,0,243,278,-189,189,221,3,1,238,321,368,321,13,1483,1063
1669,13,0.2.200,0,597,2,63,200,263,200,0,263,278,-74,110,142,3,2,142,231,190,321,14,1483,973
1669,13,1.2.278,0,571,0,20,278,298,278,0,298,298,-152,188,220,3,2,108,231,210,321,14,1483,973
1669,13,2.3.126,0,571,0,87,126,213,126,0,213,278,-126,126,194,4,1,117,413,234,413,14,1483,973
1669,13,3.2.126,0,571,0,62,126,188,77,49,188,278,0,36,68,3,2,185,231,232,321,14,1483,973
1669,13,4.2.140,1,587,1,32,140,172,140,0,172,278,-14,50,82,3,2,183,231,249,321,14,1483,973
1669,13,5.2.189,0,571,0,54,189,243,189,0,243,278,-63,99,131,3,2,238,231,368,321,14,1483,973
1669,14,0.2.200,0,605,2,63,200,263,200,0,263,278,-28,78,110,3,3,142,199,190,321,15,1483,941
1669,14,1.2.278,0,587,0,20,278,298,278,0,298,298,-106,156,188,3,3,108,199,210,321,15,1483,941
1669,14,2.3.126,0,587,0,87,126,213,126,0,213,278,-126,126,208,4,1,117,413,234,413,15,1483,941
1669,14,3.2.172,1,587,0,62,172,234,77,95,234,278,0,50,82,3,3,185,199,232,321,15,1483,941
1669,14,4.3.172,0,594,1,93,172,265,172,0,265,278,-172,172,254,4,1,151,413,249,413,15,1483,941
1669,14,5.2.189,0,605,2,54,189,243,189,0,243,278,-17,67,99,3,3,238,199,368,321,15,1483,941
1669,15,0.2.234,0,596,2,63,234,297,200,34,297,297,0,50,82,3,4,142,137,190,321,16,1483,879
1669,15,1.2.278,0,587,0,20,278,298,278,0,298,298,-44,94,126,3,4,108,137,210,321,16,1483,879
1669,15,2.3.126,0,587,0,87,126,213,126,0,213,278,-126,126,208,4,1,117,413,234,413,16,1483,879
1669,15,3.3.234,0,587,0,54,234,288,234,0,288,288,-234,234,316,4,1,123,413,232,413,16,1483,879
1669,15,4.3.172,0,594,1,93,172,265,172,0,265,278,-172,172,254,4,1,151,413,249,413,16,1483,879
1669,15,5.2.234,1,587,0,54,234,288,189,45,288,288,0,50,82,3,4,238,137,368,321,16,1483,879
1669,16,0.2.288,0,605,2,63,288,351,200,88,351,351,0,50,82,3,5,142,83,190,321,17,1483,825
1669,16,1.2.288,1,587,0,20,288,308,278,10,308,308,0,50,82,3,5,108,83,210,321,17,1483,825
1669,16,2.3.126,0,587,0,87,126,213,126,0,213,288,-126,126,208,4,1,117,413,234,413,17,1483,825
1669,16,3.3.234,0,587,0,54,234,288,234,0,288,288,-234,234,316,4,1,123,413,232,413,17,1483,825
1669,16,4.3.172,0,594,1,93,172,265,172,0,265,288,-172,172,254,4,1,151,413,249,413,17,1483,825
1669,16,5.3.288,0,614,3,96,288,384,288,0,384,384,-288,288,370,4,1,184,413,368,413,17,1483,825
1669,17,0.2.308,1,587,0,63,308,371,200,108,371,371,0,50,82,3,6,142,63,190,321,18,1483,805
1669,17,1.3.308,0,587,0,5,308,313,308,0,313,313,-308,308,390,4,1,88,413,210,413,18,1483,805
1669,17,2.3.126,0,587,0,87,126,213,126,0,213,308,-126,126,208,4,1,117,413,234,413,18,1483,805
1669,17,3.3.234,0,587,0,54,234,288,234,0,288,308,-234,234,316,4,1,123,413,232,413,18,1483,805
1669,17,4.3.172,0,594,1,93,172,265,172,0,265,308,-172,172,254,4,1,151,413,249,413,18,1483,805
1669,17,5.3.288,0,614,2,96,288,384,288,0,384,384,-288,288,370,4,1,184,413,368,413,18,1483,805
1669,18,0.3.371,0,633,3,78,371,449,371,0,449,449,-371,371,453,4,1,79,413,190,413,19,1483,742
1669,18,1.3.308,0,587,0,5,308,313,308,0,313,371,-308,308,390,4,1,88,413,210,413,19,1483,742
1669,18,2.3.126,1,587,0,87,126,213,126,0,213,371,-126,126,208,4,1,117,413,234,413,19,1483,742
1669,18,3.3.234,0,587,0,54,234,288,234,0,288,371,-234,234,316,4,1,123,413,232,413,19,1483,742
1669,18,4.3.172,0,594,1,93,172,265,172,0,265,371,-172,172,254,4,1,151,413,249,413,19,1483,742
1669,18,5.3.288,0,614,2,96,288,384,288,0,384,384,-288,288,370,4,1,184,413,368,413,19,1483,742
1669,19,0.3.371,0,633,3,78,371,449,371,0,449,449,-158,284,366,4,2,79,326,190,413,20,1483,655
1669,19,1.3.308,0,587,0,5,308,313,308,0,313,371,-95,221,303,4,2,88,326,210,413,20,1483,655
1669,19,2.4.213,1,587,0,30,213,243,213,0,243,371,-213,213,421,5,1,30,329,234,329,20,1483,655
1669,19,3.3.234,0,587,0,54,234,288,234,0,288,371,-21,147,229,4,2,123,326,232,413,20,1483,655
1669,19,4.3.213,0,605,1,93,213,306,172,41,306,371,0,126,208,4,2,151,326,249,413,20,1483,655
1669,19,5.3.288,0,614,2,96,288,384,288,0,384,384,-75,201,283,4,2,184,326,368,413,20,1483,655
1669,20,0.3.371,0,633,3,78,371,449,371,0,449,449,-158,284,579,4,2,79,326,190,413,21,1483,625
1669,20,1.3.308,0,587,0,5,308,313,308,0,313,371,-95,221,516,4,2,88,326,210,413,21,1483,625
1669,20,3.3.234,0,587,0,54,234,288,234,0,288,371,-21,147,442,4,2,123,326,232,413,21,1483,625
1669,20,4.3.213,1,605,1,93,213,306,172,41,306,371,0,126,421,4,2,151,326,249,413,21,1483,625
1669,20,5.3.288,0,614,2,96,288,384,288,0,384,384,-75,201,496,4,2,184,326,368,413,21,1483,625
1669,21,0.3.371,0,633,1,78,371,449,371,0,449,449,-65,191,486,4,3,79,233,190,413,22,1483,532
1669,21,1.3.308,1,605,0,5,308,313,308,0,313,371,-2,128,423,4,3,88,233,210,413,22,1483,532
1669,21,3.3.306,0,605,0,54,306,360,234,72,360,371,0,126,421,4,3,123,233,232,413,22,1483,532
1669,21,4.4.306,0,605,0,58,306,364,306,0,364,371,-63,276,484,5,2,58,299,249,329,22,1483,532
1669,21,5.3.306,0,643,2,96,306,402,288,18,402,402,0,126,421,4,3,184,233,368,413,22,1483,532
1669,22,0.3.371,0,633,2,78,371,449,371,0,449,449,-58,186,481,4,4,79,228,190,413,23,1483,527
1669,22,1.4.313,0,612,1,83,313,396,313,0,396,396,-70,283,493,5,2,83,299,210,329,23,1483,527
1669,22,3.3.313,1,605,0,54,313,367,234,79,367,371,0,128,423,4,4,123,228,232,413,23,1483,527
1669,22,4.4.306,0,605,0,58,306,364,306,0,364,371,-63,276,486,5,2,58,299,249,329,23,1483,527
1669,22,5.3.313,0,605,0,96,313,409,288,25,409,409,0,128,423,4,4,184,228,368,413,23,1483,527
1669,23,0.3.371,0,633,3,78,371,449,371,0,449,449,-4,132,427,4,5,79,174,190,413,24,1483,473
1669,23,1.4.313,0,612,2,83,313,396,313,0,396,396,-70,283,493,5,2,83,299,210,329,24,1483,473
1669,23,3.4.367,0,608,1,69,367,436,367,0,436,436,-124,337,547,5,2,69,299,232,329,24,1483,473
1669,23,4.4.306,0,605,0,58,306,364,306,0,364,371,-63,276,486,5,2,58,299,249,329,24,1483,473
1669,23,5.3.367,1,605,0,96,367,463,288,79,463,463,0,128,423,4,5,184,174,368,413,24,1483,473
1669,24,0.3.463,1,605,0,78,463,541,371,92,541,541,0,128,423,4,6,79,78,190,413,25,1483,377
1669,24,1.4.313,0,612,2,83,313,396,313,0,396,463,-70,283,493,5,2,83,299,210,329,25,1483,377
1669,24,3.4.367,0,608,1,69,367,436,367,0,436,463,-124,337,547,5,2,69,299,232,329,25,1483,377
1669,24,4.4.306,0,605,0,58,306,364,306,0,364,463,-63,276,486,5,2,58,299,249,329,25,1483,377
1669,24,5.4.463,0,621,3,88,463,551,463,0,551,551,-220,433,643,5,2,88,299,368,329,25,1483,377
1669,25,0.4.541,0,630,4,1,541,542,541,0,542,542,-298,511,721,5,2,1,299,190,329,26,1483,299
1669,25,1.4.313,0,612,2,83,313,396,313,0,396,541,-70,283,493,5,2,83,299,210,329,26,1483,299
1669,25,3.4.367,0,608,1,69,367,436,367,0,436,541,-124,337,547,5,2,69,299,232,329,26,1483,299
1669,25,4.4.306,1,605,0,58,306,364,306,0,364,541,-63,276,486,5,2,58,299,249,329,26,1483,299
1669,25,5.4.463,0,621,3,88,463,551,463,0,551,551,-220,433,643,5,2,88,299,368,329,26,1483,299
1669,26,0.4.541,0,630,3,1,541,542,541,0,542,542,-177,453,663,5,3,1,241,190,329,27,1483,241
1669,26,1.4.364,1,605,0,83,364,447,313,51,447,541,0,276,486,5,3,83,241,210,329,27,1483,241
1669,26,3.4.367,0,608,1,69,367,436,367,0,436,541,-3,279,489,5,3,69,241,232,329,27,1483,241
1669,26,5.4.463,0,621,2,88,463,551,463,0,551,551,-99,375,585,5,3,88,241,368,329,27,1483,241
1669,27,0.4.541,0,630,2,1,541,542,541,0,542,542,-94,370,580,5,4,1,158,190,329,28,1483,158
1669,27,3.4.447,1,605,0,69,447,516,367,80,516,541,0,276,486,5,4,69,158,232,329,28,1483,158
1669,27,5.4.463,0,621,1,88,463,551,463,0,551,551,-16,292,502,5,4,88,158,368,329,28,1483,158
1669,28,0.4.541,1,630,1,1,541,542,541,0,542,542,-25,301,511,5,5,1,89,190,329,29,1483,89
1669,28,5.4.516,0,605,0,88,516,604,463,53,604,604,0,276,486,5,5,88,89,368,329,29,1483,89
1669,29,5.4.542,1,630,0,88,542,630,463,79,630,630,0,301,511,5,6,88,88,368,329,30,1483,88
1670,0,0.0.0,1,644,1,50,0,50,0,0,50,50,0,0,0,1,1,334,384,334,384,1,1750,1750
1670,0,1.0.0,0,653,3,98,0,98,0,0,98,98,0,0,0,1,1,308,384,308,384,1,1750,1750
1670,0,2.0.0,0,630,0,68,0,68,0,0,68,68,0,0,0,1,1,359,384,359,384,1,1750,1750
1670,0,3.0.0,0,677,4,58,0,58,0,0,58,58,0,0,0,1,1,191,384,191,384,1,1750,1750
1670,0,4.0.0,0,630,0,25,0,25,0,0,25,25,0,0,0,1,1,188,384,188,384,1,1750,1750
1670,0,5.0.0,0,652,2,85,0,85,0,0,85,85,0,0,0,1,1,370,384,370,384,1,1750,1750
1670,1,0.1.50,1,644,0,79,50,129,50,0,129,129,-50,50,50,2,1,284,348,334,348,2,1750,1700
1670,1,1.0.50,0,653,2,98,50,148,0,50,148,148,0,0,0,1,2,308,334,308,384,2,1750,1700
1670,1,2.0.50,0,644,0,68,50,118,0,50,118,118,0,0,0,1,2,359,334,359,384,2,1750,1700
1670,1,3.0.50,0,680,4,58,50,108,0,50,108,108,0,0,0,1,2,191,334,191,384,2,1750,1700
1670,1,4.0.50,0,645,1,25,50,75,0,50,75,75,0,0,0,1,2,188,334,188,384,2,1750,1700
1670,1,5.0.50,0,667,3,85,50,135,0,50,135,135,0,0,0,1,2,370,334,370,384,2,1750,1700
1670,2,0.2.129,1,644,0,67,129,196,129,0,196,196,-129,129,179,3,1,205,290,334,290,3,1750,1621
1670,2,1.0.50,0,653,2,98,50,148,0,50,148,148,0,0,50,1,2,308,334,308,384,3,1750,1621
1670,2,2.0.50,0,644,0,68,50,118,0,50,118,129,0,0,50,1,2,359,334,359,384,3,1750,1621
1670,2,3.0.50,0,680,4,58,50,108,0,50,108,129,0,0,50,1,2,191,334,191,384,3,1750,1621
1670,2,4.0.50,0,645,1,25,50,75,0,50,75,129,0,0,50,1,2,188,334,188,384,3,1750,1621
1670,2,5.0.50,0,667,3,85,50,135,0,50,135,135,0,0,50,1,2,370,334,370,384,3,1750,1621
1670,3,0.3.196,1,644,0,84,196,280,196,0,280,280,-196,196,375,4,1,138,366,334,366,4,1750,1554
1670,3,1.0.50,0,653,2,98,50,148,0,50,148,196,0,0,179,1,2,308,334,308,384,4,1750,1554
1670,3,2.0.50,0,644,0,68,50,118,0,50,118,196,0,0,179,1,2,359,334,359,384,4,1750,1554
1670,3,3.0.50,0,680,4,58,50,108,0,50,108,196,0,0,179,1,2,191,334,191,384,4,1750,1554
1670,3,4.0.50,0,647,1,25,50,75,0,50,75,196,0,0,179,1,2,188,334,188,384,4,1750,1554
1670,3,5.0.50,0,667,3,85,50,135,0,50,135,196,0,0,179,1,2,370,334,370,384,4,1750,1554
1670,4,0.4.280,1,644,0,54,280,334,280,0,334,334,-280,280,655,5,1,54,362,334,362,5,1750,1470
1670,4,1.0.50,0,653,2,98,50,148,0,50,148,280,0,0,375,1,2,308,334,308,384,5,1750,1470
1670,4,2.0.50,0,644,0,68,50,118,0,50,118,280,0,0,375,1,2,359,334,359,384,5,1750,1470
1670,4,3.0.50,0,680,4,58,50,108,0,50,108,280,0,0,375,1,2,191,334,191,384,5,1750,1470
1670,4,4.0.50,0,647,1,25,50,75,0,50,75,280,0,0,375,1,2,188,334,188,384,5,1750,1470
1670,4,5.0.50,0,667,3,85,50,135,0,50,135,280,0,0,375,1,2,370,334,370,384,5,1750,1470
1670,5,1.0.50,0,653,2,98,50,148,0,50,148,334,0,0,655,1,2,308,334,308,384,6,1750,1416
1670,5,2.0.50,1,644,0,68,50,118,0,50,118,334,0,0,655,1,2,359,334,359,384,6,1750,1416
1670,5,3.0.50,0,680,4,58,50,108,0,50,108,334,0,0,655,1,2,191,334,191,384,6,1750,1416
1670,5,4.0.50,0,647,1,25,50,75,0,50,75,334,0,0,655,1,2,188,334,188,384,6,1750,1416
1670,5,5.0.50,0,667,3,85,50,135,0,50,135,334,0,0,655,1,2,370,334,370,384,6,1750,1416
1670,6,1.0.118,0,644,0,98,118,216,0,118,216,334,0,0,655,1,3,308,266,308,384,7,1750,1348
1670,6,2.1.129,0,644,0,97,129,226,118,11,226,334,0,50,655,2,2,291,269,359,348,7,1750,1348
1670,6,3.0.118,0,669,2,58,118,176,0,118,176,334,0,0,655,1,3,191,266,191,384,7,1750,1348
1670,6,4.0.118,0,644,0,25,118,143,0,118,143,334,0,0,655,1,3,188,266,188,384,7,1750,1348
1670,6,5.0.118,1,645,1,85,118,203,0,118,203,334,0,0,655,1,3,370,266,370,384,7,1750,1348
1670,7,1.0.203,0,645,0,98,203,301,0,203,301,334,0,0,655,1,4,308,181,308,384,8,1750,1263
1670,7,2.1.129,0,645,0,97,129,226,118,11,226,334,0,50,655,2,2,291,269,359,348,8,1750,1263
1670,7,3.0.203,0,655,2,58,203,261,0,203,261,334,0,0,655,1,4,191,181,191,384,8,1750,1263
1670,7,4.0.203,1,652,1,25,203,228,0,203,228,334,0,0,655,1,4,188,181,188,384,8,1750,1263
1670,7,5.1.203,0,716,3,32,203,235,203,0,235,334,-74,124,729,2,2,285,269,370,348,8,1750,1263
1670,8,1.0.228,1,652,0,98,228,326,0,228,326,334,0,0,655,1,5,308,156,308,384,9,1750,1238
1670,8,2.1.129,0,652,0,97,129,226,118,11,226,334,0,50,655,2,2,291,269,359,348,9,1750,1238
1670,8,3.0.228,0,655,1,58,228,286,0,228,286,334,0,0,655,1,5,191,156,191,384,9,1750,1238
1670,8,4.1.228,0,652,0,15,228,243,228,0,243,334,-99,149,754,2,2,163,269,188,348,9,1750,1238
1670,8,5.1.203,0,716,2,32,203,235,203,0,235,334,-74,124,729,2,2,285,269,370,348,9,1750,1238
1670,9,1.1.326,0,652,0,46,326,372,326,0,372,372,-197,247,852,2,2,210,269,308,348,10,1750,1140
1670,9,2.1.129,0,652,0,97,129,226,118,11,226,334,0,50,655,2,2,291,269,359,348,10,1750,1140
1670,9,3.0.326,1,652,0,58,326,384,0,326,384,384,0,0,655,1,6,191,58,191,384,10,1750,1140
1670,9,4.1.228,0,652,0,15,228,243,228,0,243,334,-99,149,754,2,2,163,269,188,348,10,1750,1140
1670,9,5.1.203,0,716,1,32,203,235,203,0,235,334,-74,124,729,2,2,285,269,370,348,10,1750,1140
1670,10,1.1.326,0,652,0,46,326,372,326,0,372,384,-197,247,852,2,2,210,269,308,348,11,1750,1082
1670,10,2.1.129,0,652,0,97,129,226,118,11,226,384,0,50,655,2,2,291,269,359,348,11,1750,1082
1670,10,3.1.384,0,652,0,79,384,463,384,0,463,463,-255,305,910,2,2,133,269,191,348,11,1750,1082
1670,10,4.1.228,0,652,0,15,228,243,228,0,243,384,-99,149,754,2,2,163,269,188,348,11,1750,1082
1670,10,5.1.203,1,716,1,32,203,235,203,0,235,384,-74,124,729,2,2,285,269,370,348,11,1750,1082
1670,11,1.1.326,0,716,0,46,326,372,326,0,372,384,-91,215,820,2,3,210,237,308,348,12,1750,1050
1670,11,2.1.235,0,716,0,97,235,332,118,117,332,384,0,124,729,2,3,291,237,359,348,12,1750,1050
1670,11,3.1.384,0,716,0,79,384,463,384,0,463,463,-149,273,878,2,3,133,237,191,348,12,1750,1050
1670,11,4.1.235,0,716,0,15,235,250,228,7,250,384,0,124,729,2,3,163,237,188,348,12,1750,1050
1670,11,5.2.235,1,716,0,92,235,327,235,0,327,384,-39,168,768,3,2,253,223,370,290,12,1750,1050
1670,12,1.1.326,0,716,0,46,326,372,326,0,372,384,-91,215,859,2,3,210,237,308,348,13,1750,958
1670,12,2.1.235,1,716,0,97,235,332,118,117,332,384,0,124,768,2,3,291,237,359,348,13,1750,958
1670,12,3.1.384,0,716,0,79,384,463,384,0,463,463,-149,273,917,2,3,133,237,191,348,13,1750,958
1670,12,4.1.235,0,716,0,15,235,250,228,7,250,384,0,124,768,2,3,163,237,188,348,13,1750,958
1670,12,5.3.327,0,716,0,81,327,408,327,0,408,408,-47,243,815,4,2,161,282,370,366,13,1750,958
1670,13,1.1.332,0,716,0,46,332,378,326,6,378,384,0,124,768,2,4,210,140,308,348,14,1750,861
1670,13,2.2.332,1,716,0,43,332,375,332,0,375,384,-5,173,773,3,3,194,131,359,290,14,1750,861
1670,13,3.1.384,0,716,0,79,384,463,384,0,463,463,-52,176,820,2,4,133,140,191,348,14,1750,861
1670,13,4.1.332,0,716,0,15,332,347,228,104,347,384,0,124,768,2,4,163,140,188,348,14,1750,861
1670,13,5.3.327,0,716,0,81,327,408,327,0,408,408,-47,243,815,4,2,161,282,370,366,14,1750,861
1670,14,1.1.332,0,716,0,46,332,378,326,6,378,384,0,124,773,2,4,210,140,308,348,15,1750,818
1670,14,2.3.375,0,739,1,56,375,431,375,0,431,431,-95,291,868,4,2,151,282,359,366,15,1750,818
1670,14,3.1.384,0,716,0,79,384,463,384,0,463,463,-52,176,825,2,4,133,140,191,348,15,1750,818
1670,14,4.1.332,1,716,0,15,332,347,228,104,347,384,0,124,773,2,4,163,140,188,348,15,1750,818
1670,14,5.3.327,0,716,0,81,327,408,327,0,408,408,-47,243,820,4,2,161,282,370,366,15,1750,818
1670,15,1.1.347,0,716,0,46,347,393,326,21,393,393,0,124,773,2,5,210,125,308,348,16,1750,803
1670,15,2.3.375,0,739,1,56,375,431,375,0,431,431,-95,291,868,4,2,151,282,359,366,16,1750,803
1670,15,3.1.384,0,716,0,79,384,463,384,0,463,463,-37,161,810,2,5,133,125,191,348,16,1750,803
1670,15,4.2.375,1,716,0,33,375,408,347,28,408,408,0,173,773,3,4,148,88,188,290,16,1750,803
1670,15,5.3.327,0,716,0,81,327,408,327,0,408,408,-47,243,820,4,2,161,282,370,366,16,1750,803
1670,16,1.1.347,1,716,0,46,347,393,326,21,393,408,0,124,773,2,5,210,125,308,348,17,1750,770
1670,16,2.3.375,0,739,1,56,375,431,375,0,431,431,-95,291,868,4,2,151,282,359,366,17,1750,770
1670,16,3.1.384,0,716,0,79,384,463,384,0,463,463,-37,161,810,2,5,133,125,191,348,17,1750,770
1670,16,4.3.408,0,739,1,86,408,494,408,0,494,494,-128,324,901,4,2,115,282,188,366,17,1750,770
1670,16,5.3.327,0,716,0,81,327,408,327,0,408,408,-47,243,820,4,2,161,282,370,366,17,1750,770
1670,17,1.2.408,1,716,0,25,408,433,393,15,433,433,0,173,773,3,5,164,55,308,290,18,1750,724
1670,17,2.3.375,0,739,1,56,375,431,375,0,431,431,-95,291,868,4,2,151,282,359,366,18,1750,724
1670,17,3.1.393,0,716,0,79,393,472,384,9,472,472,0,124,773,2,6,133,79,191,348,18,1750,724
1670,17,4.3.408,0,739,1,86,408,494,408,0,494,494,-128,324,901,4,2,115,282,188,366,18,1750,724
1670,17,5.3.327,0,716,0,81,327,408,327,0,408,408,-47,243,820,4,2,161,282,370,366,18,1750,724
1670,18,1.3.433,0,716,0,46,433,479,433,0,479,479,-153,349,926,4,2,139,282,308,366,19,1750,699
1670,18,2.3.375,0,739,1,56,375,431,375,0,431,433,-95,291,868,4,2,151,282,359,366,19,1750,699
1670,18,3.1.393,0,716,0,79,393,472,384,9,472,472,0,124,773,2,6,133,79,191,348,19,1750,699
1670,18,4.3.408,0,739,1,86,408,494,408,0,494,494,-128,324,901,4,2,115,282,188,366,19,1750,699
1670,18,5.3.327,1,716,0,81,327,408,327,0,408,433,-47,243,820,4,2,161,282,370,366,19,1750,699
1670,19,1.3.433,0,716,0,46,433,479,433,0,479,479,-25,268,845,4,3,139,201,308,366,20,1750,618
1670,19,2.3.408,1,716,0,56,408,464,375,33,464,464,0,243,820,4,3,151,201,359,366,20,1750,618
1670,19,3.1.393,0,716,0,79,393,472,384,9,472,472,0,124,820,2,6,133,79,191,348,20,1750,618
1670,19,4.3.408,0,739,1,86,408,494,408,0,494,494,0,243,820,4,3,115,201,188,366,20,1750,618
1670,19,5.4.408,0,716,0,80,408,488,408,0,488,488,-74,354,894,5,2,80,308,370,362,20,1750,618
1670,20,1.3.464,1,716,0,46,464,510,433,31,510,510,0,243,820,4,4,139,145,308,366,21,1750,562
1670,20,2.4.464,0,772,1,95,464,559,464,0,559,559,-130,410,950,5,2,95,308,359,362,21,1750,562
1670,20,3.1.393,0,716,0,79,393,472,384,9,472,472,0,124,820,2,6,133,79,191,348,21,1750,562
1670,20,4.3.464,0,716,0,86,464,550,408,56,550,550,0,243,820,4,4,115,145,188,366,21,1750,562
1670,20,5.4.408,0,716,0,80,408,488,408,0,488,488,-74,354,894,5,2,80,308,370,362,21,1750,562
1670,21,1.4.510,0,738,1,93,510,603,510,0,603,603,-176,456,996,5,2,93,308,308,362,22,1750,516
1670,21,2.4.464,0,772,2,95,464,559,464,0,559,559,-130,410,950,5,2,95,308,359,362,22,1750,516
1670,21,3.1.393,0,716,0,79,393,472,384,9,472,510,0,124,820,2,6,133,79,191,348,22,1750,516
1670,21,4.3.510,1,716,0,86,510,596,408,102,596,596,0,243,820,4,5,115,99,188,366,22,1750,516
1670,21,5.4.408,0,716,0,80,408,488,408,0,488,510,-74,354,894,5,2,80,308,370,362,22,1750,516
1670,22,1.4.510,0,738,2,93,510,603,510,0,603,603,-176,456,996,5,2,93,308,308,362,23,1750,430
1670,22,2.4.464,0,772,3,95,464,559,464,0,559,596,-130,410,950,5,2,95,308,359,362,23,1750,430
1670,22,3.1.393,0,716,0,79,393,472,384,9,472,596,0,124,820,2,6,133,79,191,348,23,1750,430
1670,22,4.4.596,0,729,1,29,596,625,596,0,625,625,-262,542,1082,5,2,29,308,188,362,23,1750,430
1670,22,5.4.408,1,716,0,80,408,488,408,0,488,596,-74,354,894,5,2,80,308,370,362,23,1750,430
1670,23,1.4.510,0,738,2,93,510,603,510,0,603,603,-22,376,916,5,3,93,228,308,362,24,1750,350
1670,23,2.4.488,1,716,0,95,488,583,464,24,583,596,0,354,894,5,3,95,228,359,362,24,1750,350
1670,23,3.1.393,0,716,0,79,393,472,384,9,472,596,0,124,894,2,6,133,79,191,348,24,1750,350
1670,23,4.4.596,0,729,1,29,596,625,596,0,625,625,-108,462,1002,5,3,29,228,188,362,24,1750,350
1670,24,1.4.583,1,716,0,93,583,676,510,73,676,676,0,354,894,5,4,93,133,308,362,25,1750,255
1670,24,3.1.393,0,716,0,79,393,472,384,9,472,596,0,124,894,2,6,133,79,191,348,25,1750,255
1670,24,4.4.596,0,729,1,29,596,625,596,0,625,625,-13,367,907,5,4,29,133,188,362,25,1750,255
1670,25,3.1.393,0,716,0,79,393,472,384,9,472,676,0,124,894,2,6,133,79,191,348,26,1750,162
1670,25,4.4.676,1,716,0,29,676,705,596,80,705,705,0,354,894,5,5,29,40,188,362,26,1750,162
1670,26,3.1.393,1,716,0,79,393,472,384,9,472,705,0,124,894,2,6,133,79,191,348,27,1750,133
1670,27,3.2.472,1,716,0,30,472,502,472,0,502,705,-39,212,933,3,6,54,30,191,290,28,1750,54
1670,28,3.3.596,1,716,0,13,596,609,502,94,609,705,0,243,933,4,6,24,13,191,366,29,1750,24
1670,29,3.4.705,1,716,0,11,705,716,609,96,716,716,0,354,933,5,6,11,11,191,362,30,1750,11
1671,0,0.0.0,0,611,5,63,0,63,0,0,63,63,0,0,0,1,1,278,301,278,301,1,1622,1622
1671,0,1.0.0,0,589,3,74,0,74,0,0,74,74,0,0,0,1,1,211,301,211,301,1,1622,1622
1671,0,2.0.0,1,563,1,15,0,15,0,0,15,15,0,0,0,1,1,286,301,286,301,1,1622,1622
1671,0,3.0.0,0,548,0,12,0,12,0,0,12,12,0,0,0,1,1,250,301,250,301,1,1622,1622
1671,0,4.0.0,0,570,2,47,0,47,0,0,47,47,0,0,0,1,1,324,301,324,301,1,1622,1622
1671,0,5.0.0,0,591,4,90,0,90,0,0,90,90,0,0,0,1,1,273,301,273,301,1,1622,1622
1671,1,0.0.15,0,626,4,63,15,78,0,15,78,78,0,0,0,1,2,278,286,278,301,2,1622,1607
1671,1,1.0.15,0,592,2,74,15,89,0,15,89,89,0,0,0,1,2,211,286,211,301,2,1622,1607
1671,1,2.1.15,1,592,2,90,15,105,15,0,105,105,-15,15,15,2,1,271,252,286,252,2,1622,1607
1671,1,3.0.15,0,563,0,12,15,27,0,15,27,27,0,0,0,1,2,250,286,250,301,2,1622,1607
1671,1,4.0.15,0,585,1,47,15,62,0,15,62,62,0,0,0,1,2,324,286,324,301,2,1622,1607
1671,1,5.0.15,0,606,3,90,15,105,0,15,105,105,0,0,0,1,2,273,286,273,301,2,1622,1607
1671,2,0.0.15,0,632,5,63,15,78,0,15,78,105,0,0,15,1,2,278,286,278,301,3,1622,1517
1671,2,1.0.15,0,592,0,74,15,89,0,15,89,105,0,0,15,1,2,211,286,211,301,3,1622,1517
1671,2,2.2.105,0,630,4,96,105,201,105,0,201,201,-105,105,120,3,1,181,357,286,357,3,1622,1517
1671,2,3.0.15,1,594,1,12,15,27,0,15,27,105,0,0,15,1,2,250,286,250,301,3,1622,1517
1671,2,4.0.15,0,623,3,47,15,62,0,15,62,105,0,0,15,1,2,324,286,324,301,3,1622,1517
1671,2,5.0.15,0,606,2,90,15,105,0,15,105,105,0,0,15,1,2,273,286,273,301,3,1622,1517
1671,3,0.0.27,0,634,5,63,27,90,0,27,90,105,0,0,15,1,3,278,274,278,301,4,1622,1505
1671,3,1.0.27,0,594,0,74,27,101,0,27,101,105,0,0,15,1,3,211,274,211,301,4,1622,1505
1671,3,2.2.105,0,630,4,96,105,201,105,0,201,201,-105,105,120,3,1,181,357,286,357,4,1622,1505
1671,3,3.1.105,1,609,1,17,105,122,27,78,122,122,0,15,15,2,2,238,162,250,252,4,1622,1505
1671,3,4.0.27,0,628,3,47,27,74,0,27,74,105,0,0,15,1,3,324,274,324,301,4,1622,1505
1671,3,5.0.27,0,618,2,90,27,117,0,27,117,117,0,0,15,1,3,273,274,273,301,4,1622,1505
1671,4,0.0.27,0,634,3,63,27,90,0,27,90,122,0,0,15,1,3,278,274,278,301,5,1622,1488
1671,4,1.0.27,0,609,0,74,27,101,0,27,101,122,0,0,15,1,3,211,274,211,301,5,1622,1488
1671,4,2.2.105,0,630,2,96,105,201,105,0,201,201,-105,105,120,3,1,181,357,286,357,5,1622,1488
1671,4,3.2.122,0,641,4,96,122,218,122,0,218,218,-122,122,137,3,1,221,357,250,357,5,1622,1488
1671,4,4.0.27,1,630,2,47,27,74,0,27,74,122,0,0,15,1,3,324,274,324,301,5,1622,1488
1671,4,5.0.27,0,623,1,90,27,117,0,27,117,122,0,0,15,1,3,273,274,273,301,5,1622,1488
1671,5,0.0.74,0,632,1,63,74,137,0,74,137,137,0,0,15,1,4,278,227,278,301,6,1622,1441
1671,5,1.0.74,0,634,2,74,74,148,0,74,148,148,0,0,15,1,4,211,227,211,301,6,1622,1441
1671,5,2.2.105,0,630,0,96,105,201,105,0,201,201,-105,105,120,3,1,181,357,286,357,6,1622,1441
1671,5,3.2.122,0,641,3,96,122,218,122,0,218,218,-122,122,137,3,1,221,357,250,357,6,1622,1441
1671,5,4.1.122,1,632,1,67,122,189,74,48,189,189,0,15,15,2,3,277,145,324,252,6,1622,1441
1671,5,5.0.74,0,630,0,90,74,164,0,74,164,164,0,0,15,1,4,273,227,273,301,6,1622,1441
1671,6,0.0.74,1,632,0,63,74,137,0,74,137,189,0,0,15,1,4,278,227,278,301,7,1622,1374
1671,6,1.0.74,0,635,1,74,74,148,0,74,148,189,0,0,15,1,4,211,227,211,301,7,1622,1374
1671,6,2.2.105,0,632,0,96,105,201,105,0,201,201,-105,105,120,3,1,181,357,286,357,7,1622,1374
1671,6,3.2.122,0,641,2,96,122,218,122,0,218,218,-122,122,137,3,1,221,357,250,357,7,1622,1374
1671,6,4.2.189,0,645,3,33,189,222,189,0,222,222,-189,189,204,3,1,210,357,324,357,7,1622,1374
1671,6,5.0.74,0,632,0,90,74,164,0,74,164,189,0,0,15,1,4,273,227,273,301,7,1622,1374
1671,7,0.1.189,1,632,0,47,189,236,137,52,236,236,0,15,15,2,4,215,78,278,252,8,1622,1311
1671,7,1.0.137,0,632,0,74,137,211,0,137,211,211,0,0,15,1,5,211,164,211,301,8,1622,1311
1671,7,2.2.105,0,632,0,96,105,201,105,0,201,201,-105,105,120,3,1,181,357,286,357,8,1622,1311
1671,7,3.2.122,0,641,1,96,122,218,122,0,218,218,-122,122,137,3,1,221,357,250,357,8,1622,1311
1671,7,4.2.189,0,649,2,33,189,222,189,0,222,222,-189,189,204,3,1,210,357,324,357,8,1622,1311
1671,7,5.0.137,0,632,0,90,137,227,0,137,227,227,0,0,15,1,5,273,164,273,301,8,1622,1311
1671,8,0.2.236,0,632,0,70,236,306,236,0,306,306,-236,236,251,3,1,168,357,278,357,9,1622,1264
1671,8,1.0.137,0,632,0,74,137,211,0,137,211,236,0,0,15,1,5,211,164,211,301,9,1622,1264
1671,8,2.2.105,0,632,0,96,105,201,105,0,201,236,-105,105,120,3,1,181,357,286,357,9,1622,1264
1671,8,3.2.122,0,641,1,96,122,218,122,0,218,236,-122,122,137,3,1,221,357,250,357,9,1622,1264
1671,8,4.2.189,0,651,2,33,189,222,189,0,222,236,-189,189,204,3,1,210,357,324,357,9,1622,1264
1671,8,5.0.137,1,632,0,90,137,227,0,137,227,236,0,0,15,1,5,273,164,273,301,9,1622,1264
1671,9,0.2.236,0,632,0,70,236,306,236,0,306,306,-236,236,251,3,1,168,357,278,357,10,1622,1174
1671,9,1.0.227,0,632,0,74,227,301,0,227,301,301,0,0,15,1,6,211,74,211,301,10,1622,1174
1671,9,2.2.105,0,632,0,96,105,201,105,0,201,236,-105,105,120,3,1,181,357,286,357,10,1622,1174
1671,9,3.2.122,0,641,1,96,122,218,122,0,218,236,-122,122,137,3,1,221,357,250,357,10,1622,1174
1671,9,4.2.189,0,651,2,33,189,222,189,0,222,236,-189,189,204,3,1,210,357,324,357,10,1622,1174
1671,9,5.1.236,1,632,0,16,236,252,227,9,252,252,0,15,15,2,5,183,31,273,252,10,1622,1174
1671,10,0.2.236,0,632,0,70,236,306,236,0,306,306,-236,236,251,3,1,168,357,278,357,11,1622,1158
1671,10,1.0.227,1,632,0,74,227,301,0,227,301,301,0,0,15,1,6,211,74,211,301,11,1622,1158
1671,10,2.2.105,0,632,0,96,105,201,105,0,201,252,-105,105,120,3,1,181,357,286,357,11,1622,1158
1671,10,3.2.122,0,641,1,96,122,218,122,0,218,252,-122,122,137,3,1,221,357,250,357,11,1622,1158
1671,10,4.2.189,0,651,2,33,189,222,189,0,222,252,-189,189,204,3,1,210,357,324,357,11,1622,1158
1671,10,5.2.252,0,632,0,31,252,283,252,0,283,283,-252,252,267,3,1,167,357,273,357,11,1622,1158
1671,11,0.2.236,0,632,0,70,236,306,236,0,306,306,-236,236,251,3,1,168,357,278,357,12,1622,1084
1671,11,1.1.301,1,632,0,15,301,316,301,0,316,316,-49,64,64,2,6,137,15,211,252,12,1622,1084
1671,11,2.2.105,0,632,0,96,105,201,105,0,201,301,-105,105,120,3,1,181,357,286,357,12,1622,1084
1671,11,3.2.122,0,641,1,96,122,218,122,0,218,301,-122,122,137,3,1,221,357,250,357,12,1622,1084
1671,11,4.2.189,0,651,2,33,189,222,189,0,222,301,-189,189,204,3,1,210,357,324,357,12,1622,1084
1671,11,5.2.252,0,632,0,31,252,283,252,0,283,301,-252,252,267,3,1,167,357,273,357,12,1622,1084
1671,12,0.2.236,0,632,0,70,236,306,236,0,306,316,-236,236,300,3,1,168,357,278,357,13,1622,1069
1671,12,1.2.316,0,636,1,31,316,347,316,0,347,347,-316,316,380,3,1,122,357,211,357,13,1622,1069
1671,12,2.2.105,0,632,0,96,105,201,105,0,201,316,-105,105,169,3,1,181,357,286,357,13,1622,1069
1671,12,3.2.122,0,641,2,96,122,218,122,0,218,316,-122,122,186,3,1,221,357,250,357,13,1622,1069
1671,12,4.2.189,1,651,3,33,189,222,189,0,222,316,-189,189,253,3,1,210,357,324,357,13,1622,1069
1671,12,5.2.252,0,632,0,31,252,283,252,0,283,316,-252,252,316,3,1,167,357,273,357,13,1622,1069
1671,13,0.2.236,0,651,0,70,236,306,236,0,306,316,-14,203,267,3,2,168,324,278,357,14,1622,1036
1671,13,1.2.316,0,686,4,31,316,347,316,0,347,347,-94,283,347,3,2,122,324,211,357,14,1622,1036
1671,13,2.2.222,1,672,3,96,222,318,105,117,318,318,0,189,253,3,2,181,324,286,357,14,1622,1036
1671,13,3.2.222,0,662,1,96,222,318,122,100,318,318,0,189,253,3,2,221,324,250,357,14,1622,1036
1671,13,4.3.222,0,651,0,79,222,301,222,0,301,316,-222,222,475,4,1,177,420,324,420,14,1622,1036
1671,13,5.2.252,0,667,2,31,252,283,252,0,283,316,-30,219,283,3,2,167,324,273,357,14,1622,1036
1671,14,0.2.318,0,707,1,70,318,388,236,82,388,388,0,189,253,3,3,168,228,278,357,15,1622,940
1671,14,1.2.318,0,672,0,31,318,349,316,2,349,349,0,189,253,3,3,122,228,211,357,15,1622,940
1671,14,2.3.318,0,672,0,25,318,343,318,0,343,343,-318,318,571,4,1,85,420,286,420,15,1622,940
1671,14,3.2.318,0,733,2,96,318,414,122,196,414,414,0,189,253,3,3,221,228,250,357,15,1622,940
1671,14,4.3.222,0,672,0,79,222,301,222,0,301,318,-222,222,475,4,1,177,420,324,420,15,1622,940
1671,14,5.2.318,1,672,0,31,318,349,252,66,349,349,0,189,253,3,3,167,228,273,357,15,1622,940
1671,15,0.2.349,0,678,1,70,349,419,236,113,419,419,0,189,253,3,4,168,197,278,357,16,1622,909
1671,15,1.2.349,0,672,0,31,349,380,316,33,380,380,0,189,253,3,4,122,197,211,357,16,1622,909
1671,15,2.3.318,0,672,0,25,318,343,318,0,343,349,-318,318,571,4,1,85,420,286,420,16,1622,909
1671,15,3.2.349,1,699,2,96,349,445,122,227,445,445,0,189,253,3,4,221,197,250,357,16,1622,909
1671,15,4.3.222,0,672,0,79,222,301,222,0,301,349,-222,222,475,4,1,177,420,324,420,16,1622,909
1671,15,5.3.349,0,672,0,65,349,414,349,0,414,414,-349,349,602,4,1,136,420,273,420,16,1622,909
1671,16,0.2.445,1,699,0,70,445,515,236,209,515,515,0,189,253,3,5,168,101,278,357,17,1622,813
1671,16,1.2.445,0,703,1,31,445,476,316,129,476,476,0,189,253,3,5,122,101,211,357,17,1622,813
1671,16,2.3.318,0,699,0,25,318,343,318,0,343,445,-318,318,571,4,1,85,420,286,420,17,1622,813
1671,16,3.3.445,0,699,0,72,445,517,445,0,517,517,-445,445,698,4,1,125,420,250,420,17,1622,813
1671,16,4.3.222,0,699,0,79,222,301,222,0,301,445,-222,222,475,4,1,177,420,324,420,17,1622,813
1671,16,5.3.349,0,699,0,65,349,414,349,0,414,445,-349,349,602,4,1,136,420,273,420,17,1622,813
1671,17,0.3.515,0,769,1,91,515,606,515,0,606,606,-515,515,768,4,1,98,420,278,420,18,1622,743
1671,17,1.2.515,1,699,0,31,515,546,316,199,546,546,0,189,253,3,6,122,31,211,357,18,1622,743
1671,17,2.3.318,0,699,0,25,318,343,318,0,343,515,-318,318,571,4,1,85,420,286,420,18,1622,743
1671,17,3.3.445,0,699,0,72,445,517,445,0,517,517,-445,445,698,4,1,125,420,250,420,18,1622,743
1671,17,4.3.222,0,699,0,79,222,301,222,0,301,515,-222,222,475,4,1,177,420,324,420,18,1622,743
1671,17,5.3.349,0,699,0,65,349,414,349,0,414,515,-349,349,602,4,1,136,420,273,420,18,1622,743
1671,18,0.3.515,0,769,2,91,515,606,515,0,606,606,-515,515,768,4,1,98,420,278,420,19,1622,712
1671,18,1.3.546,0,732,1,88,546,634,546,0,634,634,-546,546,799,4,1,91,420,211,420,19,1622,712
1671,18,2.3.318,0,699,0,25,318,343,318,0,343,546,-318,318,571,4,1,85,420,286,420,19,1622,712
1671,18,3.3.445,0,699,0,72,445,517,445,0,517,546,-445,445,698,4,1,125,420,250,420,19,1622,712
1671,18,4.3.222,1,699,0,79,222,301,222,0,301,546,-222,222,475,4,1,177,420,324,420,19,1622,712
1671,18,5.3.349,0,699,0,65,349,414,349,0,414,546,-349,349,602,4,1,136,420,273,420,19,1622,712
1671,19,0.3.515,0,769,2,91,515,606,515,0,606,606,-214,436,689,4,2,98,341,278,420,20,1622,633
1671,19,1.3.546,0,732,1,88,546,634,546,0,634,634,-245,467,720,4,2,91,341,211,420,20,1622,633
1671,19,2.3.318,0,699,0,25,318,343,318,0,343,546,-17,239,492,4,2,85,341,286,420,20,1622,633
1671,19,3.3.445,0,699,0,72,445,517,445,0,517,546,-144,366,619,4,2,125,341,250,420,20,1622,633
1671,19,4.4.301,1,699,0,98,301,399,301,0,399,546,-301,301,776,5,1,98,292,324,292,20,1622,633
1671,19,5.3.349,0,699,0,65,349,414,349,0,414,546,-48,270,523,4,2,136,341,273,420,20,1622,633
1671,20,0.3.515,0,769,2,91,515,606,515,0,606,606,-214,436,990,4,2,98,341,278,420,21,1622,535
1671,20,1.3.546,0,732,1,88,546,634,546,0,634,634,-245,467,1021,4,2,91,341,211,420,21,1622,535
1671,20,2.3.318,1,699,0,25,318,343,318,0,343,546,-17,239,793,4,2,85,341,286,420,21,1622,535
1671,20,3.3.445,0,699,0,72,445,517,445,0,517,546,-144,366,920,4,2,125,341,250,420,21,1622,535
1671,20,5.3.349,0,699,0,65,349,414,349,0,414,546,-48,270,824,4,2,136,341,273,420,21,1622,535
1671,21,0.3.515,0,769,2,91,515,606,515,0,606,606,-172,411,965,4,3,98,316,278,420,22,1622,510
1671,21,1.3.546,0,732,1,88,546,634,546,0,634,634,-203,442,996,4,3,91,316,211,420,22,1622,510
1671,21,2.4.399,1,699,0,60,399,459,343,56,459,546,0,301,793,5,2,60,194,286,292,22,1622,510
1671,21,3.3.445,0,699,0,72,445,517,445,0,517,546,-102,341,895,4,3,125,316,250,420,22,1622,510
1671,21,5.3.349,0,699,0,65,349,414,349,0,414,546,-6,245,799,4,3,136,316,273,420,22,1622,510
1671,22,0.3.515,0,769,2,91,515,606,515,0,606,606,-172,411,965,4,3,98,316,278,420,23,1622,450
1671,22,1.3.546,0,732,1,88,546,634,546,0,634,634,-203,442,996,4,3,91,316,211,420,23,1622,450
1671,22,3.3.445,0,699,0,72,445,517,445,0,517,546,-102,341,895,4,3,125,316,250,420,23,1622,450
1671,22,5.3.349,1,699,0,65,349,414,349,0,414,546,-6,245,799,4,3,136,316,273,420,23,1622,450
1671,23,0.3.515,0,769,2,91,515,606,515,0,606,606,-101,346,900,4,4,98,251,278,420,24,1622,385
1671,23,1.3.546,0,732,1,88,546,634,546,0,634,634,-132,377,931,4,4,91,251,211,420,24,1622,385
1671,23,3.3.445,0,699,0,72,445,517,445,0,517,546,-31,276,830,4,4,125,251,250,420,24,1622,385
1671,23,5.4.459,1,699,0,71,459,530,414,45,530,546,0,301,799,5,3,71,134,273,292,24,1622,385
1671,24,0.3.515,0,769,2,91,515,606,515,0,606,606,-101,346,900,4,4,98,251,278,420,25,1622,314
1671,24,1.3.546,0,732,1,88,546,634,546,0,634,634,-132,377,931,4,4,91,251,211,420,25,1622,314
1671,24,3.3.445,1,699,0,72,445,517,445,0,517,546,-31,276,830,4,4,125,251,250,420,25,1622,314
1671,25,0.3.517,0,699,0,91,517,608,515,2,608,608,0,276,830,4,5,98,179,278,420,26,1622,242
1671,25,1.3.546,0,732,1,88,546,634,546,0,634,634,-29,305,859,4,5,91,179,211,420,26,1622,242
1671,25,3.4.530,1,699,0,53,530,583,517,13,583,583,0,301,830,5,4,53,63,250,292,26,1622,242
1671,26,0.3.517,1,699,0,91,517,608,515,2,608,608,0,276,830,4,5,98,179,278,420,27,1622,189
1671,26,1.3.546,0,732,1,88,546,634,546,0,634,634,-29,305,859,4,5,91,179,211,420,27,1622,189
1671,27,0.4.608,1,699,0,7,608,615,608,0,615,615,-25,326,855,5,5,7,10,278,292,28,1622,98
1671,27,1.3.608,0,699,0,88,608,696,546,62,696,696,0,276,830,4,6,91,88,211,420,28,1622,98
1671,28,1.3.608,1,699,0,88,608,696,546,62,696,696,0,276,855,4,6,91,88,211,420,29,1622,91
1671,29,1.4.696,1,699,0,3,696,699,696,0,699,699,-81,407,936,5,6,3,3,211,292,30,1622,3
1672,0,0.0.0,0,644,0,76,0,76,0,0,76,76,0,0,0,1,1,322,415,322,415,1,1789,1789
1672,0,1.0.0,0,678,3,50,0,50,0,0,50,50,0,0,0,1,1,210,415,210,415,1,1789,1789
1672,0,2.0.0,1,656,1,60,0,60,0,0,60,60,0,0,0,1,1,312,415,312,415,1,1789,1789
1672,0,3.0.0,0,644,0,65,0,65,0,0,65,65,0,0,0,1,1,309,415,309,415,1,1789,1789
1672,0,4.0.0,0,656,1,69,0,69,0,0,69,69,0,0,0,1,1,262,415,262,415,1,1789,1789
1672,0,5.0.0,0,667,2,95,0,95,0,0,95,95,0,0,0,1,1,374,415,374,415,1,1789,1789
1672,1,0.0.60,0,656,0,76,60,136,0,60,136,136,0,0,0,1,2,322,355,322,415,2,1789,1729
1672,1,1.0.60,0,694,2,50,60,110,0,60,110,110,0,0,0,1,2,210,355,210,415,2,1789,1729
1672,1,2.1.60,1,656,0,84,60,144,60,0,144,144,-60,60,60,2,1,252,353,312,353,2,1789,1729
1672,1,3.0.60,0,656,0,65,60,125,0,60,125,125,0,0,0,1,2,309,355,309,415,2,1789,1729
1672,1,4.0.60,0,656,0,69,60,129,0,60,129,129,0,0,0,1,2,262,355,262,415,2,1789,1729
1672,1,5.0.60,0,667,1,95,60,155,0,60,155,155,0,0,0,1,2,374,355,374,415,2,1789,1729
1672,2,0.0.60,0,656,0,76,60,136,0,60,136,144,0,0,60,1,2,322,355,322,415,3,1789,1645
1672,2,1.0.60,0,694,2,50,60,110,0,60,110,144,0,0,60,1,2,210,355,210,415,3,1789,1645
1672,2,2.2.144,1,656,0,49,144,193,144,0,193,193,-144,144,204,3,1,168,326,312,326,3,1789,1645
1672,2,3.0.60,0,656,0,65,60,125,0,60,125,144,0,0,60,1,2,309,355,309,415,3,1789,1645
1672,2,4.0.60,0,656,0,69,60,129,0,60,129,144,0,0,60,1,2,262,355,262,415,3,1789,1645
1672,2,5.0.60,0,667,1,95,60,155,0,60,155,155,0,0,60,1,2,374,355,374,415,3,1789,1645
1672,3,0.0.60,0,658,1,76,60,136,0,60,136,193,0,0,204,1,2,322,355,322,415,4,1789,1596
1672,3,1.0.60,0,694,3,50,60,110,0,60,110,193,0,0,204,1,2,210,355,210,415,4,1789,1596
1672,3,2.3.193,1,656,0,93,193,286,193,0,286,286,-193,193,397,4,1,119,374,312,374,4,1789,1596
1672,3,3.0.60,0,656,0,65,60,125,0,60,125,193,0,0,204,1,2,309,355,309,415,4,1789,1596
1672,3,4.0.60,0,656,0,69,60,129,0,60,129,193,0,0,204,1,2,262,355,262,415,4,1789,1596
1672,3,5.0.60,0,667,2,95,60,155,0,60,155,193,0,0,204,1,2,374,355,374,415,4,1789,1596
1672,4,0.0.60,0,658,1,76,60,136,0,60,136,286,0,0,397,1,2,322,355,322,415,5,1789,1503
1672,4,1.0.60,0,694,3,50,60,110,0,60,110,286,0,0,397,1,2,210,355,210,415,5,1789,1503
1672,4,2.4.286,1,656,0,26,286,312,286,0,312,312,-286,286,683,5,1,26,321,312,321,5,1789,1503
1672,4,3.0.60,0,656,0,65,60,125,0,60,125,286,0,0,397,1,2,309,355,309,415,5,1789,1503
1672,4,4.0.60,0,656,0,69,60,129,0,60,129,286,0,0,397,1,2,262,355,262,415,5,1789,1503
1672,4,5.0.60,0,667,2,95,60,155,0,60,155,286,0,0,397,1,2,374,355,374,415,5,1789,1503
1672,5,0.0.60,0,658,1,76,60,136,0,60,136,312,0,0,683,1,2,322,355,322,415,6,1789,1477
1672,5,1.0.60,0,694,3,50,60,110,0,60,110,312,0,0,683,1,2,210,355,210,415,6,1789,1477
1672,5,3.0.60,1,656,0,65,60,125,0,60,125,312,0,0,683,1,2,309,355,309,415,6,1789,1477
1672,5,4.0.60,0,656,0,69,60,129,0,60,129,312,0,0,683,1,2,262,355,262,415,6,1789,1477
1672,5,5.0.60,0,667,2,95,60,155,0,60,155,312,0,0,683,1,2,374,355,374,415,6,1789,1477
1672,6,0.0.125,0,656,0,76,125,201,0,125,201,312,0,0,683,1,3,322,290,322,415,7,1789,1412
1672,6,1.0.125,0,694,2,50,125,175,0,125,175,312,0,0,683,1,3,210,290,210,415,7,1789,1412
1672,6,3.1.144,1,656,0,55,144,199,125,19,199,312,0,60,683,2,2,244,269,309,353,7,1789,1412
1672,6,4.0.125,0,656,0,69,125,194,0,125,194,312,0,0,683,1,3,262,290,262,415,7,1789,1412
1672,6,5.0.125,0,678,1,95,125,220,0,125,220,312,0,0,683,1,3,374,290,374,415,7,1789,1412
1672,7,0.0.125,0,656,0,76,125,201,0,125,201,312,0,0,683,1,3,322,290,322,415,8,1789,1357
1672,7,1.0.125,0,694,2,50,125,175,0,125,175,312,0,0,683,1,3,210,290,210,415,8,1789,1357
1672,7,3.2.199,1,656,0,64,199,263,199,0,263,312,-6,150,689,3,2,189,277,309,326,8,1789,1357
1672,7,4.0.125,0,656,0,69,125,194,0,125,194,312,0,0,683,1,3,262,290,262,415,8,1789,1357
1672,7,5.0.125,0,678,1,95,125,220,0,125,220,312,0,0,683,1,3,374,290,374,415,8,1789,1357
1672,8,0.0.125,0,656,0,76,125,201,0,125,201,312,0,0,689,1,3,322,290,322,415,9,1789,1293
1672,8,1.0.125,0,694,2,50,125,175,0,125,175,312,0,0,689,1,3,210,290,210,415,9,1789,1293
1672,8,3.3.286,1,656,0,31,286,317,263,23,317,317,0,193,689,4,2,125,281,309,374,9,1789,1293
1672,8,4.0.125,0,656,0,69,125,194,0,125,194,312,0,0,689,1,3,262,290,262,415,9,1789,1293
1672,8,5.0.125,0,678,1,95,125,220,0,125,220,312,0,0,689,1,3,374,290,374,415,9,1789,1293
1672,9,0.0.125,0,656,0,76,125,201,0,125,201,317,0,0,689,1,3,322,290,322,415,10,1789,1262
1672,9,1.0.125,0,694,2,50,125,175,0,125,175,317,0,0,689,1,3,210,290,210,415,10,1789,1262
1672,9,3.4.317,1,656,0,94,317,411,317,0,411,411,-5,291,694,5,2,94,295,309,321,10,1789,1262
1672,9,4.0.125,0,656,0,69,125,194,0,125,194,317,0,0,689,1,3,262,290,262,415,10,1789,1262
1672,9,5.0.125,0,678,1,95,125,220,0,125,220,317,0,0,689,1,3,374,290,374,415,10,1789,1262
1672,10,0.0.125,0,656,0,76,125,201,0,125,201,411,0,0,694,1,3,322,290,322,415,11,1789,1168
1672,10,1.0.125,0,694,2,50,125,175,0,125,175,411,0,0,694,1,3,210,290,210,415,11,1789,1168
1672,10,4.0.125,0,656,0,69,125,194,0,125,194,411,0,0,694,1,3,262,290,262,415,11,1789,1168
1672,10,5.0.125,1,678,1,95,125,220,0,125,220,411,0,0,694,1,3,374,290,374,415,11,1789,1168
1672,11,0.0.220,1,678,0,76,220,296,0,220,296,411,0,0,694,1,4,322,195,322,415,12,1789,1073
1672,11,1.0.220,0,678,0,50,220,270,0,220,270,411,0,0,694,1,4,210,195,210,415,12,1789,1073
1672,11,4.0.220,0,678,0,69,220,289,0,220,289,411,0,0,694,1,4,262,195,262,415,12,1789,1073
1672,11,5.1.220,0,678,0,98,220,318,220,0,318,411,-21,81,715,2,3,279,214,374,353,12,1789,1073
1672,12,0.1.296,0,685,1,15,296,311,296,0,311,411,-97,157,791,2,3,246,214,322,353,13,1789,997
1672,12,1.0.296,0,685,1,50,296,346,0,296,346,411,0,0,694,1,5,210,119,210,415,13,1789,997
1672,12,4.0.296,1,678,0,69,296,365,0,296,365,411,0,0,694,1,5,262,119,262,415,13,1789,997
1672,12,5.1.220,0,678,0,98,220,318,220,0,318,411,-21,81,715,2,3,279,214,374,353,13,1789,997
1672,13,0.1.296,0,685,1,15,296,311,296,0,311,411,-97,157,791,2,3,246,214,322,353,14,1789,928
1672,13,1.0.365,1,678,0,50,365,415,0,365,415,415,0,0,694,1,6,210,50,210,415,14,1789,928
1672,13,4.1.365,0,678,0,19,365,384,365,0,384,411,-166,226,860,2,3,193,214,262,353,14,1789,928
1672,13,5.1.220,0,678,0,98,220,318,220,0,318,411,-21,81,715,2,3,279,214,374,353,14,1789,928
1672,14,0.1.296,1,685,1,15,296,311,296,0,311,415,-97,157,791,2,3,246,214,322,353,15,1789,878
1672,14,1.1.415,0,678,0,82,415,497,415,0,497,497,-216,276,910,2,3,160,214,210,353,15,1789,878
1672,14,4.1.365,0,678,0,19,365,384,365,0,384,415,-166,226,860,2,3,193,214,262,353,15,1789,878
1672,14,5.1.220,0,678,0,98,220,318,220,0,318,415,-21,81,715,2,3,279,214,374,353,15,1789,878
1672,15,0.2.311,1,685,0,74,311,385,311,0,385,415,-48,198,839,3,3,231,213,322,326,16,1789,863
1672,15,1.1.415,0,702,2,82,415,497,415,0,497,497,-104,261,895,2,4,160,199,210,353,16,1789,863
1672,15,4.1.365,0,697,1,19,365,384,365,0,384,415,-54,211,845,2,4,193,199,262,353,16,1789,863
1672,15,5.1.311,0,685,0,98,311,409,220,91,409,415,0,157,791,2,4,279,199,374,353,16,1789,863
1672,16,0.3.385,0,685,0,98,385,483,385,0,483,483,-68,261,907,4,3,157,250,322,374,17,1789,789
1672,16,1.1.415,0,702,2,82,415,497,415,0,497,497,-104,261,943,2,4,160,199,210,353,17,1789,789
1672,16,4.1.365,0,697,1,19,365,384,365,0,384,415,-54,211,893,2,4,193,199,262,353,17,1789,789
1672,16,5.1.311,1,685,0,98,311,409,220,91,409,415,0,157,839,2,4,279,199,374,353,17,1789,789
1672,17,0.3.385,0,685,0,98,385,483,385,0,483,483,-68,261,907,4,3,157,250,322,374,18,1789,691
1672,17,1.1.415,0,702,1,82,415,497,415,0,497,497,-6,163,845,2,5,160,101,210,353,18,1789,691
1672,17,4.1.409,1,685,0,19,409,428,365,44,428,428,0,157,839,2,5,193,101,262,353,18,1789,691
1672,17,5.2.409,0,685,0,69,409,478,409,0,478,478,-24,222,863,3,4,181,139,374,326,18,1789,691
1672,18,0.3.385,0,685,0,98,385,483,385,0,483,483,-68,261,907,4,3,157,250,322,374,19,1789,672
1672,18,1.1.428,0,685,0,82,428,510,415,13,510,510,0,157,839,2,6,160,82,210,353,19,1789,672
1672,18,4.2.428,0,697,1,34,428,462,428,0,462,462,-43,241,882,3,4,174,139,262,326,19,1789,672
1672,18,5.2.409,1,685,0,69,409,478,409,0,478,478,-24,222,863,3,4,181,139,374,326,19,1789,672
1672,19,0.3.385,0,685,0,98,385,483,385,0,483,483,-68,261,931,4,3,157,250,322,374,20,1789,603
1672,19,1.1.428,0,685,0,82,428,510,415,13,510,510,0,157,863,2,6,160,82,210,353,20,1789,603
1672,19,4.2.478,1,685,0,34,478,512,428,50,512,512,0,222,863,3,5,174,70,262,326,20,1789,603
1672,19,5.3.478,0,769,1,50,478,528,478,0,528,528,-161,354,1024,4,3,112,250,374,374,20,1789,603
1672,20,0.3.385,1,685,0,98,385,483,385,0,483,512,-68,261,931,4,3,157,250,322,374,21,1789,569
1672,20,1.1.428,0,685,0,82,428,510,415,13,510,512,0,157,863,2,6,160,82,210,353,21,1789,569
1672,20,4.3.512,0,726,1,72,512,584,512,0,584,584,-195,388,1058,4,3,140,250,262,374,21,1789,569
1672,20,5.3.478,0,769,2,50,478,528,478,0,528,528,-161,354,1024,4,3,112,250,374,374,21,1789,569
1672,21,0.4.483,1,685,0,59,483,542,483,0,542,542,-72,363,1003,5,3,59,201,322,321,22,1789,471
1672,21,1.1.428,0,685,0,82,428,510,415,13,510,512,0,157,931,2,6,160,82,210,353,22,1789,471
1672,21,4.3.512,0,726,1,72,512,584,512,0,584,584,-29,290,960,4,4,140,152,262,374,22,1789,471
1672,21,5.3.483,0,685,0,50,483,533,478,5,533,533,0,261,931,4,4,112,152,374,374,22,1789,471
1672,22,1.1.428,0,685,0,82,428,510,415,13,510,542,0,157,1003,2,6,160,82,210,353,23,1789,412
1672,22,4.3.512,0,726,1,72,512,584,512,0,584,584,-29,290,1032,4,4,140,152,262,374,23,1789,412
1672,22,5.3.483,1,685,0,50,483,533,478,5,533,542,0,261,1003,4,4,112,152,374,374,23,1789,412
1672,23,1.1.428,0,685,0,82,428,510,415,13,510,542,0,157,1003,2,6,160,82,210,353,24,1789,362
1672,23,4.3.533,0,685,0,72,533,605,512,21,605,605,0,261,1003,4,5,140,102,262,374,24,1789,362
1672,23,5.4.542,1,685,0,62,542,604,533,9,604,604,0,363,1003,5,4,62,142,374,321,24,1789,362
1672,24,1.1.428,0,685,0,82,428,510,415,13,510,604,0,157,1003,2,6,160,82,210,353,25,1789,300
1672,24,4.3.533,1,685,0,72,533,605,512,21,605,605,0,261,1003,4,5,140,102,262,374,25,1789,300
1672,25,1.1.428,0,685,0,82,428,510,415,13,510,605,0,157,1003,2,6,160,82,210,353,26,1789,228
1672,25,4.4.605,1,685,0,68,605,673,605,0,673,673,-1,364,1004,5,5,68,80,262,321,26,1789,228
1672,26,1.1.428,1,685,0,82,428,510,415,13,510,673,0,157,1004,2,6,160,82,210,353,27,1789,160
1672,27,1.2.512,1,685,0,36,512,548,510,2,548,673,0,222,1004,3,6,78,36,210,326,28,1789,78
1672,28,1.3.605,1,685,0,30,605,635,548,57,635,673,0,261,1004,4,6,42,30,210,374,29,1789,42
1672,29,1.4.673,1,685,0,12,673,685,635,38,685,685,0,364,1004,5,6,12,12,210,321,30,1789,12
1673,0,0.0.0,0,642,4,89,0,89,0,0,89,89,0,0,0,1,1,265,329,265,329,1,1556,1556
1673,0,1.0.0,0,573,2,26,0,26,0,0,26,26,0,0,0,1,1,209,329,209,329,1,1556,1556
1673,0,2.0.0,1,553,0,6,0,6,0,0,6,6,0,0,0,1,1,239,329,239,329,1,1556,1556
1673,0,3.0.0,0,566,1,19,0,19,0,0,19,19,0,0,0,1,1,268,329,268,329,1,1556,1556
1673,0,4.0.0,0,637,3,90,0,90,0,0,90,90,0,0,0,1,1,299,329,299,329,1,1556,1556
1673,0,5.0.0,0,646,5,99,0,99,0,0,99,99,0,0,0,1,1,276,329,276,329,1,1556,1556
1673,1,0.0.6,0,584,3,89,6,95,0,6,95,95,0,0,0,1,2,265,323,265,329,2,1556,1550
1673,1,1.0.6,0,553,0,26,6,32,0,6,32,32,0,0,0,1,2,209,323,209,329,2,1556,1550
1673,1,2.1.6,0,553,0,77,6,83,6,0,83,83,-6,6,6,2,1,233,453,239,453,2,1556,1550
1673,1,3.0.6,1,553,0,19,6,25,0,6,25,25,0,0,0,1,2,268,323,268,329,2,1556,1550
1673,1,4.0.6,0,566,1,90,6,96,0,6,96,96,0,0,0,1,2,299,323,299,329,2,1556,1550
1673,1,5.0.6,0,575,2,99,6,105,0,6,105,105,0,0,0,1,2,276,323,276,329,2,1556,1550
1673,2,0.0.25,0,559,1,89,25,114,0,25,114,114,0,0,0,1,3,265,304,265,329,3,1556,1531
1673,2,1.0.25,1,553,0,26,25,51,0,25,51,51,0,0,0,1,3,209,304,209,329,3,1556,1531
1673,2,2.1.6,0,553,0,77,6,83,6,0,83,83,-6,6,6,2,1,233,453,239,453,3,1556,1531
1673,2,3.1.25,0,572,2,93,25,118,25,0,118,118,-25,25,25,2,1,249,453,268,453,3,1556,1531
1673,2,4.0.25,0,553,0,90,25,115,0,25,115,115,0,0,0,1,3,299,304,299,329,3,1556,1531
1673,2,5.0.25,0,553,0,99,25,124,0,25,124,124,0,0,0,1,3,276,304,276,329,3,1556,1531
1673,3,0.0.51,0,559,1,89,51,140,0,51,140,140,0,0,0,1,4,265,278,265,329,4,1556,1505
1673,3,1.1.51,0,598,3,50,51,101,51,0,101,101,-51,51,51,2,1,183,453,209,453,4,1556,1505
1673,3,2.1.6,0,553,0,77,6,83,6,0,83,83,-6,6,6,2,1,233,453,239,453,4,1556,1505
1673,3,3.1.25,0,572,2,93,25,118,25,0,118,118,-25,25,25,2,1,249,453,268,453,4,1556,1505
1673,3,4.0.51,1,553,0,90,51,141,0,51,141,141,0,0,0,1,4,299,278,299,329,4,1556,1505
1673,3,5.0.51,0,553,0,99,51,150,0,51,150,150,0,0,0,1,4,276,278,276,329,4,1556,1505
1673,4,0.0.141,1,555,1,89,141,230,0,141,230,230,0,0,0,1,5,265,188,265,329,5,1556,1415
1673,4,1.1.51,0,598,4,50,51,101,51,0,101,141,-51,51,51,2,1,183,453,209,453,5,1556,1415
1673,4,2.1.6,0,553,0,77,6,83,6,0,83,141,-6,6,6,2,1,233,453,239,453,5,1556,1415
1673,4,3.1.25,0,572,3,93,25,118,25,0,118,141,-25,25,25,2,1,249,453,268,453,5,1556,1415
1673,4,4.1.141,0,561,2,70,141,211,141,0,211,211,-141,141,141,2,1,209,453,299,453,5,1556,1415
1673,4,5.0.141,0,553,0,99,141,240,0,141,240,240,0,0,0,1,5,276,188,276,329,5,1556,1415
1673,5,0.1.230,0,581,3,82,230,312,230,0,312,312,-230,230,230,2,1,176,453,265,453,6,1556,1326
1673,5,1.1.51,0,598,4,50,51,101,51,0,101,230,-51,51,51,2,1,183,453,209,453,6,1556,1326
1673,5,2.1.6,0,555,0,77,6,83,6,0,83,230,-6,6,6,2,1,233,453,239,453,6,1556,1326
1673,5,3.1.25,0,574,2,93,25,118,25,0,118,230,-25,25,25,2,1,249,453,268,453,6,1556,1326
1673,5,4.1.141,0,563,1,70,141,211,141,0,211,230,-141,141,141,2,1,209,453,299,453,6,1556,1326
1673,5,5.0.230,1,555,0,99,230,329,0,230,329,329,0,0,0,1,6,276,99,276,329,6,1556,1326
1673,6,0.1.230,0,581,3,82,230,312,230,0,312,329,-230,230,230,2,1,176,453,265,453,7,1556,1227
1673,6,1.1.51,0,598,5,50,51,101,51,0,101,329,-51,51,51,2,1,183,453,209,453,7,1556,1227
1673,6,2.1.6,1,555,0,77,6,83,6,0,83,329,-6,6,6,2,1,233,453,239,453,7,1556,1227
1673,6,3.1.25,0,574,2,93,25,118,25,0,118,329,-25,25,25,2,1,249,453,268,453,7,1556,1227
1673,6,4.1.141,0,563,1,70,141,211,141,0,211,329,-141,141,141,2,1,209,453,299,453,7,1556,1227
1673,6,5.1.329,0,586,4,81,329,410,329,0,410,410,-329,329,329,2,1,177,453,276,453,7,1556,1227
1673,7,0.1.230,0,581,2,82,230,312,230,0,312,329,-147,153,153,2,2,176,376,265,453,8,1556,1150
1673,7,1.1.83,0,555,0,50,83,133,51,32,133,329,0,6,6,2,2,183,376,209,453,8,1556,1150
1673,7,2.2.83,1,555,0,3,83,86,83,0,86,329,-83,83,89,3,1,156,195,239,195,8,1556,1150
1673,7,3.1.83,0,555,0,93,83,176,25,58,176,329,0,6,6,2,2,249,376,268,453,8,1556,1150
1673,7,4.1.141,0,563,1,70,141,211,141,0,211,329,-58,64,64,2,2,209,376,299,453,8,1556,1150
1673,7,5.1.329,0,586,3,81,329,410,329,0,410,410,-246,252,252,2,2,177,376,276,453,8,1556,1150
1673,8,0.1.230,0,581,2,82,230,312,230,0,312,329,-147,153,236,2,2,176,376,265,453,9,1556,1147
1673,8,1.1.83,0,555,0,50,83,133,51,32,133,329,0,6,89,2,2,183,376,209,453,9,1556,1147
1673,8,2.3.86,1,555,0,62,86,148,86,0,148,329,-86,86,175,4,1,153,327,239,327,9,1556,1147
1673,8,3.1.83,0,555,0,93,83,176,25,58,176,329,0,6,89,2,2,249,376,268,453,9,1556,1147
1673,8,4.1.141,0,563,1,70,141,211,141,0,211,329,-58,64,147,2,2,209,376,299,453,9,1556,1147
1673,8,5.1.329,0,586,3,81,329,410,329,0,410,410,-246,252,335,2,2,177,376,276,453,9,1556,1147
1673,9,0.1.230,0,581,2,82,230,312,230,0,312,329,-147,153,322,2,2,176,376,265,453,10,1556,1085
1673,9,1.1.83,0,555,0,50,83,133,51,32,133,329,0,6,175,2,2,183,376,209,453,10,1556,1085
1673,9,2.4.148,1,555,0,91,148,239,148,0,239,329,-148,148,323,5,1,91,252,239,252,10,1556,1085
1673,9,3.1.83,0,555,0,93,83,176,25,58,176,329,0,6,175,2,2,249,376,268,453,10,1556,1085
1673,9,4.1.141,0,563,1,70,141,211,141,0,211,329,-58,64,233,2,2,209,376,299,453,10,1556,1085
1673,9,5.1.329,0,586,3,81,329,410,329,0,410,410,-246,252,421,2,2,177,376,276,453,10,1556,1085
1673,10,0.1.230,0,581,2,82,230,312,230,0,312,329,-147,153,470,2,2,176,376,265,453,11,1556,994
1673,10,1.1.83,1,555,0,50,83,133,51,32,133,329,0,6,323,2,2,183,376,209,453,11,1556,994
1673,10,3.1.83,0,555,0,93,83,176,25,58,176,329,0,6,323,2,2,249,376,268,453,11,1556,994
1673,10,4.1.141,0,563,1,70,141,211,141,0,211,329,-58,64,381,2,2,209,376,299,453,11,1556,994
1673,10,5.1.329,0,586,3,81,329,410,329,0,410,410,-246,252,569,2,2,177,376,276,453,11,1556,994
1673,11,0.1.230,0,581,2,82,230,312,230,0,312,329,-97,103,420,2,3,176,326,265,453,12,1556,944
1673,11,1.2.133,1,555,0,41,133,174,133,0,174,329,-47,130,370,3,2,133,192,209,195,12,1556,944
1673,11,3.1.133,0,555,0,93,133,226,25,108,226,329,0,6,323,2,3,249,326,268,453,12,1556,944
1673,11,4.1.141,0,563,1,70,141,211,141,0,211,329,-8,14,331,2,3,209,326,299,453,12,1556,944
1673,11,5.1.329,0,586,3,81,329,410,329,0,410,410,-196,202,519,2,3,177,326,276,453,12,1556,944
1673,12,0.1.230,0,581,2,82,230,312,230,0,312,329,-97,103,467,2,3,176,326,265,453,13,1556,903
1673,12,1.3.174,1,555,0,71,174,245,174,0,245,329,-26,112,396,4,2,92,265,209,327,13,1556,903
1673,12,3.1.133,0,555,0,93,133,226,25,108,226,329,0,6,370,2,3,249,326,268,453,13,1556,903
1673,12,4.1.141,0,563,1,70,141,211,141,0,211,329,-8,14,378,2,3,209,326,299,453,13,1556,903
1673,12,5.1.329,0,586,3,81,329,410,329,0,410,410,-196,202,566,2,3,177,326,276,453,13,1556,903
1673,13,0.1.230,0,581,2,82,230,312,230,0,312,329,-97,103,493,2,3,176,326,265,453,14,1556,832
1673,13,1.4.245,1,555,0,21,245,266,245,0,266,329,-6,154,402,5,2,21,161,209,252,14,1556,832
1673,13,3.1.133,0,555,0,93,133,226,25,108,226,329,0,6,396,2,3,249,326,268,453,14,1556,832
1673,13,4.1.141,0,563,1,70,141,211,141,0,211,329,-8,14,404,2,3,209,326,299,453,14,1556,832
1673,13,5.1.329,0,586,3,81,329,410,329,0,410,410,-196,202,592,2,3,177,326,276,453,14,1556,832
1673,14,0.1.230,0,581,2,82,230,312,230,0,312,329,-97,103,499,2,3,176,326,265,453,15,1556,811
1673,14,3.1.133,1,555,0,93,133,226,25,108,226,329,0,6,402,2,3,249,326,268,453,15,1556,811
1673,14,4.1.141,0,563,1,70,141,211,141,0,211,329,-8,14,410,2,3,209,326,299,453,15,1556,811
1673,14,5.1.329,0,586,3,81,329,410,329,0,410,410,-196,202,598,2,3,177,326,276,453,15,1556,811
1673,15,0.1.230,0,581,1,82,230,312,230,0,312,329,-4,10,406,2,4,176,233,265,453,16,1556,718
1673,15,3.2.226,1,555,0,31,226,257,226,0,257,329,-52,182,454,3,3,156,151,268,195,16,1556,718
1673,15,4.1.226,0,555,0,70,226,296,141,85,296,329,0,6,402,2,4,209,233,299,453,16,1556,718
1673,15,5.1.329,0,586,2,81,329,410,329,0,410,410,-103,109,505,2,4,177,233,276,453,16,1556,718
1673,16,0.1.230,0,581,1,82,230,312,230,0,312,329,-4,10,458,2,4,176,233,265,453,17,1556,687
1673,16,3.3.257,1,555,0,89,257,346,257,0,346,346,-12,124,466,4,3,125,194,268,327,17,1556,687
1673,16,4.1.226,0,555,0,70,226,296,141,85,296,329,0,6,454,2,4,209,233,299,453,17,1556,687
1673,16,5.1.329,0,586,2,81,329,410,329,0,410,410,-103,109,557,2,4,177,233,276,453,17,1556,687
1673,17,0.1.230,0,581,1,82,230,312,230,0,312,346,-4,10,470,2,4,176,233,265,453,18,1556,598
1673,17,3.4.346,1,555,0,36,346,382,346,0,382,382,-80,234,546,5,3,36,140,268,252,18,1556,598
1673,17,4.1.226,0,555,0,70,226,296,141,85,296,346,0,6,466,2,4,209,233,299,453,18,1556,598
1673,17,5.1.329,0,586,2,81,329,410,329,0,410,410,-103,109,569,2,4,177,233,276,453,18,1556,598
1673,18,0.1.230,0,581,1,82,230,312,230,0,312,382,-4,10,550,2,4,176,233,265,453,19,1556,562
1673,18,4.1.226,1,555,0,70,226,296,141,85,296,382,0,6,546,2,4,209,233,299,453,19,1556,562
1673,18,5.1.329,0,586,2,81,329,410,329,0,410,410,-103,109,649,2,4,177,233,276,453,19,1556,562
1673,19,0.1.296,0,555,0,82,296,378,230,66,378,382,0,6,546,2,5,176,163,265,453,20,1556,492
1673,19,4.2.296,1,555,0,35,296,331,296,0,331,382,-39,221,585,3,4,139,120,299,195,20,1556,492
1673,19,5.1.329,0,586,1,81,329,410,329,0,410,410,-33,39,579,2,5,177,163,276,453,20,1556,492
1673,20,0.1.296,0,555,0,82,296,378,230,66,378,382,0,6,585,2,5,176,163,265,453,21,1556,457
1673,20,4.3.346,1,555,0,65,346,411,331,15,411,411,0,124,585,4,4,104,105,299,327,21,1556,457
1673,20,5.1.329,0,586,1,81,329,410,329,0,410,410,-33,39,618,2,5,177,163,276,453,21,1556,457
1673,21,0.1.296,0,555,0,82,296,378,230,66,378,411,0,6,585,2,5,176,163,265,453,22,1556,392
1673,21,4.4.411,1,555,0,39,411,450,411,0,450,450,-29,263,614,5,4,39,104,299,252,22,1556,392
1673,21,5.1.329,0,586,1,81,329,410,329,0,410,411,-33,39,618,2,5,177,163,276,453,22,1556,392
1673,22,0.1.296,1,555,0,82,296,378,230,66,378,450,0,6,614,2,5,176,163,265,453,23,1556,353
1673,22,5.1.329,0,586,1,81,329,410,329,0,410,450,-33,39,647,2,5,177,163,276,453,23,1556,353
1673,23,0.2.378,1,555,0,77,378,455,378,0,455,455,-47,268,661,3,5,94,85,265,195,24,1556,271
1673,23,5.1.378,0,555,0,81,378,459,329,49,459,459,0,6,614,2,6,177,81,276,453,24,1556,271
1673,24,0.3.455,1,555,0,5,455,460,455,0,460,460,-44,168,705,4,5,17,40,265,327,25,1556,194
1673,24,5.1.378,0,555,0,81,378,459,329,49,459,459,0,6,661,2,6,177,81,276,453,25,1556,194
1673,25,0.4.460,1,555,0,12,460,472,460,0,472,472,-10,273,715,5,5,12,65,265,252,26,1556,189
1673,25,5.1.378,0,555,0,81,378,459,329,49,459,460,0,6,705,2,6,177,81,276,453,26,1556,189
1673,26,5.1.378,1,555,0,81,378,459,329,49,459,472,0,6,715,2,6,177,81,276,453,27,1556,177
1673,27,5.2.459,1,555,0,8,459,467,459,0,467,472,-4,272,719,3,6,96,8,276,195,28,1556,96
1673,28,5.3.467,1,555,0,35,467,502,467,0,502,502,-7,175,726,4,6,88,35,276,327,29,1556,88
1673,29,5.4.502,1,555,0,53,502,555,502,0,555,555,-30,303,756,5,6,53,53,276,252,30,1556,53
1674,0,0.0.0,1,487,1,3,0,3,0,0,3,3,0,0,0,1,1,211,146,211,146,1,1234,1234
1674,0,1.0.0,0,484,0,2,0,2,0,0,2,2,0,0,0,1,1,111,146,111,146,1,1234,1234
1674,0,2.0.0,0,536,5,52,0,52,0,0,52,52,0,0,0,1,1,266,146,266,146,1,1234,1234
1674,0,3.0.0,0,531,4,71,0,71,0,0,71,71,0,0,0,1,1,327,146,327,146,1,1234,1234
1674,0,4.0.0,0,497,3,13,0,13,0,0,13,13,0,0,0,1,1,139,146,139,146,1,1234,1234
1674,0,5.0.0,0,489,2,5,0,5,0,0,5,5,0,0,0,1,1,180,146,180,146,1,1234,1234
1674,1,0.1.3,0,497,2,51,3,54,3,0,54,54,-3,3,3,2,1,208,260,211,260,2,1234,1231
1674,1,1.0.3,0,487,0,2,3,5,0,3,5,5,0,0,0,1,2,111,143,111,146,2,1234,1231
1674,1,2.0.3,0,497,2,52,3,55,0,3,55,55,0,0,0,1,2,266,143,266,146,2,1234,1231
1674,1,3.0.3,0,499,3,71,3,74,0,3,74,74,0,0,0,1,2,327,143,327,146,2,1234,1231
1674,1,4.0.3,0,499,3,13,3,16,0,3,16,16,0,0,0,1,2,139,143,139,146,2,1234,1231
1674,1,5.0.3,1,492,1,5,3,8,0,3,8,8,0,0,0,1,2,180,143,180,146,2,1234,1231
1674,2,0.1.3,0,497,1,51,3,54,3,0,54,54,-3,3,3,2,1,208,260,211,260,3,1234,1226
1674,2,1.0.8,0,492,0,2,8,10,0,8,10,10,0,0,0,1,3,111,138,111,146,3,1234,1226
1674,2,2.0.8,0,497,1,52,8,60,0,8,60,60,0,0,0,1,3,266,138,266,146,3,1234,1226
1674,2,3.0.8,1,499,2,71,8,79,0,8,79,79,0,0,0,1,3,327,138,327,146,3,1234,1226
1674,2,4.0.8,0,499,2,13,8,21,0,8,21,21,0,0,0,1,3,139,138,139,146,3,1234,1226
1674,2,5.1.8,0,503,3,65,8,73,8,0,73,73,-8,8,8,2,1,175,260,180,260,3,1234,1226
1674,3,0.1.3,0,499,0,51,3,54,3,0,54,79,-3,3,3,2,1,208,260,211,260,4,1234,1155
1674,3,1.0.79,0,499,0,2,79,81,0,79,81,81,0,0,0,1,4,111,67,111,146,4,1234,1155
1674,3,2.0.79,1,499,0,52,79,131,0,79,131,131,0,0,0,1,4,266,67,266,146,4,1234,1155
1674,3,3.1.79,0,499,0,32,79,111,79,0,111,111,-79,79,79,2,1,256,260,327,260,4,1234,1155
1674,3,4.0.79,0,499,0,13,79,92,0,79,92,92,0,0,0,1,4,139,67,139,146,4,1234,1155
1674,3,5.1.8,0,503,1,65,8,73,8,0,73,79,-8,8,8,2,1,175,260,180,260,4,1234,1155
1674,4,0.1.3,0,499,0,51,3,54,3,0,54,131,-3,3,3,2,1,208,260,211,260,5,1234,1103
1674,4,1.0.131,1,499,0,2,131,133,0,131,133,133,0,0,0,1,5,111,15,111,146,5,1234,1103
1674,4,2.1.131,0,499,0,71,131,202,131,0,202,202,-131,131,131,2,1,214,260,266,260,5,1234,1103
1674,4,3.1.79,0,499,0,32,79,111,79,0,111,131,-79,79,79,2,1,256,260,327,260,5,1234,1103
1674,4,4.0.131,0,499,0,13,131,144,0,131,144,144,0,0,0,1,5,139,15,139,146,5,1234,1103
1674,4,5.1.8,0,503,1,65,8,73,8,0,73,131,-8,8,8,2,1,175,260,180,260,5,1234,1103
1674,5,0.1.3,0,499,0,51,3,54,3,0,54,133,-3,3,3,2,1,208,260,211,260,6,1234,1101
1674,5,1.1.133,0,499,0,18,133,151,133,0,151,151,-133,133,133,2,1,109,260,111,260,6,1234,1101
1674,5,2.1.131,0,499,0,71,131,202,131,0,202,202,-131,131,131,2,1,214,260,266,260,6,1234,1101
1674,5,3.1.79,0,499,0,32,79,111,79,0,111,133,-79,79,79,2,1,256,260,327,260,6,1234,1101
1674,5,4.0.133,1,499,0,13,133,146,0,133,146,146,0,0,0,1,6,139,13,139,146,6,1234,1101
1674,5,5.1.8,0,503,1,65,8,73,8,0,73,133,-8,8,8,2,1,175,260,180,260,6,1234,1101
1674,6,0.1.3,0,499,0,51,3,54,3,0,54,146,-3,3,3,2,1,208,260,211,260,7,1234,1088
1674,6,1.1.133,0,499,0,18,133,151,133,0,151,151,-133,133,133,2,1,109,260,111,260,7,1234,1088
1674,6,2.1.131,0,499,0,71,131,202,131,0,202,202,-131,131,131,2,1,214,260,266,260,7,1234,1088
1674,6,3.1.79,1,499,0,32,79,111,79,0,111,146,-79,79,79,2,1,256,260,327,260,7,1234,1088
1674,6,4.1.146,0,499,0,23,146,169,146,0,169,169,-146,146,146,2,1,126,260,139,260,7,1234,1088
1674,6,5.1.8,0,503,1,65,8,73,8,0,73,146,-8,8,8,2,1,175,260,180,260,7,1234,1088
1674,7,0.1.3,1,499,0,51,3,54,3,0,111,146,51,28,28,2,2,208,228,211,260,8,1234,1056
1674,7,1.1.133,0,499,0,18,133,151,133,0,151,151,-22,101,101,2,2,109,228,111,260,8,1234,1056
1674,7,2.1.131,0,499,0,71,131,202,131,0,202,202,-20,99,99,2,2,214,228,266,260,8,1234,1056
1674,7,3.2.111,0,539,2,98,111,209,111,0,209,209,-111,111,190,3,1,224,363,327,363,8,1234,1056
1674,7,4.1.146,0,499,0,23,146,169,146,0,169,169,-35,114,114,2,2,126,228,139,260,8,1234,1056
1674,7,5.1.8,0,503,1,65,8,73,8,0,111,146,65,14,14,2,2,175,228,180,260,8,1234,1056
1674,8,0.2.54,0,499,0,81,54,135,54,0,135,146,-54,54,82,3,1,157,363,211,363,9,1234,1005
1674,8,1.1.133,0,499,0,18,133,151,133,0,151,151,-22,50,50,2,3,109,177,111,260,9,1234,1005
1674,8,2.1.131,0,499,0,71,131,202,131,0,202,202,-20,48,48,2,3,214,177,266,260,9,1234,1005
1674,8,3.2.111,0,539,1,98,111,209,111,0,209,209,-111,111,139,3,1,224,363,327,363,9,1234,1005
1674,8,4.1.146,0,499,0,23,146,169,146,0,169,169,-35,63,63,2,3,126,177,139,260,9,1234,1005
1674,8,5.1.111,1,499,0,65,111,176,8,103,176,176,0,28,28,2,3,175,177,180,260,9,1234,1005
1674,9,0.2.54,0,499,0,81,54,135,54,0,135,176,-54,54,82,3,1,157,363,211,363,10,1234,940
1674,9,1.1.176,1,499,0,18,176,194,133,43,194,194,0,28,28,2,4,109,112,111,260,10,1234,940
1674,9,2.1.176,0,499,0,71,176,247,131,45,247,247,0,28,28,2,4,214,112,266,260,10,1234,940
1674,9,3.2.111,0,539,1,98,111,209,111,0,209,209,-111,111,139,3,1,224,363,327,363,10,1234,940
1674,9,4.1.176,0,499,0,23,176,199,146,30,199,199,0,28,28,2,4,126,112,139,260,10,1234,940
1674,9,5.2.176,0,542,2,46,176,222,176,0,222,222,-176,176,204,3,1,110,363,180,363,10,1234,940
1674,10,0.2.54,0,499,0,81,54,135,54,0,135,194,-54,54,82,3,1,157,363,211,363,11,1234,922
1674,10,1.2.194,0,575,3,47,194,241,194,0,241,241,-194,194,222,3,1,91,363,111,363,11,1234,922
1674,10,2.1.194,0,499,0,71,194,265,131,63,265,265,0,28,28,2,5,214,94,266,260,11,1234,922
1674,10,3.2.111,0,539,1,98,111,209,111,0,209,209,-111,111,139,3,1,224,363,327,363,11,1234,922
1674,10,4.1.194,1,499,0,23,194,217,146,48,217,217,0,28,28,2,5,126,94,139,260,11,1234,922
1674,10,5.2.176,0,542,2,46,176,222,176,0,222,222,-176,176,204,3,1,110,363,180,363,11,1234,922
1674,11,0.2.54,0,499,0,81,54,135,54,0,135,217,-54,54,82,3,1,157,363,211,363,12,1234,899
1674,11,1.2.194,0,575,4,47,194,241,194,0,241,241,-194,194,222,3,1,91,363,111,363,12,1234,899
1674,11,2.1.217,1,499,0,71,217,288,131,86,288,288,0,28,28,2,6,214,71,266,260,12,1234,899
1674,11,3.2.111,0,539,1,98,111,209,111,0,209,217,-111,111,139,3,1,224,363,327,363,12,1234,899
1674,11,4.2.217,0,541,2,36,217,253,217,0,253,253,-217,217,245,3,1,103,363,139,363,12,1234,899
1674,11,5.2.176,0,542,3,46,176,222,176,0,222,222,-176,176,204,3,1,110,363,180,363,12,1234,899
1674,12,0.2.54,1,499,0,81,54,135,54,0,135,288,-54,54,82,3,1,157,363,211,363,13,1234,828
1674,12,1.2.194,0,575,4,47,194,241,194,0,241,288,-194,194,222,3,1,91,363,111,363,13,1234,828
1674,12,2.2.288,0,499,0,55,288,343,288,0,343,343,-288,288,316,3,1,143,363,266,363,13,1234,828
1674,12,3.2.111,0,539,1,98,111,209,111,0,209,288,-111,111,139,3,1,224,363,327,363,13,1234,828
1674,12,4.2.217,0,541,2,36,217,253,217,0,253,288,-217,217,245,3,1,103,363,139,363,13,1234,828
1674,12,5.2.176,0,542,3,46,176,222,176,0,222,288,-176,176,204,3,1,110,363,180,363,13,1234,828
1674,13,0.3.135,1,499,0,12,135,147,135,0,147,288,-135,135,217,4,1,76,184,211,184,14,1234,747
1674,13,1.2.194,0,575,2,47,194,241,194,0,241,288,-59,113,141,3,2,91,282,111,363,14,1234,747
1674,13,2.2.288,0,499,0,55,288,343,288,0,343,343,-153,207,235,3,2,143,282,266,363,14,1234,747
1674,13,3.2.135,0,499,0,98,135,233,111,24,233,288,0,54,82,3,2,224,282,327,363,14,1234,747
1674,13,4.2.217,0,608,3,36,217,253,217,0,253,288,-82,136,164,3,2,103,282,139,363,14,1234,747
1674,13,5.2.176,0,542,1,46,176,222,176,0,222,288,-41,95,123,3,2,110,282,180,363,14,1234,747
1674,14,0.4.147,1,499,0,64,147,211,147,0,211,288,-147,147,364,5,1,64,281,211,281,15,1234,735
1674,14,1.2.194,0,575,2,47,194,241,194,0,241,288,-59,113,276,3,2,91,282,111,363,15,1234,735
1674,14,2.2.288,0,499,0,55,288,343,288,0,343,343,-153,207,370,3,2,143,282,266,363,15,1234,735
1674,14,3.2.135,0,499,0,98,135,233,111,24,233,288,0,54,217,3,2,224,282,327,363,15,1234,735
1674,14,4.2.217,0,608,3,36,217,253,217,0,253,288,-82,136,299,3,2,103,282,139,363,15,1234,735
1674,14,5.2.176,0,542,1,46,176,222,176,0,222,288,-41,95,258,3,2,110,282,180,363,15,1234,735
1674,15,1.2.194,0,575,2,47,194,241,194,0,241,288,-59,113,423,3,2,91,282,111,363,16,1234,671
1674,15,2.2.288,0,499,0,55,288,343,288,0,343,343,-153,207,517,3,2,143,282,266,363,16,1234,671
1674,15,3.2.135,1,499,0,98,135,233,111,24,233,288,0,54,364,3,2,224,282,327,363,16,1234,671
1674,15,4.2.217,0,608,3,36,217,253,217,0,253,288,-82,136,446,3,2,103,282,139,363,16,1234,671
1674,15,5.2.176,0,542,1,46,176,222,176,0,222,288,-41,95,405,3,2,110,282,180,363,16,1234,671
1674,16,1.2.233,0,499,0,47,233,280,194,39,280,288,0,54,364,3,3,91,184,111,363,17,1234,573
1674,16,2.2.288,0,499,0,55,288,343,288,0,343,343,-55,109,419,3,3,143,184,266,363,17,1234,573
1674,16,3.3.233,1,499,0,49,233,282,233,0,282,288,-86,221,450,4,2,126,172,327,184,17,1234,573
1674,16,4.2.233,0,499,0,36,233,269,217,16,269,288,0,54,364,3,3,103,184,139,363,17,1234,573
1674,16,5.2.233,0,499,0,46,233,279,176,57,279,288,0,54,364,3,3,110,184,180,363,17,1234,573
1674,17,1.2.233,0,499,0,47,233,280,194,39,280,288,0,54,450,3,3,91,184,111,363,18,1234,524
1674,17,2.2.288,0,499,0,55,288,343,288,0,343,343,-55,109,505,3,3,143,184,266,363,18,1234,524
1674,17,3.4.282,1,499,0,77,282,359,282,0,359,359,-71,218,521,5,2,77,217,327,281,18,1234,524
1674,17,4.2.233,0,499,0,36,233,269,217,16,269,288,0,54,450,3,3,103,184,139,363,18,1234,524
1674,17,5.2.233,0,499,0,46,233,279,176,57,279,288,0,54,450,3,3,110,184,180,363,18,1234,524
1674,18,1.2.233,0,499,0,47,233,280,194,39,280,359,0,54,521,3,3,91,184,111,363,19,1234,447
1674,18,2.2.288,0,499,0,55,288,343,288,0,343,359,-55,109,576,3,3,143,184,266,363,19,1234,447
1674,18,4.2.233,0,499,0,36,233,269,217,16,269,359,0,54,521,3,3,103,184,139,363,19,1234,447
1674,18,5.2.233,1,499,0,46,233,279,176,57,279,359,0,54,521,3,3,110,184,180,363,19,1234,447
1674,19,1.2.279,0,499,0,47,279,326,194,85,326,359,0,54,521,3,4,91,138,111,363,20,1234,401
1674,19,2.2.288,0,499,0,55,288,343,288,0,343,359,-9,63,530,3,4,143,138,266,363,20,1234,401
1674,19,4.2.279,0,499,0,36,279,315,217,62,315,359,0,54,521,3,4,103,138,139,363,20,1234,401
1674,19,5.3.282,1,499,0,20,282,302,279,3,302,359,0,221,521,4,3,64,123,180,184,20,1234,401
1674,20,1.2.279,0,499,0,47,279,326,194,85,326,359,0,54,521,3,4,91,138,111,363,21,1234,381
1674,20,2.2.288,0,499,0,55,288,343,288,0,343,359,-9,63,530,3,4,143,138,266,363,21,1234,381
1674,20,4.2.279,0,499,0,36,279,315,217,62,315,359,0,54,521,3,4,103,138,139,363,21,1234,381
1674,20,5.4.359,1,499,0,44,359,403,302,57,403,403,0,218,521,5,3,44,140,180,281,21,1234,381
1674,21,1.2.279,0,499,0,47,279,326,194,85,326,403,0,54,521,3,4,91,138,111,363,22,1234,337
1674,21,2.2.288,0,499,0,55,288,343,288,0,343,403,-9,63,530,3,4,143,138,266,363,22,1234,337
1674,21,4.2.279,1,499,0,36,279,315,217,62,315,403,0,54,521,3,4,103,138,139,363,22,1234,337
1674,22,1.2.315,0,505,1,47,315,362,194,121,362,403,0,54,521,3,5,91,102,111,363,23,1234,301
1674,22,2.2.315,0,499,0,55,315,370,288,27,370,403,0,54,521,3,5,143,102,266,363,23,1234,301
1674,22,4.3.315,1,499,0,58,315,373,315,0,373,403,-13,234,534,4,4,67,103,139,184,23,1234,301
1674,23,1.2.315,0,505,1,47,315,362,194,121,362,403,0,54,534,3,5,91,102,111,363,24,1234,243
1674,23,2.2.315,0,499,0,55,315,370,288,27,370,403,0,54,534,3,5,143,102,266,363,24,1234,243
1674,23,4.4.403,1,499,0,9,403,412,373,30,412,412,0,218,534,5,4,9,96,139,281,24,1234,243
1674,24,1.2.315,1,505,1,47,315,362,194,121,362,412,0,54,534,3,5,91,102,111,363,25,1234,234
1674,24,2.2.315,0,499,0,55,315,370,288,27,370,412,0,54,534,3,5,143,102,266,363,25,1234,234
1674,25,1.3.373,1,505,0,14,373,387,362,11,387,412,0,234,534,4,5,44,45,111,184,26,1234,187
1674,25,2.2.362,0,505,0,55,362,417,288,74,417,417,0,54,534,3,6,143,55,266,363,26,1234,187
1674,26,1.4.412,1,505,0,30,412,442,387,25,442,442,0,218,534,5,5,30,87,111,281,27,1234,173
1674,26,2.2.362,0,505,0,55,362,417,288,74,417,417,0,54,534,3,6,143,55,266,363,27,1234,173
1674,27,2.2.362,1,505,0,55,362,417,288,74,417,442,0,54,534,3,6,143,55,266,363,28,1234,143
1674,28,2.3.417,1,505,0,31,417,448,417,0,448,448,-30,264,564,4,6,88,31,266,184,29,1234,88
1674,29,2.4.448,1,505,0,57,448,505,448,0,505,505,-6,224,570,5,6,57,57,266,281,30,1234,57
1675,0,0.0.0,0,486,1,16,0,16,0,0,16,16,0,0,0,1,1,154,260,154,260,1,1397,1397
1675,0,1.0.0,0,544,4,77,0,77,0,0,77,77,0,0,0,1,1,309,260,309,260,1,1397,1397
1675,0,2.0.0,0,553,5,97,0,97,0,0,97,97,0,0,0,1,1,290,260,290,260,1,1397,1397
1675,0,3.0.0,0,507,3,25,0,25,0,0,25,25,0,0,0,1,1,187,260,187,260,1,1397,1397
1675,0,4.0.0,1,497,2,35,0,35,0,0,35,35,0,0,0,1,1,275,260,275,260,1,1397,1397
1675,0,5.0.0,0,482,0,10,0,10,0,0,10,10,0,0,0,1,1,182,260,182,260,1,1397,1397
1675,1,0.0.35,0,497,0,16,35,51,0,35,51,51,0,0,0,1,2,154,225,154,260,2,1397,1362
1675,1,1.0.35,0,517,2,77,35,112,0,35,112,112,0,0,0,1,2,309,225,309,260,2,1397,1362
1675,1,2.0.35,0,530,3,97,35,132,0,35,132,132,0,0,0,1,2,290,225,290,260,2,1397,1362
1675,1,3.0.35,0,507,1,25,35,60,0,35,60,60,0,0,0,1,2,187,225,187,260,2,1397,1362
1675,1,4.1.35,0,497,0,74,35,109,35,0,109,109,-35,35,35,2,1,240,361,275,361,2,1397,1362
1675,1,5.0.35,1,497,0,10,35,45,0,35,45,45,0,0,0,1,2,182,225,182,260,2,1397,1362
1675,2,0.0.45,0,497,0,16,45,61,0,45,61,61,0,0,0,1,3,154,215,154,260,3,1397,1352
1675,2,1.0.45,0,507,3,77,45,122,0,45,122,122,0,0,0,1,3,309,215,309,260,3,1397,1352
1675,2,2.0.45,0,498,1,97,45,142,0,45,142,142,0,0,0,1,3,290,215,290,260,3,1397,1352
1675,2,3.0.45,1,507,3,25,45,70,0,45,70,70,0,0,0,1,3,187,215,187,260,3,1397,1352
1675,2,4.1.35,0,497,0,74,35,109,35,0,109,109,-35,35,35,2,1,240,361,275,361,3,1397,1352
1675,2,5.1.45,0,501,2,48,45,93,45,0,93,93,-45,45,45,2,1,172,361,182,361,3,1397,1352
1675,3,0.0.70,1,511,1,16,70,86,0,70,86,86,0,0,0,1,4,154,190,154,260,4,1397,1327
1675,3,1.0.70,0,507,0,77,70,147,0,70,147,147,0,0,0,1,4,309,190,309,260,4,1397,1327
1675,3,2.0.70,0,511,1,97,70,167,0,70,167,167,0,0,0,1,4,290,190,290,260,4,1397,1327
1675,3,3.1.70,0,564,2,70,70,140,70,0,140,140,-70,70,70,2,1,162,361,187,361,4,1397,1327
1675,3,4.1.35,0,507,0,74,35,109,35,0,109,109,-35,35,35,2,1,240,361,275,361,4,1397,1327
1675,3,5.1.45,0,511,1,48,45,93,45,0,93,93,-45,45,45,2,1,172,361,182,361,4,1397,1327
1675,4,0.1.86,0,542,2,19,86,105,86,0,105,105,-86,86,86,2,1,138,361,154,361,5,1397,1311
1675,4,1.0.86,1,516,1,77,86,163,0,86,163,163,0,0,0,1,5,309,174,309,260,5,1397,1311
1675,4,2.0.86,0,511,0,97,86,183,0,86,183,183,0,0,0,1,5,290,174,290,260,5,1397,1311
1675,4,3.1.70,0,564,3,70,70,140,70,0,140,140,-70,70,70,2,1,162,361,187,361,5,1397,1311
1675,4,4.1.35,0,511,0,74,35,109,35,0,109,109,-35,35,35,2,1,240,361,275,361,5,1397,1311
1675,4,5.1.45,0,511,0,48,45,93,45,0,93,93,-45,45,45,2,1,172,361,182,361,5,1397,1311
1675,5,0.1.86,0,549,2,19,86,105,86,0,105,163,-86,86,86,2,1,138,361,154,361,6,1397,1234
1675,5,1.1.163,0,516,0,86,163,249,163,0,249,249,-163,163,163,2,1,232,361,309,361,6,1397,1234
1675,5,2.0.163,1,516,0,97,163,260,0,163,260,260,0,0,0,1,6,290,97,290,260,6,1397,1234
1675,5,3.1.70,0,582,3,70,70,140,70,0,140,163,-70,70,70,2,1,162,361,187,361,6,1397,1234
1675,5,4.1.35,0,516,0,74,35,109,35,0,109,163,-35,35,35,2,1,240,361,275,361,6,1397,1234
1675,5,5.1.45,0,519,1,48,45,93,45,0,93,163,-45,45,45,2,1,172,361,182,361,6,1397,1234
1675,6,0.1.86,0,549,2,19,86,105,86,0,105,260,-86,86,86,2,1,138,361,154,361,7,1397,1137
1675,6,1.1.163,0,516,0,86,163,249,163,0,249,260,-163,163,163,2,1,232,361,309,361,7,1397,1137
1675,6,2.1.260,0,519,1,64,260,324,260,0,324,324,-260,260,260,2,1,193,361,290,361,7,1397,1137
1675,6,3.1.70,0,582,3,70,70,140,70,0,140,260,-70,70,70,2,1,162,361,187,361,7,1397,1137
1675,6,4.1.35,1,516,0,74,35,109,35,0,109,260,-35,35,35,2,1,240,361,275,361,7,1397,1137
1675,6,5.1.45,0,519,1,48,45,93,45,0,93,260,-45,45,45,2,1,172,361,182,361,7,1397,1137
1675,7,0.1.109,0,526,2,19,109,128,86,23,128,260,0,35,35,2,2,138,287,154,361,8,1397,1063
1675,7,1.1.163,0,516,0,86,163,249,163,0,249,260,-54,89,89,2,2,232,287,309,361,8,1397,1063
1675,7,2.1.260,0,519,1,64,260,324,260,0,324,324,-151,186,186,2,2,193,287,290,361,8,1397,1063
1675,7,3.1.109,0,547,3,70,109,179,70,39,179,260,0,35,35,2,2,162,287,187,361,8,1397,1063
1675,7,4.2.109,1,516,0,36,109,145,109,0,145,260,-109,109,144,3,1,166,329,275,329,8,1397,1063
1675,7,5.1.109,0,516,0,48,109,157,45,64,157,260,0,35,35,2,2,172,287,182,361,8,1397,1063
1675,8,0.1.109,0,526,2,19,109,128,86,23,128,260,0,35,144,2,2,138,287,154,361,9,1397,1027
1675,8,1.1.163,0,516,0,86,163,249,163,0,249,260,-54,89,198,2,2,232,287,309,361,9,1397,1027
1675,8,2.1.260,0,519,1,64,260,324,260,0,324,324,-151,186,295,2,2,193,287,290,361,9,1397,1027
1675,8,3.1.109,0,547,3,70,109,179,70,39,179,260,0,35,144,2,2,162,287,187,361,9,1397,1027
1675,8,4.3.145,1,516,0,51,145,196,145,0,196,260,-145,145,289,4,1,130,236,275,236,9,1397,1027
1675,8,5.1.109,0,516,0,48,109,157,45,64,157,260,0,35,144,2,2,172,287,182,361,9,1397,1027
1675,9,0.1.109,0,526,2,19,109,128,86,23,128,260,0,35,289,2,2,138,287,154,361,10,1397,976
1675,9,1.1.163,0,516,0,86,163,249,163,0,249,260,-54,89,343,2,2,232,287,309,361,10,1397,976
1675,9,2.1.260,0,519,1,64,260,324,260,0,324,324,-151,186,440,2,2,193,287,290,361,10,1397,976
1675,9,3.1.109,0,547,3,70,109,179,70,39,179,260,0,35,289,2,2,162,287,187,361,10,1397,976
1675,9,4.4.196,1,516,0,79,196,275,196,0,275,275,-196,196,485,5,1,79,211,275,211,10,1397,976
1675,9,5.1.109,0,516,0,48,109,157,45,64,157,260,0,35,289,2,2,172,287,182,361,10,1397,976
1675,10,0.1.109,0,526,2,19,109,128,86,23,128,275,0,35,485,2,2,138,287,154,361,11,1397,897
1675,10,1.1.163,0,516,0,86,163,249,163,0,249,275,-54,89,539,2,2,232,287,309,361,11,1397,897
1675,10,2.1.260,0,519,1,64,260,324,260,0,324,324,-151,186,636,2,2,193,287,290,361,11,1397,897
1675,10,3.1.109,0,547,3,70,109,179,70,39,179,275,0,35,485,2,2,162,287,187,361,11,1397,897
1675,10,5.1.109,1,516,0,48,109,157,45,64,157,275,0,35,485,2,2,172,287,182,361,11,1397,897
1675,11,0.1.157,1,526,2,19,157,176,86,71,176,275,0,35,485,2,3,138,239,154,361,12,1397,849
1675,11,1.1.163,0,516,0,86,163,249,163,0,249,275,-6,41,491,2,3,232,239,309,361,12,1397,849
1675,11,2.1.260,0,519,1,64,260,324,260,0,324,324,-103,138,588,2,3,193,239,290,361,12,1397,849
1675,11,3.1.157,0,556,3,70,157,227,70,87,227,275,0,35,485,2,3,162,239,187,361,12,1397,849
1675,11,5.2.157,0,516,0,84,157,241,157,0,241,275,-12,121,497,3,2,124,293,182,329,12,1397,849
1675,12,0.2.176,0,544,1,84,176,260,176,0,260,275,-31,140,516,3,2,119,293,154,329,13,1397,830
1675,12,1.1.176,0,526,0,86,176,262,163,13,262,275,0,35,485,2,4,232,220,309,361,13,1397,830
1675,12,2.1.260,0,556,2,64,260,324,260,0,324,324,-84,119,569,2,4,193,220,290,361,13,1397,830
1675,12,3.1.176,1,556,2,70,176,246,70,106,246,275,0,35,485,2,4,162,220,187,361,13,1397,830
1675,12,5.2.157,0,526,0,84,157,241,157,0,241,275,-12,121,497,3,2,124,293,182,329,13,1397,830
1675,13,0.2.176,0,563,2,84,176,260,176,0,260,275,-31,140,516,3,2,119,293,154,329,14,1397,760
1675,13,1.1.246,1,577,3,86,246,332,163,83,332,332,0,35,485,2,5,232,150,309,361,14,1397,760
1675,13,2.1.260,0,556,0,64,260,324,260,0,324,324,-14,49,499,2,5,193,150,290,361,14,1397,760
1675,13,3.2.246,0,562,1,65,246,311,246,0,311,311,-101,210,586,3,2,92,293,187,329,14,1397,760
1675,13,5.2.157,0,556,0,84,157,241,157,0,241,275,-12,121,497,3,2,124,293,182,329,14,1397,760
1675,14,0.2.176,0,590,1,84,176,260,176,0,260,332,-31,140,516,3,2,119,293,154,329,15,1397,674
1675,14,1.2.332,0,577,0,52,332,384,332,0,384,384,-187,296,672,3,2,146,293,309,329,15,1397,674
1675,14,2.1.332,1,577,0,64,332,396,260,72,396,396,0,35,485,2,6,193,64,290,361,15,1397,674
1675,14,3.2.246,0,577,0,65,246,311,246,0,311,332,-101,210,586,3,2,92,293,187,329,15,1397,674
1675,14,5.2.157,0,577,0,84,157,241,157,0,241,332,-12,121,497,3,2,124,293,182,329,15,1397,674
1675,15,0.2.176,0,590,1,84,176,260,176,0,260,396,-31,140,516,3,2,119,293,154,329,16,1397,610
1675,15,1.2.332,0,577,0,52,332,384,332,0,384,396,-187,296,672,3,2,146,293,309,329,16,1397,610
1675,15,2.2.396,0,577,0,8,396,404,396,0,404,404,-251,360,736,3,2,129,293,290,329,16,1397,610
1675,15,3.2.246,0,577,0,65,246,311,246,0,311,396,-101,210,586,3,2,92,293,187,329,16,1397,610
1675,15,5.2.157,1,577,0,84,157,241,157,0,241,396,-12,121,497,3,2,124,293,182,329,16,1397,610
1675,16,0.2.241,0,578,1,84,241,325,176,65,325,396,0,121,497,3,3,119,209,154,329,17,1397,526
1675,16,1.2.332,0,577,0,52,332,384,332,0,384,396,-91,212,588,3,3,146,209,309,329,17,1397,526
1675,16,2.2.396,0,577,0,8,396,404,396,0,404,404,-155,276,652,3,3,129,209,290,329,17,1397,526
1675,16,3.2.246,0,577,0,65,246,311,246,0,311,396,-5,126,502,3,3,92,209,187,329,17,1397,526
1675,16,5.3.241,1,577,0,5,241,246,241,0,246,396,-45,190,542,4,2,40,185,182,236,17,1397,526
1675,17,0.2.241,0,578,1,84,241,325,176,65,325,396,0,121,542,3,3,119,209,154,329,18,1397,521
1675,17,1.2.332,0,577,0,52,332,384,332,0,384,396,-91,212,633,3,3,146,209,309,329,18,1397,521
1675,17,2.2.396,0,577,0,8,396,404,396,0,404,404,-155,276,697,3,3,129,209,290,329,18,1397,521
1675,17,3.2.246,0,577,0,65,246,311,246,0,311,396,-5,126,547,3,3,92,209,187,329,18,1397,521
1675,17,5.4.275,1,577,0,35,275,310,246,29,310,396,0,196,542,5,2,35,132,182,211,18,1397,521
1675,18,0.2.241,1,578,1,84,241,325,176,65,325,396,0,121,542,3,3,119,209,154,329,19,1397,486
1675,18,1.2.332,0,577,0,52,332,384,332,0,384,396,-91,212,633,3,3,146,209,309,329,19,1397,486
1675,18,2.2.396,0,577,0,8,396,404,396,0,404,404,-155,276,697,3,3,129,209,290,329,19,1397,486
1675,18,3.2.246,0,577,0,65,246,311,246,0,311,396,-5,126,547,3,3,92,209,187,329,19,1397,486
1675,19,0.3.325,1,578,0,18,325,343,325,0,343,396,-79,269,621,4,3,35,180,154,236,20,1397,402
1675,19,1.2.332,0,578,0,52,332,384,332,0,384,396,-7,128,549,3,4,146,125,309,329,20,1397,402
1675,19,2.2.396,0,579,1,8,396,404,396,0,404,404,-71,192,613,3,4,129,125,290,329,20,1397,402
1675,19,3.2.325,0,597,2,65,325,390,246,79,390,396,0,121,542,3,4,92,125,187,329,20,1397,402
1675,20,0.4.343,1,578,0,17,343,360,343,0,360,396,-33,229,654,5,3,17,97,154,211,21,1397,384
1675,20,1.2.332,0,578,0,52,332,384,332,0,384,396,-7,128,628,3,4,146,125,309,329,21,1397,384
1675,20,2.2.396,0,579,1,8,396,404,396,0,404,404,-71,192,692,3,4,129,125,290,329,21,1397,384
1675,20,3.2.325,0,597,2,65,325,390,246,79,390,396,0,121,621,3,4,92,125,187,329,21,1397,384
1675,21,1.2.332,1,578,0,52,332,384,332,0,384,396,-7,128,661,3,4,146,125,309,329,22,1397,367
1675,21,2.2.396,0,579,1,8,396,404,396,0,404,404,-71,192,725,3,4,129,125,290,329,22,1397,367
1675,21,3.2.325,0,597,2,65,325,390,246,79,390,396,0,121,654,3,4,92,125,187,329,22,1397,367
1675,22,1.3.384,0,578,0,55,384,439,384,0,439,439,-41,310,702,4,4,94,162,309,236,23,1397,315
1675,22,2.2.396,1,579,1,8,396,404,396,0,404,404,-12,140,673,3,5,129,73,290,329,23,1397,315
1675,22,3.2.384,0,578,0,65,384,449,246,138,449,449,0,128,661,3,5,92,73,187,329,23,1397,315
1675,23,1.3.384,0,579,0,55,384,439,384,0,439,439,-41,310,714,4,4,94,162,309,236,24,1397,307
1675,23,2.3.404,0,605,1,99,404,503,404,0,503,503,-61,330,734,4,4,121,162,290,236,24,1397,307
1675,23,3.2.404,1,579,0,65,404,469,246,158,469,469,0,140,673,3,6,92,65,187,329,24,1397,307
1675,24,1.3.384,1,579,0,55,384,439,384,0,439,469,-41,310,714,4,4,94,162,309,236,25,1397,242
1675,24,2.3.404,0,605,2,99,404,503,404,0,503,503,-61,330,734,4,4,121,162,290,236,25,1397,242
1675,24,3.3.469,0,598,1,8,469,477,469,0,477,477,-126,395,799,4,4,27,162,187,236,25,1397,242
1675,25,1.4.439,1,579,0,39,439,478,439,0,478,478,-79,308,793,5,4,39,80,309,211,26,1397,187
1675,25,2.3.439,0,579,0,99,439,538,404,35,538,538,0,310,714,4,5,121,107,290,236,26,1397,187
1675,25,3.3.469,0,598,1,8,469,477,469,0,477,477,-30,340,744,4,5,27,107,187,236,26,1397,187
1675,26,2.3.439,0,579,0,99,439,538,404,35,538,538,0,310,793,4,5,121,107,290,236,27,1397,148
1675,26,3.3.469,1,598,1,8,469,477,469,0,477,478,-30,340,823,4,5,27,107,187,236,27,1397,148
1675,27,2.3.477,0,598,0,99,477,576,404,73,576,576,0,340,823,4,6,121,99,290,236,28,1397,140
1675,27,3.4.478,1,598,0,19,478,497,477,1,497,497,0,308,823,5,5,19,41,187,211,28,1397,140
1675,28,2.3.477,1,598,0,99,477,576,404,73,576,576,0,340,823,4,6,121,99,290,236,29,1397,121
1675,29,2.4.576,1,598,0,22,576,598,576,0,598,598,-79,387,902,5,6,22,22,290,211,30,1397,22
1676,0,0.0.0,1,588,3,29,0,29,0,0,29,29,0,0,0,1,1,297,273,297,273,1,1562,1562
1676,0,1.0.0,0,599,5,52,0,52,0,0,52,52,0,0,0,1,1,307,273,307,273,1,1562,1562
1676,0,2.0.0,0,578,1,44,0,44,0,0,44,44,0,0,0,1,1,318,273,318,273,1,1562,1562
1676,0,3.0.0,0,595,4,78,0,78,0,0,78,78,0,0,0,1,1,245,273,245,273,1,1562,1562
1676,0,4.0.0,0,587,2,56,0,56,0,0,56,56,0,0,0,1,1,213,273,213,273,1,1562,1562
1676,0,5.0.0,0,559,0,14,0,14,0,0,14,14,0,0,0,1,1,182,273,182,273,1,1562,1562
1676,1,0.1.29,0,591,1,86,29,115,29,0,115,115,-29,29,29,2,1,268,265,297,265,2,1562,1533
1676,1,1.0.29,0,610,3,52,29,81,0,29,81,81,0,0,0,1,2,307,244,307,273,2,1562,1533
1676,1,2.0.29,1,607,2,44,29,73,0,29,73,73,0,0,0,1,2,318,244,318,273,2,1562,1533
1676,1,3.0.29,0,591,1,78,29,107,0,29,107,107,0,0,0,1,2,245,244,245,273,2,1562,1533
1676,1,4.0.29,0,610,3,56,29,85,0,29,85,85,0,0,0,1,2,213,244,213,273,2,1562,1533
1676,1,5.0.29,0,588,0,14,29,43,0,29,43,43,0,0,0,1,2,182,244,182,273,2,1562,1533
1676,2,0.1.29,0,610,2,86,29,115,29,0,115,115,-29,29,29,2,1,268,265,297,265,3,1562,1489
1676,2,1.0.73,1,607,0,52,73,125,0,73,125,125,0,0,0,1,3,307,200,307,273,3,1562,1489
1676,2,2.1.73,0,607,0,58,73,131,73,0,131,131,-73,73,73,2,1,274,265,318,265,3,1562,1489
1676,2,3.0.73,0,610,2,78,73,151,0,73,151,151,0,0,0,1,3,245,200,245,273,3,1562,1489
1676,2,4.0.73,0,610,2,56,73,129,0,73,129,129,0,0,0,1,3,213,200,213,273,3,1562,1489
1676,2,5.0.73,0,609,1,14,73,87,0,73,87,87,0,0,0,1,3,182,200,182,273,3,1562,1489
1676,3,0.1.29,0,632,3,86,29,115,29,0,115,125,-29,29,29,2,1,268,265,297,265,4,1562,1437
1676,3,1.1.125,0,632,3,54,125,179,125,0,179,179,-125,125,125,2,1,255,265,307,265,4,1562,1437
1676,3,2.1.73,0,607,0,58,73,131,73,0,131,131,-73,73,73,2,1,274,265,318,265,4,1562,1437
1676,3,3.0.125,0,614,2,78,125,203,0,125,203,203,0,0,0,1,4,245,148,245,273,4,1562,1437
1676,3,4.0.125,0,607,0,56,125,181,0,125,181,181,0,0,0,1,4,213,148,213,273,4,1562,1437
1676,3,5.0.125,1,609,1,14,125,139,0,125,139,139,0,0,0,1,4,182,148,182,273,4,1562,1437
1676,4,0.1.29,0,634,3,86,29,115,29,0,115,139,-29,29,29,2,1,268,265,297,265,5,1562,1423
1676,4,1.1.125,0,643,4,54,125,179,125,0,179,179,-125,125,125,2,1,255,265,307,265,5,1562,1423
1676,4,2.1.73,0,609,0,58,73,131,73,0,131,139,-73,73,73,2,1,274,265,318,265,5,1562,1423
1676,4,3.0.139,0,614,1,78,139,217,0,139,217,217,0,0,0,1,5,245,134,245,273,5,1562,1423
1676,4,4.0.139,1,609,0,56,139,195,0,139,195,195,0,0,0,1,5,213,134,213,273,5,1562,1423
1676,4,5.1.139,0,620,2,31,139,170,139,0,170,170,-139,139,139,2,1,168,265,182,265,5,1562,1423
1676,5,0.1.29,0,636,2,86,29,115,29,0,115,195,-29,29,29,2,1,268,265,297,265,6,1562,1367
1676,5,1.1.125,0,643,3,54,125,179,125,0,179,195,-125,125,125,2,1,255,265,307,265,6,1562,1367
1676,5,2.1.73,0,609,0,58,73,131,73,0,131,195,-73,73,73,2,1,274,265,318,265,6,1562,1367
1676,5,3.0.195,1,609,0,78,195,273,0,195,273,273,0,0,0,1,6,245,78,245,273,6,1562,1367
1676,5,4.1.195,0,609,0,27,195,222,195,0,222,222,-195,195,195,2,1,157,265,213,265,6,1562,1367
1676,5,5.1.139,0,623,1,31,139,170,139,0,170,195,-139,139,139,2,1,168,265,182,265,6,1562,1367
1676,6,0.1.29,0,636,3,86,29,115,29,0,115,273,-29,29,29,2,1,268,265,297,265,7,1562,1289
1676,6,1.1.125,0,643,4,54,125,179,125,0,179,273,-125,125,125,2,1,255,265,307,265,7,1562,1289
1676,6,2.1.73,1,609,0,58,73,131,73,0,131,273,-73,73,73,2,1,274,265,318,265,7,1562,1289
1676,6,3.1.273,0,614,1,9,273,282,273,0,282,282,-273,273,273,2,1,167,265,245,265,7,1562,1289
1676,6,4.1.195,0,609,0,27,195,222,195,0,222,273,-195,195,195,2,1,157,265,213,265,7,1562,1289
1676,6,5.1.139,0,623,2,31,139,170,139,0,170,273,-139,139,139,2,1,168,265,182,265,7,1562,1289
1676,7,0.1.131,1,633,3,86,131,217,29,102,217,273,0,73,73,2,2,268,207,297,265,8,1562,1231
1676,7,1.1.131,0,609,0,54,131,185,125,6,185,273,0,73,73,2,2,255,207,307,265,8,1562,1231
1676,7,2.2.131,0,609,0,61,131,192,131,0,192,273,-131,131,204,3,1,216,297,318,297,8,1562,1231
1676,7,3.1.273,0,614,1,9,273,282,273,0,282,282,-142,215,215,2,2,167,207,245,265,8,1562,1231
1676,7,4.1.195,0,609,0,27,195,222,195,0,222,273,-64,137,137,2,2,157,207,213,265,8,1562,1231
1676,7,5.1.139,0,623,2,31,139,170,139,0,170,273,-8,81,81,2,2,168,207,182,265,8,1562,1231
1676,8,0.2.217,0,656,2,87,217,304,217,0,304,304,-217,217,290,3,1,182,297,297,297,9,1562,1145
1676,8,1.1.217,1,656,2,54,217,271,125,92,271,273,0,73,73,2,3,255,121,307,265,9,1562,1145
1676,8,2.2.131,0,633,0,61,131,192,131,0,192,273,-131,131,204,3,1,216,297,318,297,9,1562,1145
1676,8,3.1.273,0,633,0,9,273,282,273,0,282,282,-56,129,129,2,3,167,121,245,265,9,1562,1145
1676,8,4.1.217,0,633,0,27,217,244,195,22,244,273,0,73,73,2,3,157,121,213,265,9,1562,1145
1676,8,5.1.217,0,641,1,31,217,248,139,78,248,273,0,73,73,2,3,168,121,182,265,9,1562,1145
1676,9,0.2.217,0,656,0,87,217,304,217,0,304,304,-217,217,290,3,1,182,297,297,297,10,1562,1091
1676,9,1.2.271,0,677,3,57,271,328,271,0,328,328,-271,271,344,3,1,201,297,307,297,10,1562,1091
1676,9,2.2.131,0,656,0,61,131,192,131,0,192,273,-131,131,204,3,1,216,297,318,297,10,1562,1091
1676,9,3.1.273,0,656,0,9,273,282,273,0,282,282,-2,75,75,2,4,167,67,245,265,10,1562,1091
1676,9,4.1.271,0,659,1,27,271,298,195,76,298,298,0,73,73,2,4,157,67,213,265,10,1562,1091
1676,9,5.1.271,1,663,2,31,271,302,139,132,302,302,0,73,73,2,4,168,67,182,265,10,1562,1091
1676,10,0.2.217,0,663,0,87,217,304,217,0,304,304,-217,217,290,3,1,182,297,297,297,11,1562,1060
1676,10,1.2.271,0,677,2,57,271,328,271,0,328,328,-271,271,344,3,1,201,297,307,297,11,1562,1060
1676,10,2.2.131,0,663,0,61,131,192,131,0,192,302,-131,131,204,3,1,216,297,318,297,11,1562,1060
1676,10,3.1.302,0,663,0,9,302,311,273,29,311,311,0,73,73,2,5,167,36,245,265,11,1562,1060
1676,10,4.1.302,1,671,1,27,302,329,195,107,329,329,0,73,73,2,5,157,36,213,265,11,1562,1060
1676,10,5.2.302,0,695,3,23,302,325,302,0,325,325,-302,302,375,3,1,137,297,182,297,11,1562,1060
1676,11,0.2.217,0,671,0,87,217,304,217,0,304,329,-217,217,290,3,1,182,297,297,297,12,1562,1033
1676,11,1.2.271,0,677,1,57,271,328,271,0,328,329,-271,271,344,3,1,201,297,307,297,12,1562,1033
1676,11,2.2.131,0,671,0,61,131,192,131,0,192,329,-131,131,204,3,1,216,297,318,297,12,1562,1033
1676,11,3.1.329,1,671,0,9,329,338,273,56,338,338,0,73,73,2,6,167,9,245,265,12,1562,1033
1676,11,4.2.329,0,671,0,37,329,366,329,0,366,366,-329,329,402,3,1,130,297,213,297,12,1562,1033
1676,11,5.2.302,0,695,2,23,302,325,302,0,325,329,-302,302,375,3,1,137,297,182,297,12,1562,1033
1676,12,0.2.217,0,671,0,87,217,304,217,0,304,338,-217,217,290,3,1,182,297,297,297,13,1562,1024
1676,12,1.2.271,0,677,1,57,271,328,271,0,328,338,-271,271,344,3,1,201,297,307,297,13,1562,1024
1676,12,2.2.131,1,671,0,61,131,192,131,0,192,338,-131,131,204,3,1,216,297,318,297,13,1562,1024
1676,12,3.2.338,0,671,0,32,338,370,338,0,370,370,-338,338,411,3,1,158,297,245,297,13,1562,1024
1676,12,4.2.329,0,671,0,37,329,366,329,0,366,366,-329,329,402,3,1,130,297,213,297,13,1562,1024
1676,12,5.2.302,0,695,2,23,302,325,302,0,325,338,-302,302,375,3,1,137,297,182,297,13,1562,1024
1676,13,0.2.217,0,671,0,87,217,304,217,0,304,338,-25,156,229,3,2,182,236,297,297,14,1562,963
1676,13,1.2.271,0,677,1,57,271,328,271,0,328,338,-79,210,283,3,2,201,236,307,297,14,1562,963
1676,13,2.3.192,1,671,0,68,192,260,192,0,260,338,-192,192,396,4,1,155,387,318,387,14,1562,963
1676,13,3.2.338,0,671,0,32,338,370,338,0,370,370,-146,277,350,3,2,158,236,245,297,14,1562,963
1676,13,4.2.329,0,671,0,37,329,366,329,0,366,366,-137,268,341,3,2,130,236,213,297,14,1562,963
1676,13,5.2.302,0,695,2,23,302,325,302,0,325,338,-110,241,314,3,2,137,236,182,297,14,1562,963
1676,14,0.2.217,0,671,0,87,217,304,217,0,304,338,-25,156,421,3,2,182,236,297,297,15,1562,895
1676,14,1.2.271,0,677,1,57,271,328,271,0,328,338,-79,210,475,3,2,201,236,307,297,15,1562,895
1676,14,2.4.260,1,671,0,87,260,347,260,0,347,347,-260,260,656,5,1,87,340,318,340,15,1562,895
1676,14,3.2.338,0,671,0,32,338,370,338,0,370,370,-146,277,542,3,2,158,236,245,297,15,1562,895
1676,14,4.2.329,0,671,0,37,329,366,329,0,366,366,-137,268,533,3,2,130,236,213,297,15,1562,895
1676,14,5.2.302,0,695,2,23,302,325,302,0,325,338,-110,241,506,3,2,137,236,182,297,15,1562,895
1676,15,0.2.217,1,671,0,87,217,304,217,0,304,347,-25,156,681,3,2,182,236,297,297,16,1562,808
1676,15,1.2.271,0,677,1,57,271,328,271,0,328,347,-79,210,735,3,2,201,236,307,297,16,1562,808
1676,15,3.2.338,0,671,0,32,338,370,338,0,370,370,-146,277,802,3,2,158,236,245,297,16,1562,808
1676,15,4.2.329,0,671,0,37,329,366,329,0,366,366,-137,268,793,3,2,130,236,213,297,16,1562,808
1676,15,5.2.302,0,695,2,23,302,325,302,0,325,347,-110,241,766,3,2,137,236,182,297,16,1562,808
1676,16,0.3.304,0,671,0,25,304,329,304,0,329,347,-44,236,725,4,2,95,319,297,387,17,1562,721
1676,16,1.2.304,1,681,1,57,304,361,271,33,361,361,0,156,681,3,3,201,149,307,297,17,1562,721
1676,16,3.2.338,0,671,0,32,338,370,338,0,370,370,-34,190,715,3,3,158,149,245,297,17,1562,721
1676,16,4.2.329,0,671,0,37,329,366,329,0,366,366,-25,181,706,3,3,130,149,213,297,17,1562,721
1676,16,5.2.304,0,671,0,23,304,327,302,2,327,347,0,156,681,3,3,137,149,182,297,17,1562,721
1676,17,0.3.304,0,681,0,25,304,329,304,0,329,361,-44,236,725,4,2,95,319,297,387,18,1562,664
1676,17,1.3.361,0,681,0,96,361,457,361,0,457,457,-101,293,782,4,2,144,319,307,387,18,1562,664
1676,17,3.2.361,0,681,0,32,361,393,338,23,393,393,0,156,681,3,4,158,92,245,297,18,1562,664
1676,17,4.2.361,0,681,0,37,361,398,329,32,398,398,0,156,681,3,4,130,92,213,297,18,1562,664
1676,17,5.2.361,1,681,0,23,361,384,302,59,384,384,0,156,681,3,4,137,92,182,297,18,1562,664
1676,18,0.3.304,0,681,0,25,304,329,304,0,329,384,-44,236,725,4,2,95,319,297,387,19,1562,641
1676,18,1.3.361,0,681,0,96,361,457,361,0,457,457,-101,293,782,4,2,144,319,307,387,19,1562,641
1676,18,3.2.384,1,681,0,32,384,416,338,46,416,416,0,156,681,3,5,158,69,245,297,19,1562,641
1676,18,4.2.384,0,681,0,37,384,421,329,55,421,421,0,156,681,3,5,130,69,213,297,19,1562,641
1676,18,5.3.384,0,726,1,88,384,472,384,0,472,472,-124,316,805,4,2,114,319,182,387,19,1562,641
1676,19,0.3.304,0,681,0,25,304,329,304,0,329,416,-44,236,725,4,2,95,319,297,387,20,1562,609
1676,19,1.3.361,0,681,0,96,361,457,361,0,457,457,-101,293,782,4,2,144,319,307,387,20,1562,609
1676,19,3.3.416,0,736,2,66,416,482,416,0,482,482,-156,348,837,4,2,126,319,245,387,20,1562,609
1676,19,4.2.416,1,681,0,37,416,453,329,87,453,453,0,156,681,3,6,130,37,213,297,20,1562,609
1676,19,5.3.384,0,726,1,88,384,472,384,0,472,472,-124,316,805,4,2,114,319,182,387,20,1562,609
1676,20,0.3.304,1,681,0,25,304,329,304,0,329,453,-44,236,725,4,2,95,319,297,387,21,1562,572
1676,20,1.3.361,0,681,0,96,361,457,361,0,457,457,-101,293,782,4,2,144,319,307,387,21,1562,572
1676,20,3.3.416,0,736,2,66,416,482,416,0,482,482,-156,348,837,4,2,126,319,245,387,21,1562,572
1676,20,4.3.453,0,773,3,44,453,497,453,0,497,497,-193,385,874,4,2,93,319,213,387,21,1562,572
1676,20,5.3.384,0,726,1,88,384,472,384,0,472,472,-124,316,805,4,2,114,319,182,387,21,1562,572
1676,21,0.4.347,1,681,0,70,347,417,329,18,417,453,0,260,725,5,2,70,253,297,340,22,1562,547
1676,21,1.3.361,0,681,0,96,361,457,361,0,457,457,-32,268,757,4,3,144,294,307,387,22,1562,547
1676,21,3.3.416,0,736,2,66,416,482,416,0,482,482,-87,323,812,4,3,126,294,245,387,22,1562,547
1676,21,4.3.453,0,773,3,44,453,497,453,0,497,497,-124,360,849,4,3,93,294,213,387,22,1562,547
1676,21,5.3.384,0,726,1,88,384,472,384,0,472,472,-55,291,780,4,3,114,294,182,387,22,1562,547
1676,22,1.3.361,1,681,0,96,361,457,361,0,457,457,-32,268,757,4,3,144,294,307,387,23,1562,477
1676,22,3.3.416,0,736,2,66,416,482,416,0,482,482,-87,323,812,4,3,126,294,245,387,23,1562,477
1676,22,4.3.453,0,773,3,44,453,497,453,0,497,497,-124,360,849,4,3,93,294,213,387,23,1562,477
1676,22,5.3.384,0,726,1,88,384,472,384,0,472,472,-55,291,780,4,3,114,294,182,387,23,1562,477
1676,23,1.4.457,1,681,0,48,457,505,457,0,505,505,-40,300,797,5,3,48,183,307,340,24,1562,381
1676,23,3.3.457,0,681,0,66,457,523,416,41,523,523,0,268,757,4,4,126,198,245,387,24,1562,381
1676,23,4.3.457,0,681,0,44,457,501,453,4,501,501,0,268,757,4,4,93,198,213,387,24,1562,381
1676,23,5.3.457,0,715,1,88,457,545,384,73,545,545,0,268,757,4,4,114,198,182,387,24,1562,381
1676,24,3.3.457,1,681,0,66,457,523,416,41,523,523,0,268,797,4,4,126,198,245,387,25,1562,333
1676,24,4.3.457,0,681,0,44,457,501,453,4,501,505,0,268,797,4,4,93,198,213,387,25,1562,333
1676,24,5.3.457,0,715,1,88,457,545,384,73,545,545,0,268,797,4,4,114,198,182,387,25,1562,333
1676,25,3.4.523,1,681,0,60,523,583,523,0,583,583,-18,318,815,5,4,60,135,245,340,26,1562,267
1676,25,4.3.523,0,681,0,44,523,567,453,70,567,567,0,268,797,4,5,93,132,213,387,26,1562,267
1676,25,5.3.523,0,704,1,88,523,611,384,139,611,611,0,268,797,4,5,114,132,182,387,26,1562,267
1676,26,4.3.523,1,681,0,44,523,567,453,70,567,583,0,268,815,4,5,93,132,213,387,27,1562,207
1676,26,5.3.523,0,704,1,88,523,611,384,139,611,611,0,268,815,4,5,114,132,182,387,27,1562,207
1676,27,4.4.583,1,681,0,49,583,632,567,16,632,632,0,318,815,5,5,49,75,213,340,28,1562,163
1676,27,5.3.567,0,681,0,88,567,655,384,183,655,655,0,268,815,4,6,114,88,182,387,28,1562,163
1676,28,5.3.567,1,681,0,88,567,655,384,183,655,655,0,268,815,4,6,114,88,182,387,29,1562,114
1676,29,5.4.655,1,681,0,26,655,681,655,0,681,681,-23,341,838,5,6,26,26,182,340,30,1562,26
1677,0,0.0.0,0,481,2,42,0,42,0,0,42,42,0,0,0,1,1,242,288,242,288,1,1336,1336
1677,0,1.0.0,0,472,1,28,0,28,0,0,28,28,0,0,0,1,1,208,288,208,288,1,1336,1336
1677,0,2.0.0,0,516,4,89,0,89,0,0,89,89,0,0,0,1,1,244,288,244,288,1,1336,1336
1677,0,3.0.0,0,481,2,32,0,32,0,0,32,32,0,0,0,1,1,207,288,207,288,1,1336,1336
1677,0,4.0.0,0,512,3,78,0,78,0,0,78,78,0,0,0,1,1,251,288,251,288,1,1336,1336
1677,0,5.0.0,1,461,0,19,0,19,0,0,19,19,0,0,0,1,1,184,288,184,288,1,1336,1336
1677,1,0.0.19,0,472,1,42,19,61,0,19,61,61,0,0,0,1,2,242,269,242,288,2,1336,1317
1677,1,1.0.19,0,461,0,28,19,47,0,19,47,47,0,0,0,1,2,208,269,208,288,2,1336,1317
1677,1,2.0.19,0,509,3,89,19,108,0,19,108,108,0,0,0,1,2,244,269,244,288,2,1336,1317
1677,1,3.0.19,0,461,0,32,19,51,0,19,51,51,0,0,0,1,2,207,269,207,288,2,1336,1317
1677,1,4.0.19,0,508,2,78,19,97,0,19,97,97,0,0,0,1,2,251,269,251,288,2,1336,1317
1677,1,5.1.19,1,461,0,14,19,33,19,0,33,33,-19,19,19,2,1,165,266,184,266,2,1336,1317
1677,2,0.0.19,0,472,1,42,19,61,0,19,61,61,0,0,19,1,2,242,269,242,288,3,1336,1303
1677,2,1.0.19,1,461,0,28,19,47,0,19,47,47,0,0,19,1,2,208,269,208,288,3,1336,1303
1677,2,2.0.19,0,509,3,89,19,108,0,19,108,108,0,0,19,1,2,244,269,244,288,3,1336,1303
1677,2,3.0.19,0,461,0,32,19,51,0,19,51,51,0,0,19,1,2,207,269,207,288,3,1336,1303
1677,2,4.0.19,0,508,2,78,19,97,0,19,97,97,0,0,19,1,2,251,269,251,288,3,1336,1303
1677,2,5.2.33,0,461,0,61,33,94,33,0,94,94,-33,33,52,3,1,151,365,184,365,3,1336,1303
1677,3,0.0.47,0,469,1,42,47,89,0,47,89,89,0,0,19,1,3,242,241,242,288,4,1336,1275
1677,3,1.1.47,1,461,0,22,47,69,47,0,69,69,-14,33,33,2,2,180,252,208,266,4,1336,1275
1677,3,2.0.47,0,509,3,89,47,136,0,47,136,136,0,0,19,1,3,244,241,244,288,4,1336,1275
1677,3,3.0.47,0,461,0,32,47,79,0,47,79,79,0,0,19,1,3,207,241,207,288,4,1336,1275
1677,3,4.0.47,0,490,2,78,47,125,0,47,125,125,0,0,19,1,3,251,241,251,288,4,1336,1275
1677,3,5.2.33,0,461,0,61,33,94,33,0,94,94,-33,33,52,3,1,151,365,184,365,4,1336,1275
1677,4,0.0.47,1,469,1,42,47,89,0,47,89,89,0,0,33,1,3,242,241,242,288,5,1336,1253
1677,4,1.2.69,0,481,2,62,69,131,69,0,131,131,-69,69,102,3,1,158,365,208,365,5,1336,1253
1677,4,2.0.47,0,509,4,89,47,136,0,47,136,136,0,0,33,1,3,244,241,244,288,5,1336,1253
1677,4,3.0.47,0,461,0,32,47,79,0,47,79,79,0,0,33,1,3,207,241,207,288,5,1336,1253
1677,4,4.0.47,0,490,3,78,47,125,0,47,125,125,0,0,33,1,3,251,241,251,288,5,1336,1253
1677,4,5.2.33,0,461,0,61,33,94,33,0,94,94,-33,33,66,3,1,151,365,184,365,5,1336,1253
1677,5,0.1.89,0,469,0,54,89,143,89,0,143,143,-20,53,53,2,3,200,230,242,266,6,1336,1211
1677,5,1.2.69,0,481,2,62,69,131,69,0,131,131,-69,69,102,3,1,158,365,208,365,6,1336,1211
1677,5,2.0.89,0,470,1,89,89,178,0,89,178,178,0,0,33,1,4,244,199,244,288,6,1336,1211
1677,5,3.0.89,1,469,0,32,89,121,0,89,121,121,0,0,33,1,4,207,199,207,288,6,1336,1211
1677,5,4.0.89,0,482,3,78,89,167,0,89,167,167,0,0,33,1,4,251,199,251,288,6,1336,1211
1677,5,5.2.33,0,469,0,61,33,94,33,0,94,94,-33,33,66,3,1,151,365,184,365,6,1336,1211
1677,6,0.1.89,0,469,0,54,89,143,89,0,143,143,-20,53,53,2,3,200,230,242,266,7,1336,1179
1677,6,1.2.69,0,481,2,62,69,131,69,0,131,131,-69,69,102,3,1,158,365,208,365,7,1336,1179
1677,6,2.0.121,0,469,0,89,121,210,0,121,210,210,0,0,33,1,5,244,167,244,288,7,1336,1179
1677,6,3.1.121,0,473,1,47,121,168,121,0,168,168,-52,85,85,2,3,175,230,207,266,7,1336,1179
1677,6,4.0.121,1,473,1,78,121,199,0,121,199,199,0,0,33,1,5,251,167,251,288,7,1336,1179
1677,6,5.2.33,0,469,0,61,33,94,33,0,94,121,-33,33,66,3,1,151,365,184,365,7,1336,1179
1677,7,0.1.89,0,473,0,54,89,143,89,0,143,199,-20,53,53,2,3,200,230,242,266,8,1336,1101
1677,7,1.2.69,0,481,1,62,69,131,69,0,131,199,-69,69,102,3,1,158,365,208,365,8,1336,1101
1677,7,2.0.199,1,473,0,89,199,288,0,199,288,288,0,0,33,1,6,244,89,244,288,8,1336,1101
1677,7,3.1.121,0,493,2,47,121,168,121,0,168,199,-52,85,85,2,3,175,230,207,266,8,1336,1101
1677,7,4.1.199,0,473,0,78,199,277,199,0,277,277,-130,163,163,2,3,173,230,251,266,8,1336,1101
1677,7,5.2.33,0,473,0,61,33,94,33,0,94,199,-33,33,66,3,1,151,365,184,365,8,1336,1101
1677,8,0.1.89,1,473,0,54,89,143,89,0,143,288,-20,53,53,2,3,200,230,242,266,9,1336,1012
1677,8,1.2.69,0,481,1,62,69,131,69,0,131,288,-69,69,102,3,1,158,365,208,365,9,1336,1012
1677,8,2.1.288,0,473,0,51,288,339,288,0,339,339,-219,252,252,2,3,155,230,244,266,9,1336,1012
1677,8,3.1.121,0,493,2,47,121,168,121,0,168,288,-52,85,85,2,3,175,230,207,266,9,1336,1012
1677,8,4.1.199,0,473,0,78,199,277,199,0,277,288,-130,163,163,2,3,173,230,251,266,9,1336,1012
1677,8,5.2.33,0,473,0,61,33,94,33,0,94,288,-33,33,66,3,1,151,365,184,365,9,1336,1012
1677,9,0.2.143,0,481,1,91,143,234,143,0,234,288,-143,143,196,3,1,146,365,242,365,10,1336,958
1677,9,1.2.69,0,481,1,62,69,131,69,0,131,288,-69,69,122,3,1,158,365,208,365,10,1336,958
1677,9,2.1.288,0,473,0,51,288,339,288,0,339,339,-145,198,198,2,4,155,176,244,266,10,1336,958
1677,9,3.1.143,1,473,0,47,143,190,121,22,190,288,0,53,53,2,4,175,176,207,266,10,1336,958
1677,9,4.1.199,0,473,0,78,199,277,199,0,277,288,-56,109,109,2,4,173,176,251,266,10,1336,958
1677,9,5.2.33,0,473,0,61,33,94,33,0,94,288,-33,33,86,3,1,151,365,184,365,10,1336,958
1677,10,0.2.143,0,481,1,91,143,234,143,0,234,288,-143,143,196,3,1,146,365,242,365,11,1336,911
1677,10,1.2.69,0,481,1,62,69,131,69,0,131,288,-69,69,122,3,1,158,365,208,365,11,1336,911
1677,10,2.1.288,0,473,0,51,288,339,288,0,339,339,-98,151,151,2,5,155,129,244,266,11,1336,911
1677,10,3.2.190,0,499,2,99,190,289,190,0,289,289,-190,190,243,3,1,128,365,207,365,11,1336,911
1677,10,4.1.199,1,473,0,78,199,277,199,0,277,288,-9,62,62,2,5,173,129,251,266,11,1336,911
1677,10,5.2.33,0,473,0,61,33,94,33,0,94,288,-33,33,86,3,1,151,365,184,365,11,1336,911
1677,11,0.2.143,0,481,1,91,143,234,143,0,234,288,-143,143,205,3,1,146,365,242,365,12,1336,833
1677,11,1.2.69,0,481,1,62,69,131,69,0,131,288,-69,69,131,3,1,158,365,208,365,12,1336,833
1677,11,2.1.288,1,473,0,51,288,339,288,0,339,339,-11,73,73,2,6,155,51,244,266,12,1336,833
1677,11,3.2.190,0,499,2,99,190,289,190,0,289,289,-190,190,252,3,1,128,365,207,365,12,1336,833
1677,11,4.2.277,0,481,1,38,277,315,277,0,315,315,-277,277,339,3,1,95,365,251,365,12,1336,833
1677,11,5.2.33,0,473,0,61,33,94,33,0,94,288,-33,33,95,3,1,151,365,184,365,12,1336,833
1677,12,0.2.143,0,481,1,91,143,234,143,0,234,339,-143,143,216,3,1,146,365,242,365,13,1336,782
1677,12,1.2.69,0,481,1,62,69,131,69,0,131,339,-69,69,142,3,1,158,365,208,365,13,1336,782
1677,12,2.2.339,0,481,1,14,339,353,339,0,353,353,-339,339,412,3,1,104,365,244,365,13,1336,782
1677,12,3.2.190,0,499,2,99,190,289,190,0,289,339,-190,190,263,3,1,128,365,207,365,13,1336,782
1677,12,4.2.277,0,481,1,38,277,315,277,0,315,339,-277,277,350,3,1,95,365,251,365,13,1336,782
1677,12,5.2.33,1,473,0,61,33,94,33,0,94,339,-33,33,106,3,1,151,365,184,365,13,1336,782
1677,13,0.2.143,0,481,1,91,143,234,143,0,234,339,-49,82,155,3,2,146,304,242,365,14,1336,721
1677,13,1.2.94,0,473,0,62,94,156,69,25,156,339,0,33,106,3,2,158,304,208,365,14,1336,721
1677,13,2.2.339,0,481,1,14,339,353,339,0,353,353,-245,278,351,3,2,104,304,244,365,14,1336,721
1677,13,3.2.190,0,499,2,99,190,289,190,0,289,339,-96,129,202,3,2,128,304,207,365,14,1336,721
1677,13,4.2.277,0,481,1,38,277,315,277,0,315,339,-183,216,289,3,2,95,304,251,365,14,1336,721
1677,13,5.3.94,1,473,0,73,94,167,94,0,167,339,-94,94,200,4,1,90,244,184,244,14,1336,721
1677,14,0.2.143,0,481,1,91,143,234,143,0,234,339,-49,82,249,3,2,146,304,242,365,15,1336,648
1677,14,1.2.94,0,473,0,62,94,156,69,25,156,339,0,33,200,3,2,158,304,208,365,15,1336,648
1677,14,2.2.339,0,481,1,14,339,353,339,0,353,353,-245,278,445,3,2,104,304,244,365,15,1336,648
1677,14,3.2.190,0,499,2,99,190,289,190,0,289,339,-96,129,296,3,2,128,304,207,365,15,1336,648
1677,14,4.2.277,0,481,1,38,277,315,277,0,315,339,-183,216,383,3,2,95,304,251,365,15,1336,648
1677,14,5.4.167,1,473,0,17,167,184,167,0,184,339,-167,167,367,5,1,17,173,184,173,15,1336,648
1677,15,0.2.143,0,481,1,91,143,234,143,0,234,339,-49,82,416,3,2,146,304,242,365,16,1336,631
1677,15,1.2.94,1,473,0,62,94,156,69,25,156,339,0,33,367,3,2,158,304,208,365,16,1336,631
1677,15,2.2.339,0,481,1,14,339,353,339,0,353,353,-245,278,612,3,2,104,304,244,365,16,1336,631
1677,15,3.2.190,0,499,2,99,190,289,190,0,289,339,-96,129,463,3,2,128,304,207,365,16,1336,631
1677,15,4.2.277,0,481,1,38,277,315,277,0,315,339,-183,216,550,3,2,95,304,251,365,16,1336,631
1677,16,0.2.156,0,473,0,91,156,247,143,13,247,339,0,33,367,3,3,146,242,242,365,17,1336,569
1677,16,1.3.167,1,473,0,39,167,206,156,11,206,339,0,94,367,4,2,96,171,208,244,17,1336,569
1677,16,2.2.339,0,481,1,14,339,353,339,0,353,353,-183,216,550,3,3,104,242,244,365,17,1336,569
1677,16,3.2.190,0,499,2,99,190,289,190,0,289,339,-34,67,401,3,3,128,242,207,365,17,1336,569
1677,16,4.2.277,0,481,1,38,277,315,277,0,315,339,-121,154,488,3,3,95,242,251,365,17,1336,569
1677,17,0.2.156,0,473,0,91,156,247,143,13,247,339,0,33,367,3,3,146,242,242,365,18,1336,530
1677,17,1.4.206,1,473,0,57,206,263,206,0,263,339,-22,189,389,5,2,57,156,208,173,18,1336,530
1677,17,2.2.339,0,481,1,14,339,353,339,0,353,353,-183,216,550,3,3,104,242,244,365,18,1336,530
1677,17,3.2.190,0,499,2,99,190,289,190,0,289,339,-34,67,401,3,3,128,242,207,365,18,1336,530
1677,17,4.2.277,0,481,1,38,277,315,277,0,315,339,-121,154,488,3,3,95,242,251,365,18,1336,530
1677,18,0.2.156,1,473,0,91,156,247,143,13,247,339,0,33,389,3,3,146,242,242,365,19,1336,473
1677,18,2.2.339,0,481,1,14,339,353,339,0,353,353,-183,216,572,3,3,104,242,244,365,19,1336,473
1677,18,3.2.190,0,499,2,99,190,289,190,0,289,339,-34,67,423,3,3,128,242,207,365,19,1336,473
1677,18,4.2.277,0,481,1,38,277,315,277,0,315,339,-121,154,510,3,3,95,242,251,365,19,1336,473
1677,19,0.3.247,1,473,0,32,247,279,247,0,279,339,-41,135,430,4,3,55,132,242,244,20,1336,382
1677,19,2.2.339,0,481,1,14,339,353,339,0,353,353,-92,125,481,3,4,104,151,244,365,20,1336,382
1677,19,3.2.247,0,473,0,99,247,346,190,57,346,346,0,33,389,3,4,128,151,207,365,20,1336,382
1677,19,4.2.277,0,481,1,38,277,315,277,0,315,339,-30,63,419,3,4,95,151,251,365,20,1336,382
1677,20,0.4.279,1,473,0,23,279,302,279,0,302,339,-16,205,446,5,3,23,99,242,173,21,1336,350
1677,20,2.2.339,0,481,1,14,339,353,339,0,353,353,-92,125,522,3,4,104,151,244,365,21,1336,350
1677,20,3.2.247,0,473,0,99,247,346,190,57,346,346,0,33,430,3,4,128,151,207,365,21,1336,350
1677,20,4.2.277,0,481,1,38,277,315,277,0,315,339,-30,63,460,3,4,95,151,251,365,21,1336,350
1677,21,2.2.339,0,481,1,14,339,353,339,0,353,353,-92,125,538,3,4,104,151,244,365,22,1336,327
1677,21,3.2.247,0,473,0,99,247,346,190,57,346,346,0,33,446,3,4,128,151,207,365,22,1336,327
1677,21,4.2.277,1,481,1,38,277,315,277,0,315,339,-30,63,476,3,4,95,151,251,365,22,1336,327
1677,22,2.2.339,0,481,0,14,339,353,339,0,353,353,-24,87,500,3,5,104,113,244,365,23,1336,289
1677,22,3.2.315,0,521,1,99,315,414,190,125,414,414,0,63,476,3,5,128,113,207,365,23,1336,289
1677,22,4.3.315,1,481,0,37,315,352,315,0,352,352,-36,171,512,4,4,57,100,251,244,23,1336,289
1677,23,2.2.339,0,481,0,14,339,353,339,0,353,353,-24,87,536,3,5,104,113,244,365,24,1336,252
1677,23,3.2.315,0,521,1,99,315,414,190,125,414,414,0,63,512,3,5,128,113,207,365,24,1336,252
1677,23,4.4.352,1,481,0,20,352,372,352,0,372,372,-50,255,562,5,4,20,76,251,173,24,1336,252
1677,24,2.2.339,1,481,0,14,339,353,339,0,353,372,-24,87,586,3,5,104,113,244,365,25,1336,232
1677,24,3.2.315,0,521,1,99,315,414,190,125,414,414,0,63,562,3,5,128,113,207,365,25,1336,232
1677,25,2.3.353,1,481,0,37,353,390,353,0,390,390,-1,172,587,4,5,90,63,244,244,26,1336,218
1677,25,3.2.353,0,481,0,99,353,452,190,163,452,452,0,87,586,3,6,128,99,207,365,26,1336,218
1677,26,2.4.390,1,481,0,53,390,443,390,0,443,443,-18,273,605,5,5,53,56,244,173,27,1336,181
1677,26,3.2.353,0,481,0,99,353,452,190,163,452,452,0,87,587,3,6,128,99,207,365,27,1336,181
1677,27,3.2.353,1,481,0,99,353,452,190,163,452,452,0,87,605,3,6,128,99,207,365,28,1336,128
1677,28,3.3.452,1,481,0,26,452,478,452,0,478,478,-62,234,667,4,6,29,26,207,244,29,1336,29
1677,29,3.4.478,1,481,0,3,478,481,478,0,481,481,-35,308,702,5,6,3,3,207,173,30,1336,3
1678,0,0.0.0,0,569,3,55,0,55,0,0,55,55,0,0,0,1,1,284,203,284,203,1,1602,1602
1678,0,1.0.0,1,543,1,4,0,4,0,0,4,4,0,0,0,1,1,307,203,307,203,1,1602,1602
1678,0,2.0.0,0,571,4,35,0,35,0,0,35,35,0,0,0,1,1,172,203,172,203,1,1602,1602
1678,0,3.0.0,0,619,5,84,0,84,0,0,84,84,0,0,0,1,1,363,203,363,203,1,1602,1602
1678,0,4.0.0,0,539,0,1,0,1,0,0,1,1,0,0,0,1,1,190,203,190,203,1,1602,1602
1678,0,5.0.0,0,563,2,24,0,24,0,0,24,24,0,0,0,1,1,286,203,286,203,1,1602,1602
1678,1,0.0.4,0,551,1,55,4,59,0,4,59,59,0,0,0,1,2,284,199,284,203,2,1602,1598
1678,1,1.1.4,0,551,1,89,4,93,4,0,93,93,-4,4,4,2,1,303,368,307,368,2,1602,1598
1678,1,2.0.4,0,552,2,35,4,39,0,4,39,39,0,0,0,1,2,172,199,172,203,2,1602,1598
1678,1,3.0.4,0,551,1,84,4,88,0,4,88,88,0,0,0,1,2,363,199,363,203,2,1602,1598
1678,1,4.0.4,0,543,0,1,4,5,0,4,5,5,0,0,0,1,2,190,199,190,203,2,1602,1598
1678,1,5.0.4,1,551,1,24,4,28,0,4,28,28,0,0,0,1,2,286,199,286,203,2,1602,1598
1678,2,0.0.28,0,551,0,55,28,83,0,28,83,83,0,0,0,1,3,284,175,284,203,3,1602,1574
1678,2,1.1.4,0,551,0,89,4,93,4,0,93,93,-4,4,4,2,1,303,368,307,368,3,1602,1574
1678,2,2.0.28,0,576,2,35,28,63,0,28,63,63,0,0,0,1,3,172,175,172,203,3,1602,1574
1678,2,3.0.28,0,563,1,84,28,112,0,28,112,112,0,0,0,1,3,363,175,363,203,3,1602,1574
1678,2,4.0.28,1,551,0,1,28,29,0,28,29,29,0,0,0,1,3,190,175,190,203,3,1602,1574
1678,2,5.1.28,0,608,3,97,28,125,28,0,125,125,-28,28,28,2,1,262,368,286,368,3,1602,1574
1678,3,0.0.29,1,551,0,55,29,84,0,29,84,84,0,0,0,1,4,284,174,284,203,4,1602,1573
1678,3,1.1.4,0,551,0,89,4,93,4,0,93,93,-4,4,4,2,1,303,368,307,368,4,1602,1573
1678,3,2.0.29,0,576,3,35,29,64,0,29,64,64,0,0,0,1,4,172,174,172,203,4,1602,1573
1678,3,3.0.29,0,559,1,84,29,113,0,29,113,113,0,0,0,1,4,363,174,363,203,4,1602,1573
1678,3,4.1.29,0,567,2,30,29,59,29,0,59,59,-29,29,29,2,1,189,368,190,368,4,1602,1573
1678,3,5.1.28,0,608,4,97,28,125,28,0,125,125,-28,28,28,2,1,262,368,286,368,4,1602,1573
1678,4,0.1.84,0,568,2,22,84,106,84,0,106,106,-84,84,84,2,1,229,368,284,368,5,1602,1518
1678,4,1.1.4,0,551,0,89,4,93,4,0,93,93,-4,4,4,2,1,303,368,307,368,5,1602,1518
1678,4,2.0.84,0,576,3,35,84,119,0,84,119,119,0,0,0,1,5,172,119,172,203,5,1602,1518
1678,4,3.0.84,1,551,0,84,84,168,0,84,168,168,0,0,0,1,5,363,119,363,203,5,1602,1518
1678,4,4.1.29,0,567,1,30,29,59,29,0,59,84,-29,29,29,2,1,189,368,190,368,5,1602,1518
1678,4,5.1.28,0,608,4,97,28,125,28,0,125,125,-28,28,28,2,1,262,368,286,368,5,1602,1518
1678,5,0.1.84,0,568,2,22,84,106,84,0,106,168,-84,84,84,2,1,229,368,284,368,6,1602,1434
1678,5,1.1.4,0,551,0,89,4,93,4,0,93,168,-4,4,4,2,1,303,368,307,368,6,1602,1434
1678,5,2.0.168,1,551,0,35,168,203,0,168,203,203,0,0,0,1,6,172,35,172,203,6,1602,1434
1678,5,3.1.168,0,551,0,85,168,253,168,0,253,253,-168,168,168,2,1,279,368,363,368,6,1602,1434
1678,5,4.1.29,0,567,1,30,29,59,29,0,59,168,-29,29,29,2,1,189,368,190,368,6,1602,1434
1678,5,5.1.28,0,608,3,97,28,125,28,0,125,168,-28,28,28,2,1,262,368,286,368,6,1602,1434
1678,6,0.1.84,0,568,2,22,84,106,84,0,106,203,-84,84,84,2,1,229,368,284,368,7,1602,1399
1678,6,1.1.4,1,551,0,89,4,93,4,0,93,203,-4,4,4,2,1,303,368,307,368,7,1602,1399
1678,6,2.1.203,0,595,3,45,203,248,203,0,248,248,-203,203,203,2,1,137,368,172,368,7,1602,1399
1678,6,3.1.168,0,551,0,85,168,253,168,0,253,253,-168,168,168,2,1,279,368,363,368,7,1602,1399
1678,6,4.1.29,0,567,1,30,29,59,29,0,59,203,-29,29,29,2,1,189,368,190,368,7,1602,1399
1678,6,5.1.28,0,608,4,97,28,125,28,0,125,203,-28,28,28,2,1,262,368,286,368,7,1602,1399
1678,7,0.1.93,1,551,0,22,93,115,84,9,115,203,0,4,4,2,2,229,279,284,368,8,1602,1310
1678,7,1.2.93,0,551,0,68,93,161,93,0,161,203,-93,93,97,3,1,214,433,307,433,8,1602,1310
1678,7,2.1.203,0,595,1,45,203,248,203,0,248,248,-110,114,114,2,2,137,279,172,368,8,1602,1310
1678,7,3.1.168,0,551,0,85,168,253,168,0,253,253,-75,79,79,2,2,279,279,363,368,8,1602,1310
1678,7,4.1.93,0,551,0,30,93,123,29,64,123,203,0,4,4,2,2,189,279,190,368,8,1602,1310
1678,7,5.1.93,0,602,2,97,93,190,28,65,190,203,0,4,4,2,2,262,279,286,368,8,1602,1310
1678,8,0.2.115,0,573,1,94,115,209,115,0,209,209,-115,115,119,3,1,207,433,284,433,9,1602,1288
1678,8,1.2.93,0,551,0,68,93,161,93,0,161,203,-93,93,97,3,1,214,433,307,433,9,1602,1288
1678,8,2.1.203,0,595,3,45,203,248,203,0,248,248,-88,92,92,2,3,137,257,172,368,9,1602,1288
1678,8,3.1.168,0,551,0,85,168,253,168,0,253,253,-53,57,57,2,3,279,257,363,368,9,1602,1288
1678,8,4.1.115,1,551,0,30,115,145,29,86,145,203,0,4,4,2,3,189,257,190,368,9,1602,1288
1678,8,5.1.115,0,584,2,97,115,212,28,87,212,212,0,4,4,2,3,262,257,286,368,9,1602,1288
1678,9,0.2.115,0,573,1,94,115,209,115,0,209,209,-115,115,119,3,1,207,433,284,433,10,1602,1258
1678,9,1.2.93,0,551,0,68,93,161,93,0,161,203,-93,93,97,3,1,214,433,307,433,10,1602,1258
1678,9,2.1.203,0,595,3,45,203,248,203,0,248,248,-58,62,62,2,4,137,227,172,368,10,1602,1258
1678,9,3.1.168,0,551,0,85,168,253,168,0,253,253,-23,27,27,2,4,279,227,363,368,10,1602,1258
1678,9,4.2.145,0,603,4,39,145,184,145,0,184,203,-145,145,149,3,1,159,433,190,433,10,1602,1258
1678,9,5.1.145,1,584,2,97,145,242,28,117,242,242,0,4,4,2,4,262,227,286,368,10,1602,1258
1678,10,0.2.115,0,584,0,94,115,209,115,0,209,242,-115,115,119,3,1,207,433,284,433,11,1602,1161
1678,10,1.2.93,0,584,0,68,93,161,93,0,161,242,-93,93,97,3,1,214,433,307,433,11,1602,1161
1678,10,2.1.242,0,603,1,45,242,287,203,39,287,287,0,4,4,2,5,137,130,172,368,11,1602,1161
1678,10,3.1.242,1,584,0,85,242,327,168,74,327,327,0,4,4,2,5,279,130,363,368,11,1602,1161
1678,10,4.2.145,0,603,1,39,145,184,145,0,184,242,-145,145,149,3,1,159,433,190,433,11,1602,1161
1678,10,5.2.242,0,633,2,99,242,341,242,0,341,341,-242,242,246,3,1,165,433,286,433,11,1602,1161
1678,11,0.2.115,0,584,0,94,115,209,115,0,209,327,-115,115,119,3,1,207,433,284,433,12,1602,1076
1678,11,1.2.93,0,584,0,68,93,161,93,0,161,327,-93,93,97,3,1,214,433,307,433,12,1602,1076
1678,11,2.1.327,1,584,0,45,327,372,203,124,372,372,0,4,4,2,6,137,45,172,368,12,1602,1076
1678,11,3.2.327,0,584,0,66,327,393,327,0,393,393,-327,327,331,3,1,194,433,363,433,12,1602,1076
1678,11,4.2.145,0,603,1,39,145,184,145,0,184,327,-145,145,149,3,1,159,433,190,433,12,1602,1076
1678,11,5.2.242,0,633,2,99,242,341,242,0,341,341,-242,242,246,3,1,165,433,286,433,12,1602,1076
1678,12,0.2.115,0,584,0,94,115,209,115,0,209,372,-115,115,119,3,1,207,433,284,433,13,1602,1031
1678,12,1.2.93,1,584,0,68,93,161,93,0,161,372,-93,93,97,3,1,214,433,307,433,13,1602,1031
1678,12,2.2.372,0,670,3,67,372,439,372,0,439,439,-372,372,376,3,1,92,433,172,433,13,1602,1031
1678,12,3.2.327,0,584,0,66,327,393,327,0,393,393,-327,327,331,3,1,194,433,363,433,13,1602,1031
1678,12,4.2.145,0,603,1,39,145,184,145,0,184,372,-145,145,149,3,1,159,433,190,433,13,1602,1031
1678,12,5.2.242,0,633,2,99,242,341,242,0,341,372,-242,242,246,3,1,165,433,286,433,13,1602,1031
1678,13,0.2.161,0,584,0,94,161,255,115,46,255,372,0,93,97,3,2,207,365,284,433,14,1602,963
1678,13,1.3.161,1,584,0,80,161,241,161,0,241,372,-161,161,258,4,1,146,297,307,297,14,1602,963
1678,13,2.2.372,0,670,2,67,372,439,372,0,439,439,-211,304,308,3,2,92,365,172,433,14,1602,963
1678,13,3.2.327,0,584,0,66,327,393,327,0,393,393,-166,259,263,3,2,194,365,363,433,14,1602,963
1678,13,4.2.161,0,584,0,39,161,200,145,16,200,372,0,93,97,3,2,159,365,190,433,14,1602,963
1678,13,5.2.242,0,633,1,99,242,341,242,0,341,372,-81,174,178,3,2,165,365,286,433,14,1602,963
1678,14,0.2.161,0,584,0,94,161,255,115,46,255,372,0,93,258,3,2,207,365,284,433,15,1602,883
1678,14,1.4.241,1,584,0,66,241,307,241,0,307,372,-241,241,499,5,1,66,301,307,301,15,1602,883
1678,14,2.2.372,0,670,2,67,372,439,372,0,439,439,-211,304,469,3,2,92,365,172,433,15,1602,883
1678,14,3.2.327,0,584,0,66,327,393,327,0,393,393,-166,259,424,3,2,194,365,363,433,15,1602,883
1678,14,4.2.161,0,584,0,39,161,200,145,16,200,372,0,93,258,3,2,159,365,190,433,15,1602,883
1678,14,5.2.242,0,633,1,99,242,341,242,0,341,372,-81,174,339,3,2,165,365,286,433,15,1602,883
1678,15,0.2.161,0,584,0,94,161,255,115,46,255,372,0,93,499,3,2,207,365,284,433,16,1602,817
1678,15,2.2.372,0,670,2,67,372,439,372,0,439,439,-211,304,710,3,2,92,365,172,433,16,1602,817
1678,15,3.2.327,0,584,0,66,327,393,327,0,393,393,-166,259,665,3,2,194,365,363,433,16,1602,817
1678,15,4.2.161,1,584,0,39,161,200,145,16,200,372,0,93,499,3,2,159,365,190,433,16,1602,817
1678,15,5.2.242,0,633,1,99,242,341,242,0,341,372,-81,174,580,3,2,165,365,286,433,16,1602,817
1678,16,0.2.200,0,584,0,94,200,294,115,85,294,372,0,93,499,3,3,207,326,284,433,17,1602,778
1678,16,2.2.372,0,670,2,67,372,439,372,0,439,439,-172,265,671,3,3,92,326,172,433,17,1602,778
1678,16,3.2.327,0,584,0,66,327,393,327,0,393,393,-127,220,626,3,3,194,326,363,433,17,1602,778
1678,16,4.3.241,1,584,0,31,241,272,200,41,272,372,0,161,499,4,2,120,217,190,297,17,1602,778
1678,16,5.2.242,0,633,1,99,242,341,242,0,341,372,-42,135,541,3,3,165,326,286,433,17,1602,778
1678,17,0.2.200,0,584,0,94,200,294,115,85,294,372,0,93,499,3,3,207,326,284,433,18,1602,747
1678,17,2.2.372,0,670,2,67,372,439,372,0,439,439,-172,265,671,3,3,92,326,172,433,18,1602,747
1678,17,3.2.327,0,584,0,66,327,393,327,0,393,393,-127,220,626,3,3,194,326,363,433,18,1602,747
1678,17,4.4.307,1,584,0,89,307,396,272,35,396,396,0,241,499,5,2,89,235,190,301,18,1602,747
1678,17,5.2.242,0,633,1,99,242,341,242,0,341,372,-42,135,541,3,3,165,326,286,433,18,1602,747
1678,18,0.2.200,1,584,0,94,200,294,115,85,294,396,0,93,499,3,3,207,326,284,433,19,1602,658
1678,18,2.2.372,0,670,2,67,372,439,372,0,439,439,-172,265,671,3,3,92,326,172,433,19,1602,658
1678,18,3.2.327,0,584,0,66,327,393,327,0,393,396,-127,220,626,3,3,194,326,363,433,19,1602,658
1678,18,5.2.242,0,633,1,99,242,341,242,0,341,396,-42,135,541,3,3,165,326,286,433,19,1602,658
1678,19,0.3.294,1,584,0,38,294,332,294,0,332,396,-22,183,521,4,3,113,186,284,297,20,1602,564
1678,19,2.2.372,0,670,2,67,372,439,372,0,439,439,-78,171,577,3,4,92,232,172,433,20,1602,564
1678,19,3.2.327,0,584,0,66,327,393,327,0,393,396,-33,126,532,3,4,194,232,363,433,20,1602,564
1678,19,5.2.294,0,606,1,99,294,393,242,52,393,396,0,93,499,3,4,165,232,286,433,20,1602,564
1678,20,0.4.396,1,584,0,75,396,471,332,64,471,471,0,241,521,5,3,75,146,284,301,21,1602,526
1678,20,2.2.372,0,670,2,67,372,439,372,0,439,439,-78,171,599,3,4,92,232,172,433,21,1602,526
1678,20,3.2.327,0,584,0,66,327,393,327,0,393,396,-33,126,554,3,4,194,232,363,433,21,1602,526
1678,20,5.2.294,0,606,1,99,294,393,242,52,393,396,0,93,521,3,4,165,232,286,433,21,1602,526
1678,21,2.2.372,0,670,2,67,372,439,372,0,439,471,-78,171,599,3,4,92,232,172,433,22,1602,451
1678,21,3.2.327,1,584,0,66,327,393,327,0,393,471,-33,126,554,3,4,194,232,363,433,22,1602,451
1678,21,5.2.294,0,606,1,99,294,393,242,52,393,471,0,93,521,3,4,165,232,286,433,22,1602,451
1678,22,2.2.393,0,625,1,67,393,460,372,21,460,471,0,126,554,3,5,92,166,172,433,23,1602,385
1678,22,3.3.393,1,584,0,84,393,477,393,0,477,477,-61,244,615,4,4,128,148,363,297,23,1602,385
1678,22,5.2.393,0,584,0,99,393,492,242,151,492,492,0,126,554,3,5,165,166,286,433,23,1602,385
1678,23,2.2.393,0,625,1,67,393,460,372,21,460,477,0,126,615,3,5,92,166,172,433,24,1602,301
1678,23,3.4.477,1,584,0,44,477,521,477,0,521,521,-6,247,621,5,4,44,71,363,301,24,1602,301
1678,23,5.2.393,0,584,0,99,393,492,242,151,492,492,0,126,615,3,5,165,166,286,433,24,1602,301
1678,24,2.2.393,0,625,1,67,393,460,372,21,460,521,0,126,621,3,5,92,166,172,433,25,1602,257
1678,24,5.2.393,1,584,0,99,393,492,242,151,492,521,0,126,621,3,5,165,166,286,433,25,1602,257
1678,25,2.2.492,0,584,0,67,492,559,372,120,559,559,0,126,621,3,6,92,67,172,433,26,1602,158
1678,25,5.3.492,1,584,0,58,492,550,492,0,550,550,-15,259,636,4,5,66,64,286,297,26,1602,158
1678,26,2.2.492,0,584,0,67,492,559,372,120,559,559,0,126,636,3,6,92,67,172,433,27,1602,100
1678,26,5.4.550,1,584,0,8,550,558,550,0,558,558,-29,276,665,5,5,8,27,286,301,27,1602,100
1678,27,2.2.492,1,584,0,67,492,559,372,120,559,559,0,126,665,3,6,92,67,172,433,28,1602,92
1678,28,2.3.559,1,584,0,6,559,565,559,0,565,565,-9,268,674,4,6,25,6,172,297,29,1602,25
1678,29,2.4.565,1,584,0,19,565,584,565,0,584,584,-7,283,681,5,6,19,19,172,301,30,1602,19
1679,0,0.0.0,0,650,5,68,0,68,0,0,68,68,0,0,0,1,1,329,316,329,316,1,1672,1672
1679,0,1.0.0,0,647,4,79,0,79,0,0,79,79,0,0,0,1,1,307,316,307,316,1,1672,1672
1679,0,2.0.0,0,643,3,81,0,81,0,0,81,81,0,0,0,1,1,297,316,297,316,1,1672,1672
1679,0,3.0.0,0,582,0,38,0,38,0,0,38,38,0,0,0,1,1,224,316,224,316,1,1672,1672
1679,0,4.0.0,0,597,1,22,0,22,0,0,22,22,0,0,0,1,1,227,316,227,316,1,1672,1672
1679,0,5.0.0,1,610,2,28,0,28,0,0,28,28,0,0,0,1,1,288,316,288,316,1,1672,1672
1679,1,0.0.28,0,618,1,68,28,96,0,28,96,96,0,0,0,1,2,329,288,329,316,2,1672,1644
1679,1,1.0.28,0,618,1,79,28,107,0,28,107,107,0,0,0,1,2,307,288,307,316,2,1672,1644
1679,1,2.0.28,0,618,1,81,28,109,0,28,109,109,0,0,0,1,2,297,288,297,316,2,1672,1644
1679,1,3.0.28,0,610,0,38,28,66,0,28,66,66,0,0,0,1,2,224,288,224,316,2,1672,1644
1679,1,4.0.28,1,618,1,22,28,50,0,28,50,50,0,0,0,1,2,227,288,227,316,2,1672,1644
1679,1,5.1.28,0,618,1,80,28,108,28,0,108,108,-28,28,28,2,1,260,373,288,373,2,1672,1644
1679,2,0.0.50,1,618,0,68,50,118,0,50,118,118,0,0,0,1,3,329,266,329,316,3,1672,1622
1679,2,1.0.50,0,618,0,79,50,129,0,50,129,129,0,0,0,1,3,307,266,307,316,3,1672,1622
1679,2,2.0.50,0,618,0,81,50,131,0,50,131,131,0,0,0,1,3,297,266,297,316,3,1672,1622
1679,2,3.0.50,0,618,0,38,50,88,0,50,88,88,0,0,0,1,3,224,266,224,316,3,1672,1622
1679,2,4.1.50,0,625,1,82,50,132,50,0,132,132,-50,50,50,2,1,205,373,227,373,3,1672,1622
1679,2,5.1.28,0,618,0,80,28,108,28,0,108,108,-28,28,28,2,1,260,373,288,373,3,1672,1622
1679,3,0.1.118,0,639,3,90,118,208,118,0,208,208,-118,118,118,2,1,261,373,329,373,4,1672,1554
1679,3,1.0.118,0,618,0,79,118,197,0,118,197,197,0,0,0,1,4,307,198,307,316,4,1672,1554
1679,3,2.0.118,0,620,1,81,118,199,0,118,199,199,0,0,0,1,4,297,198,297,316,4,1672,1554
1679,3,3.0.118,1,618,0,38,118,156,0,118,156,156,0,0,0,1,4,224,198,224,316,4,1672,1554
1679,3,4.1.50,0,627,2,82,50,132,50,0,132,132,-50,50,50,2,1,205,373,227,373,4,1672,1554
1679,3,5.1.28,0,618,0,80,28,108,28,0,108,118,-28,28,28,2,1,260,373,288,373,4,1672,1554
1679,4,0.1.118,0,639,4,90,118,208,118,0,208,208,-118,118,118,2,1,261,373,329,373,5,1672,1516
1679,4,1.0.156,1,618,0,79,156,235,0,156,235,235,0,0,0,1,5,307,160,307,316,5,1672,1516
1679,4,2.0.156,0,631,3,81,156,237,0,156,237,237,0,0,0,1,5,297,160,297,316,5,1672,1516
1679,4,3.1.156,0,620,1,24,156,180,156,0,180,180,-156,156,156,2,1,186,373,224,373,5,1672,1516
1679,4,4.1.50,0,627,2,82,50,132,50,0,132,156,-50,50,50,2,1,205,373,227,373,5,1672,1516
1679,4,5.1.28,0,618,0,80,28,108,28,0,108,156,-28,28,28,2,1,260,373,288,373,5,1672,1516
1679,5,0.1.118,0,639,3,90,118,208,118,0,208,235,-118,118,118,2,1,261,373,329,373,6,1672,1437
1679,5,1.1.235,0,618,0,58,235,293,235,0,293,293,-235,235,235,2,1,228,373,307,373,6,1672,1437
1679,5,2.0.235,1,618,0,81,235,316,0,235,316,316,0,0,0,1,6,297,81,297,316,6,1672,1437
1679,5,3.1.156,0,620,1,24,156,180,156,0,180,235,-156,156,156,2,1,186,373,224,373,6,1672,1437
1679,5,4.1.50,0,627,2,82,50,132,50,0,132,235,-50,50,50,2,1,205,373,227,373,6,1672,1437
1679,5,5.1.28,0,618,0,80,28,108,28,0,108,235,-28,28,28,2,1,260,373,288,373,6,1672,1437
1679,6,0.1.118,0,639,3,90,118,208,118,0,208,316,-118,118,118,2,1,261,373,329,373,7,1672,1356
1679,6,1.1.235,0,618,0,58,235,293,235,0,293,316,-235,235,235,2,1,228,373,307,373,7,1672,1356
1679,6,2.1.316,0,618,0,39,316,355,316,0,355,355,-316,316,316,2,1,216,373,297,373,7,1672,1356
1679,6,3.1.156,0,620,1,24,156,180,156,0,180,316,-156,156,156,2,1,186,373,224,373,7,1672,1356
1679,6,4.1.50,0,627,2,82,50,132,50,0,132,316,-50,50,50,2,1,205,373,227,373,7,1672,1356
1679,6,5.1.28,1,618,0,80,28,108,28,0,108,316,-28,28,28,2,1,260,373,288,373,7,1672,1356
1679,7,0.1.118,0,639,2,90,118,208,118,0,208,316,-10,38,38,2,2,261,293,329,373,8,1672,1276
1679,7,1.1.235,0,618,0,58,235,293,235,0,293,316,-127,155,155,2,2,228,293,307,373,8,1672,1276
1679,7,2.1.316,0,618,0,39,316,355,316,0,355,355,-208,236,236,2,2,216,293,297,373,8,1672,1276
1679,7,3.1.156,0,620,1,24,156,180,156,0,180,316,-48,76,76,2,2,186,293,224,373,8,1672,1276
1679,7,4.1.108,0,618,0,82,108,190,50,58,190,316,0,28,28,2,2,205,293,227,373,8,1672,1276
1679,7,5.2.108,1,618,0,38,108,146,108,0,146,316,-108,108,136,3,1,180,303,288,303,8,1672,1276
1679,8,0.1.118,0,639,2,90,118,208,118,0,208,316,-10,38,146,2,2,261,293,329,373,9,1672,1238
1679,8,1.1.235,0,618,0,58,235,293,235,0,293,316,-127,155,263,2,2,228,293,307,373,9,1672,1238
1679,8,2.1.316,0,618,0,39,316,355,316,0,355,355,-208,236,344,2,2,216,293,297,373,9,1672,1238
1679,8,3.1.156,0,620,1,24,156,180,156,0,180,316,-48,76,184,2,2,186,293,224,373,9,1672,1238
1679,8,4.1.108,0,618,0,82,108,190,50,58,190,316,0,28,136,2,2,205,293,227,373,9,1672,1238
1679,8,5.3.146,1,618,0,43,146,189,146,0,189,316,-146,146,282,4,1,142,251,288,251,9,1672,1238
1679,9,0.1.118,0,639,2,90,118,208,118,0,208,316,-10,38,292,2,2,261,293,329,373,10,1672,1195
1679,9,1.1.235,0,618,0,58,235,293,235,0,293,316,-127,155,409,2,2,228,293,307,373,10,1672,1195
1679,9,2.1.316,0,618,0,39,316,355,316,0,355,355,-208,236,490,2,2,216,293,297,373,10,1672,1195
1679,9,3.1.156,0,620,1,24,156,180,156,0,180,316,-48,76,330,2,2,186,293,224,373,10,1672,1195
1679,9,4.1.108,0,618,0,82,108,190,50,58,190,316,0,28,282,2,2,205,293,227,373,10,1672,1195
1679,9,5.4.189,1,618,0,99,189,288,189,0,288,316,-189,189,471,5,1,99,429,288,429,10,1672,1195
1679,10,0.1.118,0,639,2,90,118,208,118,0,208,316,-10,38,481,2,2,261,293,329,373,11,1672,1096
1679,10,1.1.235,0,618,0,58,235,293,235,0,293,316,-127,155,598,2,2,228,293,307,373,11,1672,1096
1679,10,2.1.316,0,618,0,39,316,355,316,0,355,355,-208,236,679,2,2,216,293,297,373,11,1672,1096
1679,10,3.1.156,0,620,1,24,156,180,156,0,180,316,-48,76,519,2,2,186,293,224,373,11,1672,1096
1679,10,4.1.108,1,618,0,82,108,190,50,58,190,316,0,28,471,2,2,205,293,227,373,11,1672,1096
1679,11,0.1.190,0,652,1,90,190,280,118,72,280,316,0,28,471,2,3,261,211,329,373,12,1672,1014
1679,11,1.1.235,0,618,0,58,235,293,235,0,293,316,-45,73,516,2,3,228,211,307,373,12,1672,1014
1679,11,2.1.316,0,618,0,39,316,355,316,0,355,355,-126,154,597,2,3,216,211,297,373,12,1672,1014
1679,11,3.1.190,1,618,0,24,190,214,156,34,214,316,0,28,471,2,3,186,211,224,373,12,1672,1014
1679,11,4.2.190,0,618,0,40,190,230,190,0,230,316,-44,152,515,3,2,123,265,227,303,12,1672,1014
1679,12,0.1.214,1,643,2,90,214,304,118,96,304,316,0,28,471,2,4,261,187,329,373,13,1672,990
1679,12,1.1.235,0,618,0,58,235,293,235,0,293,316,-21,49,492,2,4,228,187,307,373,13,1672,990
1679,12,2.1.316,0,618,0,39,316,355,316,0,355,355,-102,130,573,2,4,216,187,297,373,13,1672,990
1679,12,3.2.214,0,621,1,34,214,248,214,0,248,316,-68,176,539,3,2,162,265,224,303,13,1672,990
1679,12,4.2.190,0,618,0,40,190,230,190,0,230,316,-44,152,515,3,2,123,265,227,303,13,1672,990
1679,13,0.2.304,0,655,1,98,304,402,304,0,402,402,-158,266,629,3,2,171,265,329,303,14,1672,900
1679,13,1.1.304,1,643,0,58,304,362,235,69,362,362,0,28,471,2,5,228,97,307,373,14,1672,900
1679,13,2.1.316,0,643,0,39,316,355,316,0,355,355,-12,40,483,2,5,216,97,297,373,14,1672,900
1679,13,3.2.214,0,643,0,34,214,248,214,0,248,316,-68,176,539,3,2,162,265,224,303,14,1672,900
1679,13,4.2.190,0,643,0,40,190,230,190,0,230,316,-44,152,515,3,2,123,265,227,303,14,1672,900
1679,14,0.2.304,0,655,1,98,304,402,304,0,402,402,-158,266,629,3,2,171,265,329,303,15,1672,842
1679,14,1.2.362,0,643,0,73,362,435,362,0,435,435,-216,324,687,3,2,170,265,307,303,15,1672,842
1679,14,2.1.362,1,643,0,39,362,401,316,46,401,401,0,28,471,2,6,216,39,297,373,15,1672,842
1679,14,3.2.214,0,643,0,34,214,248,214,0,248,362,-68,176,539,3,2,162,265,224,303,15,1672,842
1679,14,4.2.190,0,643,0,40,190,230,190,0,230,362,-44,152,515,3,2,123,265,227,303,15,1672,842
1679,15,0.2.304,0,655,1,98,304,402,304,0,402,402,-158,266,629,3,2,171,265,329,303,16,1672,803
1679,15,1.2.362,0,643,0,73,362,435,362,0,435,435,-216,324,687,3,2,170,265,307,303,16,1672,803
1679,15,2.2.401,0,681,2,20,401,421,401,0,421,421,-255,363,726,3,2,177,265,297,303,16,1672,803
1679,15,3.2.214,0,643,0,34,214,248,214,0,248,401,-68,176,539,3,2,162,265,224,303,16,1672,803
1679,15,4.2.190,1,643,0,40,190,230,190,0,230,401,-44,152,515,3,2,123,265,227,303,16,1672,803
1679,16,0.2.304,0,655,1,98,304,402,304,0,402,402,-74,226,589,3,3,171,225,329,303,17,1672,763
1679,16,1.2.362,0,643,0,73,362,435,362,0,435,435,-132,284,647,3,3,170,225,307,303,17,1672,763
1679,16,2.2.401,0,681,2,20,401,421,401,0,421,421,-171,323,686,3,3,177,225,297,303,17,1672,763
1679,16,3.2.230,0,643,0,34,230,264,214,16,264,401,0,152,515,3,3,162,225,224,303,17,1672,763
1679,16,4.3.230,1,643,0,24,230,254,230,0,254,401,-41,187,556,4,2,83,208,227,251,17,1672,763
1679,17,0.2.304,0,655,1,98,304,402,304,0,402,402,-74,226,630,3,3,171,225,329,303,18,1672,739
1679,17,1.2.362,0,643,0,73,362,435,362,0,435,435,-132,284,688,3,3,170,225,307,303,18,1672,739
1679,17,2.2.401,0,681,2,20,401,421,401,0,421,421,-171,323,727,3,3,177,225,297,303,18,1672,739
1679,17,3.2.230,1,643,0,34,230,264,214,16,264,401,0,152,556,3,3,162,225,224,303,18,1672,739
1679,17,4.4.288,0,643,0,59,288,347,254,34,347,401,0,189,556,5,2,59,330,227,429,18,1672,739
1679,18,0.2.304,0,655,1,98,304,402,304,0,402,402,-40,192,596,3,4,171,191,329,303,19,1672,705
1679,18,1.2.362,0,643,0,73,362,435,362,0,435,435,-98,250,654,3,4,170,191,307,303,19,1672,705
1679,18,2.2.401,0,681,2,20,401,421,401,0,421,421,-137,289,693,3,4,177,191,297,303,19,1672,705
1679,18,3.3.264,1,643,0,43,264,307,264,0,307,401,-10,197,566,4,3,128,184,224,251,19,1672,705
1679,18,4.4.288,0,643,0,59,288,347,254,34,347,401,0,189,556,5,2,59,330,227,429,19,1672,705
1679,19,0.2.304,0,655,1,98,304,402,304,0,402,402,-40,192,606,3,4,171,191,329,303,20,1672,662
1679,19,1.2.362,0,643,0,73,362,435,362,0,435,435,-98,250,664,3,4,170,191,307,303,20,1672,662
1679,19,2.2.401,0,681,2,20,401,421,401,0,421,421,-137,289,703,3,4,177,191,297,303,20,1672,662
1679,19,3.4.307,0,643,0,85,307,392,307,0,392,401,-19,208,585,5,2,85,330,224,429,20,1672,662
1679,19,4.4.288,1,643,0,59,288,347,254,34,347,401,0,189,566,5,2,59,330,227,429,20,1672,662
1679,20,0.2.304,0,655,1,98,304,402,304,0,402,402,-40,192,606,3,4,171,191,329,303,21,1672,603
1679,20,1.2.362,0,643,0,73,362,435,362,0,435,435,-98,250,664,3,4,170,191,307,303,21,1672,603
1679,20,2.2.401,0,681,2,20,401,421,401,0,421,421,-137,289,703,3,4,177,191,297,303,21,1672,603
1679,20,3.4.347,1,643,0,85,347,432,307,40,432,432,0,189,566,5,3,85,271,224,429,21,1672,603
1679,21,0.2.304,0,655,1,98,304,402,304,0,402,432,-40,192,606,3,4,171,191,329,303,22,1672,518
1679,21,1.2.362,0,643,0,73,362,435,362,0,435,435,-98,250,664,3,4,170,191,307,303,22,1672,518
1679,21,2.2.401,1,681,2,20,401,421,401,0,421,432,-137,289,703,3,4,177,191,297,303,22,1672,518
1679,22,0.2.421,0,689,1,98,421,519,304,117,519,519,0,289,703,3,5,171,171,329,303,23,1672,498
1679,22,1.2.421,0,681,0,73,421,494,362,59,494,494,0,289,703,3,5,170,171,307,303,23,1672,498
1679,22,2.3.421,1,681,0,74,421,495,421,0,495,495,-114,311,817,4,4,157,141,297,251,23,1672,498
1679,23,0.2.421,0,689,1,98,421,519,304,117,519,519,0,289,817,3,5,171,171,329,303,24,1672,424
1679,23,1.2.421,0,681,0,73,421,494,362,59,494,495,0,289,817,3,5,170,171,307,303,24,1672,424
1679,23,2.4.495,1,681,0,83,495,578,495,0,578,578,-63,252,880,5,4,83,186,297,429,24,1672,424
1679,24,0.2.421,1,689,1,98,421,519,304,117,519,578,0,289,880,3,5,171,171,329,303,25,1672,341
1679,24,1.2.421,0,681,0,73,421,494,362,59,494,578,0,289,880,3,5,170,171,307,303,25,1672,341
1679,25,0.3.519,1,689,0,45,519,564,519,0,564,578,-24,335,904,4,5,73,67,329,251,26,1672,243
1679,25,1.2.519,0,689,0,73,519,592,362,157,592,592,0,289,880,3,6,170,73,307,303,26,1672,243
1679,26,0.4.578,1,689,0,28,578,606,564,14,606,606,0,252,904,5,5,28,103,329,429,27,1672,198
1679,26,1.2.519,0,689,0,73,519,592,362,157,592,592,0,289,904,3,6,170,73,307,303,27,1672,198
1679,27,1.2.519,1,689,0,73,519,592,362,157,592,606,0,289,904,3,6,170,73,307,303,28,1672,170
1679,28,1.3.592,1,689,0,22,592,614,592,0,614,614,-28,363,932,4,6,97,22,307,251,29,1672,97
1679,29,1.4.614,1,689,0,75,614,689,614,0,689,689,-8,260,940,5,6,75,75,307,429,30,1672,75
1680,0,0.0.0,0,579,3,81,0,81,0,0,81,81,0,0,0,1,1,273,331,273,331,1,1442,1442
1680,0,1.0.0,0,584,4,55,0,55,0,0,55,55,0,0,0,1,1,308,331,308,331,1,1442,1442
1680,0,2.0.0,0,547,0,27,0,27,0,0,27,27,0,0,0,1,1,223,331,223,331,1,1442,1442
1680,0,3.0.0,0,626,5,91,0,91,0,0,91,91,0,0,0,1,1,184,331,184,331,1,1442,1442
1680,0,4.0.0,0,575,2,44,0,44,0,0,44,44,0,0,0,1,1,165,331,165,331,1,1442,1442
1680,0,5.0.0,1,560,1,33,0,33,0,0,33,33,0,0,0,1,1,289,331,289,331,1,1442,1442
1680,1,0.0.33,0,560,0,81,33,114,0,33,114,114,0,0,0,1,2,273,298,273,331,2,1442,1409
1680,1,1.0.33,0,560,0,55,33,88,0,33,88,88,0,0,0,1,2,308,298,308,331,2,1442,1409
1680,1,2.0.33,0,560,0,27,33,60,0,33,60,60,0,0,0,1,2,223,298,223,331,2,1442,1409
1680,1,3.0.33,0,577,1,91,33,124,0,33,124,124,0,0,0,1,2,184,298,184,331,2,1442,1409
1680,1,4.0.33,0,560,0,44,33,77,0,33,77,77,0,0,0,1,2,165,298,165,331,2,1442,1409
1680,1,5.1.33,1,560,0,63,33,96,33,0,96,96,-33,33,33,2,1,256,275,289,275,2,1442,1409
1680,2,0.0.33,0,560,0,81,33,114,0,33,114,114,0,0,33,1,2,273,298,273,331,3,1442,1346
1680,2,1.0.33,0,560,0,55,33,88,0,33,88,96,0,0,33,1,2,308,298,308,331,3,1442,1346
1680,2,2.0.33,0,560,0,27,33,60,0,33,60,96,0,0,33,1,2,223,298,223,331,3,1442,1346
1680,2,3.0.33,0,577,1,91,33,124,0,33,124,124,0,0,33,1,2,184,298,184,331,3,1442,1346
1680,2,4.0.33,0,560,0,44,33,77,0,33,77,96,0,0,33,1,2,165,298,165,331,3,1442,1346
1680,2,5.2.96,1,560,0,76,96,172,96,0,172,172,-96,96,129,3,1,193,270,289,270,3,1442,1346
1680,3,0.0.33,0,560,0,81,33,114,0,33,114,172,0,0,129,1,2,273,298,273,331,4,1442,1270
1680,3,1.0.33,0,560,0,55,33,88,0,33,88,172,0,0,129,1,2,308,298,308,331,4,1442,1270
1680,3,2.0.33,0,560,0,27,33,60,0,33,60,172,0,0,129,1,2,223,298,223,331,4,1442,1270
1680,3,3.0.33,0,577,1,91,33,124,0,33,124,172,0,0,129,1,2,184,298,184,331,4,1442,1270
1680,3,4.0.33,0,560,0,44,33,77,0,33,77,172,0,0,129,1,2,165,298,165,331,4,1442,1270
1680,3,5.3.172,1,560,0,27,172,199,172,0,199,199,-172,172,301,4,1,117,205,289,205,4,1442,1270
1680,4,0.0.33,0,560,0,81,33,114,0,33,114,199,0,0,301,1,2,273,298,273,331,5,1442,1243
1680,4,1.0.33,0,560,0,55,33,88,0,33,88,199,0,0,301,1,2,308,298,308,331,5,1442,1243
1680,4,2.0.33,0,560,0,27,33,60,0,33,60,199,0,0,301,1,2,223,298,223,331,5,1442,1243
1680,4,3.0.33,0,577,1,91,33,124,0,33,124,199,0,0,301,1,2,184,298,184,331,5,1442,1243
1680,4,4.0.33,0,560,0,44,33,77,0,33,77,199,0,0,301,1,2,165,298,165,331,5,1442,1243
1680,4,5.4.199,1,560,0,90,199,289,199,0,289,289,-199,199,500,5,1,90,361,289,361,5,1442,1243
1680,5,0.0.33,0,560,0,81,33,114,0,33,114,289,0,0,500,1,2,273,298,273,331,6,1442,1153
1680,5,1.0.33,1,560,0,55,33,88,0,33,88,289,0,0,500,1,2,308,298,308,331,6,1442,1153
1680,5,2.0.33,0,560,0,27,33,60,0,33,60,289,0,0,500,1,2,223,298,223,331,6,1442,1153
1680,5,3.0.33,0,577,1,91,33,124,0,33,124,289,0,0,500,1,2,184,298,184,331,6,1442,1153
1680,5,4.0.33,0,560,0,44,33,77,0,33,77,289,0,0,500,1,2,165,298,165,331,6,1442,1153
1680,6,0.0.88,0,560,0,81,88,169,0,88,169,289,0,0,500,1,3,273,243,273,331,7,1442,1098
1680,6,1.1.96,1,560,0,26,96,122,88,8,122,289,0,33,500,2,2,253,212,308,275,7,1442,1098
1680,6,2.0.88,0,560,0,27,88,115,0,88,115,289,0,0,500,1,3,223,243,223,331,7,1442,1098
1680,6,3.0.88,0,562,1,91,88,179,0,88,179,289,0,0,500,1,3,184,243,184,331,7,1442,1098
1680,6,4.0.88,0,568,2,44,88,132,0,88,132,289,0,0,500,1,3,165,243,165,331,7,1442,1098
1680,7,0.0.88,0,560,0,81,88,169,0,88,169,289,0,0,500,1,3,273,243,273,331,8,1442,1072
1680,7,1.2.172,1,562,1,78,172,250,122,50,250,289,0,96,500,3,2,227,194,308,270,8,1442,1072
1680,7,2.0.88,0,560,0,27,88,115,0,88,115,289,0,0,500,1,3,223,243,223,331,8,1442,1072
1680,7,3.0.88,0,562,1,91,88,179,0,88,179,289,0,0,500,1,3,184,243,184,331,8,1442,1072
1680,7,4.0.88,0,568,2,44,88,132,0,88,132,289,0,0,500,1,3,165,243,165,331,8,1442,1072
1680,8,0.0.88,0,575,1,81,88,169,0,88,169,289,0,0,500,1,3,273,243,273,331,9,1442,994
1680,8,1.3.250,1,585,3,64,250,314,250,0,314,314,-51,223,551,4,2,149,178,308,205,9,1442,994
1680,8,2.0.88,0,579,2,27,88,115,0,88,115,289,0,0,500,1,3,223,243,223,331,9,1442,994
1680,8,3.0.88,0,562,0,91,88,179,0,88,179,289,0,0,500,1,3,184,243,184,331,9,1442,994
1680,8,4.0.88,0,585,3,44,88,132,0,88,132,289,0,0,500,1,3,165,243,165,331,9,1442,994
1680,9,0.0.88,0,585,0,81,88,169,0,88,169,314,0,0,551,1,3,273,243,273,331,10,1442,930
1680,9,1.4.314,1,585,0,85,314,399,314,0,399,399,-25,224,576,5,2,85,271,308,361,10,1442,930
1680,9,2.0.88,0,585,0,27,88,115,0,88,115,314,0,0,551,1,3,223,243,223,331,10,1442,930
1680,9,3.0.88,0,585,0,91,88,179,0,88,179,314,0,0,551,1,3,184,243,184,331,10,1442,930
1680,9,4.0.88,0,585,0,44,88,132,0,88,132,314,0,0,551,1,3,165,243,165,331,10,1442,930
1680,10,0.0.88,0,585,0,81,88,169,0,88,169,399,0,0,576,1,3,273,243,273,331,11,1442,845
1680,10,2.0.88,1,585,0,27,88,115,0,88,115,399,0,0,576,1,3,223,243,223,331,11,1442,845
1680,10,3.0.88,0,585,0,91,88,179,0,88,179,399,0,0,576,1,3,184,243,184,331,11,1442,845
1680,10,4.0.88,0,585,0,44,88,132,0,88,132,399,0,0,576,1,3,165,243,165,331,11,1442,845
1680,11,0.0.115,0,585,0,81,115,196,0,115,196,399,0,0,576,1,4,273,216,273,331,12,1442,818
1680,11,2.1.122,1,585,0,32,122,154,115,7,154,399,0,33,576,2,3,196,186,223,275,12,1442,818
1680,11,3.0.115,0,585,0,91,115,206,0,115,206,399,0,0,576,1,4,184,216,184,331,12,1442,818
1680,11,4.0.115,0,585,0,44,115,159,0,115,159,399,0,0,576,1,4,165,216,165,331,12,1442,818
1680,12,0.0.115,0,585,0,81,115,196,0,115,196,399,0,0,576,1,4,273,216,273,331,13,1442,786
1680,12,2.2.250,1,585,0,73,250,323,154,96,323,399,0,96,576,3,3,164,116,223,270,13,1442,786
1680,12,3.0.115,0,585,0,91,115,206,0,115,206,399,0,0,576,1,4,184,216,184,331,13,1442,786
1680,12,4.0.115,0,585,0,44,115,159,0,115,159,399,0,0,576,1,4,165,216,165,331,13,1442,786
1680,13,0.0.115,0,585,0,81,115,196,0,115,196,399,0,0,576,1,4,273,216,273,331,14,1442,713
1680,13,2.3.323,1,585,0,42,323,365,323,0,365,399,-9,232,585,4,3,91,114,223,205,14,1442,713
1680,13,3.0.115,0,585,0,91,115,206,0,115,206,399,0,0,576,1,4,184,216,184,331,14,1442,713
1680,13,4.0.115,0,585,0,44,115,159,0,115,159,399,0,0,576,1,4,165,216,165,331,14,1442,713
1680,14,0.0.115,0,585,0,81,115,196,0,115,196,399,0,0,585,1,4,273,216,273,331,15,1442,671
1680,14,2.4.399,1,585,0,49,399,448,365,34,448,448,0,224,585,5,3,49,186,223,361,15,1442,671
1680,14,3.0.115,0,585,0,91,115,206,0,115,206,399,0,0,585,1,4,184,216,184,331,15,1442,671
1680,14,4.0.115,0,585,0,44,115,159,0,115,159,399,0,0,585,1,4,165,216,165,331,15,1442,671
1680,15,0.0.115,1,585,0,81,115,196,0,115,196,448,0,0,585,1,4,273,216,273,331,16,1442,622
1680,15,3.0.115,0,585,0,91,115,206,0,115,206,448,0,0,585,1,4,184,216,184,331,16,1442,622
1680,15,4.0.115,0,585,0,44,115,159,0,115,159,448,0,0,585,1,4,165,216,165,331,16,1442,622
1680,16,0.1.196,0,585,0,58,196,254,196,0,254,448,-42,75,627,2,4,192,154,273,275,17,1442,541
1680,16,3.0.196,0,585,0,91,196,287,0,196,287,448,0,0,585,1,5,184,135,184,331,17,1442,541
1680,16,4.0.196,1,585,0,44,196,240,0,196,240,448,0,0,585,1,5,165,135,165,331,17,1442,541
1680,17,0.1.196,0,585,0,58,196,254,196,0,254,448,-42,75,627,2,4,192,154,273,275,18,1442,497
1680,17,3.0.240,1,585,0,91,240,331,0,240,331,448,0,0,585,1,6,184,91,184,331,18,1442,497
1680,17,4.1.240,0,585,0,34,240,274,240,0,274,448,-86,119,671,2,4,121,154,165,275,18,1442,497
1680,18,0.1.196,1,585,0,58,196,254,196,0,254,448,-42,75,627,2,4,192,154,273,275,19,1442,406
1680,18,3.1.331,0,585,0,62,331,393,331,0,393,448,-177,210,762,2,4,93,154,184,275,19,1442,406
1680,18,4.1.240,0,585,0,34,240,274,240,0,274,448,-86,119,671,2,4,121,154,165,275,19,1442,406
1680,19,0.2.323,1,585,0,2,323,325,254,69,325,448,0,96,627,3,4,134,43,273,270,20,1442,348
1680,19,3.1.331,0,585,0,62,331,393,331,0,393,448,-77,152,704,2,5,93,96,184,275,20,1442,348
1680,19,4.1.254,0,585,0,34,254,288,240,14,288,448,0,75,627,2,5,121,96,165,275,20,1442,348
1680,20,0.3.365,1,585,0,52,365,417,325,40,417,448,0,232,627,4,4,132,72,273,205,21,1442,346
1680,20,3.1.331,0,585,0,62,331,393,331,0,393,448,-77,152,704,2,5,93,96,184,275,21,1442,346
1680,20,4.1.254,0,585,0,34,254,288,240,14,288,448,0,75,627,2,5,121,96,165,275,21,1442,346
1680,21,0.4.448,1,585,0,80,448,528,417,31,528,528,0,224,627,5,4,80,137,273,361,22,1442,294
1680,21,3.1.331,0,585,0,62,331,393,331,0,393,448,-77,152,704,2,5,93,96,184,275,22,1442,294
1680,21,4.1.254,0,585,0,34,254,288,240,14,288,448,0,75,627,2,5,121,96,165,275,22,1442,294
1680,22,3.1.331,0,585,0,62,331,393,331,0,393,528,-77,152,704,2,5,93,96,184,275,23,1442,214
1680,22,4.1.254,1,585,0,34,254,288,240,14,288,528,0,75,627,2,5,121,96,165,275,23,1442,214
1680,23,3.1.331,0,585,0,62,331,393,331,0,393,528,-43,118,670,2,6,93,62,184,275,24,1442,180
1680,23,4.2.325,1,585,0,40,325,365,288,37,365,528,0,96,627,3,5,87,41,165,270,24,1442,180
1680,24,3.1.331,0,585,0,62,331,393,331,0,393,528,-43,118,670,2,6,93,62,184,275,25,1442,140
1680,24,4.3.417,1,585,0,17,417,434,365,52,434,528,0,232,627,4,5,47,20,165,205,25,1442,140
1680,25,3.1.331,0,585,0,62,331,393,331,0,393,528,-43,118,670,2,6,93,62,184,275,26,1442,123
1680,25,4.4.528,1,585,0,30,528,558,434,94,558,558,0,224,627,5,5,30,57,165,361,26,1442,123
1680,26,3.1.331,1,585,0,62,331,393,331,0,393,558,-43,118,670,2,6,93,62,184,275,27,1442,93
1680,27,3.2.393,1,585,0,1,393,394,393,0,394,558,-28,124,698,3,6,31,1,184,270,28,1442,31
1680,28,3.3.434,1,585,0,3,434,437,394,40,437,558,0,232,698,4,6,30,3,184,205,29,1442,30
1680,29,3.4.558,1,585,0,27,558,585,437,121,585,585,0,224,698,5,6,27,27,184,361,30,1442,27
1681,0,0.0.0,0,598,5,94,0,94,0,0,94,94,0,0,0,1,1,217,346,217,346,1,1411,1411
1681,0,1.0.0,1,566,2,30,0,30,0,0,30,30,0,0,0,1,1,307,346,307,346,1,1411,1411
1681,0,2.0.0,0,595,4,73,0,73,0,0,73,73,0,0,0,1,1,151,346,151,346,1,1411,1411
1681,0,3.0.0,0,553,1,45,0,45,0,0,45,45,0,0,0,1,1,243,346,243,346,1,1411,1411
1681,0,4.0.0,0,593,3,66,0,66,0,0,66,66,0,0,0,1,1,302,346,302,346,1,1411,1411
1681,0,5.0.0,0,537,0,38,0,38,0,0,38,38,0,0,0,1,1,191,346,191,346,1,1411,1411
1681,1,0.0.30,0,603,4,94,30,124,0,30,124,124,0,0,0,1,2,217,316,217,346,2,1411,1381
1681,1,1.1.30,1,585,2,93,30,123,30,0,123,123,-30,30,30,2,1,277,278,307,278,2,1411,1381
1681,1,2.0.30,0,596,3,73,30,103,0,30,103,103,0,0,0,1,2,151,316,151,346,2,1411,1381
1681,1,3.0.30,0,583,1,45,30,75,0,30,75,75,0,0,0,1,2,243,316,243,346,2,1411,1381
1681,1,4.0.30,0,596,3,66,30,96,0,30,96,96,0,0,0,1,2,302,316,302,346,2,1411,1381
1681,1,5.0.30,0,566,0,38,30,68,0,30,68,68,0,0,0,1,2,191,316,191,346,2,1411,1381
1681,2,0.0.30,0,603,2,94,30,124,0,30,124,124,0,0,30,1,2,217,316,217,346,3,1411,1288
1681,2,1.2.123,1,603,2,84,123,207,123,0,207,207,-123,123,153,3,1,184,239,307,239,3,1411,1288
1681,2,2.0.30,0,596,1,73,30,103,0,30,103,123,0,0,30,1,2,151,316,151,346,3,1411,1288
1681,2,3.0.30,0,585,0,45,30,75,0,30,75,123,0,0,30,1,2,243,316,243,346,3,1411,1288
1681,2,4.0.30,0,596,1,66,30,96,0,30,96,123,0,0,30,1,2,302,316,302,346,3,1411,1288
1681,2,5.0.30,0,585,0,38,30,68,0,30,68,123,0,0,30,1,2,191,316,191,346,3,1411,1288
1681,3,0.0.30,0,603,0,94,30,124,0,30,124,207,0,0,153,1,2,217,316,217,346,4,1411,1204
1681,3,1.3.207,1,603,0,6,207,213,207,0,213,213,-207,207,360,4,1,100,158,307,158,4,1411,1204
1681,3,2.0.30,0,603,0,73,30,103,0,30,103,207,0,0,153,1,2,151,316,151,346,4,1411,1204
1681,3,3.0.30,0,603,0,45,30,75,0,30,75,207,0,0,153,1,2,243,316,243,346,4,1411,1204
1681,3,4.0.30,0,603,0,66,30,96,0,30,96,207,0,0,153,1,2,302,316,302,346,4,1411,1204
1681,3,5.0.30,0,603,0,38,30,68,0,30,68,207,0,0,153,1,2,191,316,191,346,4,1411,1204
1681,4,0.0.30,0,603,0,94,30,124,0,30,124,213,0,0,360,1,2,217,316,217,346,5,1411,1198
1681,4,1.4.213,1,603,0,94,213,307,213,0,307,307,-213,213,573,5,1,94,390,307,390,5,1411,1198
1681,4,2.0.30,0,603,0,73,30,103,0,30,103,213,0,0,360,1,2,151,316,151,346,5,1411,1198
1681,4,3.0.30,0,603,0,45,30,75,0,30,75,213,0,0,360,1,2,243,316,243,346,5,1411,1198
1681,4,4.0.30,0,603,0,66,30,96,0,30,96,213,0,0,360,1,2,302,316,302,346,5,1411,1198
1681,4,5.0.30,0,603,0,38,30,68,0,30,68,213,0,0,360,1,2,191,316,191,346,5,1411,1198
1681,5,0.0.30,0,603,0,94,30,124,0,30,124,307,0,0,573,1,2,217,316,217,346,6,1411,1104
1681,5,2.0.30,0,603,0,73,30,103,0,30,103,307,0,0,573,1,2,151,316,151,346,6,1411,1104
1681,5,3.0.30,0,603,0,45,30,75,0,30,75,307,0,0,573,1,2,243,316,243,346,6,1411,1104
1681,5,4.0.30,1,603,0,66,30,96,0,30,96,307,0,0,573,1,2,302,316,302,346,6,1411,1104
1681,5,5.0.30,0,603,0,38,30,68,0,30,68,307,0,0,573,1,2,191,316,191,346,6,1411,1104
1681,6,0.0.96,0,603,0,94,96,190,0,96,190,307,0,0,573,1,3,217,250,217,346,7,1411,1038
1681,6,2.0.96,0,603,0,73,96,169,0,96,169,307,0,0,573,1,3,151,250,151,346,7,1411,1038
1681,6,3.0.96,0,603,0,45,96,141,0,96,141,307,0,0,573,1,3,243,250,243,346,7,1411,1038
1681,6,4.1.123,1,603,0,86,123,209,96,27,209,307,0,30,573,2,2,236,185,302,278,7,1411,1038
1681,6,5.0.96,0,603,0,38,96,134,0,96,134,307,0,0,573,1,3,191,250,191,346,7,1411,1038
1681,7,0.0.96,0,603,0,94,96,190,0,96,190,307,0,0,573,1,3,217,250,217,346,8,1411,952
1681,7,2.0.96,0,603,0,73,96,169,0,96,169,307,0,0,573,1,3,151,250,151,346,8,1411,952
1681,7,3.0.96,0,603,0,45,96,141,0,96,141,307,0,0,573,1,3,243,250,243,346,8,1411,952
1681,7,4.2.209,1,603,0,41,209,250,209,0,250,307,-2,125,575,3,2,150,155,302,239,8,1411,952
1681,7,5.0.96,0,603,0,38,96,134,0,96,134,307,0,0,573,1,3,191,250,191,346,8,1411,952
1681,8,0.0.96,0,603,0,94,96,190,0,96,190,307,0,0,575,1,3,217,250,217,346,9,1411,911
1681,8,2.0.96,0,603,0,73,96,169,0,96,169,307,0,0,575,1,3,151,250,151,346,9,1411,911
1681,8,3.0.96,0,603,0,45,96,141,0,96,141,307,0,0,575,1,3,243,250,243,346,9,1411,911
1681,8,4.3.250,1,603,0,10,250,260,250,0,260,307,-37,244,612,4,2,109,152,302,158,9,1411,911
1681,8,5.0.96,0,603,0,38,96,134,0,96,134,307,0,0,575,1,3,191,250,191,346,9,1411,911
1681,9,0.0.96,0,603,0,94,96,190,0,96,190,307,0,0,612,1,3,217,250,217,346,10,1411,901
1681,9,2.0.96,0,603,0,73,96,169,0,96,169,307,0,0,612,1,3,151,250,151,346,10,1411,901
1681,9,3.0.96,0,603,0,45,96,141,0,96,141,307,0,0,612,1,3,243,250,243,346,10,1411,901
1681,9,4.4.307,1,603,0,99,307,406,260,47,406,406,0,213,612,5,2,99,296,302,390,10,1411,901
1681,9,5.0.96,0,603,0,38,96,134,0,96,134,307,0,0,612,1,3,191,250,191,346,10,1411,901
1681,10,0.0.96,0,603,0,94,96,190,0,96,190,406,0,0,612,1,3,217,250,217,346,11,1411,802
1681,10,2.0.96,0,603,0,73,96,169,0,96,169,406,0,0,612,1,3,151,250,151,346,11,1411,802
1681,10,3.0.96,1,603,0,45,96,141,0,96,141,406,0,0,612,1,3,243,250,243,346,11,1411,802
1681,10,5.0.96,0,603,0,38,96,134,0,96,134,406,0,0,612,1,3,191,250,191,346,11,1411,802
1681,11,0.0.141,0,603,0,94,141,235,0,141,235,406,0,0,612,1,4,217,205,217,346,12,1411,757
1681,11,2.0.141,0,603,0,73,141,214,0,141,214,406,0,0,612,1,4,151,205,151,346,12,1411,757
1681,11,3.1.209,1,603,0,1,209,210,141,68,210,406,0,30,612,2,3,198,99,243,278,12,1411,757
1681,11,5.0.141,0,603,0,38,141,179,0,141,179,406,0,0,612,1,4,191,205,191,346,12,1411,757
1681,12,0.0.141,0,603,0,94,141,235,0,141,235,406,0,0,612,1,4,217,205,217,346,13,1411,756
1681,12,2.0.141,0,603,0,73,141,214,0,141,214,406,0,0,612,1,4,151,205,151,346,13,1411,756
1681,12,3.2.250,1,603,0,68,250,318,210,40,318,406,0,125,612,3,3,197,114,243,239,13,1411,756
1681,12,5.0.141,0,603,0,38,141,179,0,141,179,406,0,0,612,1,4,191,205,191,346,13,1411,756
1681,13,0.0.141,0,603,0,94,141,235,0,141,235,406,0,0,612,1,4,217,205,217,346,14,1411,688
1681,13,2.0.141,0,603,0,73,141,214,0,141,214,406,0,0,612,1,4,151,205,151,346,14,1411,688
1681,13,3.3.318,1,603,0,61,318,379,318,0,379,406,-58,302,670,4,3,129,142,243,158,14,1411,688
1681,13,5.0.141,0,603,0,38,141,179,0,141,179,406,0,0,612,1,4,191,205,191,346,14,1411,688
1681,14,0.0.141,0,603,0,94,141,235,0,141,235,406,0,0,670,1,4,217,205,217,346,15,1411,627
1681,14,2.0.141,0,603,0,73,141,214,0,141,214,406,0,0,670,1,4,151,205,151,346,15,1411,627
1681,14,3.4.406,1,603,0,68,406,474,379,27,474,474,0,213,670,5,3,68,197,243,390,15,1411,627
1681,14,5.0.141,0,603,0,38,141,179,0,141,179,406,0,0,670,1,4,191,205,191,346,15,1411,627
1681,15,0.0.141,0,603,0,94,141,235,0,141,235,474,0,0,670,1,4,217,205,217,346,16,1411,559
1681,15,2.0.141,0,603,0,73,141,214,0,141,214,474,0,0,670,1,4,151,205,151,346,16,1411,559
1681,15,5.0.141,1,603,0,38,141,179,0,141,179,474,0,0,670,1,4,191,205,191,346,16,1411,559
1681,16,0.0.179,0,603,0,94,179,273,0,179,273,474,0,0,670,1,5,217,167,217,346,17,1411,521
1681,16,2.0.179,0,603,0,73,179,252,0,179,252,474,0,0,670,1,5,151,167,151,346,17,1411,521
1681,16,5.1.210,1,603,0,46,210,256,179,31,256,474,0,30,670,2,4,153,98,191,278,17,1411,521
1681,17,0.0.179,0,603,0,94,179,273,0,179,273,474,0,0,670,1,5,217,167,217,346,18,1411,475
1681,17,2.0.179,0,603,0,73,179,252,0,179,252,474,0,0,670,1,5,151,167,151,346,18,1411,475
1681,17,5.2.318,1,603,0,14,318,332,256,62,332,474,0,125,670,3,4,107,46,191,239,18,1411,475
1681,18,0.0.179,0,603,0,94,179,273,0,179,273,474,0,0,670,1,5,217,167,217,346,19,1411,461
1681,18,2.0.179,0,603,0,73,179,252,0,179,252,474,0,0,670,1,5,151,167,151,346,19,1411,461
1681,18,5.3.379,1,603,0,12,379,391,332,47,391,474,0,302,670,4,4,93,81,191,158,19,1411,461
1681,19,0.0.179,0,603,0,94,179,273,0,179,273,474,0,0,670,1,5,217,167,217,346,20,1411,449
1681,19,2.0.179,0,603,0,73,179,252,0,179,252,474,0,0,670,1,5,151,167,151,346,20,1411,449
1681,19,5.4.474,1,603,0,81,474,555,391,83,555,555,0,213,670,5,4,81,129,191,390,20,1411,449
1681,20,0.0.179,1,603,0,94,179,273,0,179,273,555,0,0,670,1,5,217,167,217,346,21,1411,368
1681,20,2.0.179,0,603,0,73,179,252,0,179,252,555,0,0,670,1,5,151,167,151,346,21,1411,368
1681,21,0.1.273,1,603,0,26,273,299,273,0,299,555,-17,47,687,2,5,123,52,217,278,22,1411,274
1681,21,2.0.273,0,603,0,73,273,346,0,273,346,555,0,0,670,1,6,151,73,151,346,22,1411,274
1681,22,0.2.332,1,603,0,6,332,338,299,33,338,555,0,125,687,3,5,97,32,217,239,23,1411,248
1681,22,2.0.273,0,603,0,73,273,346,0,273,346,555,0,0,687,1,6,151,73,151,346,23,1411,248
1681,23,0.3.391,1,603,0,58,391,449,338,53,449,555,0,302,687,4,5,91,69,217,158,24,1411,242
1681,23,2.0.273,0,603,0,73,273,346,0,273,346,555,0,0,687,1,6,151,73,151,346,24,1411,242
1681,24,0.4.555,1,603,0,33,555,588,449,106,588,588,0,213,687,5,5,33,48,217,390,25,1411,184
1681,24,2.0.273,0,603,0,73,273,346,0,273,346,555,0,0,687,1,6,151,73,151,346,25,1411,184
1681,25,2.0.273,1,603,0,73,273,346,0,273,346,588,0,0,687,1,6,151,73,151,346,26,1411,151
1681,26,2.1.346,1,603,0,26,346,372,346,0,372,588,-47,94,734,2,6,78,26,151,278,27,1411,78
1681,27,2.2.372,1,603,0,26,372,398,372,0,398,588,-34,159,768,3,6,52,26,151,239,28,1411,52
1681,28,2.3.449,1,603,0,11,449,460,398,51,460,588,0,302,768,4,6,26,11,151,158,29,1411,26
1681,29,2.4.588,1,603,0,15,588,603,460,128,603,603,0,213,768,5,6,15,15,151,390,30,1411,15
1682,0,0.0.0,1,498,0,8,0,8,0,0,8,8,0,0,0,1,1,261,259,261,259,1,1478,1478
1682,0,1.0.0,0,504,1,6,0,6,0,0,6,6,0,0,0,1,1,207,259,207,259,1,1478,1478
1682,0,2.0.0,0,517,2,19,0,19,0,0,19,19,0,0,0,1,1,276,259,276,259,1,1478,1478
1682,0,3.0.0,0,595,5,97,0,97,0,0,97,97,0,0,0,1,1,202,259,202,259,1,1478,1478
1682,0,4.0.0,0,568,4,87,0,87,0,0,87,87,0,0,0,1,1,240,259,240,259,1,1478,1478
1682,0,5.0.0,0,540,3,42,0,42,0,0,42,42,0,0,0,1,1,292,259,292,259,1,1478,1478
1682,1,0.1.8,0,498,0,93,8,101,8,0,101,101,-8,8,8,2,1,253,280,261,280,2,1478,1470
1682,1,1.0.8,0,498,0,6,8,14,0,8,14,14,0,0,0,1,2,207,251,207,259,2,1478,1470
1682,1,2.0.8,1,506,2,19,8,27,0,8,27,27,0,0,0,1,2,276,251,276,259,2,1478,1470
1682,1,3.0.8,0,538,3,97,8,105,0,8,105,105,0,0,0,1,2,202,251,202,259,2,1478,1470
1682,1,4.0.8,0,503,1,87,8,95,0,8,95,95,0,0,0,1,2,240,251,240,259,2,1478,1470
1682,1,5.0.8,0,498,0,42,8,50,0,8,50,50,0,0,0,1,2,292,251,292,259,2,1478,1470
1682,2,0.1.8,0,506,0,93,8,101,8,0,101,101,-8,8,8,2,1,253,280,261,280,3,1478,1451
1682,2,1.0.27,0,506,0,6,27,33,0,27,33,33,0,0,0,1,3,207,232,207,259,3,1478,1451
1682,2,2.1.27,1,527,2,19,27,46,27,0,46,46,-27,27,27,2,1,257,280,276,280,3,1478,1451
1682,2,3.0.27,0,515,1,97,27,124,0,27,124,124,0,0,0,1,3,202,232,202,259,3,1478,1451
1682,2,4.0.27,0,506,0,87,27,114,0,27,114,114,0,0,0,1,3,240,232,240,259,3,1478,1451
1682,2,5.0.27,0,506,0,42,27,69,0,27,69,69,0,0,0,1,3,292,232,292,259,3,1478,1451
1682,3,0.1.46,0,527,0,93,46,139,8,38,139,139,0,27,27,2,2,253,261,261,280,4,1478,1432
1682,3,1.0.27,1,527,0,6,27,33,0,27,33,46,0,0,27,1,3,207,232,207,259,4,1478,1432
1682,3,2.2.46,0,527,0,79,46,125,46,0,125,125,-46,46,73,3,1,238,306,276,306,4,1478,1432
1682,3,3.0.27,0,527,0,97,27,124,0,27,124,124,0,0,27,1,3,202,232,202,259,4,1478,1432
1682,3,4.0.27,0,527,0,87,27,114,0,27,114,114,0,0,27,1,3,240,232,240,259,4,1478,1432
1682,3,5.0.27,0,527,0,42,27,69,0,27,69,69,0,0,27,1,3,292,232,292,259,4,1478,1432
1682,4,0.1.46,0,527,0,93,46,139,8,38,139,139,0,27,27,2,2,253,261,261,280,5,1478,1426
1682,4,1.1.46,0,527,0,61,46,107,33,13,107,107,0,27,27,2,2,201,261,207,280,5,1478,1426
1682,4,2.2.46,0,527,0,79,46,125,46,0,125,125,-46,46,73,3,1,238,306,276,306,5,1478,1426
1682,4,3.0.33,0,527,0,97,33,130,0,33,130,130,0,0,27,1,4,202,226,202,259,5,1478,1426
1682,4,4.0.33,0,527,0,87,33,120,0,33,120,120,0,0,27,1,4,240,226,240,259,5,1478,1426
1682,4,5.0.33,1,527,0,42,33,75,0,33,75,75,0,0,27,1,4,292,226,292,259,5,1478,1426
1682,5,0.1.46,0,527,0,93,46,139,8,38,139,139,0,27,27,2,2,253,261,261,280,6,1478,1384
1682,5,1.1.46,0,527,0,61,46,107,33,13,107,107,0,27,27,2,2,201,261,207,280,6,1478,1384
1682,5,2.2.46,0,527,0,79,46,125,46,0,125,125,-46,46,73,3,1,238,306,276,306,6,1478,1384
1682,5,3.0.75,0,527,0,97,75,172,0,75,172,172,0,0,27,1,5,202,184,202,259,6,1478,1384
1682,5,4.0.75,0,527,0,87,75,162,0,75,162,162,0,0,27,1,5,240,184,240,259,6,1478,1384
1682,5,5.1.75,1,527,0,30,75,105,75,0,105,105,-29,56,56,2,2,250,261,292,280,6,1478,1384
1682,6,0.1.105,0,527,0,93,105,198,8,97,198,198,0,56,56,2,3,253,231,261,280,7,1478,1354
1682,6,1.1.105,0,527,0,61,105,166,33,72,166,166,0,56,56,2,3,201,231,207,280,7,1478,1354
1682,6,2.2.46,1,527,0,79,46,125,46,0,125,125,-46,46,102,3,1,238,306,276,306,7,1478,1354
1682,6,3.0.75,0,527,0,97,75,172,0,75,172,172,0,0,56,1,5,202,184,202,259,7,1478,1354
1682,6,4.0.75,0,527,0,87,75,162,0,75,162,162,0,0,56,1,5,240,184,240,259,7,1478,1354
1682,6,5.2.105,0,576,1,52,105,157,105,0,157,157,-105,105,161,3,1,220,306,292,306,7,1478,1354
1682,7,0.1.105,0,527,0,93,105,198,8,97,198,198,0,56,102,2,3,253,231,261,280,8,1478,1275
1682,7,1.1.105,0,527,0,61,105,166,33,72,166,166,0,56,102,2,3,201,231,207,280,8,1478,1275
1682,7,2.3.125,0,527,0,79,125,204,125,0,204,204,-125,125,227,4,1,159,310,276,310,8,1478,1275
1682,7,3.0.75,0,527,0,97,75,172,0,75,172,172,0,0,102,1,5,202,184,202,259,8,1478,1275
1682,7,4.0.75,0,527,0,87,75,162,0,75,162,162,0,0,102,1,5,240,184,240,259,8,1478,1275
1682,7,5.2.125,1,527,0,52,125,177,105,20,177,177,0,46,102,3,2,220,227,292,306,8,1478,1275
1682,8,0.1.105,0,527,0,93,105,198,8,97,198,198,0,56,102,2,3,253,231,261,280,9,1478,1223
1682,8,1.1.105,0,527,0,61,105,166,33,72,166,177,0,56,102,2,3,201,231,207,280,9,1478,1223
1682,8,2.3.125,1,527,0,79,125,204,125,0,204,204,-125,125,227,4,1,159,310,276,310,9,1478,1223
1682,8,3.0.75,0,527,0,97,75,172,0,75,172,177,0,0,102,1,5,202,184,202,259,9,1478,1223
1682,8,4.0.75,0,527,0,87,75,162,0,75,162,177,0,0,102,1,5,240,184,240,259,9,1478,1223
1682,8,5.3.177,0,596,1,96,177,273,177,0,273,273,-177,177,279,4,1,168,310,292,310,9,1478,1223
1682,9,0.1.105,0,527,0,93,105,198,8,97,198,204,0,56,227,2,3,253,231,261,280,10,1478,1144
1682,9,1.1.105,0,527,0,61,105,166,33,72,166,204,0,56,227,2,3,201,231,207,280,10,1478,1144
1682,9,2.4.204,1,527,0,80,204,284,204,0,284,284,-204,204,431,5,1,80,323,276,323,10,1478,1144
1682,9,3.0.75,0,527,0,97,75,172,0,75,172,204,0,0,227,1,5,202,184,202,259,10,1478,1144
1682,9,4.0.75,0,527,0,87,75,162,0,75,162,204,0,0,227,1,5,240,184,240,259,10,1478,1144
1682,9,5.3.204,0,543,1,96,204,300,177,27,300,300,0,125,227,4,2,168,231,292,310,10,1478,1144
1682,10,0.1.105,0,527,0,93,105,198,8,97,198,284,0,56,431,2,3,253,231,261,280,11,1478,1064
1682,10,1.1.105,0,527,0,61,105,166,33,72,166,284,0,56,431,2,3,201,231,207,280,11,1478,1064
1682,10,3.0.75,0,527,0,97,75,172,0,75,172,284,0,0,431,1,5,202,184,202,259,11,1478,1064
1682,10,4.0.75,0,527,0,87,75,162,0,75,162,284,0,0,431,1,5,240,184,240,259,11,1478,1064
1682,10,5.3.204,1,543,1,96,204,300,177,27,300,300,0,125,431,4,2,168,231,292,310,11,1478,1064
1682,11,0.1.105,0,543,0,93,105,198,8,97,198,300,0,56,431,2,3,253,231,261,280,12,1478,968
1682,11,1.1.105,0,543,0,61,105,166,33,72,166,300,0,56,431,2,3,201,231,207,280,12,1478,968
1682,11,3.0.75,0,543,0,97,75,172,0,75,172,300,0,0,431,1,5,202,184,202,259,12,1478,968
1682,11,4.0.75,0,543,0,87,75,162,0,75,162,300,0,0,431,1,5,240,184,240,259,12,1478,968
1682,11,5.4.300,1,543,0,72,300,372,300,0,372,372,-16,220,447,5,2,72,243,292,323,12,1478,968
1682,12,0.1.105,0,543,0,93,105,198,8,97,198,372,0,56,447,2,3,253,231,261,280,13,1478,896
1682,12,1.1.105,0,543,0,61,105,166,33,72,166,372,0,56,447,2,3,201,231,207,280,13,1478,896
1682,12,3.0.75,0,543,0,97,75,172,0,75,172,372,0,0,447,1,5,202,184,202,259,13,1478,896
1682,12,4.0.75,1,543,0,87,75,162,0,75,162,372,0,0,447,1,5,240,184,240,259,13,1478,896
1682,13,0.1.105,0,543,0,93,105,198,8,97,198,372,0,56,447,2,3,253,231,261,280,14,1478,809
1682,13,1.1.105,0,543,0,61,105,166,33,72,166,372,0,56,447,2,3,201,231,207,280,14,1478,809
1682,13,3.0.162,1,543,0,97,162,259,0,162,259,372,0,0,447,1,6,202,97,202,259,14,1478,809
1682,13,4.1.162,0,543,0,38,162,200,162,0,200,372,-57,113,504,2,3,153,231,240,280,14,1478,809
1682,14,0.1.105,1,543,0,93,105,198,8,97,198,372,0,56,447,2,3,253,231,261,280,15,1478,712
1682,14,1.1.105,0,543,0,61,105,166,33,72,166,372,0,56,447,2,3,201,231,207,280,15,1478,712
1682,14,3.1.259,0,543,0,39,259,298,259,0,298,372,-154,210,601,2,3,105,231,202,280,15,1478,712
1682,14,4.1.162,0,543,0,38,162,200,162,0,200,372,-57,113,504,2,3,153,231,240,280,15,1478,712
1682,15,0.2.198,1,543,0,9,198,207,198,0,207,372,-21,67,468,3,3,160,175,261,306,16,1478,619
1682,15,1.1.198,0,543,0,61,198,259,33,165,259,372,0,56,447,2,4,201,138,207,280,16,1478,619
1682,15,3.1.259,0,543,0,39,259,298,259,0,298,372,-61,117,508,2,4,105,138,202,280,16,1478,619
1682,15,4.1.198,0,543,0,38,198,236,162,36,236,372,0,56,447,2,4,153,138,240,280,16,1478,619
1682,16,0.3.300,1,543,0,65,300,365,207,93,365,372,0,125,468,4,3,151,135,261,310,17,1478,610
1682,16,1.1.198,0,543,0,61,198,259,33,165,259,372,0,56,468,2,4,201,138,207,280,17,1478,610
1682,16,3.1.259,0,543,0,39,259,298,259,0,298,372,-61,117,529,2,4,105,138,202,280,17,1478,610
1682,16,4.1.198,0,543,0,38,198,236,162,36,236,372,0,56,468,2,4,153,138,240,280,17,1478,610
1682,17,0.4.372,0,543,0,86,372,458,365,7,458,458,0,220,468,5,3,86,171,261,323,18,1478,545
1682,17,1.1.198,1,543,0,61,198,259,33,165,259,372,0,56,468,2,4,201,138,207,280,18,1478,545
1682,17,3.1.259,0,543,0,39,259,298,259,0,298,372,-61,117,529,2,4,105,138,202,280,18,1478,545
1682,17,4.1.198,0,543,0,38,198,236,162,36,236,372,0,56,468,2,4,153,138,240,280,18,1478,545
1682,18,0.4.372,0,543,0,86,372,458,365,7,458,458,0,220,468,5,3,86,171,261,323,19,1478,484
1682,18,1.2.259,0,543,0,89,259,348,259,0,348,372,-52,119,520,3,4,140,166,207,306,19,1478,484
1682,18,3.1.259,0,543,0,39,259,298,259,0,298,372,0,56,468,2,5,105,77,202,280,19,1478,484
1682,18,4.1.259,1,543,0,38,259,297,162,97,297,372,0,56,468,2,5,153,77,240,280,19,1478,484
1682,19,0.4.372,0,543,0,86,372,458,365,7,458,458,0,220,468,5,3,86,171,261,323,20,1478,446
1682,19,1.2.259,0,543,0,89,259,348,259,0,348,372,-52,119,520,3,4,140,166,207,306,20,1478,446
1682,19,3.1.297,1,543,0,39,297,336,259,38,336,372,0,56,468,2,6,105,39,202,280,20,1478,446
1682,19,4.2.297,0,543,0,42,297,339,297,0,339,372,-90,157,558,3,4,115,166,240,306,20,1478,446
1682,20,0.4.372,1,543,0,86,372,458,365,7,458,458,0,220,468,5,3,86,171,261,323,21,1478,407
1682,20,1.2.259,0,543,0,89,259,348,259,0,348,372,-52,119,520,3,4,140,166,207,306,21,1478,407
1682,20,3.2.336,0,553,1,35,336,371,336,0,371,372,-129,196,597,3,4,66,166,202,306,21,1478,407
1682,20,4.2.297,0,543,0,42,297,339,297,0,339,372,-90,157,558,3,4,115,166,240,306,21,1478,407
1682,21,1.2.259,0,543,0,89,259,348,259,0,348,458,-52,119,520,3,4,140,166,207,306,22,1478,321
1682,21,3.2.336,0,553,1,35,336,371,336,0,371,458,-129,196,597,3,4,66,166,202,306,22,1478,321
1682,21,4.2.297,1,543,0,42,297,339,297,0,339,458,-90,157,558,3,4,115,166,240,306,22,1478,321
1682,22,1.2.339,0,543,0,89,339,428,259,80,428,458,0,157,558,3,5,140,124,207,306,23,1478,279
1682,22,3.2.339,0,543,0,35,339,374,336,3,374,458,0,157,558,3,5,66,124,202,306,23,1478,279
1682,22,4.3.365,1,543,0,3,365,368,339,26,368,458,0,125,558,4,4,73,70,240,310,23,1478,279
1682,23,1.2.339,0,543,0,89,339,428,259,80,428,458,0,157,558,3,5,140,124,207,306,24,1478,276
1682,23,3.2.339,0,543,0,35,339,374,336,3,374,458,0,157,558,3,5,66,124,202,306,24,1478,276
1682,23,4.4.458,1,543,0,70,458,528,368,90,528,528,0,220,558,5,4,70,85,240,323,24,1478,276
1682,24,1.2.339,0,543,0,89,339,428,259,80,428,528,0,157,558,3,5,140,124,207,306,25,1478,206
1682,24,3.2.339,1,543,0,35,339,374,336,3,374,528,0,157,558,3,5,66,124,202,306,25,1478,206
1682,25,1.2.374,0,543,0,89,374,463,259,115,463,528,0,157,558,3,6,140,89,207,306,26,1478,171
1682,25,3.3.374,1,543,0,20,374,394,374,0,394,528,-6,131,564,4,5,31,67,202,310,26,1478,171
1682,26,1.2.374,0,543,0,89,374,463,259,115,463,528,0,157,564,3,6,140,89,207,306,27,1478,151
1682,26,3.4.528,1,543,0,11,528,539,394,134,539,539,0,220,564,5,5,11,15,202,323,27,1478,151
1682,27,1.2.374,1,543,0,89,374,463,259,115,463,539,0,157,564,3,6,140,89,207,306,28,1478,140
1682,28,1.3.463,1,543,0,47,463,510,463,0,510,539,-69,200,633,4,6,51,47,207,310,29,1478,51
1682,29,1.4.539,1,543,0,4,539,543,510,29,543,543,0,220,633,5,6,4,4,207,323,30,1478,4
1683,0,0.0.0,0,572,0,21,0,21,0,0,21,21,0,0,0,1,1,204,275,204,275,1,1548,1548
1683,0,1.0.0,0,653,5,81,0,81,0,0,81,81,0,0,0,1,1,307,275,307,275,1,1548,1548
1683,0,2.0.0,0,605,2,65,0,65,0,0,65,65,0,0,0,1,1,203,275,203,275,1,1548,1548
1683,0,3.0.0,0,607,3,51,0,51,0,0,51,51,0,0,0,1,1,262,275,262,275,1,1548,1548
1683,0,4.0.0,1,582,1,10,0,10,0,0,10,10,0,0,0,1,1,278,275,278,275,1,1548,1548
1683,0,5.0.0,0,619,4,47,0,47,0,0,47,47,0,0,0,1,1,294,275,294,275,1,1548,1548
1683,1,0.0.10,0,582,0,21,10,31,0,10,31,31,0,0,0,1,2,204,265,204,275,2,1548,1538
1683,1,1.0.10,0,619,3,81,10,91,0,10,91,91,0,0,0,1,2,307,265,307,275,2,1548,1538
1683,1,2.0.10,0,615,1,65,10,75,0,10,75,75,0,0,0,1,2,203,265,203,275,2,1548,1538
1683,1,3.0.10,0,617,2,51,10,61,0,10,61,61,0,0,0,1,2,262,265,262,275,2,1548,1538
1683,1,4.1.10,0,619,3,90,10,100,10,0,100,100,-10,10,10,2,1,268,284,278,284,2,1548,1538
1683,1,5.0.10,1,619,3,47,10,57,0,10,57,57,0,0,0,1,2,294,265,294,275,2,1548,1538
1683,2,0.0.57,0,619,0,21,57,78,0,57,78,78,0,0,0,1,3,204,218,204,275,3,1548,1491
1683,2,1.0.57,0,619,0,81,57,138,0,57,138,138,0,0,0,1,3,307,218,307,275,3,1548,1491
1683,2,2.0.57,0,619,0,65,57,122,0,57,122,122,0,0,0,1,3,203,218,203,275,3,1548,1491
1683,2,3.0.57,0,619,0,51,57,108,0,57,108,108,0,0,0,1,3,262,218,262,275,3,1548,1491
1683,2,4.1.10,0,619,0,90,10,100,10,0,100,100,-10,10,10,2,1,268,284,278,284,3,1548,1491
1683,2,5.1.57,1,629,1,13,57,70,57,0,70,70,-57,57,57,2,1,247,284,294,284,3,1548,1491
1683,3,0.0.57,0,629,0,21,57,78,0,57,78,78,0,0,57,1,3,204,218,204,275,4,1548,1478
1683,3,1.0.57,0,636,1,81,57,138,0,57,138,138,0,0,57,1,3,307,218,307,275,4,1548,1478
1683,3,2.0.57,0,636,1,65,57,122,0,57,122,122,0,0,57,1,3,203,218,203,275,4,1548,1478
1683,3,3.0.57,0,636,1,51,57,108,0,57,108,108,0,0,57,1,3,262,218,262,275,4,1548,1478
1683,3,4.1.70,0,636,1,90,70,160,10,60,160,160,0,57,57,2,2,268,271,278,284,4,1548,1478
1683,3,5.2.70,1,636,1,90,70,160,70,0,160,160,-70,70,127,3,1,234,274,294,274,4,1548,1478
1683,4,0.0.57,1,636,0,21,57,78,0,57,78,160,0,0,127,1,3,204,218,204,275,5,1548,1388
1683,4,1.0.57,0,636,0,81,57,138,0,57,138,160,0,0,127,1,3,307,218,307,275,5,1548,1388
1683,4,2.0.57,0,636,0,65,57,122,0,57,122,160,0,0,127,1,3,203,218,203,275,5,1548,1388
1683,4,3.0.57,0,636,0,51,57,108,0,57,108,160,0,0,127,1,3,262,218,262,275,5,1548,1388
1683,4,4.1.70,0,636,0,90,70,160,10,60,160,160,0,57,127,2,2,268,271,278,284,5,1548,1388
1683,4,5.3.160,0,636,0,81,160,241,160,0,241,241,-160,160,287,4,1,144,463,294,463,5,1548,1388
1683,5,0.1.78,0,636,0,61,78,139,78,0,139,160,-8,65,135,2,2,183,271,204,284,6,1548,1367
1683,5,1.0.78,0,636,0,81,78,159,0,78,159,160,0,0,127,1,4,307,197,307,275,6,1548,1367
1683,5,2.0.78,0,636,0,65,78,143,0,78,143,160,0,0,127,1,4,203,197,203,275,6,1548,1367
1683,5,3.0.78,1,636,0,51,78,129,0,78,129,160,0,0,127,1,4,262,197,262,275,6,1548,1367
1683,5,4.1.70,0,636,0,90,70,160,10,60,160,160,0,57,127,2,2,268,271,278,284,6,1548,1367
1683,5,5.3.160,0,636,0,81,160,241,160,0,241,241,-160,160,287,4,1,144,463,294,463,6,1548,1367
1683,6,0.1.78,0,636,0,61,78,139,78,0,139,160,-8,65,135,2,2,183,271,204,284,7,1548,1316
1683,6,1.0.129,1,636,0,81,129,210,0,129,210,210,0,0,127,1,5,307,146,307,275,7,1548,1316
1683,6,2.0.129,0,636,0,65,129,194,0,129,194,194,0,0,127,1,5,203,146,203,275,7,1548,1316
1683,6,3.1.129,0,636,0,77,129,206,129,0,206,206,-59,116,186,2,2,211,271,262,284,7,1548,1316
1683,6,4.1.70,0,636,0,90,70,160,10,60,160,160,0,57,127,2,2,268,271,278,284,7,1548,1316
1683,6,5.3.160,0,636,0,81,160,241,160,0,241,241,-160,160,287,4,1,144,463,294,463,7,1548,1316
1683,7,0.1.78,0,636,0,61,78,139,78,0,139,210,-8,65,135,2,2,183,271,204,284,8,1548,1235
1683,7,1.1.210,0,636,0,30,210,240,210,0,240,240,-140,197,267,2,2,226,271,307,284,8,1548,1235
1683,7,2.0.210,1,636,0,65,210,275,0,210,275,275,0,0,127,1,6,203,65,203,275,8,1548,1235
1683,7,3.1.129,0,636,0,77,129,206,129,0,206,210,-59,116,186,2,2,211,271,262,284,8,1548,1235
1683,7,4.1.70,0,636,0,90,70,160,10,60,160,210,0,57,127,2,2,268,271,278,284,8,1548,1235
1683,7,5.3.160,0,636,0,81,160,241,160,0,241,241,-160,160,287,4,1,144,463,294,463,8,1548,1235
1683,8,0.1.78,0,636,0,61,78,139,78,0,139,275,-8,65,135,2,2,183,271,204,284,9,1548,1170
1683,8,1.1.210,0,636,0,30,210,240,210,0,240,275,-140,197,267,2,2,226,271,307,284,9,1548,1170
1683,8,2.1.275,0,636,0,13,275,288,275,0,288,288,-205,262,332,2,2,138,271,203,284,9,1548,1170
1683,8,3.1.129,0,636,0,77,129,206,129,0,206,275,-59,116,186,2,2,211,271,262,284,9,1548,1170
1683,8,4.1.70,1,636,0,90,70,160,10,60,160,275,0,57,127,2,2,268,271,278,284,9,1548,1170
1683,8,5.3.160,0,636,0,81,160,241,160,0,241,275,-160,160,287,4,1,144,463,294,463,9,1548,1170
1683,9,0.1.160,0,636,0,61,160,221,78,82,221,275,0,57,127,2,3,183,181,204,284,10,1548,1080
1683,9,1.1.210,0,636,0,30,210,240,210,0,240,275,-50,107,177,2,3,226,181,307,284,10,1548,1080
1683,9,2.1.275,0,636,0,13,275,288,275,0,288,288,-115,172,242,2,3,138,181,203,284,10,1548,1080
1683,9,3.1.160,0,636,0,77,160,237,129,31,237,275,0,57,127,2,3,211,181,262,284,10,1548,1080
1683,9,4.2.160,1,636,0,43,160,203,160,0,203,275,0,70,127,3,2,178,184,278,274,10,1548,1080
1683,9,5.3.160,0,636,0,81,160,241,160,0,241,275,-160,160,287,4,1,144,463,294,463,10,1548,1080
1683,10,0.1.160,1,636,0,61,160,221,78,82,221,275,0,57,127,2,3,183,181,204,284,11,1548,1037
1683,10,1.1.210,0,636,0,30,210,240,210,0,240,275,-50,107,177,2,3,226,181,307,284,11,1548,1037
1683,10,2.1.275,0,636,0,13,275,288,275,0,288,288,-115,172,242,2,3,138,181,203,284,11,1548,1037
1683,10,3.1.160,0,636,0,77,160,237,129,31,237,275,0,57,127,2,3,211,181,262,284,11,1548,1037
1683,10,4.3.203,0,679,1,95,203,298,203,0,298,298,-203,203,330,4,1,135,463,278,463,11,1548,1037
1683,10,5.3.160,0,636,0,81,160,241,160,0,241,275,-160,160,287,4,1,144,463,294,463,11,1548,1037
1683,11,0.2.221,1,636,0,12,221,233,221,0,233,275,-18,88,145,3,3,122,141,204,274,12,1548,976
1683,11,1.1.221,0,636,0,30,221,251,210,11,251,275,0,57,127,2,4,226,120,307,284,12,1548,976
1683,11,2.1.275,0,636,0,13,275,288,275,0,288,288,-54,111,181,2,4,138,120,203,284,12,1548,976
1683,11,3.1.221,0,636,0,77,221,298,129,92,298,298,0,57,127,2,4,211,120,262,284,12,1548,976
1683,11,4.3.203,0,679,1,95,203,298,203,0,298,298,-203,203,330,4,1,135,463,278,463,12,1548,976
1683,11,5.3.160,0,636,0,81,160,241,160,0,241,275,-160,160,287,4,1,144,463,294,463,12,1548,976
1683,12,0.3.233,0,709,2,71,233,304,233,0,304,304,-233,233,378,4,1,110,463,204,463,13,1548,964
1683,12,1.1.221,1,636,0,30,221,251,210,11,251,275,0,57,145,2,4,226,120,307,284,13,1548,964
1683,12,2.1.275,0,636,0,13,275,288,275,0,288,288,-54,111,199,2,4,138,120,203,284,13,1548,964
1683,12,3.1.221,0,636,0,77,221,298,129,92,298,298,0,57,145,2,4,211,120,262,284,13,1548,964
1683,12,4.3.203,0,679,1,95,203,298,203,0,298,298,-203,203,348,4,1,135,463,278,463,13,1548,964
1683,12,5.3.160,0,636,0,81,160,241,160,0,241,275,-160,160,305,4,1,144,463,294,463,13,1548,964
1683,13,0.3.233,0,709,2,71,233,304,233,0,304,304,-233,233,378,4,1,110,463,204,463,14,1548,934
1683,13,1.2.251,0,636,0,94,251,345,251,0,345,345,-18,106,163,3,4,196,129,307,274,14,1548,934
1683,13,2.1.275,0,636,0,13,275,288,275,0,288,288,-24,81,169,2,5,138,90,203,284,14,1548,934
1683,13,3.1.251,1,636,0,77,251,328,129,122,328,328,0,57,145,2,5,211,90,262,284,14,1548,934
1683,13,4.3.203,0,679,1,95,203,298,203,0,298,298,-203,203,348,4,1,135,463,278,463,14,1548,934
1683,13,5.3.160,0,636,0,81,160,241,160,0,241,275,-160,160,305,4,1,144,463,294,463,14,1548,934
1683,14,0.3.233,0,709,2,71,233,304,233,0,304,328,-233,233,378,4,1,110,463,204,463,15,1548,857
1683,14,1.2.251,0,636,0,94,251,345,251,0,345,345,-18,106,163,3,4,196,129,307,274,15,1548,857
1683,14,2.1.328,1,636,0,13,328,341,275,53,341,341,0,57,145,2,6,138,13,203,284,15,1548,857
1683,14,3.2.328,0,636,0,3,328,331,328,0,331,331,-95,183,240,3,4,134,129,262,274,15,1548,857
1683,14,4.3.203,0,679,1,95,203,298,203,0,298,328,-203,203,348,4,1,135,463,278,463,15,1548,857
1683,14,5.3.160,0,636,0,81,160,241,160,0,241,328,-160,160,305,4,1,144,463,294,463,15,1548,857
1683,15,0.3.233,0,709,2,71,233,304,233,0,304,341,-233,233,378,4,1,110,463,204,463,16,1548,844
1683,15,1.2.251,0,636,0,94,251,345,251,0,345,345,-18,106,163,3,4,196,129,307,274,16,1548,844
1683,15,2.2.341,0,636,0,32,341,373,341,0,373,373,-108,196,253,3,4,125,129,203,274,16,1548,844
1683,15,3.2.328,1,636,0,3,328,331,328,0,331,341,-95,183,240,3,4,134,129,262,274,16,1548,844
1683,15,4.3.203,0,679,1,95,203,298,203,0,298,341,-203,203,348,4,1,135,463,278,463,16,1548,844
1683,15,5.3.160,0,636,0,81,160,241,160,0,241,341,-160,160,305,4,1,144,463,294,463,16,1548,844
1683,16,0.3.233,0,709,3,71,233,304,233,0,304,341,-233,233,473,4,1,110,463,204,463,17,1548,841
1683,16,1.2.331,1,636,0,94,331,425,251,80,425,425,0,183,240,3,5,196,126,307,274,17,1548,841
1683,16,2.2.341,0,636,0,32,341,373,341,0,373,373,-10,193,250,3,5,125,126,203,274,17,1548,841
1683,16,3.3.331,0,655,1,79,331,410,331,0,410,410,-331,331,571,4,1,131,463,262,463,17,1548,841
1683,16,4.3.203,0,679,2,95,203,298,203,0,298,341,-203,203,443,4,1,135,463,278,463,17,1548,841
1683,16,5.3.160,0,636,0,81,160,241,160,0,241,341,-160,160,400,4,1,144,463,294,463,17,1548,841
1683,17,0.3.233,0,709,4,71,233,304,233,0,304,425,-233,233,473,4,1,110,463,204,463,18,1548,747
1683,17,1.3.425,0,672,2,89,425,514,425,0,514,514,-425,425,665,4,1,102,463,307,463,18,1548,747
1683,17,2.2.425,1,636,0,32,425,457,341,84,457,457,0,183,240,3,6,125,32,203,274,18,1548,747
1683,17,3.3.331,0,655,1,79,331,410,331,0,410,425,-331,331,571,4,1,131,463,262,463,18,1548,747
1683,17,4.3.203,0,679,3,95,203,298,203,0,298,425,-203,203,443,4,1,135,463,278,463,18,1548,747
1683,17,5.3.160,0,636,0,81,160,241,160,0,241,425,-160,160,400,4,1,144,463,294,463,18,1548,747
1683,18,0.3.233,0,709,5,71,233,304,233,0,304,457,-233,233,473,4,1,110,463,204,463,19,1548,715
1683,18,1.3.425,0,672,2,89,425,514,425,0,514,514,-425,425,665,4,1,102,463,307,463,19,1548,715
1683,18,2.3.457,0,678,3,48,457,505,457,0,505,505,-457,457,697,4,1,93,463,203,463,19,1548,715
1683,18,3.3.331,0,655,1,79,331,410,331,0,410,457,-331,331,571,4,1,131,463,262,463,19,1548,715
1683,18,4.3.203,0,679,4,95,203,298,203,0,298,457,-203,203,443,4,1,135,463,278,463,19,1548,715
1683,18,5.3.160,1,636,0,81,160,241,160,0,241,457,-160,160,400,4,1,144,463,294,463,19,1548,715
1683,19,0.3.241,0,636,0,71,241,312,233,8,312,457,0,160,400,4,2,110,382,204,463,20,1548,634
1683,19,1.3.425,0,672,2,89,425,514,425,0,514,514,-184,344,584,4,2,102,382,307,463,20,1548,634
1683,19,2.3.457,0,678,3,48,457,505,457,0,505,505,-216,376,616,4,2,93,382,203,463,20,1548,634
1683,19,3.3.331,0,655,1,79,331,410,331,0,410,457,-90,250,490,4,2,131,382,262,463,20,1548,634
1683,19,4.3.241,0,636,0,95,241,336,203,38,336,457,0,160,400,4,2,135,382,278,463,20,1548,634
1683,19,5.4.241,1,636,0,63,241,304,241,0,304,457,-241,241,641,5,1,63,252,294,252,20,1548,634
1683,20,0.3.241,0,636,0,71,241,312,233,8,312,457,0,160,641,4,2,110,382,204,463,21,1548,571
1683,20,1.3.425,0,672,2,89,425,514,425,0,514,514,-184,344,825,4,2,102,382,307,463,21,1548,571
1683,20,2.3.457,0,678,3,48,457,505,457,0,505,505,-216,376,857,4,2,93,382,203,463,21,1548,571
1683,20,3.3.331,0,655,1,79,331,410,331,0,410,457,-90,250,731,4,2,131,382,262,463,21,1548,571
1683,20,4.3.241,1,636,0,95,241,336,203,38,336,457,0,160,641,4,2,135,382,278,463,21,1548,571
1683,21,0.3.336,0,636,0,71,336,407,233,103,407,457,0,160,641,4,3,110,287,204,463,22,1548,476
1683,21,1.3.425,0,672,1,89,425,514,425,0,514,514,-89,249,730,4,3,102,287,307,463,22,1548,476
1683,21,2.3.457,0,678,2,48,457,505,457,0,505,505,-121,281,762,4,3,93,287,203,463,22,1548,476
1683,21,3.3.336,0,636,0,79,336,415,331,5,415,457,0,160,641,4,3,131,287,262,463,22,1548,476
1683,21,4.4.336,1,636,0,40,336,376,336,0,376,457,-32,273,673,5,2,40,189,278,252,22,1548,476
1683,22,0.3.336,1,636,0,71,336,407,233,103,407,457,0,160,673,4,3,110,287,204,463,23,1548,436
1683,22,1.3.425,0,672,1,89,425,514,425,0,514,514,-89,249,762,4,3,102,287,307,463,23,1548,436
1683,22,2.3.457,0,678,2,48,457,505,457,0,505,505,-121,281,794,4,3,93,287,203,463,23,1548,436
1683,22,3.3.336,0,636,0,79,336,415,331,5,415,457,0,160,673,4,3,131,287,262,463,23,1548,436
1683,23,0.4.407,1,636,0,39,407,446,407,0,446,457,-31,304,704,5,3,39,149,204,252,24,1548,365
1683,23,1.3.425,0,690,2,89,425,514,425,0,514,514,-18,178,691,4,4,102,216,307,463,24,1548,365
1683,23,2.3.457,0,686,1,48,457,505,457,0,505,505,-50,210,723,4,4,93,216,203,463,24,1548,365
1683,23,3.3.407,0,636,0,79,407,486,331,76,486,486,0,160,673,4,4,131,216,262,463,24,1548,365
1683,24,1.3.425,0,690,2,89,425,514,425,0,514,514,-18,178,722,4,4,102,216,307,463,25,1548,326
1683,24,2.3.457,0,686,1,48,457,505,457,0,505,505,-50,210,754,4,4,93,216,203,463,25,1548,326
1683,24,3.3.407,1,636,0,79,407,486,331,76,486,486,0,160,704,4,4,131,216,262,463,25,1548,326
1683,25,1.3.486,0,668,1,89,486,575,425,61,575,575,0,160,704,4,5,102,137,307,463,26,1548,247
1683,25,2.3.486,0,636,0,48,486,534,457,29,534,534,0,160,704,4,5,93,137,203,463,26,1548,247
1683,25,3.4.486,1,636,0,52,486,538,486,0,538,538,-40,344,744,5,4,52,110,262,252,26,1548,247
1683,26,1.3.486,0,668,1,89,486,575,425,61,575,575,0,160,744,4,5,102,137,307,463,27,1548,195
1683,26,2.3.486,1,636,0,48,486,534,457,29,534,538,0,160,744,4,5,93,137,203,463,27,1548,195
1683,27,1.3.534,0,636,0,89,534,623,425,109,623,623,0,160,744,4,6,102,89,307,463,28,1548,147
1683,27,2.4.538,1,636,0,45,538,583,534,4,583,583,0,344,744,5,5,45,58,203,252,28,1548,147
1683,28,1.3.534,1,636,0,89,534,623,425,109,623,623,0,160,744,4,6,102,89,307,463,29,1548,102
1683,29,1.4.623,1,636,0,13,623,636,623,0,636,636,-40,384,784,5,6,13,13,307,252,30,1548,13
1684,0,0.0.0,0,477,0,34,0,34,0,0,34,34,0,0,0,1,1,249,190,249,190,1,1414,1414
1684,0,1.0.0,0,523,2,57,0,57,0,0,57,57,0,0,0,1,1,306,190,306,190,1,1414,1414
1684,0,2.0.0,0,477,0,11,0,11,0,0,11,11,0,0,0,1,1,129,190,129,190,1,1414,1414
1684,0,3.0.0,1,477,0,5,0,5,0,0,5,5,0,0,0,1,1,221,190,221,190,1,1414,1414
1684,0,4.0.0,0,477,0,32,0,32,0,0,32,32,0,0,0,1,1,215,190,215,190,1,1414,1414
1684,0,5.0.0,0,497,1,51,0,51,0,0,51,51,0,0,0,1,1,294,190,294,190,1,1414,1414
1684,1,0.0.5,1,477,0,34,5,39,0,5,39,39,0,0,0,1,2,249,185,249,190,2,1414,1409
1684,1,1.0.5,0,515,2,57,5,62,0,5,62,62,0,0,0,1,2,306,185,306,190,2,1414,1409
1684,1,2.0.5,0,477,0,11,5,16,0,5,16,16,0,0,0,1,2,129,185,129,190,2,1414,1409
1684,1,3.1.5,0,477,0,16,5,21,5,0,21,21,-5,5,5,2,1,216,286,221,286,2,1414,1409
1684,1,4.0.5,0,477,0,32,5,37,0,5,37,37,0,0,0,1,2,215,185,215,190,2,1414,1409
1684,1,5.0.5,0,481,1,51,5,56,0,5,56,56,0,0,0,1,2,294,185,294,190,2,1414,1409
1684,2,0.1.39,0,477,0,30,39,69,39,0,69,69,-39,39,39,2,1,215,286,249,286,3,1414,1375
1684,2,1.0.39,0,503,2,57,39,96,0,39,96,96,0,0,0,1,3,306,151,306,190,3,1414,1375
1684,2,2.0.39,0,477,0,11,39,50,0,39,50,50,0,0,0,1,3,129,151,129,190,3,1414,1375
1684,2,3.1.5,0,477,0,16,5,21,5,0,21,39,-5,5,5,2,1,216,286,221,286,3,1414,1375
1684,2,4.0.39,0,477,0,32,39,71,0,39,71,71,0,0,0,1,3,215,151,215,190,3,1414,1375
1684,2,5.0.39,1,493,1,51,39,90,0,39,90,90,0,0,0,1,3,294,151,294,190,3,1414,1375
1684,3,0.1.39,0,493,0,30,39,69,39,0,69,90,-39,39,39,2,1,215,286,249,286,4,1414,1324
1684,3,1.0.90,1,493,0,57,90,147,0,90,147,147,0,0,0,1,4,306,100,306,190,4,1414,1324
1684,3,2.0.90,0,493,0,11,90,101,0,90,101,101,0,0,0,1,4,129,100,129,190,4,1414,1324
1684,3,3.1.5,0,493,0,16,5,21,5,0,21,90,-5,5,5,2,1,216,286,221,286,4,1414,1324
1684,3,4.0.90,0,493,0,32,90,122,0,90,122,122,0,0,0,1,4,215,100,215,190,4,1414,1324
1684,3,5.1.90,0,493,0,95,90,185,90,0,185,185,-90,90,90,2,1,243,286,294,286,4,1414,1324
1684,4,0.1.39,0,493,0,30,39,69,39,0,69,147,-39,39,39,2,1,215,286,249,286,5,1414,1267
1684,4,1.1.147,0,555,1,97,147,244,147,0,244,244,-147,147,147,2,1,249,286,306,286,5,1414,1267
1684,4,2.0.147,0,493,0,11,147,158,0,147,158,158,0,0,0,1,5,129,43,129,190,5,1414,1267
1684,4,3.1.5,0,493,0,16,5,21,5,0,21,147,-5,5,5,2,1,216,286,221,286,5,1414,1267
1684,4,4.0.147,1,493,0,32,147,179,0,147,179,179,0,0,0,1,5,215,43,215,190,5,1414,1267
1684,4,5.1.90,0,493,0,95,90,185,90,0,185,185,-90,90,90,2,1,243,286,294,286,5,1414,1267
1684,5,0.1.39,0,493,0,30,39,69,39,0,69,179,-39,39,39,2,1,215,286,249,286,6,1414,1235
1684,5,1.1.147,0,555,1,97,147,244,147,0,244,244,-147,147,147,2,1,249,286,306,286,6,1414,1235
1684,5,2.0.179,1,493,0,11,179,190,0,179,190,190,0,0,0,1,6,129,11,129,190,6,1414,1235
1684,5,3.1.5,0,493,0,16,5,21,5,0,21,179,-5,5,5,2,1,216,286,221,286,6,1414,1235
1684,5,4.1.179,0,571,2,42,179,221,179,0,221,221,-179,179,179,2,1,183,286,215,286,6,1414,1235
1684,5,5.1.90,0,493,0,95,90,185,90,0,185,185,-90,90,90,2,1,243,286,294,286,6,1414,1235
1684,6,0.1.39,0,493,0,30,39,69,39,0,69,190,-39,39,39,2,1,215,286,249,286,7,1414,1224
1684,6,1.1.147,0,555,1,97,147,244,147,0,244,244,-147,147,147,2,1,249,286,306,286,7,1414,1224
1684,6,2.1.190,0,493,0,6,190,196,190,0,196,196,-190,190,190,2,1,118,286,129,286,7,1414,1224
1684,6,3.1.5,1,493,0,16,5,21,5,0,21,190,-5,5,5,2,1,216,286,221,286,7,1414,1224
1684,6,4.1.179,0,571,2,42,179,221,179,0,221,221,-179,179,179,2,1,183,286,215,286,7,1414,1224
1684,6,5.1.90,0,493,0,95,90,185,90,0,185,190,-90,90,90,2,1,243,286,294,286,7,1414,1224
1684,7,0.1.39,1,493,0,30,39,69,39,0,69,190,-18,23,23,2,2,215,270,249,286,8,1414,1208
1684,7,1.1.147,0,555,1,97,147,244,147,0,244,244,-126,131,131,2,2,249,270,306,286,8,1414,1208
1684,7,2.1.190,0,493,0,6,190,196,190,0,196,196,-169,174,174,2,2,118,270,129,286,8,1414,1208
1684,7,3.2.21,0,493,0,69,21,90,21,0,90,190,-21,21,26,3,1,200,340,221,340,8,1414,1208
1684,7,4.1.179,0,571,2,42,179,221,179,0,221,221,-158,163,163,2,2,183,270,215,286,8,1414,1208
1684,7,5.1.90,0,493,0,95,90,185,90,0,185,190,-69,74,74,2,2,243,270,294,286,8,1414,1208
1684,8,0.2.69,1,493,0,16,69,85,69,0,85,190,-69,69,92,3,1,185,340,249,340,9,1414,1178
1684,8,1.1.147,0,555,1,97,147,244,147,0,244,244,-78,101,101,2,3,249,240,306,286,9,1414,1178
1684,8,2.1.190,0,493,0,6,190,196,190,0,196,196,-121,144,144,2,3,118,240,129,286,9,1414,1178
1684,8,3.2.21,0,493,0,69,21,90,21,0,90,190,-21,21,44,3,1,200,340,221,340,9,1414,1178
1684,8,4.1.179,0,571,2,42,179,221,179,0,221,221,-110,133,133,2,3,183,240,215,286,9,1414,1178
1684,8,5.1.90,0,493,0,95,90,185,90,0,185,190,-21,44,44,2,3,243,240,294,286,9,1414,1178
1684,9,0.3.85,1,493,0,78,85,163,85,0,163,190,-85,85,177,4,1,169,317,249,317,10,1414,1162
1684,9,1.1.147,0,555,1,97,147,244,147,0,244,244,-78,101,170,2,3,249,240,306,286,10,1414,1162
1684,9,2.1.190,0,493,0,6,190,196,190,0,196,196,-121,144,213,2,3,118,240,129,286,10,1414,1162
1684,9,3.2.85,0,493,0,69,85,154,21,64,154,190,0,69,92,3,2,200,324,221,340,10,1414,1162
1684,9,4.1.179,0,571,2,42,179,221,179,0,221,221,-110,133,202,2,3,183,240,215,286,10,1414,1162
1684,9,5.1.90,0,493,0,95,90,185,90,0,185,190,-21,44,113,2,3,243,240,294,286,10,1414,1162
1684,10,0.4.163,1,493,0,91,163,254,163,0,254,254,-163,163,340,5,1,91,281,249,281,11,1414,1084
1684,10,1.1.147,0,555,1,97,147,244,147,0,244,244,-78,101,255,2,3,249,240,306,286,11,1414,1084
1684,10,2.1.190,0,493,0,6,190,196,190,0,196,196,-121,144,298,2,3,118,240,129,286,11,1414,1084
1684,10,3.2.85,0,493,0,69,85,154,21,64,154,190,0,69,177,3,2,200,324,221,340,11,1414,1084
1684,10,4.1.179,0,571,2,42,179,221,179,0,221,221,-110,133,287,2,3,183,240,215,286,11,1414,1084
1684,10,5.1.90,0,493,0,95,90,185,90,0,185,190,-21,44,198,2,3,243,240,294,286,11,1414,1084
1684,11,1.1.147,0,555,1,97,147,244,147,0,244,254,-78,101,418,2,3,249,240,306,286,12,1414,993
1684,11,2.1.190,0,493,0,6,190,196,190,0,196,254,-121,144,461,2,3,118,240,129,286,12,1414,993
1684,11,3.2.85,1,493,0,69,85,154,21,64,154,254,0,69,340,3,2,200,324,221,340,12,1414,993
1684,11,4.1.179,0,571,2,42,179,221,179,0,221,254,-110,133,450,2,3,183,240,215,286,12,1414,993
1684,11,5.1.90,0,493,0,95,90,185,90,0,185,254,-21,44,361,2,3,243,240,294,286,12,1414,993
1684,12,1.1.147,0,555,1,97,147,244,147,0,244,254,-78,101,418,2,3,249,240,306,286,13,1414,924
1684,12,2.1.190,0,493,0,6,190,196,190,0,196,254,-121,144,461,2,3,118,240,129,286,13,1414,924
1684,12,3.3.163,1,493,0,38,163,201,154,9,201,254,0,85,340,4,2,131,239,221,317,13,1414,924
1684,12,4.1.179,0,571,2,42,179,221,179,0,221,254,-110,133,450,2,3,183,240,215,286,13,1414,924
1684,12,5.1.90,0,493,0,95,90,185,90,0,185,254,-21,44,361,2,3,243,240,294,286,13,1414,924
1684,13,1.1.147,0,555,1,97,147,244,147,0,244,254,-78,101,418,2,3,249,240,306,286,14,1414,886
1684,13,2.1.190,0,493,0,6,190,196,190,0,196,254,-121,144,461,2,3,118,240,129,286,14,1414,886
1684,13,3.4.254,1,493,0,93,254,347,201,53,347,347,0,163,340,5,2,93,190,221,281,14,1414,886
1684,13,4.1.179,0,571,2,42,179,221,179,0,221,254,-110,133,450,2,3,183,240,215,286,14,1414,886
1684,13,5.1.90,0,493,0,95,90,185,90,0,185,254,-21,44,361,2,3,243,240,294,286,14,1414,886
1684,14,1.1.147,0,555,1,97,147,244,147,0,244,347,-78,101,418,2,3,249,240,306,286,15,1414,793
1684,14,2.1.190,0,493,0,6,190,196,190,0,196,347,-121,144,461,2,3,118,240,129,286,15,1414,793
1684,14,4.1.179,0,571,2,42,179,221,179,0,221,347,-110,133,450,2,3,183,240,215,286,15,1414,793
1684,14,5.1.90,1,493,0,95,90,185,90,0,185,347,-21,44,361,2,3,243,240,294,286,15,1414,793
1684,15,1.1.185,0,540,2,97,185,282,147,38,282,347,0,44,361,2,4,249,145,306,286,16,1414,698
1684,15,2.1.190,0,493,0,6,190,196,190,0,196,347,-5,49,366,2,4,118,145,129,286,16,1414,698
1684,15,4.1.185,0,506,1,42,185,227,179,6,227,347,0,44,361,2,4,183,145,215,286,16,1414,698
1684,15,5.2.185,1,493,0,29,185,214,185,0,214,347,-31,100,392,3,3,148,255,294,340,16,1414,698
1684,16,1.1.185,0,540,2,97,185,282,147,38,282,347,0,44,392,2,4,249,145,306,286,17,1414,669
1684,16,2.1.190,0,493,0,6,190,196,190,0,196,347,-5,49,397,2,4,118,145,129,286,17,1414,669
1684,16,4.1.185,0,506,1,42,185,227,179,6,227,347,0,44,392,2,4,183,145,215,286,17,1414,669
1684,16,5.3.214,1,493,0,65,214,279,214,0,279,347,-13,98,405,4,3,119,201,294,317,17,1414,669
1684,17,1.1.185,0,540,2,97,185,282,147,38,282,347,0,44,405,2,4,249,145,306,286,18,1414,604
1684,17,2.1.190,0,493,0,6,190,196,190,0,196,347,-5,49,410,2,4,118,145,129,286,18,1414,604
1684,17,4.1.185,0,506,1,42,185,227,179,6,227,347,0,44,405,2,4,183,145,215,286,18,1414,604
1684,17,5.4.347,1,493,0,54,347,401,279,68,401,401,0,163,405,5,3,54,97,294,281,18,1414,604
1684,18,1.1.185,0,540,2,97,185,282,147,38,282,401,0,44,405,2,4,249,145,306,286,19,1414,550
1684,18,2.1.190,0,493,0,6,190,196,190,0,196,401,-5,49,410,2,4,118,145,129,286,19,1414,550
1684,18,4.1.185,1,506,1,42,185,227,179,6,227,401,0,44,405,2,4,183,145,215,286,19,1414,550
1684,19,1.1.227,0,535,1,97,227,324,147,80,324,401,0,44,405,2,5,249,103,306,286,20,1414,508
1684,19,2.1.227,1,506,0,6,227,233,190,37,233,401,0,44,405,2,5,118,103,129,286,20,1414,508
1684,19,4.2.227,0,506,0,43,227,270,227,0,270,401,-13,113,418,3,4,141,226,215,340,20,1414,508
1684,20,1.1.233,1,506,0,97,233,330,147,86,330,401,0,44,405,2,6,249,97,306,286,21,1414,502
1684,20,2.2.233,0,512,1,84,233,317,233,0,317,401,-19,119,424,3,4,112,226,129,340,21,1414,502
1684,20,4.2.227,0,506,0,43,227,270,227,0,270,401,-13,113,418,3,4,141,226,215,340,21,1414,502
1684,21,1.2.330,0,541,2,99,330,429,330,0,429,429,-116,216,521,3,4,152,226,306,340,22,1414,405
1684,21,2.2.233,0,512,1,84,233,317,233,0,317,401,-19,119,424,3,4,112,226,129,340,22,1414,405
1684,21,4.2.227,1,506,0,43,227,270,227,0,270,401,-13,113,418,3,4,141,226,215,340,22,1414,405
1684,22,1.2.330,0,541,1,99,330,429,330,0,429,429,-60,173,478,3,5,152,183,306,340,23,1414,362
1684,22,2.2.270,0,506,0,84,270,354,233,37,354,401,0,113,418,3,5,112,183,129,340,23,1414,362
1684,22,4.3.279,1,506,0,88,279,367,270,9,367,401,0,98,418,4,4,98,136,215,317,23,1414,362
1684,23,1.2.330,0,541,1,99,330,429,330,0,429,429,-60,173,478,3,5,152,183,306,340,24,1414,274
1684,23,2.2.270,0,506,0,84,270,354,233,37,354,401,0,113,418,3,5,112,183,129,340,24,1414,274
1684,23,4.4.401,1,506,0,10,401,411,367,34,411,411,0,163,418,5,4,10,43,215,281,24,1414,274
1684,24,1.2.330,0,541,1,99,330,429,330,0,429,429,-60,173,478,3,5,152,183,306,340,25,1414,264
1684,24,2.2.270,1,506,0,84,270,354,233,37,354,411,0,113,418,3,5,112,183,129,340,25,1414,264
1684,25,1.2.354,0,506,0,99,354,453,330,24,453,453,0,113,418,3,6,152,99,306,340,26,1414,180
1684,25,2.3.367,1,506,0,17,367,384,354,13,384,411,0,98,418,4,5,28,48,129,317,26,1414,180
1684,26,1.2.354,0,506,0,99,354,453,330,24,453,453,0,113,418,3,6,152,99,306,340,27,1414,163
1684,26,2.4.411,1,506,0,11,411,422,384,27,422,422,0,163,418,5,5,11,33,129,281,27,1414,163
1684,27,1.2.354,1,506,0,99,354,453,330,24,453,453,0,113,418,3,6,152,99,306,340,28,1414,152
1684,28,1.3.453,1,506,0,31,453,484,453,0,484,484,-69,167,487,4,6,53,31,306,317,29,1414,53
1684,29,1.4.484,1,506,0,22,484,506,484,0,506,506,-62,225,549,5,6,22,22,306,281,30,1414,22
1685,0,0.0.0,0,688,2,47,0,47,0,0,47,47,0,0,0,1,1,292,303,292,303,1,1779,1779
1685,0,1.0.0,0,668,0,33,0,33,0,0,33,33,0,0,0,1,1,207,303,207,303,1,1779,1779
1685,0,2.0.0,0,693,4,56,0,56,0,0,56,56,0,0,0,1,1,354,303,354,303,1,1779,1779
1685,0,3.0.0,0,687,1,58,0,58,0,0,58,58,0,0,0,1,1,279,303,279,303,1,1779,1779
1685,0,4.0.0,1,690,3,53,0,53,0,0,53,53,0,0,0,1,1,351,303,351,303,1,1779,1779
1685,0,5.0.0,0,701,5,56,0,56,0,0,56,56,0,0,0,1,1,296,303,296,303,1,1779,1779
1685,1,0.0.53,0,694,1,47,53,100,0,53,100,100,0,0,0,1,2,292,250,292,303,2,1779,1726
1685,1,1.0.53,0,690,0,33,53,86,0,53,86,86,0,0,0,1,2,207,250,207,303,2,1779,1726
1685,1,2.0.53,1,702,2,56,53,109,0,53,109,109,0,0,0,1,2,354,250,354,303,2,1779,1726
1685,1,3.0.53,0,690,0,58,53,111,0,53,111,111,0,0,0,1,2,279,250,279,303,2,1779,1726
1685,1,4.1.53,0,690,0,93,53,146,53,0,146,146,-53,53,53,2,1,298,486,351,486,2,1779,1726
1685,1,5.0.53,0,703,3,56,53,109,0,53,109,109,0,0,0,1,2,296,250,296,303,2,1779,1726
1685,2,0.0.109,1,702,0,47,109,156,0,109,156,156,0,0,0,1,3,292,194,292,303,3,1779,1670
1685,2,1.0.109,0,702,0,33,109,142,0,109,142,142,0,0,0,1,3,207,194,207,303,3,1779,1670
1685,2,2.1.109,0,746,1,99,109,208,109,0,208,208,-109,109,109,2,1,298,486,354,486,3,1779,1670
1685,2,3.0.109,0,702,0,58,109,167,0,109,167,167,0,0,0,1,3,279,194,279,303,3,1779,1670
1685,2,4.1.53,0,702,0,93,53,146,53,0,146,146,-53,53,53,2,1,298,486,351,486,3,1779,1670
1685,2,5.0.109,0,702,0,56,109,165,0,109,165,165,0,0,0,1,3,296,194,296,303,3,1779,1670
1685,3,0.1.156,0,704,1,97,156,253,156,0,253,253,-156,156,156,2,1,245,486,292,486,4,1779,1623
1685,3,1.0.156,0,702,0,33,156,189,0,156,189,189,0,0,0,1,4,207,147,207,303,4,1779,1623
1685,3,2.1.109,0,746,2,99,109,208,109,0,208,208,-109,109,109,2,1,298,486,354,486,4,1779,1623
1685,3,3.0.156,0,702,0,58,156,214,0,156,214,214,0,0,0,1,4,279,147,279,303,4,1779,1623
1685,3,4.1.53,0,702,0,93,53,146,53,0,146,156,-53,53,53,2,1,298,486,351,486,4,1779,1623
1685,3,5.0.156,1,702,0,56,156,212,0,156,212,212,0,0,0,1,4,296,147,296,303,4,1779,1623
1685,4,0.1.156,0,721,1,97,156,253,156,0,253,253,-156,156,156,2,1,245,486,292,486,5,1779,1567
1685,4,1.0.212,1,702,0,33,212,245,0,212,245,245,0,0,0,1,5,207,91,207,303,5,1779,1567
1685,4,2.1.109,0,750,2,99,109,208,109,0,208,212,-109,109,109,2,1,298,486,354,486,5,1779,1567
1685,4,3.0.212,0,702,0,58,212,270,0,212,270,270,0,0,0,1,5,279,91,279,303,5,1779,1567
1685,4,4.1.53,0,702,0,93,53,146,53,0,146,212,-53,53,53,2,1,298,486,351,486,5,1779,1567
1685,4,5.1.212,0,772,3,78,212,290,212,0,290,290,-212,212,212,2,1,240,486,296,486,5,1779,1567
1685,5,0.1.156,0,724,2,97,156,253,156,0,253,253,-156,156,156,2,1,245,486,292,486,6,1779,1534
1685,5,1.1.245,0,715,1,65,245,310,245,0,310,310,-245,245,245,2,1,174,486,207,486,6,1779,1534
1685,5,2.1.109,0,750,3,99,109,208,109,0,208,245,-109,109,109,2,1,298,486,354,486,6,1779,1534
1685,5,3.0.245,1,702,0,58,245,303,0,245,303,303,0,0,0,1,6,279,58,279,303,6,1779,1534
1685,5,4.1.53,0,702,0,93,53,146,53,0,146,245,-53,53,53,2,1,298,486,351,486,6,1779,1534
1685,5,5.1.212,0,772,4,78,212,290,212,0,290,290,-212,212,212,2,1,240,486,296,486,6,1779,1534
1685,6,0.1.156,0,724,2,97,156,253,156,0,253,303,-156,156,156,2,1,245,486,292,486,7,1779,1476
1685,6,1.1.245,0,715,1,65,245,310,245,0,310,310,-245,245,245,2,1,174,486,207,486,7,1779,1476
1685,6,2.1.109,0,750,4,99,109,208,109,0,208,303,-109,109,109,2,1,298,486,354,486,7,1779,1476
1685,6,3.1.303,0,740,3,54,303,357,303,0,357,357,-303,303,303,2,1,221,486,279,486,7,1779,1476
1685,6,4.1.53,1,702,0,93,53,146,53,0,146,303,-53,53,53,2,1,298,486,351,486,7,1779,1476
1685,6,5.1.212,0,772,5,78,212,290,212,0,290,303,-212,212,212,2,1,240,486,296,486,7,1779,1476
1685,7,0.1.156,0,724,2,97,156,253,156,0,253,303,-10,63,63,2,2,245,393,292,486,8,1779,1383
1685,7,1.1.245,0,715,1,65,245,310,245,0,310,310,-99,152,152,2,2,174,393,207,486,8,1779,1383
1685,7,2.1.146,0,702,0,99,146,245,109,37,245,303,0,53,53,2,2,298,393,354,486,8,1779,1383
1685,7,3.1.303,0,740,3,54,303,357,303,0,357,357,-157,210,210,2,2,221,393,279,486,8,1779,1383
1685,7,4.2.146,1,702,0,44,146,190,146,0,190,303,-146,146,199,3,1,205,210,351,210,8,1779,1383
1685,7,5.1.212,0,776,4,78,212,290,212,0,290,303,-66,119,119,2,2,240,393,296,486,8,1779,1383
1685,8,0.1.156,0,724,2,97,156,253,156,0,253,303,-10,63,209,2,2,245,393,292,486,9,1779,1339
1685,8,1.1.245,0,715,1,65,245,310,245,0,310,310,-99,152,298,2,2,174,393,207,486,9,1779,1339
1685,8,2.1.146,0,702,0,99,146,245,109,37,245,303,0,53,199,2,2,298,393,354,486,9,1779,1339
1685,8,3.1.303,0,740,3,54,303,357,303,0,357,357,-157,210,356,2,2,221,393,279,486,9,1779,1339
1685,8,4.3.190,1,702,0,81,190,271,190,0,271,303,-190,190,389,4,1,161,469,351,469,9,1779,1339
1685,8,5.1.212,0,776,4,78,212,290,212,0,290,303,-66,119,265,2,2,240,393,296,486,9,1779,1339
1685,9,0.1.156,0,724,2,97,156,253,156,0,253,303,-10,63,399,2,2,245,393,292,486,10,1779,1258
1685,9,1.1.245,0,715,1,65,245,310,245,0,310,310,-99,152,488,2,2,174,393,207,486,10,1779,1258
1685,9,2.1.146,0,702,0,99,146,245,109,37,245,303,0,53,389,2,2,298,393,354,486,10,1779,1258
1685,9,3.1.303,0,740,3,54,303,357,303,0,357,357,-157,210,546,2,2,221,393,279,486,10,1779,1258
1685,9,4.4.271,1,702,0,80,271,351,271,0,351,351,-271,271,660,5,1,80,311,351,311,10,1779,1258
1685,9,5.1.212,0,776,4,78,212,290,212,0,290,303,-66,119,455,2,2,240,393,296,486,10,1779,1258
1685,10,0.1.156,0,724,2,97,156,253,156,0,253,351,-10,63,670,2,2,245,393,292,486,11,1779,1178
1685,10,1.1.245,0,715,1,65,245,310,245,0,310,351,-99,152,759,2,2,174,393,207,486,11,1779,1178
1685,10,2.1.146,1,702,0,99,146,245,109,37,245,351,0,53,660,2,2,298,393,354,486,11,1779,1178
1685,10,3.1.303,0,740,3,54,303,357,303,0,357,357,-157,210,817,2,2,221,393,279,486,11,1779,1178
1685,10,5.1.212,0,776,4,78,212,290,212,0,290,351,-66,119,726,2,2,240,393,296,486,11,1779,1178
1685,11,0.1.245,0,702,0,97,245,342,156,89,342,351,0,53,660,2,3,245,294,292,486,12,1779,1079
1685,11,1.1.245,0,715,1,65,245,310,245,0,310,351,0,53,660,2,3,174,294,207,486,12,1779,1079
1685,11,2.2.245,1,702,0,38,245,283,245,0,283,351,-55,201,715,3,2,199,166,354,210,12,1779,1079
1685,11,3.1.303,0,740,3,54,303,357,303,0,357,357,-58,111,718,2,3,221,294,279,486,12,1779,1079
1685,11,5.1.245,0,724,2,78,245,323,212,33,323,351,0,53,660,2,3,240,294,296,486,12,1779,1079
1685,12,0.1.245,0,702,0,97,245,342,156,89,342,351,0,53,715,2,3,245,294,292,486,13,1779,1041
1685,12,1.1.245,0,715,1,65,245,310,245,0,310,351,0,53,715,2,3,174,294,207,486,13,1779,1041
1685,12,2.3.283,1,702,0,85,283,368,283,0,368,368,-12,202,727,4,2,161,388,354,469,13,1779,1041
1685,12,3.1.303,0,740,3,54,303,357,303,0,357,357,-58,111,773,2,3,221,294,279,486,13,1779,1041
1685,12,5.1.245,0,724,2,78,245,323,212,33,323,351,0,53,715,2,3,240,294,296,486,13,1779,1041
1685,13,0.1.245,0,702,0,97,245,342,156,89,342,368,0,53,727,2,3,245,294,292,486,14,1779,956
1685,13,1.1.245,0,715,1,65,245,310,245,0,310,368,0,53,727,2,3,174,294,207,486,14,1779,956
1685,13,2.4.368,1,702,0,76,368,444,368,0,444,444,-17,288,744,5,2,76,231,354,311,14,1779,956
1685,13,3.1.303,0,740,3,54,303,357,303,0,357,368,-58,111,785,2,3,221,294,279,486,14,1779,956
1685,13,5.1.245,0,724,2,78,245,323,212,33,323,368,0,53,727,2,3,240,294,296,486,14,1779,956
1685,14,0.1.245,1,702,0,97,245,342,156,89,342,444,0,53,744,2,3,245,294,292,486,15,1779,880
1685,14,1.1.245,0,715,1,65,245,310,245,0,310,444,0,53,744,2,3,174,294,207,486,15,1779,880
1685,14,3.1.303,0,740,3,54,303,357,303,0,357,444,-58,111,802,2,3,221,294,279,486,15,1779,880
1685,14,5.1.245,0,724,2,78,245,323,212,33,323,444,0,53,744,2,3,240,294,296,486,15,1779,880
1685,15,0.2.342,1,702,0,19,342,361,342,0,361,444,-59,260,803,3,3,148,128,292,210,16,1779,783
1685,15,1.1.342,0,716,1,65,342,407,245,97,407,444,0,53,744,2,4,174,197,207,486,16,1779,783
1685,15,3.1.342,0,702,0,54,342,396,303,39,396,444,0,53,744,2,4,221,197,279,486,16,1779,783
1685,15,5.1.342,0,736,2,78,342,420,212,130,420,444,0,53,744,2,4,240,197,296,486,16,1779,783
1685,16,0.3.368,0,702,0,85,368,453,361,7,453,453,0,202,803,4,3,129,303,292,469,17,1779,764
1685,16,1.1.342,0,716,1,65,342,407,245,97,407,444,0,53,803,2,4,174,197,207,486,17,1779,764
1685,16,3.1.342,0,702,0,54,342,396,303,39,396,444,0,53,803,2,4,221,197,279,486,17,1779,764
1685,16,5.1.342,1,736,2,78,342,420,212,130,420,444,0,53,803,2,4,240,197,296,486,17,1779,764
1685,17,0.3.368,0,736,0,85,368,453,361,7,453,453,0,202,803,4,3,129,303,292,469,18,1779,686
1685,17,1.1.420,0,740,1,65,420,485,245,175,485,485,0,53,803,2,5,174,119,207,486,18,1779,686
1685,17,3.1.420,0,736,0,54,420,474,303,117,474,474,0,53,803,2,5,221,119,279,486,18,1779,686
1685,17,5.2.420,1,736,0,67,420,487,420,0,487,487,-59,319,862,3,4,162,109,296,210,18,1779,686
1685,18,0.3.368,0,736,0,85,368,453,361,7,453,487,0,202,862,4,3,129,303,292,469,19,1779,619
1685,18,1.1.420,0,740,1,65,420,485,245,175,485,487,0,53,862,2,5,174,119,207,486,19,1779,619
1685,18,3.1.420,1,736,0,54,420,474,303,117,474,487,0,53,862,2,5,221,119,279,486,19,1779,619
1685,18,5.3.487,0,736,0,50,487,537,487,0,537,537,-119,321,981,4,3,95,303,296,469,19,1779,619
1685,19,0.3.368,0,736,0,85,368,453,361,7,453,487,0,202,862,4,3,129,303,292,469,20,1779,565
1685,19,1.1.474,0,736,0,65,474,539,245,229,539,539,0,53,862,2,6,174,65,207,486,20,1779,565
1685,19,3.2.487,1,736,0,36,487,523,474,13,523,523,0,319,862,3,5,167,42,279,210,20,1779,565
1685,19,5.3.487,0,736,0,50,487,537,487,0,537,537,-119,321,981,4,3,95,303,296,469,20,1779,565
1685,20,0.3.368,0,736,0,85,368,453,361,7,453,523,0,202,862,4,3,129,303,292,469,21,1779,529
1685,20,1.1.474,1,736,0,65,474,539,245,229,539,539,0,53,862,2,6,174,65,207,486,21,1779,529
1685,20,3.3.523,0,772,1,96,523,619,523,0,619,619,-155,357,1017,4,3,131,303,279,469,21,1779,529
1685,20,5.3.487,0,736,0,50,487,537,487,0,537,537,-119,321,981,4,3,95,303,296,469,21,1779,529
1685,21,0.3.368,0,736,0,85,368,453,361,7,453,539,0,202,862,4,3,129,303,292,469,22,1779,464
1685,21,1.2.539,1,736,0,6,539,545,539,0,545,545,-16,335,878,3,6,109,6,207,210,22,1779,464
1685,21,3.3.523,0,772,1,96,523,619,523,0,619,619,-155,357,1017,4,3,131,303,279,469,22,1779,464
1685,21,5.3.487,0,736,0,50,487,537,487,0,537,539,-119,321,981,4,3,95,303,296,469,22,1779,464
1685,22,0.3.368,1,736,0,85,368,453,361,7,453,545,0,202,878,4,3,129,303,292,469,23,1779,458
1685,22,1.3.545,0,748,1,72,545,617,545,0,617,617,-177,379,1055,4,3,103,303,207,469,23,1779,458
1685,22,3.3.523,0,772,2,96,523,619,523,0,619,619,-155,357,1033,4,3,131,303,279,469,23,1779,458
1685,22,5.3.487,0,736,0,50,487,537,487,0,537,545,-119,321,997,4,3,95,303,296,469,23,1779,458
1685,23,0.4.453,1,736,0,44,453,497,453,0,497,545,-9,297,887,5,3,44,155,292,311,24,1779,373
1685,23,1.3.545,0,748,1,72,545,617,545,0,617,617,-92,294,970,4,4,103,218,207,469,24,1779,373
1685,23,3.3.523,0,772,2,96,523,619,523,0,619,619,-70,272,948,4,4,131,218,279,469,24,1779,373
1685,23,5.3.487,0,736,0,50,487,537,487,0,537,545,-34,236,912,4,4,95,218,296,469,24,1779,373
1685,24,1.3.545,0,748,1,72,545,617,545,0,617,617,-92,294,979,4,4,103,218,207,469,25,1779,329
1685,24,3.3.523,0,772,2,96,523,619,523,0,619,619,-70,272,957,4,4,131,218,279,469,25,1779,329
1685,24,5.3.487,1,736,0,50,487,537,487,0,537,545,-34,236,921,4,4,95,218,296,469,25,1779,329
1685,25,1.3.545,0,748,1,72,545,617,545,0,617,617,-8,244,929,4,5,103,168,207,469,26,1779,279
1685,25,3.3.537,0,736,0,96,537,633,523,14,633,633,0,236,921,4,5,131,168,279,469,26,1779,279
1685,25,5.4.537,1,736,0,45,537,582,537,0,582,582,-40,337,961,5,4,45,111,296,311,26,1779,279
1685,26,1.3.545,0,748,1,72,545,617,545,0,617,617,-8,244,969,4,5,103,168,207,469,27,1779,234
1685,26,3.3.537,1,736,0,96,537,633,523,14,633,633,0,236,961,4,5,131,168,279,469,27,1779,234
1685,27,1.3.633,0,736,0,72,633,705,545,88,705,705,0,236,961,4,6,103,72,207,469,28,1779,138
1685,27,3.4.633,1,736,0,35,633,668,633,0,668,668,-51,388,1012,5,5,35,66,279,311,28,1779,138
1685,28,1.3.633,1,736,0,72,633,705,545,88,705,705,0,236,1012,4,6,103,72,207,469,29,1779,103
1685,29,1.4.705,1,736,0,31,705,736,705,0,736,736,-37,425,1049,5,6,31,31,207,311,30,1779,31
1686,0,0.0.0,0,601,3,60,0,60,0,0,60,60,0,0,0,1,1,335,218,335,218,1,1451,1451
1686,0,1.0.0,0,558,2,8,0,8,0,0,8,8,0,0,0,1,1,107,218,107,218,1,1451,1451
1686,0,2.0.0,1,556,1,3,0,3,0,0,3,3,0,0,0,1,1,281,218,281,218,1,1451,1451
1686,0,3.0.0,0,553,0,11,0,11,0,0,11,11,0,0,0,1,1,238,218,238,218,1,1451,1451
1686,0,4.0.0,0,616,5,75,0,75,0,0,75,75,0,0,0,1,1,290,218,290,218,1,1451,1451
1686,0,5.0.0,0,614,4,61,0,61,0,0,61,61,0,0,0,1,1,200,218,200,218,1,1451,1451
1686,1,0.0.3,0,582,2,60,3,63,0,3,63,63,0,0,0,1,2,335,215,335,218,2,1451,1448
1686,1,1.0.3,0,561,1,8,3,11,0,3,11,11,0,0,0,1,2,107,215,107,218,2,1451,1448
1686,1,2.1.3,0,582,2,92,3,95,3,0,95,95,-3,3,3,2,1,278,390,281,390,2,1451,1448
1686,1,3.0.3,1,556,0,11,3,14,0,3,14,14,0,0,0,1,2,238,215,238,218,2,1451,1448
1686,1,4.0.3,0,582,2,75,3,78,0,3,78,78,0,0,0,1,2,290,215,290,218,2,1451,1448
1686,1,5.0.3,0,582,2,61,3,64,0,3,64,64,0,0,0,1,2,200,215,200,218,2,1451,1448
1686,2,0.0.14,1,556,0,60,14,74,0,14,74,74,0,0,0,1,3,335,204,335,218,3,1451,1437
1686,2,1.0.14,0,556,0,8,14,22,0,14,22,22,0,0,0,1,3,107,204,107,218,3,1451,1437
1686,2,2.1.3,0,582,3,92,3,95,3,0,95,95,-3,3,3,2,1,278,390,281,390,3,1451,1437
1686,2,3.1.14,0,556,0,92,14,106,14,0,106,106,-14,14,14,2,1,227,390,238,390,3,1451,1437
1686,2,4.0.14,0,564,1,75,14,89,0,14,89,89,0,0,0,1,3,290,204,290,218,3,1451,1437
1686,2,5.0.14,0,578,2,61,14,75,0,14,75,75,0,0,0,1,3,200,204,200,218,3,1451,1437
1686,3,0.1.74,0,615,3,65,74,139,74,0,139,139,-74,74,74,2,1,275,390,335,390,4,1451,1377
1686,3,1.0.74,1,556,0,8,74,82,0,74,82,82,0,0,0,1,4,107,144,107,218,4,1451,1377
1686,3,2.1.3,0,582,2,92,3,95,3,0,95,95,-3,3,3,2,1,278,390,281,390,4,1451,1377
1686,3,3.1.14,0,556,0,92,14,106,14,0,106,106,-14,14,14,2,1,227,390,238,390,4,1451,1377
1686,3,4.0.74,0,556,0,75,74,149,0,74,149,149,0,0,0,1,4,290,144,290,218,4,1451,1377
1686,3,5.0.74,0,578,1,61,74,135,0,74,135,135,0,0,0,1,4,200,144,200,218,4,1451,1377
1686,4,0.1.74,0,615,3,65,74,139,74,0,139,139,-74,74,74,2,1,275,390,335,390,5,1451,1369
1686,4,1.1.82,0,623,4,33,82,115,82,0,115,115,-82,82,82,2,1,99,390,107,390,5,1451,1369
1686,4,2.1.3,0,582,2,92,3,95,3,0,95,95,-3,3,3,2,1,278,390,281,390,5,1451,1369
1686,4,3.1.14,0,556,0,92,14,106,14,0,106,106,-14,14,14,2,1,227,390,238,390,5,1451,1369
1686,4,4.0.82,1,556,0,75,82,157,0,82,157,157,0,0,0,1,5,290,136,290,218,5,1451,1369
1686,4,5.0.82,0,578,1,61,82,143,0,82,143,143,0,0,0,1,5,200,136,200,218,5,1451,1369
1686,5,0.1.74,0,615,3,65,74,139,74,0,139,157,-74,74,74,2,1,275,390,335,390,6,1451,1294
1686,5,1.1.82,0,623,4,33,82,115,82,0,115,157,-82,82,82,2,1,99,390,107,390,6,1451,1294
1686,5,2.1.3,0,582,1,92,3,95,3,0,95,157,-3,3,3,2,1,278,390,281,390,6,1451,1294
1686,5,3.1.14,0,556,0,92,14,106,14,0,106,157,-14,14,14,2,1,227,390,238,390,6,1451,1294
1686,5,4.1.157,0,587,2,46,157,203,157,0,203,203,-157,157,157,2,1,215,390,290,390,6,1451,1294
1686,5,5.0.157,1,556,0,61,157,218,0,157,218,218,0,0,0,1,6,200,61,200,218,6,1451,1294
1686,6,0.1.74,0,615,4,65,74,139,74,0,139,218,-74,74,74,2,1,275,390,335,390,7,1451,1233
1686,6,1.1.82,0,623,5,33,82,115,82,0,115,218,-82,82,82,2,1,99,390,107,390,7,1451,1233
1686,6,2.1.3,1,582,1,92,3,95,3,0,95,218,-3,3,3,2,1,278,390,281,390,7,1451,1233
1686,6,3.1.14,0,556,0,92,14,106,14,0,106,218,-14,14,14,2,1,227,390,238,390,7,1451,1233
1686,6,4.1.157,0,587,3,46,157,203,157,0,203,218,-157,157,157,2,1,215,390,290,390,7,1451,1233
1686,6,5.1.218,0,584,2,62,218,280,218,0,280,280,-218,218,218,2,1,139,390,200,390,7,1451,1233
1686,7,0.1.95,0,603,1,65,95,160,74,21,160,218,0,3,3,2,2,275,298,335,390,8,1451,1141
1686,7,1.1.95,0,582,0,33,95,128,82,13,128,218,0,3,3,2,2,99,298,107,390,8,1451,1141
1686,7,2.2.95,1,582,0,90,95,185,95,0,185,218,-95,95,98,3,1,186,179,281,179,8,1451,1141
1686,7,3.1.95,0,582,0,92,95,187,14,81,187,218,0,3,3,2,2,227,298,238,390,8,1451,1141
1686,7,4.1.157,0,606,2,46,157,203,157,0,203,218,-62,65,65,2,2,215,298,290,390,8,1451,1141
1686,7,5.1.218,0,603,1,62,218,280,218,0,280,280,-123,126,126,2,2,139,298,200,390,8,1451,1141
1686,8,0.1.95,0,603,1,65,95,160,74,21,160,218,0,3,98,2,2,275,298,335,390,9,1451,1051
1686,8,1.1.95,0,582,0,33,95,128,82,13,128,218,0,3,98,2,2,99,298,107,390,9,1451,1051
1686,8,2.3.185,1,582,0,54,185,239,185,0,239,239,-185,185,283,4,1,96,324,281,324,9,1451,1051
1686,8,3.1.95,0,582,0,92,95,187,14,81,187,218,0,3,98,2,2,227,298,238,390,9,1451,1051
1686,8,4.1.157,0,606,2,46,157,203,157,0,203,218,-62,65,160,2,2,215,298,290,390,9,1451,1051
1686,8,5.1.218,0,603,1,62,218,280,218,0,280,280,-123,126,221,2,2,139,298,200,390,9,1451,1051
1686,9,0.1.95,0,603,1,65,95,160,74,21,160,239,0,3,283,2,2,275,298,335,390,10,1451,997
1686,9,1.1.95,0,582,0,33,95,128,82,13,128,239,0,3,283,2,2,99,298,107,390,10,1451,997
1686,9,2.4.239,1,582,0,42,239,281,239,0,281,281,-239,239,522,5,1,42,340,281,340,10,1451,997
1686,9,3.1.95,0,582,0,92,95,187,14,81,187,239,0,3,283,2,2,227,298,238,390,10,1451,997
1686,9,4.1.157,0,606,2,46,157,203,157,0,203,239,-62,65,345,2,2,215,298,290,390,10,1451,997
1686,9,5.1.218,0,603,1,62,218,280,218,0,280,280,-123,126,406,2,2,139,298,200,390,10,1451,997
1686,10,0.1.95,1,603,1,65,95,160,74,21,160,281,0,3,522,2,2,275,298,335,390,11,1451,955
1686,10,1.1.95,0,582,0,33,95,128,82,13,128,281,0,3,522,2,2,99,298,107,390,11,1451,955
1686,10,3.1.95,0,582,0,92,95,187,14,81,187,281,0,3,522,2,2,227,298,238,390,11,1451,955
1686,10,4.1.157,0,606,2,46,157,203,157,0,203,281,-62,65,584,2,2,215,298,290,390,11,1451,955
1686,10,5.1.218,0,603,1,62,218,280,218,0,280,281,-123,126,645,2,2,139,298,200,390,11,1451,955
1686,11,0.2.185,1,603,0,23,185,208,160,25,208,281,0,95,522,3,2,210,89,335,179,12,1451,890
1686,11,1.1.160,0,603,0,33,160,193,82,78,193,281,0,3,522,2,3,99,233,107,390,12,1451,890
1686,11,3.1.160,0,609,1,92,160,252,14,146,252,281,0,3,522,2,3,227,233,238,390,12,1451,890
1686,11,4.1.160,0,614,2,46,160,206,157,3,206,281,0,3,522,2,3,215,233,290,390,12,1451,890
1686,11,5.1.218,0,603,0,62,218,280,218,0,280,281,-58,61,580,2,3,139,233,200,390,12,1451,890
1686,12,0.3.239,1,628,3,91,239,330,208,31,330,330,0,185,522,4,2,187,270,335,324,13,1451,867
1686,12,1.1.160,0,603,0,33,160,193,82,78,193,281,0,3,522,2,3,99,233,107,390,13,1451,867
1686,12,3.1.160,0,609,1,92,160,252,14,146,252,281,0,3,522,2,3,227,233,238,390,13,1451,867
1686,12,4.1.160,0,614,2,46,160,206,157,3,206,281,0,3,522,2,3,215,233,290,390,13,1451,867
1686,12,5.1.218,0,603,0,62,218,280,218,0,280,281,-58,61,580,2,3,139,233,200,390,13,1451,867
1686,13,0.4.330,0,628,0,96,330,426,330,0,426,426,-49,288,571,5,2,96,298,335,340,14,1451,776
1686,13,1.1.160,0,628,0,33,160,193,82,78,193,330,0,3,522,2,3,99,233,107,390,14,1451,776
1686,13,3.1.160,1,628,0,92,160,252,14,146,252,330,0,3,522,2,3,227,233,238,390,14,1451,776
1686,13,4.1.160,0,628,0,46,160,206,157,3,206,330,0,3,522,2,3,215,233,290,390,14,1451,776
1686,13,5.1.218,0,628,0,62,218,280,218,0,280,330,-58,61,580,2,3,139,233,200,390,14,1451,776
1686,14,0.4.330,0,628,0,96,330,426,330,0,426,426,-49,288,571,5,2,96,298,335,340,15,1451,684
1686,14,1.1.252,0,628,0,33,252,285,82,170,285,330,0,3,522,2,4,99,141,107,390,15,1451,684
1686,14,3.2.252,1,628,0,4,252,256,252,0,256,330,-44,139,566,3,3,135,66,238,179,15,1451,684
1686,14,4.1.252,0,628,0,46,252,298,157,95,298,330,0,3,522,2,4,215,141,290,390,15,1451,684
1686,14,5.1.252,0,628,0,62,252,314,218,34,314,330,0,3,522,2,4,139,141,200,390,15,1451,684
1686,15,0.4.330,0,628,0,96,330,426,330,0,426,426,-49,288,615,5,2,96,298,335,340,16,1451,680
1686,15,1.1.252,0,628,0,33,252,285,82,170,285,330,0,3,566,2,4,99,141,107,390,16,1451,680
1686,15,3.3.330,1,628,0,55,330,385,256,74,385,385,0,185,566,4,3,131,179,238,324,16,1451,680
1686,15,4.1.252,0,628,0,46,252,298,157,95,298,330,0,3,566,2,4,215,141,290,390,16,1451,680
1686,15,5.1.252,0,628,0,62,252,314,218,34,314,330,0,3,566,2,4,139,141,200,390,16,1451,680
1686,16,0.4.330,0,628,0,96,330,426,330,0,426,426,-49,288,615,5,2,96,298,335,340,17,1451,625
1686,16,1.1.252,0,628,0,33,252,285,82,170,285,385,0,3,566,2,4,99,141,107,390,17,1451,625
1686,16,3.4.385,0,683,1,76,385,461,385,0,461,461,-104,343,670,5,2,76,298,238,340,17,1451,625
1686,16,4.1.252,1,628,0,46,252,298,157,95,298,385,0,3,566,2,4,215,141,290,390,17,1451,625
1686,16,5.1.252,0,628,0,62,252,314,218,34,314,385,0,3,566,2,4,139,141,200,390,17,1451,625
1686,17,0.4.330,0,628,0,96,330,426,330,0,426,426,-49,288,615,5,2,96,298,335,340,18,1451,579
1686,17,1.1.298,0,628,0,33,298,331,82,216,331,385,0,3,566,2,5,99,95,107,390,18,1451,579
1686,17,3.4.385,0,683,1,76,385,461,385,0,461,461,-104,343,670,5,2,76,298,238,340,18,1451,579
1686,17,4.2.298,1,628,0,45,298,343,298,0,343,385,-42,181,608,3,4,169,62,290,179,18,1451,579
1686,17,5.1.298,0,628,0,62,298,360,218,80,360,385,0,3,566,2,5,139,95,200,390,18,1451,579
1686,18,0.4.330,0,628,0,96,330,426,330,0,426,426,-49,288,657,5,2,96,298,335,340,19,1451,534
1686,18,1.1.298,1,628,0,33,298,331,82,216,331,385,0,3,608,2,5,99,95,107,390,19,1451,534
1686,18,3.4.385,0,683,1,76,385,461,385,0,461,461,-104,343,712,5,2,76,298,238,340,19,1451,534
1686,18,4.3.385,0,628,0,74,385,459,343,42,459,459,0,185,608,4,4,124,124,290,324,19,1451,534
1686,18,5.1.298,0,628,0,62,298,360,218,80,360,385,0,3,608,2,5,139,95,200,390,19,1451,534
1686,19,0.4.330,0,628,0,96,330,426,330,0,426,426,-49,288,657,5,2,96,298,335,340,20,1451,501
1686,19,1.2.343,1,628,0,11,343,354,331,12,354,385,0,181,608,3,5,66,17,107,179,20,1451,501
1686,19,3.4.385,0,683,1,76,385,461,385,0,461,461,-104,343,712,5,2,76,298,238,340,20,1451,501
1686,19,4.3.385,0,628,0,74,385,459,343,42,459,459,0,185,608,4,4,124,124,290,324,20,1451,501
1686,19,5.1.331,0,628,0,62,331,393,218,113,393,393,0,3,608,2,6,139,62,200,390,20,1451,501
1686,20,0.4.330,0,628,0,96,330,426,330,0,426,426,-49,288,657,5,2,96,298,335,340,21,1451,490
1686,20,1.3.385,1,628,0,15,385,400,354,31,400,400,0,185,608,4,4,55,124,107,324,21,1451,490
1686,20,3.4.385,0,683,1,76,385,461,385,0,461,461,-104,343,712,5,2,76,298,238,340,21,1451,490
1686,20,4.3.385,0,628,0,74,385,459,343,42,459,459,0,185,608,4,4,124,124,290,324,21,1451,490
1686,20,5.1.331,0,628,0,62,331,393,218,113,393,393,0,3,608,2,6,139,62,200,390,21,1451,490
1686,21,0.4.330,0,628,0,96,330,426,330,0,426,426,-49,288,657,5,2,96,298,335,340,22,1451,475
1686,21,1.4.400,0,698,2,40,400,440,400,0,440,440,-119,358,727,5,2,40,298,107,340,22,1451,475
1686,21,3.4.385,0,683,1,76,385,461,385,0,461,461,-104,343,712,5,2,76,298,238,340,22,1451,475
1686,21,4.3.400,1,628,0,74,400,474,343,57,474,474,0,185,608,4,5,124,109,290,324,22,1451,475
1686,21,5.1.331,0,628,0,62,331,393,218,113,393,400,0,3,608,2,6,139,62,200,390,22,1451,475
1686,22,0.4.330,0,628,0,96,330,426,330,0,426,474,-49,288,657,5,2,96,298,335,340,23,1451,401
1686,22,1.4.400,0,698,3,40,400,440,400,0,440,474,-119,358,727,5,2,40,298,107,340,23,1451,401
1686,22,3.4.385,0,683,2,76,385,461,385,0,461,474,-104,343,712,5,2,76,298,238,340,23,1451,401
1686,22,4.4.474,0,636,1,50,474,524,474,0,524,524,-193,432,801,5,2,50,298,290,340,23,1451,401
1686,22,5.1.331,1,628,0,62,331,393,218,113,393,474,0,3,608,2,6,139,62,200,390,23,1451,401
1686,23,0.4.330,0,628,0,96,330,426,330,0,426,474,-49,288,657,5,2,96,298,335,340,24,1451,339
1686,23,1.4.400,0,698,3,40,400,440,400,0,440,474,-119,358,727,5,2,40,298,107,340,24,1451,339
1686,23,3.4.385,0,683,2,76,385,461,385,0,461,474,-104,343,712,5,2,76,298,238,340,24,1451,339
1686,23,4.4.474,0,636,1,50,474,524,474,0,524,524,-193,432,801,5,2,50,298,290,340,24,1451,339
1686,23,5.2.393,1,628,0,6,393,399,393,0,399,474,-39,220,647,3,6,77,6,200,179,24,1451,339
1686,24,0.4.330,0,628,0,96,330,426,330,0,426,474,-49,288,696,5,2,96,298,335,340,25,1451,333
1686,24,1.4.400,0,698,3,40,400,440,400,0,440,474,-119,358,766,5,2,40,298,107,340,25,1451,333
1686,24,3.4.385,0,683,2,76,385,461,385,0,461,474,-104,343,751,5,2,76,298,238,340,25,1451,333
1686,24,4.4.474,0,636,1,50,474,524,474,0,524,524,-193,432,840,5,2,50,298,290,340,25,1451,333
1686,24,5.3.474,1,628,0,35,474,509,399,75,509,509,0,185,647,4,6,71,35,200,324,25,1451,333
1686,25,0.4.330,1,628,0,96,330,426,330,0,426,509,-49,288,696,5,2,96,298,335,340,26,1451,298
1686,25,1.4.400,0,698,4,40,400,440,400,0,440,509,-119,358,766,5,2,40,298,107,340,26,1451,298
1686,25,3.4.385,0,683,3,76,385,461,385,0,461,509,-104,343,751,5,2,76,298,238,340,26,1451,298
1686,25,4.4.474,0,636,2,50,474,524,474,0,524,524,-193,432,840,5,2,50,298,290,340,26,1451,298
1686,25,5.4.509,0,635,1,36,509,545,509,0,545,545,-228,467,875,5,2,36,298,200,340,26,1451,298
1686,26,1.4.426,0,628,0,40,426,466,400,26,466,509,0,288,696,5,3,40,202,107,340,27,1451,202
1686,26,3.4.426,1,628,0,76,426,502,385,41,502,509,0,288,696,5,3,76,202,238,340,27,1451,202
1686,26,4.4.474,0,636,2,50,474,524,474,0,524,524,-48,336,744,5,3,50,202,290,340,27,1451,202
1686,26,5.4.509,0,635,1,36,509,545,509,0,545,545,-83,371,779,5,3,36,202,200,340,27,1451,202
1686,27,1.4.502,0,628,0,40,502,542,400,102,542,542,0,288,696,5,4,40,126,107,340,28,1451,126
1686,27,4.4.502,1,628,0,50,502,552,474,28,552,552,0,288,696,5,4,50,126,290,340,28,1451,126
1686,27,5.4.509,0,635,1,36,509,545,509,0,545,545,-7,295,703,5,4,36,126,200,340,28,1451,126
1686,28,1.4.552,1,628,0,40,552,592,400,152,592,592,0,288,696,5,5,40,76,107,340,29,1451,76
1686,28,5.4.552,0,628,0,36,552,588,509,43,588,588,0,288,696,5,5,36,76,200,340,29,1451,76
1686,29,5.4.592,1,628,0,36,592,628,509,83,628,628,0,288,696,5,6,36,36,200,340,30,1451,36
1687,0,0.0.0,0,563,0,73,0,73,0,0,73,73,0,0,0,1,1,279,430,279,430,1,1422,1422
1687,0,1.0.0,0,588,3,83,0,83,0,0,83,83,0,0,0,1,1,206,430,206,430,1,1422,1422
1687,0,2.0.0,1,564,1,48,0,48,0,0,48,48,0,0,0,1,1,208,430,208,430,1,1422,1422
1687,0,3.0.0,0,570,2,64,0,64,0,0,64,64,0,0,0,1,1,198,430,198,430,1,1422,1422
1687,0,4.0.0,0,563,0,97,0,97,0,0,97,97,0,0,0,1,1,329,430,329,430,1,1422,1422
1687,0,5.0.0,0,564,1,65,0,65,0,0,65,65,0,0,0,1,1,202,430,202,430,1,1422,1422
1687,1,0.0.48,0,564,0,73,48,121,0,48,121,121,0,0,0,1,2,279,382,279,430,2,1422,1374
1687,1,1.0.48,0,591,3,83,48,131,0,48,131,131,0,0,0,1,2,206,382,206,430,2,1422,1374
1687,1,2.1.48,1,564,0,86,48,134,48,0,134,134,-48,48,48,2,1,160,294,208,294,2,1422,1374
1687,1,3.0.48,0,570,2,64,48,112,0,48,112,112,0,0,0,1,2,198,382,198,430,2,1422,1374
1687,1,4.0.48,0,566,1,97,48,145,0,48,145,145,0,0,0,1,2,329,382,329,430,2,1422,1374
1687,1,5.0.48,0,564,0,65,48,113,0,48,113,113,0,0,0,1,2,202,382,202,430,2,1422,1374
1687,2,0.0.48,0,564,0,73,48,121,0,48,121,134,0,0,48,1,2,279,382,279,430,3,1422,1288
1687,2,1.0.48,0,591,3,83,48,131,0,48,131,134,0,0,48,1,2,206,382,206,430,3,1422,1288
1687,2,2.2.134,1,564,0,44,134,178,134,0,178,178,-134,134,182,3,1,74,246,208,246,3,1422,1288
1687,2,3.0.48,0,570,2,64,48,112,0,48,112,134,0,0,48,1,2,198,382,198,430,3,1422,1288
1687,2,4.0.48,0,566,1,97,48,145,0,48,145,145,0,0,48,1,2,329,382,329,430,3,1422,1288
1687,2,5.0.48,0,564,0,65,48,113,0,48,113,134,0,0,48,1,2,202,382,202,430,3,1422,1288
1687,3,0.0.48,0,564,0,73,48,121,0,48,121,178,0,0,182,1,2,279,382,279,430,4,1422,1244
1687,3,1.0.48,0,591,3,83,48,131,0,48,131,178,0,0,182,1,2,206,382,206,430,4,1422,1244
1687,3,2.3.178,1,564,0,23,178,201,178,0,201,201,-178,178,360,4,1,30,280,208,280,4,1422,1244
1687,3,3.0.48,0,570,2,64,48,112,0,48,112,178,0,0,182,1,2,198,382,198,430,4,1422,1244
1687,3,4.0.48,0,566,1,97,48,145,0,48,145,178,0,0,182,1,2,329,382,329,430,4,1422,1244
1687,3,5.0.48,0,564,0,65,48,113,0,48,113,178,0,0,182,1,2,202,382,202,430,4,1422,1244
1687,4,0.0.48,0,564,0,73,48,121,0,48,121,201,0,0,360,1,2,279,382,279,430,5,1422,1221
1687,4,1.0.48,0,591,3,83,48,131,0,48,131,201,0,0,360,1,2,206,382,206,430,5,1422,1221
1687,4,2.4.201,1,564,0,7,201,208,201,0,208,208,-201,201,561,5,1,7,172,208,172,5,1422,1221
1687,4,3.0.48,0,570,2,64,48,112,0,48,112,201,0,0,360,1,2,198,382,198,430,5,1422,1221
1687,4,4.0.48,0,566,1,97,48,145,0,48,145,201,0,0,360,1,2,329,382,329,430,5,1422,1221
1687,4,5.0.48,0,564,0,65,48,113,0,48,113,201,0,0,360,1,2,202,382,202,430,5,1422,1221
1687,5,0.0.48,1,564,0,73,48,121,0,48,121,208,0,0,561,1,2,279,382,279,430,6,1422,1214
1687,5,1.0.48,0,591,3,83,48,131,0,48,131,208,0,0,561,1,2,206,382,206,430,6,1422,1214
1687,5,3.0.48,0,570,2,64,48,112,0,48,112,208,0,0,561,1,2,198,382,198,430,6,1422,1214
1687,5,4.0.48,0,566,1,97,48,145,0,48,145,208,0,0,561,1,2,329,382,329,430,6,1422,1214
1687,5,5.0.48,0,564,0,65,48,113,0,48,113,208,0,0,561,1,2,202,382,202,430,6,1422,1214
1687,6,0.1.134,1,564,0,33,134,167,121,13,167,208,0,48,561,2,2,206,208,279,294,7,1422,1141
1687,6,1.0.121,0,591,2,83,121,204,0,121,204,208,0,0,561,1,3,206,309,206,430,7,1422,1141
1687,6,3.0.121,0,570,1,64,121,185,0,121,185,208,0,0,561,1,3,198,309,198,430,7,1422,1141
1687,6,4.0.121,0,564,0,97,121,218,0,121,218,218,0,0,561,1,3,329,309,329,430,7,1422,1141
1687,6,5.0.121,0,564,0,65,121,186,0,121,186,208,0,0,561,1,3,202,309,202,430,7,1422,1141
1687,7,0.2.178,1,564,0,26,178,204,167,11,204,208,0,134,561,3,2,173,202,279,246,8,1422,1108
1687,7,1.0.121,0,591,2,83,121,204,0,121,204,208,0,0,561,1,3,206,309,206,430,8,1422,1108
1687,7,3.0.121,0,570,1,64,121,185,0,121,185,208,0,0,561,1,3,198,309,198,430,8,1422,1108
1687,7,4.0.121,0,564,0,97,121,218,0,121,218,218,0,0,561,1,3,329,309,329,430,8,1422,1108
1687,7,5.0.121,0,564,0,65,121,186,0,121,186,208,0,0,561,1,3,202,309,202,430,8,1422,1108
1687,8,0.3.204,1,564,0,98,204,302,204,0,302,302,-3,181,564,4,2,147,257,279,280,9,1422,1082
1687,8,1.0.121,0,591,2,83,121,204,0,121,204,208,0,0,561,1,3,206,309,206,430,9,1422,1082
1687,8,3.0.121,0,570,1,64,121,185,0,121,185,208,0,0,561,1,3,198,309,198,430,9,1422,1082
1687,8,4.0.121,0,564,0,97,121,218,0,121,218,218,0,0,561,1,3,329,309,329,430,9,1422,1082
1687,8,5.0.121,0,564,0,65,121,186,0,121,186,208,0,0,561,1,3,202,309,202,430,9,1422,1082
1687,9,0.4.302,1,564,0,49,302,351,302,0,351,351,-94,295,658,5,2,49,165,279,172,10,1422,984
1687,9,1.0.121,0,591,2,83,121,204,0,121,204,302,0,0,564,1,3,206,309,206,430,10,1422,984
1687,9,3.0.121,0,570,1,64,121,185,0,121,185,302,0,0,564,1,3,198,309,198,430,10,1422,984
1687,9,4.0.121,0,564,0,97,121,218,0,121,218,302,0,0,564,1,3,329,309,329,430,10,1422,984
1687,9,5.0.121,0,564,0,65,121,186,0,121,186,302,0,0,564,1,3,202,309,202,430,10,1422,984
1687,10,1.0.121,0,591,2,83,121,204,0,121,204,351,0,0,658,1,3,206,309,206,430,11,1422,935
1687,10,3.0.121,0,570,1,64,121,185,0,121,185,351,0,0,658,1,3,198,309,198,430,11,1422,935
1687,10,4.0.121,1,564,0,97,121,218,0,121,218,351,0,0,658,1,3,329,309,329,430,11,1422,935
1687,10,5.0.121,0,564,0,65,121,186,0,121,186,351,0,0,658,1,3,202,309,202,430,11,1422,935
1687,11,1.0.218,0,564,0,83,218,301,0,218,301,351,0,0,658,1,4,206,212,206,430,12,1422,838
1687,11,3.0.218,0,574,2,64,218,282,0,218,282,351,0,0,658,1,4,198,212,198,430,12,1422,838
1687,11,4.1.218,1,564,0,97,218,315,218,0,315,351,-51,99,709,2,3,232,175,329,294,12,1422,838
1687,11,5.0.218,0,567,1,65,218,283,0,218,283,351,0,0,658,1,4,202,212,202,430,12,1422,838
1687,12,1.0.218,0,564,0,83,218,301,0,218,301,351,0,0,709,1,4,206,212,206,430,13,1422,741
1687,12,3.0.218,0,574,2,64,218,282,0,218,282,351,0,0,709,1,4,198,212,198,430,13,1422,741
1687,12,4.2.315,1,567,1,46,315,361,315,0,361,361,-111,245,820,3,3,135,176,329,246,13,1422,741
1687,12,5.0.218,0,567,1,65,218,283,0,218,283,351,0,0,709,1,4,202,212,202,430,13,1422,741
1687,13,1.0.218,0,568,1,83,218,301,0,218,301,361,0,0,820,1,4,206,212,206,430,14,1422,695
1687,13,3.0.218,0,574,3,64,218,282,0,218,282,361,0,0,820,1,4,198,212,198,430,14,1422,695
1687,13,4.3.361,1,572,2,68,361,429,361,0,429,429,-59,240,879,4,3,89,159,329,280,14,1422,695
1687,13,5.0.218,0,567,0,65,218,283,0,218,283,361,0,0,820,1,4,202,212,202,430,14,1422,695
1687,14,1.0.218,0,580,2,83,218,301,0,218,301,429,0,0,879,1,4,206,212,206,430,15,1422,627
1687,14,3.0.218,0,579,1,64,218,282,0,218,282,429,0,0,879,1,4,198,212,198,430,15,1422,627
1687,14,4.4.429,1,572,0,21,429,450,429,0,450,450,-78,373,957,5,3,21,116,329,172,15,1422,627
1687,14,5.0.218,0,572,0,65,218,283,0,218,283,429,0,0,879,1,4,202,212,202,430,15,1422,627
1687,15,1.0.218,0,580,2,83,218,301,0,218,301,450,0,0,957,1,4,206,212,206,430,16,1422,606
1687,15,3.0.218,0,579,1,64,218,282,0,218,282,450,0,0,957,1,4,198,212,198,430,16,1422,606
1687,15,5.0.218,1,572,0,65,218,283,0,218,283,450,0,0,957,1,4,202,212,202,430,16,1422,606
1687,16,1.0.283,0,572,0,83,283,366,0,283,366,450,0,0,957,1,5,206,147,206,430,17,1422,541
1687,16,3.0.283,0,572,0,64,283,347,0,283,347,450,0,0,957,1,5,198,147,198,430,17,1422,541
1687,16,5.1.315,1,572,0,45,315,360,283,32,360,450,0,99,957,2,4,137,78,202,294,17,1422,541
1687,17,1.0.283,0,572,0,83,283,366,0,283,366,450,0,0,957,1,5,206,147,206,430,18,1422,496
1687,17,3.0.283,1,572,0,64,283,347,0,283,347,450,0,0,957,1,5,198,147,198,430,18,1422,496
1687,17,5.2.361,0,572,0,44,361,405,360,1,405,450,0,245,957,3,4,92,130,202,246,18,1422,496
1687,18,1.0.347,1,572,0,83,347,430,0,347,430,450,0,0,957,1,6,206,83,206,430,19,1422,432
1687,18,3.1.360,0,572,0,31,360,391,347,13,391,450,0,99,957,2,5,134,33,198,294,19,1422,432
1687,18,5.2.361,0,572,0,44,361,405,360,1,405,450,0,245,957,3,4,92,130,202,246,19,1422,432
1687,19,1.1.430,0,572,0,2,430,432,430,0,432,450,-70,169,1027,2,5,123,33,206,294,20,1422,349
1687,19,3.1.360,1,572,0,31,360,391,347,13,391,450,0,99,957,2,5,134,33,198,294,20,1422,349
1687,19,5.2.361,0,572,0,44,361,405,360,1,405,450,0,245,957,3,4,92,130,202,246,20,1422,349
1687,20,1.1.430,1,572,0,2,430,432,430,0,432,450,-39,138,996,2,6,123,2,206,294,21,1422,318
1687,20,3.2.391,0,610,1,70,391,461,391,0,461,461,-30,275,987,3,4,103,130,198,246,21,1422,318
1687,20,5.2.361,0,572,0,44,361,405,360,1,405,450,0,245,957,3,4,92,130,202,246,21,1422,318
1687,21,1.2.432,0,572,0,16,432,448,432,0,448,450,-71,316,1067,3,4,121,130,206,246,22,1422,316
1687,21,3.2.391,0,610,1,70,391,461,391,0,461,461,-30,275,1026,3,4,103,130,198,246,22,1422,316
1687,21,5.2.361,1,572,0,44,361,405,360,1,405,450,0,245,996,3,4,92,130,202,246,22,1422,316
1687,22,1.2.432,0,572,0,16,432,448,432,0,448,450,-27,272,1023,3,5,121,86,206,246,23,1422,272
1687,22,3.2.405,0,596,1,70,405,475,391,14,475,475,0,245,996,3,5,103,86,198,246,23,1422,272
1687,22,5.3.429,1,572,0,20,429,449,405,24,449,450,0,240,996,4,4,48,91,202,280,23,1422,272
1687,23,1.2.432,0,572,0,16,432,448,432,0,448,450,-27,272,1023,3,5,121,86,206,246,24,1422,252
1687,23,3.2.405,0,596,1,70,405,475,391,14,475,475,0,245,996,3,5,103,86,198,246,24,1422,252
1687,23,5.4.450,1,572,0,28,450,478,449,1,478,478,0,373,996,5,4,28,95,202,172,24,1422,252
1687,24,1.2.432,1,572,0,16,432,448,432,0,448,478,-27,272,1023,3,5,121,86,206,246,25,1422,224
1687,24,3.2.405,0,596,1,70,405,475,391,14,475,478,0,245,996,3,5,103,86,198,246,25,1422,224
1687,25,1.3.449,1,572,0,56,449,505,448,1,505,505,0,240,1023,4,5,105,71,206,280,26,1422,208
1687,25,3.2.448,0,572,0,70,448,518,391,57,518,518,0,272,1023,3,6,103,70,198,246,26,1422,208
1687,26,1.4.505,1,572,0,49,505,554,505,0,554,554,-27,400,1050,5,5,49,67,206,172,27,1422,152
1687,26,3.2.448,0,572,0,70,448,518,391,57,518,518,0,272,1023,3,6,103,70,198,246,27,1422,152
1687,27,3.2.448,1,572,0,70,448,518,391,57,518,554,0,272,1050,3,6,103,70,198,246,28,1422,103
1687,28,3.3.518,1,572,0,15,518,533,518,0,533,554,-13,253,1063,4,6,33,15,198,280,29,1422,33
1687,29,3.4.554,1,572,0,18,554,572,533,21,572,572,0,400,1063,5,6,18,18,198,172,30,1422,18
1688,0,0.0.0,0,649,4,86,0,86,0,0,86,86,0,0,0,1,1,124,346,124,346,1,1589,1589
1688,0,1.0.0,0,599,2,59,0,59,0,0,59,59,0,0,0,1,1,305,346,305,346,1,1589,1589
1688,0,2.0.0,0,658,5,94,0,94,0,0,94,94,0,0,0,1,1,432,346,432,346,1,1589,1589
1688,0,3.0.0,0,566,0,18,0,18,0,0,18,18,0,0,0,1,1,258,346,258,346,1,1589,1589
1688,0,4.0.0,1,567,1,19,0,19,0,0,19,19,0,0,0,1,1,266,346,266,346,1,1589,1589
1688,0,5.0.0,0,627,3,70,0,70,0,0,70,70,0,0,0,1,1,204,346,204,346,1,1589,1589
1688,1,0.0.19,0,633,4,86,19,105,0,19,105,105,0,0,0,1,2,124,327,124,346,2,1589,1570
1688,1,1.0.19,0,576,1,59,19,78,0,19,78,78,0,0,0,1,2,305,327,305,346,2,1589,1570
1688,1,2.0.19,0,615,3,94,19,113,0,19,113,113,0,0,0,1,2,432,327,432,346,2,1589,1570
1688,1,3.0.19,0,567,0,18,19,37,0,19,37,37,0,0,0,1,2,258,327,258,346,2,1589,1570
1688,1,4.1.19,1,567,0,50,19,69,19,0,69,69,-19,19,19,2,1,247,296,266,296,2,1589,1570
1688,1,5.0.19,0,601,2,70,19,89,0,19,89,89,0,0,0,1,2,204,327,204,346,2,1589,1570
1688,2,0.0.19,0,633,4,86,19,105,0,19,105,105,0,0,19,1,2,124,327,124,346,3,1589,1520
1688,2,1.0.19,0,576,1,59,19,78,0,19,78,78,0,0,19,1,2,305,327,305,346,3,1589,1520
1688,2,2.0.19,0,615,3,94,19,113,0,19,113,113,0,0,19,1,2,432,327,432,346,3,1589,1520
1688,2,3.0.19,0,567,0,18,19,37,0,19,37,69,0,0,19,1,2,258,327,258,346,3,1589,1520
1688,2,4.2.69,1,567,0,46,69,115,69,0,115,115,-69,69,88,3,1,197,313,266,313,3,1589,1520
1688,2,5.0.19,0,601,2,70,19,89,0,19,89,89,0,0,19,1,2,204,327,204,346,3,1589,1520
1688,3,0.0.19,0,633,4,86,19,105,0,19,105,115,0,0,88,1,2,124,327,124,346,4,1589,1474
1688,3,1.0.19,0,576,1,59,19,78,0,19,78,115,0,0,88,1,2,305,327,305,346,4,1589,1474
1688,3,2.0.19,0,615,3,94,19,113,0,19,113,115,0,0,88,1,2,432,327,432,346,4,1589,1474
1688,3,3.0.19,0,567,0,18,19,37,0,19,37,115,0,0,88,1,2,258,327,258,346,4,1589,1474
1688,3,4.3.115,1,567,0,61,115,176,115,0,176,176,-115,115,203,4,1,151,332,266,332,4,1589,1474
1688,3,5.0.19,0,601,2,70,19,89,0,19,89,115,0,0,88,1,2,204,327,204,346,4,1589,1474
1688,4,0.0.19,0,633,4,86,19,105,0,19,105,176,0,0,203,1,2,124,327,124,346,5,1589,1413
1688,4,1.0.19,0,576,1,59,19,78,0,19,78,176,0,0,203,1,2,305,327,305,346,5,1589,1413
1688,4,2.0.19,0,615,3,94,19,113,0,19,113,176,0,0,203,1,2,432,327,432,346,5,1589,1413
1688,4,3.0.19,0,567,0,18,19,37,0,19,37,176,0,0,203,1,2,258,327,258,346,5,1589,1413
1688,4,4.4.176,1,567,0,90,176,266,176,0,266,266,-176,176,379,5,1,90,302,266,302,5,1589,1413
1688,4,5.0.19,0,601,2,70,19,89,0,19,89,176,0,0,203,1,2,204,327,204,346,5,1589,1413
1688,5,0.0.19,0,633,4,86,19,105,0,19,105,266,0,0,379,1,2,124,327,124,346,6,1589,1323
1688,5,1.0.19,0,576,1,59,19,78,0,19,78,266,0,0,379,1,2,305,327,305,346,6,1589,1323
1688,5,2.0.19,0,615,3,94,19,113,0,19,113,266,0,0,379,1,2,432,327,432,346,6,1589,1323
1688,5,3.0.19,1,567,0,18,19,37,0,19,37,266,0,0,379,1,2,258,327,258,346,6,1589,1323
1688,5,5.0.19,0,601,2,70,19,89,0,19,89,266,0,0,379,1,2,204,327,204,346,6,1589,1323
1688,6,0.0.37,0,633,3,86,37,123,0,37,123,266,0,0,379,1,3,124,309,124,346,7,1589,1305
1688,6,1.0.37,0,567,0,59,37,96,0,37,96,266,0,0,379,1,3,305,309,305,346,7,1589,1305
1688,6,2.0.37,0,575,1,94,37,131,0,37,131,266,0,0,379,1,3,432,309,432,346,7,1589,1305
1688,6,3.1.69,1,567,0,69,69,138,37,32,138,266,0,19,379,2,2,240,246,258,296,7,1589,1305
1688,6,5.0.37,0,601,2,70,37,107,0,37,107,266,0,0,379,1,3,204,309,204,346,7,1589,1305
1688,7,0.0.37,0,633,3,86,37,123,0,37,123,266,0,0,379,1,3,124,309,124,346,8,1589,1236
1688,7,1.0.37,0,567,0,59,37,96,0,37,96,266,0,0,379,1,3,305,309,305,346,8,1589,1236
1688,7,2.0.37,0,575,1,94,37,131,0,37,131,266,0,0,379,1,3,432,309,432,346,8,1589,1236
1688,7,3.2.138,1,567,0,38,138,176,138,0,176,266,-23,92,402,3,2,171,267,258,313,8,1589,1236
1688,7,5.0.37,0,601,2,70,37,107,0,37,107,266,0,0,379,1,3,204,309,204,346,8,1589,1236
1688,8,0.0.37,0,633,3,86,37,123,0,37,123,266,0,0,402,1,3,124,309,124,346,9,1589,1198
1688,8,1.0.37,0,567,0,59,37,96,0,37,96,266,0,0,402,1,3,305,309,305,346,9,1589,1198
1688,8,2.0.37,0,575,1,94,37,131,0,37,131,266,0,0,402,1,3,432,309,432,346,9,1589,1198
1688,8,3.3.176,1,567,0,73,176,249,176,0,249,266,0,115,402,4,2,133,271,258,332,9,1589,1198
1688,8,5.0.37,0,601,2,70,37,107,0,37,107,266,0,0,402,1,3,204,309,204,346,9,1589,1198
1688,9,0.0.37,0,633,3,86,37,123,0,37,123,266,0,0,402,1,3,124,309,124,346,10,1589,1125
1688,9,1.0.37,0,567,0,59,37,96,0,37,96,266,0,0,402,1,3,305,309,305,346,10,1589,1125
1688,9,2.0.37,0,575,1,94,37,131,0,37,131,266,0,0,402,1,3,432,309,432,346,10,1589,1125
1688,9,3.4.266,1,567,0,60,266,326,249,17,326,326,0,176,402,5,2,60,212,258,302,10,1589,1125
1688,9,5.0.37,0,601,2,70,37,107,0,37,107,266,0,0,402,1,3,204,309,204,346,10,1589,1125
1688,10,0.0.37,0,633,3,86,37,123,0,37,123,326,0,0,402,1,3,124,309,124,346,11,1589,1065
1688,10,1.0.37,0,567,0,59,37,96,0,37,96,326,0,0,402,1,3,305,309,305,346,11,1589,1065
1688,10,2.0.37,1,575,1,94,37,131,0,37,131,326,0,0,402,1,3,432,309,432,346,11,1589,1065
1688,10,5.0.37,0,601,2,70,37,107,0,37,107,326,0,0,402,1,3,204,309,204,346,11,1589,1065
1688,11,0.0.131,0,581,1,86,131,217,0,131,217,326,0,0,402,1,4,124,215,124,346,12,1589,971
1688,11,1.0.131,0,575,0,59,131,190,0,131,190,326,0,0,402,1,4,305,215,305,346,12,1589,971
1688,11,2.1.138,1,575,0,79,138,217,131,7,217,326,0,19,402,2,3,338,177,432,296,12,1589,971
1688,11,5.0.131,0,575,0,70,131,201,0,131,201,326,0,0,402,1,4,204,215,204,346,12,1589,971
1688,12,0.0.131,0,581,1,86,131,217,0,131,217,326,0,0,402,1,4,124,215,124,346,13,1589,892
1688,12,1.0.131,0,575,0,59,131,190,0,131,190,326,0,0,402,1,4,305,215,305,346,13,1589,892
1688,12,2.2.217,1,575,0,96,217,313,217,0,313,326,-41,133,443,3,3,259,229,432,313,13,1589,892
1688,12,5.0.131,0,575,0,70,131,201,0,131,201,326,0,0,402,1,4,204,215,204,346,13,1589,892
1688,13,0.0.131,0,581,1,86,131,217,0,131,217,326,0,0,443,1,4,124,215,124,346,14,1589,796
1688,13,1.0.131,0,575,0,59,131,190,0,131,190,326,0,0,443,1,4,305,215,305,346,14,1589,796
1688,13,2.3.313,1,575,0,91,313,404,313,0,404,404,-64,179,507,4,3,163,198,432,332,14,1589,796
1688,13,5.0.131,0,575,0,70,131,201,0,131,201,326,0,0,443,1,4,204,215,204,346,14,1589,796
1688,14,0.0.131,0,581,1,86,131,217,0,131,217,404,0,0,507,1,4,124,215,124,346,15,1589,705
1688,14,1.0.131,0,575,0,59,131,190,0,131,190,404,0,0,507,1,4,305,215,305,346,15,1589,705
1688,14,2.4.404,1,575,0,72,404,476,404,0,476,476,-78,254,585,5,3,72,152,432,302,15,1589,705
1688,14,5.0.131,0,575,0,70,131,201,0,131,201,404,0,0,507,1,4,204,215,204,346,15,1589,705
1688,15,0.0.131,0,581,1,86,131,217,0,131,217,476,0,0,585,1,4,124,215,124,346,16,1589,633
1688,15,1.0.131,1,575,0,59,131,190,0,131,190,476,0,0,585,1,4,305,215,305,346,16,1589,633
1688,15,5.0.131,0,575,0,70,131,201,0,131,201,476,0,0,585,1,4,204,215,204,346,16,1589,633
1688,16,0.0.190,0,581,2,86,190,276,0,190,276,476,0,0,585,1,5,124,156,124,346,17,1589,574
1688,16,1.1.217,1,576,1,69,217,286,190,27,286,476,0,19,585,2,4,246,98,305,296,17,1589,574
1688,16,5.0.190,0,575,0,70,190,260,0,190,260,476,0,0,585,1,5,204,156,204,346,17,1589,574
1688,17,0.0.190,0,581,2,86,190,276,0,190,276,476,0,0,585,1,5,124,156,124,346,18,1589,505
1688,17,1.2.313,1,580,1,22,313,335,286,27,335,476,0,133,585,3,4,177,133,305,313,18,1589,505
1688,17,5.0.190,0,576,0,70,190,260,0,190,260,476,0,0,585,1,5,204,156,204,346,18,1589,505
1688,18,0.0.190,0,581,1,86,190,276,0,190,276,476,0,0,585,1,5,124,156,124,346,19,1589,483
1688,18,1.3.404,1,581,1,97,404,501,335,69,501,501,0,179,585,4,4,155,107,305,332,19,1589,483
1688,18,5.0.190,0,580,0,70,190,260,0,190,260,476,0,0,585,1,5,204,156,204,346,19,1589,483
1688,19,0.0.190,0,581,0,86,190,276,0,190,276,501,0,0,585,1,5,124,156,124,346,20,1589,386
1688,19,1.4.501,1,581,0,58,501,559,501,0,559,559,-25,279,610,5,4,58,80,305,302,20,1589,386
1688,19,5.0.190,0,581,0,70,190,260,0,190,260,501,0,0,585,1,5,204,156,204,346,20,1589,386
1688,20,0.0.190,0,581,0,86,190,276,0,190,276,559,0,0,610,1,5,124,156,124,346,21,1589,328
1688,20,5.0.190,1,581,0,70,190,260,0,190,260,559,0,0,610,1,5,204,156,204,346,21,1589,328
1688,21,0.0.260,0,581,0,86,260,346,0,260,346,559,0,0,610,1,6,124,86,124,346,22,1589,258
1688,21,5.1.286,1,581,0,28,286,314,260,26,314,559,0,19,610,2,5,134,29,204,296,22,1589,258
1688,22,0.0.260,1,581,0,86,260,346,0,260,346,559,0,0,610,1,6,124,86,124,346,23,1589,230
1688,22,5.2.335,0,581,0,82,335,417,314,21,417,559,0,133,610,3,5,106,111,204,313,23,1589,230
1688,23,0.1.346,1,581,0,1,346,347,346,0,347,559,-32,51,642,2,6,38,1,124,296,24,1589,144
1688,23,5.2.335,0,581,0,82,335,417,314,21,417,559,0,133,610,3,5,106,111,204,313,24,1589,144
1688,24,0.2.347,1,581,0,29,347,376,347,0,376,559,-12,145,654,3,5,37,111,124,313,25,1589,143
1688,24,5.2.335,0,581,0,82,335,417,314,21,417,559,0,133,642,3,5,106,111,204,313,25,1589,143
1688,25,0.3.501,1,581,0,5,501,506,376,125,506,559,0,179,654,4,5,8,10,124,332,26,1589,114
1688,25,5.2.376,0,581,0,82,376,458,314,62,458,559,0,145,654,3,6,106,82,204,313,26,1589,114
1688,26,0.4.559,1,581,0,3,559,562,506,53,562,562,0,279,654,5,5,3,22,124,302,27,1589,109
1688,26,5.2.376,0,581,0,82,376,458,314,62,458,559,0,145,654,3,6,106,82,204,313,27,1589,109
1688,27,5.2.376,1,581,0,82,376,458,314,62,458,562,0,145,654,3,6,106,82,204,313,28,1589,106
1688,28,5.3.506,1,581,0,5,506,511,458,48,511,562,0,179,654,4,6,24,5,204,332,29,1589,24
1688,29,5.4.562,1,581,0,19,562,581,511,51,581,581,0,279,654,5,6,19,19,204,302,30,1589,19
1689,0,0.0.0,0,511,3,99,0,99,0,0,99,99,0,0,0,1,1,268,361,268,361,1,1264,1264
1689,0,1.0.0,0,460,0,35,0,35,0,0,35,35,0,0,0,1,1,207,361,207,361,1,1264,1264
1689,0,2.0.0,1,460,0,40,0,40,0,0,40,40,0,0,0,1,1,261,361,261,361,1,1264,1264
1689,0,3.0.0,0,507,2,71,0,71,0,0,71,71,0,0,0,1,1,118,361,118,361,1,1264,1264
1689,0,4.0.0,0,460,0,41,0,41,0,0,41,41,0,0,0,1,1,205,361,205,361,1,1264,1264
1689,0,5.0.0,0,469,1,75,0,75,0,0,75,75,0,0,0,1,1,205,361,205,361,1,1264,1264
1689,1,0.0.40,0,474,1,99,40,139,0,40,139,139,0,0,0,1,2,268,321,268,361,2,1264,1224
1689,1,1.0.40,0,460,0,35,40,75,0,40,75,75,0,0,0,1,2,207,321,207,361,2,1264,1224
1689,1,2.1.40,1,460,0,73,40,113,40,0,113,113,-40,40,40,2,1,221,200,261,200,2,1264,1224
1689,1,3.0.40,0,507,2,71,40,111,0,40,111,111,0,0,0,1,2,118,321,118,361,2,1264,1224
1689,1,4.0.40,0,460,0,41,40,81,0,40,81,81,0,0,0,1,2,205,321,205,361,2,1264,1224
1689,1,5.0.40,0,474,1,75,40,115,0,40,115,115,0,0,0,1,2,205,321,205,361,2,1264,1224
1689,2,0.0.40,0,474,1,99,40,139,0,40,139,139,0,0,40,1,2,268,321,268,361,3,1264,1151
1689,2,1.0.40,0,460,0,35,40,75,0,40,75,113,0,0,40,1,2,207,321,207,361,3,1264,1151
1689,2,2.2.113,1,460,0,50,113,163,113,0,163,163,-113,113,153,3,1,148,183,261,183,3,1264,1151
1689,2,3.0.40,0,507,2,71,40,111,0,40,111,113,0,0,40,1,2,118,321,118,361,3,1264,1151
1689,2,4.0.40,0,460,0,41,40,81,0,40,81,113,0,0,40,1,2,205,321,205,361,3,1264,1151
1689,2,5.0.40,0,474,1,75,40,115,0,40,115,115,0,0,40,1,2,205,321,205,361,3,1264,1151
1689,3,0.0.40,0,474,1,99,40,139,0,40,139,163,0,0,153,1,2,268,321,268,361,4,1264,1101
1689,3,1.0.40,0,460,0,35,40,75,0,40,75,163,0,0,153,1,2,207,321,207,361,4,1264,1101
1689,3,2.3.163,1,460,0,60,163,223,163,0,223,223,-163,163,316,4,1,98,286,261,286,4,1264,1101
1689,3,3.0.40,0,507,2,71,40,111,0,40,111,163,0,0,153,1,2,118,321,118,361,4,1264,1101
1689,3,4.0.40,0,460,0,41,40,81,0,40,81,163,0,0,153,1,2,205,321,205,361,4,1264,1101
1689,3,5.0.40,0,474,1,75,40,115,0,40,115,163,0,0,153,1,2,205,321,205,361,4,1264,1101
1689,4,0.0.40,0,474,1,99,40,139,0,40,139,223,0,0,316,1,2,268,321,268,361,5,1264,1041
1689,4,1.0.40,0,460,0,35,40,75,0,40,75,223,0,0,316,1,2,207,321,207,361,5,1264,1041
1689,4,2.4.223,1,460,0,38,223,261,223,0,261,261,-223,223,539,5,1,38,234,261,234,5,1264,1041
1689,4,3.0.40,0,507,2,71,40,111,0,40,111,223,0,0,316,1,2,118,321,118,361,5,1264,1041
1689,4,4.0.40,0,460,0,41,40,81,0,40,81,223,0,0,316,1,2,205,321,205,361,5,1264,1041
1689,4,5.0.40,0,474,1,75,40,115,0,40,115,223,0,0,316,1,2,205,321,205,361,5,1264,1041
1689,5,0.0.40,0,474,1,99,40,139,0,40,139,261,0,0,539,1,2,268,321,268,361,6,1264,1003
1689,5,1.0.40,1,460,0,35,40,75,0,40,75,261,0,0,539,1,2,207,321,207,361,6,1264,1003
1689,5,3.0.40,0,507,2,71,40,111,0,40,111,261,0,0,539,1,2,118,321,118,361,6,1264,1003
1689,5,4.0.40,0,460,0,41,40,81,0,40,81,261,0,0,539,1,2,205,321,205,361,6,1264,1003
1689,5,5.0.40,0,474,1,75,40,115,0,40,115,261,0,0,539,1,2,205,321,205,361,6,1264,1003
1689,6,0.0.75,0,462,1,99,75,174,0,75,174,261,0,0,539,1,3,268,286,268,361,7,1264,968
1689,6,1.1.113,1,460,0,37,113,150,75,38,150,261,0,40,539,2,2,172,127,207,200,7,1264,968
1689,6,3.0.75,0,507,3,71,75,146,0,75,146,261,0,0,539,1,3,118,286,118,361,7,1264,968
1689,6,4.0.75,0,460,0,41,75,116,0,75,116,261,0,0,539,1,3,205,286,205,361,7,1264,968
1689,6,5.0.75,0,474,2,75,75,150,0,75,150,261,0,0,539,1,3,205,286,205,361,7,1264,968
1689,7,0.0.75,0,462,1,99,75,174,0,75,174,261,0,0,539,1,3,268,286,268,361,8,1264,931
1689,7,1.2.163,1,460,0,27,163,190,150,13,190,261,0,113,539,3,2,135,133,207,183,8,1264,931
1689,7,3.0.75,0,507,3,71,75,146,0,75,146,261,0,0,539,1,3,118,286,118,361,8,1264,931
1689,7,4.0.75,0,460,0,41,75,116,0,75,116,261,0,0,539,1,3,205,286,205,361,8,1264,931
1689,7,5.0.75,0,474,2,75,75,150,0,75,150,261,0,0,539,1,3,205,286,205,361,8,1264,931
1689,8,0.0.75,0,462,1,99,75,174,0,75,174,261,0,0,539,1,3,268,286,268,361,9,1264,904
1689,8,1.3.223,1,460,0,40,223,263,190,33,263,263,0,163,539,4,2,108,226,207,286,9,1264,904
1689,8,3.0.75,0,507,3,71,75,146,0,75,146,261,0,0,539,1,3,118,286,118,361,9,1264,904
1689,8,4.0.75,0,460,0,41,75,116,0,75,116,261,0,0,539,1,3,205,286,205,361,9,1264,904
1689,8,5.0.75,0,474,2,75,75,150,0,75,150,261,0,0,539,1,3,205,286,205,361,9,1264,904
1689,9,0.0.75,0,462,1,99,75,174,0,75,174,263,0,0,539,1,3,268,286,268,361,10,1264,864
1689,9,1.4.263,1,460,0,68,263,331,263,0,331,331,-2,225,541,5,2,68,196,207,234,10,1264,864
1689,9,3.0.75,0,507,3,71,75,146,0,75,146,263,0,0,539,1,3,118,286,118,361,10,1264,864
1689,9,4.0.75,0,460,0,41,75,116,0,75,116,263,0,0,539,1,3,205,286,205,361,10,1264,864
1689,9,5.0.75,0,474,2,75,75,150,0,75,150,263,0,0,539,1,3,205,286,205,361,10,1264,864
1689,10,0.0.75,0,462,1,99,75,174,0,75,174,331,0,0,541,1,3,268,286,268,361,11,1264,796
1689,10,3.0.75,0,507,3,71,75,146,0,75,146,331,0,0,541,1,3,118,286,118,361,11,1264,796
1689,10,4.0.75,1,460,0,41,75,116,0,75,116,331,0,0,541,1,3,205,286,205,361,11,1264,796
1689,10,5.0.75,0,474,2,75,75,150,0,75,150,331,0,0,541,1,3,205,286,205,361,11,1264,796
1689,11,0.0.116,0,460,0,99,116,215,0,116,215,331,0,0,541,1,4,268,245,268,361,12,1264,755
1689,11,3.0.116,0,507,2,71,116,187,0,116,187,331,0,0,541,1,4,118,245,118,361,12,1264,755
1689,11,4.1.150,1,460,0,2,150,152,116,34,152,331,0,40,541,2,3,164,90,205,200,12,1264,755
1689,11,5.0.116,0,474,1,75,116,191,0,116,191,331,0,0,541,1,4,205,245,205,361,12,1264,755
1689,12,0.0.116,0,460,0,99,116,215,0,116,215,331,0,0,541,1,4,268,245,268,361,13,1264,753
1689,12,3.0.116,0,507,2,71,116,187,0,116,187,331,0,0,541,1,4,118,245,118,361,13,1264,753
1689,12,4.2.190,1,460,0,47,190,237,152,38,237,331,0,113,541,3,3,162,106,205,183,13,1264,753
1689,12,5.0.116,0,474,1,75,116,191,0,116,191,331,0,0,541,1,4,205,245,205,361,13,1264,753
1689,13,0.0.116,0,460,0,99,116,215,0,116,215,331,0,0,541,1,4,268,245,268,361,14,1264,706
1689,13,3.0.116,0,507,2,71,116,187,0,116,187,331,0,0,541,1,4,118,245,118,361,14,1264,706
1689,13,4.3.263,1,460,0,54,263,317,237,26,317,331,0,163,541,4,3,115,186,205,286,14,1264,706
1689,13,5.0.116,0,474,1,75,116,191,0,116,191,331,0,0,541,1,4,205,245,205,361,14,1264,706
1689,14,0.0.116,0,460,0,99,116,215,0,116,215,331,0,0,541,1,4,268,245,268,361,15,1264,652
1689,14,3.0.116,0,507,2,71,116,187,0,116,187,331,0,0,541,1,4,118,245,118,361,15,1264,652
1689,14,4.4.331,1,460,0,61,331,392,317,14,392,392,0,225,541,5,3,61,128,205,234,15,1264,652
1689,14,5.0.116,0,474,1,75,116,191,0,116,191,331,0,0,541,1,4,205,245,205,361,15,1264,652
1689,15,0.0.116,1,460,0,99,116,215,0,116,215,392,0,0,541,1,4,268,245,268,361,16,1264,591
1689,15,3.0.116,0,507,2,71,116,187,0,116,187,392,0,0,541,1,4,118,245,118,361,16,1264,591
1689,15,5.0.116,0,474,1,75,116,191,0,116,191,392,0,0,541,1,4,205,245,205,361,16,1264,591
1689,16,0.1.215,1,460,0,69,215,284,215,0,284,392,-63,103,604,2,4,169,88,268,200,17,1264,492
1689,16,3.0.215,0,491,1,71,215,286,0,215,286,392,0,0,541,1,5,118,146,118,361,17,1264,492
1689,16,5.0.215,0,460,0,75,215,290,0,215,290,392,0,0,541,1,5,205,146,205,361,17,1264,492
1689,17,0.2.284,1,460,0,33,284,317,284,0,317,392,-47,160,651,3,4,100,59,268,183,18,1264,423
1689,17,3.0.215,0,491,1,71,215,286,0,215,286,392,0,0,604,1,5,118,146,118,361,18,1264,423
1689,17,5.0.215,0,460,0,75,215,290,0,215,290,392,0,0,604,1,5,205,146,205,361,18,1264,423
1689,18,0.3.317,1,460,0,12,317,329,317,0,329,392,0,163,651,4,4,67,132,268,286,19,1264,390
1689,18,3.0.215,0,491,1,71,215,286,0,215,286,392,0,0,651,1,5,118,146,118,361,19,1264,390
1689,18,5.0.215,0,460,0,75,215,290,0,215,290,392,0,0,651,1,5,205,146,205,361,19,1264,390
1689,19,0.4.392,1,460,0,55,392,447,329,63,447,447,0,225,651,5,4,55,67,268,234,20,1264,378
1689,19,3.0.215,0,491,1,71,215,286,0,215,286,392,0,0,651,1,5,118,146,118,361,20,1264,378
1689,19,5.0.215,0,460,0,75,215,290,0,215,290,392,0,0,651,1,5,205,146,205,361,20,1264,378
1689,20,3.0.215,0,491,1,71,215,286,0,215,286,447,0,0,651,1,5,118,146,118,361,21,1264,323
1689,20,5.0.215,1,460,0,75,215,290,0,215,290,447,0,0,651,1,5,205,146,205,361,21,1264,323
1689,21,3.0.290,0,460,0,71,290,361,0,290,361,447,0,0,651,1,6,118,71,118,361,22,1264,248
1689,21,5.1.290,1,460,0,11,290,301,290,0,301,447,-6,109,657,2,5,130,19,205,200,22,1264,248
1689,22,3.0.290,0,460,0,71,290,361,0,290,361,447,0,0,657,1,6,118,71,118,361,23,1264,237
1689,22,5.2.317,1,460,0,21,317,338,301,16,338,447,0,160,657,3,5,119,26,205,183,23,1264,237
1689,23,3.0.290,0,460,0,71,290,361,0,290,361,447,0,0,657,1,6,118,71,118,361,24,1264,216
1689,23,5.3.338,1,460,0,88,338,426,338,0,426,447,-9,172,666,4,5,98,120,205,286,24,1264,216
1689,24,3.0.290,0,460,0,71,290,361,0,290,361,447,0,0,666,1,6,118,71,118,361,25,1264,128
1689,24,5.4.447,1,460,0,10,447,457,426,21,457,457,0,225,666,5,5,10,12,205,234,25,1264,128
1689,25,3.0.290,1,460,0,71,290,361,0,290,361,457,0,0,666,1,6,118,71,118,361,26,1264,118
1689,26,3.1.361,1,460,0,8,361,369,361,0,369,457,-60,169,726,2,6,47,8,118,200,27,1264,47
1689,27,3.2.369,1,460,0,5,369,374,369,0,374,457,-31,191,757,3,6,39,5,118,183,28,1264,39
1689,28,3.3.426,1,460,0,32,426,458,374,52,458,458,0,172,757,4,6,34,32,118,286,29,1264,34
1689,29,3.4.458,1,460,0,2,458,460,458,0,460,460,-1,226,758,5,6,2,2,118,234,30,1264,2
1690,0,0.0.0,0,435,0,13,0,13,0,0,13,13,0,0,0,1,1,113,275,113,275,1,1331,1331
1690,0,1.0.0,0,435,0,11,0,11,0,0,11,11,0,0,0,1,1,206,275,206,275,1,1331,1331
1690,0,2.0.0,0,515,3,85,0,85,0,0,85,85,0,0,0,1,1,187,275,187,275,1,1331,1331
1690,0,3.0.0,1,435,0,24,0,24,0,0,24,24,0,0,0,1,1,276,275,276,275,1,1331,1331
1690,0,4.0.0,0,469,1,63,0,63,0,0,63,63,0,0,0,1,1,243,275,243,275,1,1331,1331
1690,0,5.0.0,0,495,2,79,0,79,0,0,79,79,0,0,0,1,1,306,275,306,275,1,1331,1331
1690,1,0.0.24,0,444,1,13,24,37,0,24,37,37,0,0,0,1,2,113,251,113,275,2,1331,1307
1690,1,1.0.24,1,435,0,11,24,35,0,24,35,35,0,0,0,1,2,206,251,206,275,2,1331,1307
1690,1,2.0.24,0,502,5,85,24,109,0,24,109,109,0,0,0,1,2,187,251,187,275,2,1331,1307
1690,1,3.1.24,0,451,2,46,24,70,24,0,70,70,-24,24,24,2,1,252,302,276,302,2,1331,1307
1690,1,4.0.24,0,476,3,63,24,87,0,24,87,87,0,0,0,1,2,243,251,243,275,2,1331,1307
1690,1,5.0.24,0,486,4,79,24,103,0,24,103,103,0,0,0,1,2,306,251,306,275,2,1331,1307
1690,2,0.0.35,0,435,0,13,35,48,0,35,48,48,0,0,0,1,3,113,240,113,275,3,1331,1296
1690,2,1.1.35,1,435,0,5,35,40,35,0,40,40,-35,35,35,2,1,195,302,206,302,3,1331,1296
1690,2,2.0.35,0,504,4,85,35,120,0,35,120,120,0,0,0,1,3,187,240,187,275,3,1331,1296
1690,2,3.1.24,0,451,3,46,24,70,24,0,70,70,-24,24,24,2,1,252,302,276,302,3,1331,1296
1690,2,4.0.35,0,449,2,63,35,98,0,35,98,98,0,0,0,1,3,243,240,243,275,3,1331,1296
1690,2,5.0.35,0,439,1,79,35,114,0,35,114,114,0,0,0,1,3,306,240,306,275,3,1331,1296
1690,3,0.0.35,0,435,0,13,35,48,0,35,48,48,0,0,35,1,3,113,240,113,275,4,1331,1291
1690,3,1.2.40,1,435,0,32,40,72,40,0,72,72,-40,40,75,3,1,190,250,206,250,4,1331,1291
1690,3,2.0.35,0,504,3,85,35,120,0,35,120,120,0,0,35,1,3,187,240,187,275,4,1331,1291
1690,3,3.1.40,0,435,0,46,40,86,24,16,86,86,0,35,35,2,2,252,297,276,302,4,1331,1291
1690,3,4.0.35,0,449,2,63,35,98,0,35,98,98,0,0,35,1,3,243,240,243,275,4,1331,1291
1690,3,5.0.35,0,439,1,79,35,114,0,35,114,114,0,0,35,1,3,306,240,306,275,4,1331,1291
1690,4,0.0.35,0,435,0,13,35,48,0,35,48,72,0,0,75,1,3,113,240,113,275,5,1331,1259
1690,4,1.3.72,1,435,0,81,72,153,72,0,153,153,-72,72,147,4,1,158,340,206,340,5,1331,1259
1690,4,2.0.35,0,504,3,85,35,120,0,35,120,120,0,0,75,1,3,187,240,187,275,5,1331,1259
1690,4,3.1.40,0,435,0,46,40,86,24,16,86,86,0,35,75,2,2,252,297,276,302,5,1331,1259
1690,4,4.0.35,0,449,2,63,35,98,0,35,98,98,0,0,75,1,3,243,240,243,275,5,1331,1259
1690,4,5.0.35,0,439,1,79,35,114,0,35,114,114,0,0,75,1,3,306,240,306,275,5,1331,1259
1690,5,0.0.35,0,435,0,13,35,48,0,35,48,153,0,0,147,1,3,113,240,113,275,6,1331,1178
1690,5,1.4.153,1,435,0,77,153,230,153,0,230,230,-153,153,300,5,1,77,164,206,164,6,1331,1178
1690,5,2.0.35,0,504,3,85,35,120,0,35,120,153,0,0,147,1,3,187,240,187,275,6,1331,1178
1690,5,3.1.40,0,435,0,46,40,86,24,16,86,153,0,35,147,2,2,252,297,276,302,6,1331,1178
1690,5,4.0.35,0,449,2,63,35,98,0,35,98,153,0,0,147,1,3,243,240,243,275,6,1331,1178
1690,5,5.0.35,0,439,1,79,35,114,0,35,114,153,0,0,147,1,3,306,240,306,275,6,1331,1178
1690,6,0.0.35,0,435,0,13,35,48,0,35,48,230,0,0,300,1,3,113,240,113,275,7,1331,1101
1690,6,2.0.35,0,504,3,85,35,120,0,35,120,230,0,0,300,1,3,187,240,187,275,7,1331,1101
1690,6,3.1.40,1,435,0,46,40,86,24,16,86,230,0,35,300,2,2,252,297,276,302,7,1331,1101
1690,6,4.0.35,0,449,2,63,35,98,0,35,98,230,0,0,300,1,3,243,240,243,275,7,1331,1101
1690,6,5.0.35,0,439,1,79,35,114,0,35,114,230,0,0,300,1,3,306,240,306,275,7,1331,1101
1690,7,0.0.35,0,435,0,13,35,48,0,35,48,230,0,0,300,1,3,113,240,113,275,8,1331,1055
1690,7,2.0.35,0,504,3,85,35,120,0,35,120,230,0,0,300,1,3,187,240,187,275,8,1331,1055
1690,7,3.2.86,1,435,0,72,86,158,86,0,158,230,-14,54,314,3,2,206,218,276,250,8,1331,1055
1690,7,4.0.35,0,449,2,63,35,98,0,35,98,230,0,0,300,1,3,243,240,243,275,8,1331,1055
1690,7,5.0.35,0,439,1,79,35,114,0,35,114,230,0,0,300,1,3,306,240,306,275,8,1331,1055
1690,8,0.0.35,0,435,0,13,35,48,0,35,48,230,0,0,314,1,3,113,240,113,275,9,1331,983
1690,8,2.0.35,0,504,3,85,35,120,0,35,120,230,0,0,314,1,3,187,240,187,275,9,1331,983
1690,8,3.3.158,1,435,0,91,158,249,158,0,249,249,-5,77,319,4,2,134,259,276,340,9,1331,983
1690,8,4.0.35,0,449,2,63,35,98,0,35,98,230,0,0,314,1,3,243,240,243,275,9,1331,983
1690,8,5.0.35,0,439,1,79,35,114,0,35,114,230,0,0,314,1,3,306,240,306,275,9,1331,983
1690,9,0.0.35,0,435,0,13,35,48,0,35,48,249,0,0,319,1,3,113,240,113,275,10,1331,892
1690,9,2.0.35,0,504,3,85,35,120,0,35,120,249,0,0,319,1,3,187,240,187,275,10,1331,892
1690,9,3.4.249,1,435,0,43,249,292,249,0,292,292,-19,172,338,5,2,43,87,276,164,10,1331,892
1690,9,4.0.35,0,449,2,63,35,98,0,35,98,249,0,0,319,1,3,243,240,243,275,10,1331,892
1690,9,5.0.35,0,439,1,79,35,114,0,35,114,249,0,0,319,1,3,306,240,306,275,10,1331,892
1690,10,0.0.35,0,435,0,13,35,48,0,35,48,292,0,0,338,1,3,113,240,113,275,11,1331,849
1690,10,2.0.35,0,504,3,85,35,120,0,35,120,292,0,0,338,1,3,187,240,187,275,11,1331,849
1690,10,4.0.35,0,449,2,63,35,98,0,35,98,292,0,0,338,1,3,243,240,243,275,11,1331,849
1690,10,5.0.35,1,439,1,79,35,114,0,35,114,292,0,0,338,1,3,306,240,306,275,11,1331,849
1690,11,0.0.114,0,439,0,13,114,127,0,114,127,292,0,0,338,1,4,113,161,113,275,12,1331,770
1690,11,2.0.114,0,459,1,85,114,199,0,114,199,292,0,0,338,1,4,187,161,187,275,12,1331,770
1690,11,4.0.114,1,439,0,63,114,177,0,114,177,292,0,0,338,1,4,243,161,243,275,12,1331,770
1690,11,5.1.114,0,439,0,94,114,208,114,0,208,292,-28,63,366,2,3,227,251,306,302,12,1331,770
1690,12,0.0.177,1,439,0,13,177,190,0,177,190,292,0,0,338,1,5,113,98,113,275,13,1331,707
1690,12,2.0.177,0,439,0,85,177,262,0,177,262,292,0,0,338,1,5,187,98,187,275,13,1331,707
1690,12,4.1.177,0,509,1,54,177,231,177,0,231,292,-91,126,429,2,3,180,251,243,302,13,1331,707
1690,12,5.1.114,0,439,0,94,114,208,114,0,208,292,-28,63,366,2,3,227,251,306,302,13,1331,707
1690,13,0.1.190,0,535,2,37,190,227,190,0,227,292,-104,139,442,2,3,100,251,113,302,14,1331,694
1690,13,2.0.190,1,439,0,85,190,275,0,190,275,292,0,0,338,1,6,187,85,187,275,14,1331,694
1690,13,4.1.177,0,509,1,54,177,231,177,0,231,292,-91,126,429,2,3,180,251,243,302,14,1331,694
1690,13,5.1.114,0,439,0,94,114,208,114,0,208,292,-28,63,366,2,3,227,251,306,302,14,1331,694
1690,14,0.1.190,0,535,3,37,190,227,190,0,227,292,-104,139,442,2,3,100,251,113,302,15,1331,609
1690,14,2.1.275,0,443,1,66,275,341,275,0,341,341,-189,224,527,2,3,102,251,187,302,15,1331,609
1690,14,4.1.177,0,509,2,54,177,231,177,0,231,292,-91,126,429,2,3,180,251,243,302,15,1331,609
1690,14,5.1.114,1,439,0,94,114,208,114,0,208,292,-28,63,366,2,3,227,251,306,302,15,1331,609
1690,15,0.1.208,0,441,1,37,208,245,190,18,245,292,0,63,366,2,4,100,157,113,302,16,1331,515
1690,15,2.1.275,0,443,2,66,275,341,275,0,341,341,-67,130,433,2,4,102,157,187,302,16,1331,515
1690,15,4.1.208,0,439,0,54,208,262,177,31,262,292,0,63,366,2,4,180,157,243,302,16,1331,515
1690,15,5.2.208,1,439,0,59,208,267,208,0,267,292,-50,104,416,3,3,133,146,306,250,16,1331,515
1690,16,0.1.208,0,441,1,37,208,245,190,18,245,292,0,63,416,2,4,100,157,113,302,17,1331,456
1690,16,2.1.275,0,443,2,66,275,341,275,0,341,341,-67,130,483,2,4,102,157,187,302,17,1331,456
1690,16,4.1.208,0,439,0,54,208,262,177,31,262,292,0,63,416,2,4,180,157,243,302,17,1331,456
1690,16,5.3.267,1,439,0,73,267,340,267,0,340,340,-18,95,434,4,3,74,168,306,340,17,1331,456
1690,17,0.1.208,0,441,1,37,208,245,190,18,245,340,0,63,434,2,4,100,157,113,302,18,1331,383
1690,17,2.1.275,0,443,2,66,275,341,275,0,341,341,-67,130,501,2,4,102,157,187,302,18,1331,383
1690,17,4.1.208,0,439,0,54,208,262,177,31,262,340,0,63,434,2,4,180,157,243,302,18,1331,383
1690,17,5.4.340,1,439,0,1,340,341,340,0,341,341,-48,220,482,5,3,1,44,306,164,18,1331,383
1690,18,0.1.208,0,441,1,37,208,245,190,18,245,341,0,63,482,2,4,100,157,113,302,19,1331,382
1690,18,2.1.275,0,443,2,66,275,341,275,0,341,341,-67,130,549,2,4,102,157,187,302,19,1331,382
1690,18,4.1.208,1,439,0,54,208,262,177,31,262,341,0,63,482,2,4,180,157,243,302,19,1331,382
1690,19,0.1.262,0,439,0,37,262,299,190,72,299,341,0,63,482,2,5,100,103,113,302,20,1331,328
1690,19,2.1.275,0,443,1,66,275,341,275,0,341,341,-13,76,495,2,5,102,103,187,302,20,1331,328
1690,19,4.2.267,1,439,0,48,267,315,262,5,315,341,0,104,482,3,4,126,87,243,250,20,1331,328
1690,20,0.1.262,0,439,0,37,262,299,190,72,299,341,0,63,482,2,5,100,103,113,302,21,1331,280
1690,20,2.1.275,0,443,1,66,275,341,275,0,341,341,-13,76,495,2,5,102,103,187,302,21,1331,280
1690,20,4.3.340,1,439,0,47,340,387,315,25,387,387,0,95,482,4,4,78,95,243,340,21,1331,280
1690,21,0.1.262,0,439,0,37,262,299,190,72,299,387,0,63,482,2,5,100,103,113,302,22,1331,233
1690,21,2.1.275,0,443,1,66,275,341,275,0,341,387,-13,76,495,2,5,102,103,187,302,22,1331,233
1690,21,4.4.387,1,439,0,31,387,418,387,0,418,418,-46,266,528,5,4,31,43,243,164,22,1331,233
1690,22,0.1.262,1,439,0,37,262,299,190,72,299,418,0,63,528,2,5,100,103,113,302,23,1331,202
1690,22,2.1.275,0,443,1,66,275,341,275,0,341,418,-13,76,541,2,5,102,103,187,302,23,1331,202
1690,23,0.2.315,1,439,0,36,315,351,299,16,351,418,0,104,528,3,5,63,39,113,250,24,1331,165
1690,23,2.1.299,0,439,0,66,299,365,275,24,365,418,0,63,528,2,6,102,66,187,302,24,1331,165
1690,24,0.3.387,1,439,0,19,387,406,351,36,406,418,0,95,528,4,5,27,48,113,340,25,1331,129
1690,24,2.1.299,0,439,0,66,299,365,275,24,365,418,0,63,528,2,6,102,66,187,302,25,1331,129
1690,25,0.4.418,1,439,0,8,418,426,406,12,426,426,0,266,528,5,5,8,12,113,164,26,1331,110
1690,25,2.1.299,0,439,0,66,299,365,275,24,365,418,0,63,528,2,6,102,66,187,302,26,1331,110
1690,26,2.1.299,1,439,0,66,299,365,275,24,365,426,0,63,528,2,6,102,66,187,302,27,1331,102
1690,27,2.2.365,1,439,0,3,365,368,365,0,368,426,-14,118,542,3,6,36,3,187,250,28,1331,36
1690,28,2.3.406,1,439,0,29,406,435,368,38,435,435,0,95,542,4,6,33,29,187,340,29,1331,33
1690,29,2.4.435,1,439,0,4,435,439,435,0,439,439,-9,275,551,5,6,4,4,187,164,30,1331,4
1691,0,0.0.0,0,628,0,26,0,26,0,0,26,26,0,0,0,1,1,156,388,156,388,1,1695,1695
1691,0,1.0.0,0,633,1,85,0,85,0,0,85,85,0,0,0,1,1,305,388,305,388,1,1695,1695
1691,0,2.0.0,1,628,0,32,0,32,0,0,32,32,0,0,0,1,1,313,388,313,388,1,1695,1695
1691,0,3.0.0,0,628,0,77,0,77,0,0,77,77,0,0,0,1,1,334,388,334,388,1,1695,1695
1691,0,4.0.0,0,711,3,84,0,84,0,0,84,84,0,0,0,1,1,180,388,180,388,1,1695,1695
1691,0,5.0.0,0,677,2,84,0,84,0,0,84,84,0,0,0,1,1,407,388,407,388,1,1695,1695
1691,1,0.0.32,0,628,0,26,32,58,0,32,58,58,0,0,0,1,2,156,356,156,388,2,1695,1663
1691,1,1.0.32,0,629,1,85,32,117,0,32,117,117,0,0,0,1,2,305,356,305,388,2,1695,1663
1691,1,2.1.32,1,628,0,60,32,92,32,0,92,92,-32,32,32,2,1,281,305,313,305,2,1695,1663
1691,1,3.0.32,0,635,2,77,32,109,0,32,109,109,0,0,0,1,2,334,356,334,388,2,1695,1663
1691,1,4.0.32,0,711,4,84,32,116,0,32,116,116,0,0,0,1,2,180,356,180,388,2,1695,1663
1691,1,5.0.32,0,641,3,84,32,116,0,32,116,116,0,0,0,1,2,407,356,407,388,2,1695,1663
1691,2,0.0.32,0,628,0,26,32,58,0,32,58,92,0,0,32,1,2,156,356,156,388,3,1695,1603
1691,2,1.0.32,0,629,1,85,32,117,0,32,117,117,0,0,32,1,2,305,356,305,388,3,1695,1603
1691,2,2.2.92,1,628,0,56,92,148,92,0,148,148,-92,92,124,3,1,221,319,313,319,3,1695,1603
1691,2,3.0.32,0,635,2,77,32,109,0,32,109,109,0,0,32,1,2,334,356,334,388,3,1695,1603
1691,2,4.0.32,0,711,4,84,32,116,0,32,116,116,0,0,32,1,2,180,356,180,388,3,1695,1603
1691,2,5.0.32,0,641,3,84,32,116,0,32,116,116,0,0,32,1,2,407,356,407,388,3,1695,1603
1691,3,0.0.32,0,628,0,26,32,58,0,32,58,148,0,0,124,1,2,156,356,156,388,4,1695,1547
1691,3,1.0.32,0,629,1,85,32,117,0,32,117,148,0,0,124,1,2,305,356,305,388,4,1695,1547
1691,3,2.3.148,1,635,2,97,148,245,148,0,245,245,-148,148,272,4,1,165,293,313,293,4,1695,1547
1691,3,3.0.32,0,635,2,77,32,109,0,32,109,148,0,0,124,1,2,334,356,334,388,4,1695,1547
1691,3,4.0.32,0,711,4,84,32,116,0,32,116,148,0,0,124,1,2,180,356,180,388,4,1695,1547
1691,3,5.0.32,0,641,3,84,32,116,0,32,116,148,0,0,124,1,2,407,356,407,388,4,1695,1547
1691,4,0.0.32,0,635,0,26,32,58,0,32,58,245,0,0,272,1,2,156,356,156,388,5,1695,1450
1691,4,1.0.32,0,635,0,85,32,117,0,32,117,245,0,0,272,1,2,305,356,305,388,5,1695,1450
1691,4,2.4.245,1,635,0,68,245,313,245,0,313,313,-245,245,517,5,1,68,390,313,390,5,1695,1450
1691,4,3.0.32,0,635,0,77,32,109,0,32,109,245,0,0,272,1,2,334,356,334,388,5,1695,1450
1691,4,4.0.32,0,711,2,84,32,116,0,32,116,245,0,0,272,1,2,180,356,180,388,5,1695,1450
1691,4,5.0.32,0,641,1,84,32,116,0,32,116,245,0,0,272,1,2,407,356,407,388,5,1695,1450
1691,5,0.0.32,0,635,0,26,32,58,0,32,58,313,0,0,517,1,2,156,356,156,388,6,1695,1382
1691,5,1.0.32,0,635,0,85,32,117,0,32,117,313,0,0,517,1,2,305,356,305,388,6,1695,1382
1691,5,3.0.32,0,635,0,77,32,109,0,32,109,313,0,0,517,1,2,334,356,334,388,6,1695,1382
1691,5,4.0.32,0,711,2,84,32,116,0,32,116,313,0,0,517,1,2,180,356,180,388,6,1695,1382
1691,5,5.0.32,1,641,1,84,32,116,0,32,116,313,0,0,517,1,2,407,356,407,388,6,1695,1382
1691,6,0.0.116,0,641,0,26,116,142,0,116,142,313,0,0,517,1,3,156,272,156,388,7,1695,1298
1691,6,1.0.116,0,670,3,85,116,201,0,116,201,313,0,0,517,1,3,305,272,305,388,7,1695,1298
1691,6,3.0.116,0,666,2,77,116,193,0,116,193,313,0,0,517,1,3,334,272,334,388,7,1695,1298
1691,6,4.0.116,0,670,3,84,116,200,0,116,200,313,0,0,517,1,3,180,272,180,388,7,1695,1298
1691,6,5.1.116,1,655,1,77,116,193,116,0,193,313,-24,56,541,2,2,323,245,407,305,7,1695,1298
1691,7,0.0.116,0,655,0,26,116,142,0,116,142,313,0,0,541,1,3,156,272,156,388,8,1695,1221
1691,7,1.0.116,0,670,2,85,116,201,0,116,201,313,0,0,541,1,3,305,272,305,388,8,1695,1221
1691,7,3.0.116,0,666,1,77,116,193,0,116,193,313,0,0,541,1,3,334,272,334,388,8,1695,1221
1691,7,4.0.116,0,670,2,84,116,200,0,116,200,313,0,0,541,1,3,180,272,180,388,8,1695,1221
1691,7,5.2.193,1,670,2,97,193,290,193,0,290,313,-45,137,586,3,2,246,263,407,319,8,1695,1221
1691,8,0.0.116,0,670,0,26,116,142,0,116,142,313,0,0,586,1,3,156,272,156,388,9,1695,1124
1691,8,1.0.116,0,670,0,85,116,201,0,116,201,313,0,0,586,1,3,305,272,305,388,9,1695,1124
1691,8,3.0.116,0,670,0,77,116,193,0,116,193,313,0,0,586,1,3,334,272,334,388,9,1695,1124
1691,8,4.0.116,0,670,0,84,116,200,0,116,200,313,0,0,586,1,3,180,272,180,388,9,1695,1124
1691,8,5.3.290,1,670,0,58,290,348,290,0,348,348,-45,193,631,4,2,149,196,407,293,9,1695,1124
1691,9,0.0.116,0,670,0,26,116,142,0,116,142,348,0,0,631,1,3,156,272,156,388,10,1695,1066
1691,9,1.0.116,0,670,0,85,116,201,0,116,201,348,0,0,631,1,3,305,272,305,388,10,1695,1066
1691,9,3.0.116,0,670,0,77,116,193,0,116,193,348,0,0,631,1,3,334,272,334,388,10,1695,1066
1691,9,4.0.116,0,670,0,84,116,200,0,116,200,348,0,0,631,1,3,180,272,180,388,10,1695,1066
1691,9,5.4.348,1,670,0,91,348,439,348,0,439,439,-35,280,666,5,2,91,322,407,390,10,1695,1066
1691,10,0.0.116,0,670,0,26,116,142,0,116,142,439,0,0,666,1,3,156,272,156,388,11,1695,975
1691,10,1.0.116,0,670,0,85,116,201,0,116,201,439,0,0,666,1,3,305,272,305,388,11,1695,975
1691,10,3.0.116,1,670,0,77,116,193,0,116,193,439,0,0,666,1,3,334,272,334,388,11,1695,975
1691,10,4.0.116,0,670,0,84,116,200,0,116,200,439,0,0,666,1,3,180,272,180,388,11,1695,975
1691,11,0.0.193,0,670,0,26,193,219,0,193,219,439,0,0,666,1,4,156,195,156,388,12,1695,898
1691,11,1.0.193,0,670,0,85,193,278,0,193,278,439,0,0,666,1,4,305,195,305,388,12,1695,898
1691,11,3.1.193,1,670,0,84,193,277,193,0,277,439,0,56,666,2,3,257,168,334,305,12,1695,898
1691,11,4.0.193,0,670,0,84,193,277,0,193,277,439,0,0,666,1,4,180,195,180,388,12,1695,898
1691,12,0.0.193,0,670,0,26,193,219,0,193,219,439,0,0,666,1,4,156,195,156,388,13,1695,814
1691,12,1.0.193,0,670,0,85,193,278,0,193,278,439,0,0,666,1,4,305,195,305,388,13,1695,814
1691,12,3.2.290,1,670,0,39,290,329,277,13,329,439,0,137,666,3,3,173,166,334,319,13,1695,814
1691,12,4.0.193,0,670,0,84,193,277,0,193,277,439,0,0,666,1,4,180,195,180,388,13,1695,814
1691,13,0.0.193,0,670,0,26,193,219,0,193,219,439,0,0,666,1,4,156,195,156,388,14,1695,775
1691,13,1.0.193,0,670,0,85,193,278,0,193,278,439,0,0,666,1,4,305,195,305,388,14,1695,775
1691,13,3.3.348,1,670,0,50,348,398,329,19,398,439,0,193,666,4,3,134,138,334,293,14,1695,775
1691,13,4.0.193,0,670,0,84,193,277,0,193,277,439,0,0,666,1,4,180,195,180,388,14,1695,775
1691,14,0.0.193,0,670,0,26,193,219,0,193,219,439,0,0,666,1,4,156,195,156,388,15,1695,725
1691,14,1.0.193,1,670,0,85,193,278,0,193,278,439,0,0,666,1,4,305,195,305,388,15,1695,725
1691,14,3.4.439,0,670,0,84,439,523,398,41,523,523,0,280,666,5,3,84,231,334,390,15,1695,725
1691,14,4.0.193,0,670,0,84,193,277,0,193,277,439,0,0,666,1,4,180,195,180,388,15,1695,725
1691,15,0.0.278,1,670,0,26,278,304,0,278,304,439,0,0,666,1,5,156,110,156,388,16,1695,640
1691,15,1.1.278,0,670,0,73,278,351,278,0,351,439,-1,57,667,2,4,220,84,305,305,16,1695,640
1691,15,3.4.439,0,670,0,84,439,523,398,41,523,523,0,280,666,5,3,84,231,334,390,16,1695,640
1691,15,4.0.278,0,670,0,84,278,362,0,278,362,439,0,0,666,1,5,180,110,180,388,16,1695,640
1691,16,0.1.304,0,670,0,5,304,309,304,0,309,439,-27,83,693,2,4,130,84,156,305,17,1695,614
1691,16,1.1.278,0,670,0,73,278,351,278,0,351,439,-1,57,667,2,4,220,84,305,305,17,1695,614
1691,16,3.4.439,0,670,0,84,439,523,398,41,523,523,0,280,666,5,3,84,231,334,390,17,1695,614
1691,16,4.0.304,1,670,0,84,304,388,0,304,388,439,0,0,666,1,6,180,84,180,388,17,1695,614
1691,17,0.1.304,0,670,0,5,304,309,304,0,309,439,-27,83,693,2,4,130,84,156,305,18,1695,530
1691,17,1.1.278,1,670,0,73,278,351,278,0,351,439,-1,57,667,2,4,220,84,305,305,18,1695,530
1691,17,3.4.439,0,670,0,84,439,523,398,41,523,523,0,280,666,5,3,84,231,334,390,18,1695,530
1691,17,4.1.388,0,670,0,6,388,394,388,0,394,439,-111,167,777,2,4,96,84,180,305,18,1695,530
1691,18,0.1.351,1,670,0,5,351,356,304,47,356,439,0,57,667,2,5,130,11,156,305,19,1695,457
1691,18,1.2.351,0,670,0,38,351,389,351,0,389,439,-22,159,689,3,4,147,127,305,319,19,1695,457
1691,18,3.4.439,0,670,0,84,439,523,398,41,523,523,0,280,667,5,3,84,231,334,390,19,1695,457
1691,18,4.1.388,0,670,0,6,388,394,388,0,394,439,-37,94,704,2,5,96,11,180,305,19,1695,457
1691,19,0.2.356,0,670,0,40,356,396,356,0,396,439,-27,164,694,3,4,125,127,156,319,20,1695,452
1691,19,1.2.351,0,670,0,38,351,389,351,0,389,439,-22,159,689,3,4,147,127,305,319,20,1695,452
1691,19,3.4.439,0,670,0,84,439,523,398,41,523,523,0,280,667,5,3,84,231,334,390,20,1695,452
1691,19,4.1.388,1,670,0,6,388,394,388,0,394,439,-32,89,699,2,6,96,6,180,305,20,1695,452
1691,20,0.2.356,0,670,0,40,356,396,356,0,396,439,-27,164,726,3,4,125,127,156,319,21,1695,446
1691,20,1.2.351,1,670,0,38,351,389,351,0,389,439,-22,159,721,3,4,147,127,305,319,21,1695,446
1691,20,3.4.439,0,670,0,84,439,523,398,41,523,523,0,280,699,5,3,84,231,334,390,21,1695,446
1691,20,4.2.394,0,670,0,49,394,443,394,0,443,443,-65,202,764,3,4,90,127,180,319,21,1695,446
1691,21,0.2.389,0,670,0,40,389,429,356,33,429,439,0,159,721,3,5,125,89,156,319,22,1695,408
1691,21,1.3.398,1,670,0,23,398,421,389,9,421,439,0,193,721,4,4,109,88,305,293,22,1695,408
1691,21,3.4.439,0,670,0,84,439,523,398,41,523,523,0,280,721,5,3,84,231,334,390,22,1695,408
1691,21,4.2.394,0,670,0,49,394,443,394,0,443,443,-5,164,726,3,5,90,89,180,319,22,1695,408
1691,22,0.2.389,1,670,0,40,389,429,356,33,429,439,0,159,721,3,5,125,89,156,319,23,1695,385
1691,22,1.4.439,0,670,0,86,439,525,421,18,525,525,0,280,721,5,3,86,231,305,390,23,1695,385
1691,22,3.4.439,0,670,0,84,439,523,398,41,523,523,0,280,721,5,3,84,231,334,390,23,1695,385
1691,22,4.2.394,0,670,0,49,394,443,394,0,443,443,-5,164,726,3,5,90,89,180,319,23,1695,385
1691,23,0.3.429,1,670,0,25,429,454,429,0,454,454,-8,201,729,4,5,85,65,156,293,24,1695,345
1691,23,1.4.439,0,670,0,86,439,525,421,18,525,525,0,280,721,5,3,86,231,305,390,24,1695,345
1691,23,3.4.439,0,670,0,84,439,523,398,41,523,523,0,280,721,5,3,84,231,334,390,24,1695,345
1691,23,4.2.429,0,670,0,49,429,478,394,35,478,478,0,159,721,3,6,90,49,180,319,24,1695,345
1691,24,0.4.454,0,685,1,60,454,514,454,0,514,514,-15,295,744,5,3,60,231,156,390,25,1695,320
1691,24,1.4.439,0,670,0,86,439,525,421,18,525,525,0,280,729,5,3,86,231,305,390,25,1695,320
1691,24,3.4.439,0,670,0,84,439,523,398,41,523,523,0,280,729,5,3,84,231,334,390,25,1695,320
1691,24,4.2.429,1,670,0,49,429,478,394,35,478,478,0,159,729,3,6,90,49,180,319,25,1695,320
1691,25,0.4.454,0,685,1,60,454,514,454,0,514,514,-15,295,744,5,3,60,231,156,390,26,1695,271
1691,25,1.4.439,0,670,0,86,439,525,421,18,525,525,0,280,729,5,3,86,231,305,390,26,1695,271
1691,25,3.4.439,0,670,0,84,439,523,398,41,523,523,0,280,729,5,3,84,231,334,390,26,1695,271
1691,25,4.3.478,1,670,0,40,478,518,478,0,518,518,-24,225,753,4,6,41,40,180,293,26,1695,271
1691,26,0.4.454,0,685,1,60,454,514,454,0,514,518,-15,295,768,5,3,60,231,156,390,27,1695,231
1691,26,1.4.439,0,670,0,86,439,525,421,18,525,525,0,280,753,5,3,86,231,305,390,27,1695,231
1691,26,3.4.439,1,670,0,84,439,523,398,41,523,523,0,280,753,5,3,84,231,334,390,27,1695,231
1691,26,4.4.518,0,689,2,1,518,519,518,0,519,519,-79,359,832,5,3,1,231,180,390,27,1695,231
1691,27,0.4.523,0,670,0,60,523,583,454,69,583,583,0,280,753,5,4,60,147,156,390,28,1695,147
1691,27,1.4.523,0,670,0,86,523,609,421,102,609,609,0,280,753,5,4,86,147,305,390,28,1695,147
1691,27,4.4.523,1,670,0,1,523,524,518,5,524,524,0,280,753,5,4,1,147,180,390,28,1695,147
1691,28,0.4.524,0,670,0,60,524,584,454,70,584,584,0,280,753,5,5,60,146,156,390,29,1695,146
1691,28,1.4.524,1,670,0,86,524,610,421,103,610,610,0,280,753,5,5,86,146,305,390,29,1695,146
1691,29,0.4.610,1,670,0,60,610,670,454,156,670,670,0,280,753,5,6,60,60,156,390,30,1695,60
1692,0,0.0.0,0,506,2,39,0,39,0,0,39,39,0,0,0,1,1,199,304,199,304,1,1366,1366
1692,0,1.0.0,0,521,3,61,0,61,0,0,61,61,0,0,0,1,1,305,304,305,304,1,1366,1366
1692,0,2.0.0,0,544,5,77,0,77,0,0,77,77,0,0,0,1,1,239,304,239,304,1,1366,1366
1692,0,3.0.0,0,490,1,31,0,31,0,0,31,31,0,0,0,1,1,96,304,96,304,1,1366,1366
1692,0,4.0.0,1,471,0,7,0,7,0,0,7,7,0,0,0,1,1,217,304,217,304,1,1366,1366
1692,0,5.0.0,0,539,4,89,0,89,0,0,89,89,0,0,0,1,1,310,304,310,304,1,1366,1366
1692,1,0.0.7,0,498,3,39,7,46,0,7,46,46,0,0,0,1,2,199,297,199,304,2,1366,1359
1692,1,1.0.7,0,471,0,61,7,68,0,7,68,68,0,0,0,1,2,305,297,305,304,2,1366,1359
1692,1,2.0.7,0,500,4,77,7,84,0,7,84,84,0,0,0,1,2,239,297,239,304,2,1366,1359
1692,1,3.0.7,0,478,1,31,7,38,0,7,38,38,0,0,0,1,2,96,297,96,304,2,1366,1359
1692,1,4.1.7,1,471,0,57,7,64,7,0,64,64,-7,7,7,2,1,210,306,217,306,2,1366,1359
1692,1,5.0.7,0,479,2,89,7,96,0,7,96,96,0,0,0,1,2,310,297,310,304,2,1366,1359
1692,2,0.0.7,0,498,3,39,7,46,0,7,46,64,0,0,7,1,2,199,297,199,304,3,1366,1302
1692,2,1.0.7,0,471,0,61,7,68,0,7,68,68,0,0,7,1,2,305,297,305,304,3,1366,1302
1692,2,2.0.7,0,500,4,77,7,84,0,7,84,84,0,0,7,1,2,239,297,239,304,3,1366,1302
1692,2,3.0.7,0,478,1,31,7,38,0,7,38,64,0,0,7,1,2,96,297,96,304,3,1366,1302
1692,2,4.2.64,1,471,0,49,64,113,64,0,113,113,-64,64,71,3,1,153,187,217,187,3,1366,1302
1692,2,5.0.7,0,479,2,89,7,96,0,7,96,96,0,0,7,1,2,310,297,310,304,3,1366,1302
1692,3,0.0.7,0,498,3,39,7,46,0,7,46,113,0,0,71,1,2,199,297,199,304,4,1366,1253
1692,3,1.0.7,0,471,0,61,7,68,0,7,68,113,0,0,71,1,2,305,297,305,304,4,1366,1253
1692,3,2.0.7,0,500,4,77,7,84,0,7,84,113,0,0,71,1,2,239,297,239,304,4,1366,1253
1692,3,3.0.7,0,478,1,31,7,38,0,7,38,113,0,0,71,1,2,96,297,96,304,4,1366,1253
1692,3,4.3.113,1,471,0,33,113,146,113,0,146,146,-113,113,184,4,1,104,248,217,248,4,1366,1253
1692,3,5.0.7,0,479,2,89,7,96,0,7,96,113,0,0,71,1,2,310,297,310,304,4,1366,1253
1692,4,0.0.7,0,498,3,39,7,46,0,7,46,146,0,0,184,1,2,199,297,199,304,5,1366,1220
1692,4,1.0.7,0,471,0,61,7,68,0,7,68,146,0,0,184,1,2,305,297,305,304,5,1366,1220
1692,4,2.0.7,0,500,4,77,7,84,0,7,84,146,0,0,184,1,2,239,297,239,304,5,1366,1220
1692,4,3.0.7,0,478,1,31,7,38,0,7,38,146,0,0,184,1,2,96,297,96,304,5,1366,1220
1692,4,4.4.146,1,471,0,71,146,217,146,0,217,217,-146,146,330,5,1,71,321,217,321,5,1366,1220
1692,4,5.0.7,0,479,2,89,7,96,0,7,96,146,0,0,184,1,2,310,297,310,304,5,1366,1220
1692,5,0.0.7,0,498,3,39,7,46,0,7,46,217,0,0,330,1,2,199,297,199,304,6,1366,1149
1692,5,1.0.7,1,471,0,61,7,68,0,7,68,217,0,0,330,1,2,305,297,305,304,6,1366,1149
1692,5,2.0.7,0,500,4,77,7,84,0,7,84,217,0,0,330,1,2,239,297,239,304,6,1366,1149
1692,5,3.0.7,0,478,1,31,7,38,0,7,38,217,0,0,330,1,2,96,297,96,304,6,1366,1149
1692,5,5.0.7,0,479,2,89,7,96,0,7,96,217,0,0,330,1,2,310,297,310,304,6,1366,1149
1692,6,0.0.68,0,471,0,39,68,107,0,68,107,217,0,0,330,1,3,199,236,199,304,7,1366,1088
1692,6,1.1.68,1,471,0,41,68,109,68,0,109,217,-4,11,334,2,2,244,249,305,306,7,1366,1088
1692,6,2.0.68,0,484,2,77,68,145,0,68,145,217,0,0,330,1,3,239,236,239,304,7,1366,1088
1692,6,3.0.68,0,478,1,31,68,99,0,68,99,217,0,0,330,1,3,96,236,96,304,7,1366,1088
1692,6,5.0.68,0,471,0,89,68,157,0,68,157,217,0,0,330,1,3,310,236,310,304,7,1366,1088
1692,7,0.0.68,0,471,0,39,68,107,0,68,107,217,0,0,334,1,3,199,236,199,304,8,1366,1047
1692,7,1.2.113,1,471,0,43,113,156,109,4,156,217,0,64,334,3,2,203,138,305,187,8,1366,1047
1692,7,2.0.68,0,484,2,77,68,145,0,68,145,217,0,0,334,1,3,239,236,239,304,8,1366,1047
1692,7,3.0.68,0,478,1,31,68,99,0,68,99,217,0,0,334,1,3,96,236,96,304,8,1366,1047
1692,7,5.0.68,0,471,0,89,68,157,0,68,157,217,0,0,334,1,3,310,236,310,304,8,1366,1047
1692,8,0.0.68,0,471,0,39,68,107,0,68,107,217,0,0,334,1,3,199,236,199,304,9,1366,1004
1692,8,1.3.156,1,471,0,65,156,221,156,0,221,221,-10,123,344,4,2,160,215,305,248,9,1366,1004
1692,8,2.0.68,0,484,2,77,68,145,0,68,145,217,0,0,334,1,3,239,236,239,304,9,1366,1004
1692,8,3.0.68,0,478,1,31,68,99,0,68,99,217,0,0,334,1,3,96,236,96,304,9,1366,1004
1692,8,5.0.68,0,471,0,89,68,157,0,68,157,217,0,0,334,1,3,310,236,310,304,9,1366,1004
1692,9,0.0.68,0,471,0,39,68,107,0,68,107,221,0,0,344,1,3,199,236,199,304,10,1366,939
1692,9,1.4.221,1,471,0,95,221,316,221,0,316,316,-4,150,348,5,2,95,250,305,321,10,1366,939
1692,9,2.0.68,0,484,2,77,68,145,0,68,145,221,0,0,344,1,3,239,236,239,304,10,1366,939
1692,9,3.0.68,0,478,1,31,68,99,0,68,99,221,0,0,344,1,3,96,236,96,304,10,1366,939
1692,9,5.0.68,0,471,0,89,68,157,0,68,157,221,0,0,344,1,3,310,236,310,304,10,1366,939
1692,10,0.0.68,1,471,0,39,68,107,0,68,107,316,0,0,348,1,3,199,236,199,304,11,1366,844
1692,10,2.0.68,0,484,2,77,68,145,0,68,145,316,0,0,348,1,3,239,236,239,304,11,1366,844
1692,10,3.0.68,0,478,1,31,68,99,0,68,99,316,0,0,348,1,3,96,236,96,304,11,1366,844
1692,10,5.0.68,0,471,0,89,68,157,0,68,157,316,0,0,348,1,3,310,236,310,304,11,1366,844
1692,11,0.1.109,0,471,0,72,109,181,107,2,181,316,0,11,348,2,3,160,208,199,306,12,1366,805
1692,11,2.0.107,0,510,2,77,107,184,0,107,184,316,0,0,348,1,4,239,197,239,304,12,1366,805
1692,11,3.0.107,0,482,1,31,107,138,0,107,138,316,0,0,348,1,4,96,197,96,304,12,1366,805
1692,11,5.0.107,1,471,0,89,107,196,0,107,196,316,0,0,348,1,4,310,197,310,304,12,1366,805
1692,12,0.1.109,0,471,0,72,109,181,107,2,181,316,0,11,348,2,3,160,208,199,306,13,1366,716
1692,12,2.0.196,1,477,1,77,196,273,0,196,273,316,0,0,348,1,5,239,108,239,304,13,1366,716
1692,12,3.0.196,0,471,0,31,196,227,0,196,227,316,0,0,348,1,5,96,108,96,304,13,1366,716
1692,12,5.1.196,0,471,0,60,196,256,196,0,256,316,-87,98,435,2,3,221,208,310,306,13,1366,716
1692,13,0.1.109,0,477,0,72,109,181,107,2,181,316,0,11,348,2,3,160,208,199,306,14,1366,639
1692,13,2.1.273,0,477,0,53,273,326,273,0,326,326,-164,175,512,2,3,162,208,239,306,14,1366,639
1692,13,3.0.273,1,477,0,31,273,304,0,273,304,316,0,0,348,1,6,96,31,96,304,14,1366,639
1692,13,5.1.196,0,477,0,60,196,256,196,0,256,316,-87,98,435,2,3,221,208,310,306,14,1366,639
1692,14,0.1.109,1,477,0,72,109,181,107,2,181,316,0,11,348,2,3,160,208,199,306,15,1366,608
1692,14,2.1.273,0,477,0,53,273,326,273,0,326,326,-164,175,512,2,3,162,208,239,306,15,1366,608
1692,14,3.1.304,0,489,1,23,304,327,304,0,327,327,-195,206,543,2,3,65,208,96,306,15,1366,608
1692,14,5.1.196,0,477,0,60,196,256,196,0,256,316,-87,98,435,2,3,221,208,310,306,15,1366,608
1692,15,0.2.181,1,477,0,43,181,224,181,0,224,316,-25,89,373,3,3,88,95,199,187,16,1366,536
1692,15,2.1.273,0,477,0,53,273,326,273,0,326,326,-92,103,440,2,4,162,136,239,306,16,1366,536
1692,15,3.1.304,0,489,1,23,304,327,304,0,327,327,-123,134,471,2,4,65,136,96,306,16,1366,536
1692,15,5.1.196,0,477,0,60,196,256,196,0,256,316,-15,26,363,2,4,221,136,310,306,16,1366,536
1692,16,0.3.224,1,477,0,32,224,256,224,0,256,316,-3,126,376,4,3,45,150,199,248,17,1366,493
1692,16,2.1.273,0,477,0,53,273,326,273,0,326,326,-92,103,465,2,4,162,136,239,306,17,1366,493
1692,16,3.1.304,0,489,1,23,304,327,304,0,327,327,-123,134,496,2,4,65,136,96,306,17,1366,493
1692,16,5.1.196,0,477,0,60,196,256,196,0,256,316,-15,26,388,2,4,221,136,310,306,17,1366,493
1692,17,0.4.316,1,477,0,13,316,329,256,60,329,329,0,150,376,5,3,13,155,199,321,18,1366,461
1692,17,2.1.273,0,477,0,53,273,326,273,0,326,326,-92,103,468,2,4,162,136,239,306,18,1366,461
1692,17,3.1.304,0,489,1,23,304,327,304,0,327,327,-123,134,499,2,4,65,136,96,306,18,1366,461
1692,17,5.1.196,0,477,0,60,196,256,196,0,256,316,-15,26,391,2,4,221,136,310,306,18,1366,461
1692,18,2.1.273,0,477,0,53,273,326,273,0,326,329,-92,103,468,2,4,162,136,239,306,19,1366,448
1692,18,3.1.304,0,489,1,23,304,327,304,0,327,329,-123,134,499,2,4,65,136,96,306,19,1366,448
1692,18,5.1.196,1,477,0,60,196,256,196,0,256,329,-15,26,391,2,4,221,136,310,306,19,1366,448
1692,19,2.1.273,0,477,0,53,273,326,273,0,326,329,-17,43,408,2,5,162,76,239,306,20,1366,388
1692,19,3.1.304,0,489,1,23,304,327,304,0,327,329,-48,74,439,2,5,65,76,96,306,20,1366,388
1692,19,5.2.256,1,477,0,36,256,292,256,0,292,329,-32,121,423,3,4,161,52,310,187,20,1366,388
1692,20,2.1.273,0,477,0,53,273,326,273,0,326,329,-17,43,440,2,5,162,76,239,306,21,1366,352
1692,20,3.1.304,0,489,1,23,304,327,304,0,327,329,-48,74,471,2,5,65,76,96,306,21,1366,352
1692,20,5.3.292,1,477,0,43,292,335,292,0,335,335,-36,162,459,4,4,125,118,310,248,21,1366,352
1692,21,2.1.273,0,477,0,53,273,326,273,0,326,335,-17,43,476,2,5,162,76,239,306,22,1366,309
1692,21,3.1.304,0,489,1,23,304,327,304,0,327,335,-48,74,507,2,5,65,76,96,306,22,1366,309
1692,21,5.4.335,1,477,0,82,335,417,335,0,417,417,-6,156,465,5,4,82,142,310,321,22,1366,309
1692,22,2.1.273,1,477,0,53,273,326,273,0,326,417,-17,43,482,2,5,162,76,239,306,23,1366,227
1692,22,3.1.304,0,489,1,23,304,327,304,0,327,417,-48,74,513,2,5,65,76,96,306,23,1366,227
1692,23,2.2.326,1,477,0,9,326,335,326,0,335,417,-34,155,516,3,5,109,16,239,187,24,1366,174
1692,23,3.1.326,0,477,0,23,326,349,304,22,349,417,0,43,482,2,6,65,23,96,306,24,1366,174
1692,24,2.3.335,1,477,0,66,335,401,335,0,401,417,0,162,516,4,5,100,75,239,248,25,1366,165
1692,24,3.1.326,0,477,0,23,326,349,304,22,349,417,0,43,516,2,6,65,23,96,306,25,1366,165
1692,25,2.4.417,1,477,0,34,417,451,401,16,451,451,0,156,516,5,5,34,60,239,321,26,1366,99
1692,25,3.1.326,0,477,0,23,326,349,304,22,349,417,0,43,516,2,6,65,23,96,306,26,1366,99
1692,26,3.1.326,1,477,0,23,326,349,304,22,349,451,0,43,516,2,6,65,23,96,306,27,1366,65
1692,27,3.2.349,1,477,0,7,349,356,349,0,356,451,-14,169,530,3,6,42,7,96,187,28,1366,42
1692,28,3.3.401,1,477,0,9,401,410,356,45,410,451,0,162,530,4,6,35,9,96,248,29,1366,35
1692,29,3.4.451,1,477,0,26,451,477,410,41,477,477,0,156,530,5,6,26,26,96,321,30,1366,26
1693,0,0.0.0,0,537,0,52,0,52,0,0,52,52,0,0,0,1,1,243,319,243,319,1,1436,1436
1693,0,1.0.0,0,569,1,37,0,37,0,0,37,37,0,0,0,1,1,106,319,106,319,1,1436,1436
1693,0,2.0.0,1,537,0,24,0,24,0,0,24,24,0,0,0,1,1,266,319,266,319,1,1436,1436
1693,0,3.0.0,0,590,3,84,0,84,0,0,84,84,0,0,0,1,1,354,319,354,319,1,1436,1436
1693,0,4.0.0,0,537,0,29,0,29,0,0,29,29,0,0,0,1,1,156,319,156,319,1,1436,1436
1693,0,5.0.0,0,589,2,93,0,93,0,0,93,93,0,0,0,1,1,311,319,311,319,1,1436,1436
1693,1,0.0.24,0,537,0,52,24,76,0,24,76,76,0,0,0,1,2,243,295,243,319,2,1436,1412
1693,1,1.0.24,0,569,3,37,24,61,0,24,61,61,0,0,0,1,2,106,295,106,319,2,1436,1412
1693,1,2.1.24,1,537,0,47,24,71,24,0,71,71,-24,24,24,2,1,242,211,266,211,2,1436,1412
1693,1,3.0.24,0,560,2,84,24,108,0,24,108,108,0,0,0,1,2,354,295,354,319,2,1436,1412
1693,1,4.0.24,0,537,0,29,24,53,0,24,53,53,0,0,0,1,2,156,295,156,319,2,1436,1412
1693,1,5.0.24,0,557,1,93,24,117,0,24,117,117,0,0,0,1,2,311,295,311,319,2,1436,1412
1693,2,0.0.24,0,537,0,52,24,76,0,24,76,76,0,0,24,1,2,243,295,243,319,3,1436,1365
1693,2,1.0.24,0,569,3,37,24,61,0,24,61,71,0,0,24,1,2,106,295,106,319,3,1436,1365
1693,2,2.2.71,1,537,0,61,71,132,71,0,132,132,-71,71,95,3,1,195,353,266,353,3,1436,1365
1693,2,3.0.24,0,560,2,84,24,108,0,24,108,108,0,0,24,1,2,354,295,354,319,3,1436,1365
1693,2,4.0.24,0,537,0,29,24,53,0,24,53,71,0,0,24,1,2,156,295,156,319,3,1436,1365
1693,2,5.0.24,0,557,1,93,24,117,0,24,117,117,0,0,24,1,2,311,295,311,319,3,1436,1365
1693,3,0.0.24,0,537,0,52,24,76,0,24,76,132,0,0,95,1,2,243,295,243,319,4,1436,1304
1693,3,1.0.24,0,569,3,37,24,61,0,24,61,132,0,0,95,1,2,106,295,106,319,4,1436,1304
1693,3,2.3.132,1,537,0,35,132,167,132,0,167,167,-132,132,227,4,1,134,202,266,202,4,1436,1304
1693,3,3.0.24,0,560,2,84,24,108,0,24,108,132,0,0,95,1,2,354,295,354,319,4,1436,1304
1693,3,4.0.24,0,537,0,29,24,53,0,24,53,132,0,0,95,1,2,156,295,156,319,4,1436,1304
1693,3,5.0.24,0,557,1,93,24,117,0,24,117,132,0,0,95,1,2,311,295,311,319,4,1436,1304
1693,4,0.0.24,0,537,0,52,24,76,0,24,76,167,0,0,227,1,2,243,295,243,319,5,1436,1269
1693,4,1.0.24,0,569,3,37,24,61,0,24,61,167,0,0,227,1,2,106,295,106,319,5,1436,1269
1693,4,2.4.167,1,537,0,99,167,266,167,0,266,266,-167,167,394,5,1,99,351,266,351,5,1436,1269
1693,4,3.0.24,0,560,2,84,24,108,0,24,108,167,0,0,227,1,2,354,295,354,319,5,1436,1269
1693,4,4.0.24,0,537,0,29,24,53,0,24,53,167,0,0,227,1,2,156,295,156,319,5,1436,1269
1693,4,5.0.24,0,557,1,93,24,117,0,24,117,167,0,0,227,1,2,311,295,311,319,5,1436,1269
1693,5,0.0.24,0,537,0,52,24,76,0,24,76,266,0,0,394,1,2,243,295,243,319,6,1436,1170
1693,5,1.0.24,0,569,3,37,24,61,0,24,61,266,0,0,394,1,2,106,295,106,319,6,1436,1170
1693,5,3.0.24,1,560,2,84,24,108,0,24,108,266,0,0,394,1,2,354,295,354,319,6,1436,1170
1693,5,4.0.24,0,537,0,29,24,53,0,24,53,266,0,0,394,1,2,156,295,156,319,6,1436,1170
1693,5,5.0.24,0,557,1,93,24,117,0,24,117,266,0,0,394,1,2,311,295,311,319,6,1436,1170
1693,6,0.0.108,0,562,1,52,108,160,0,108,160,266,0,0,394,1,3,243,211,243,319,7,1436,1086
1693,6,1.0.108,0,562,1,37,108,145,0,108,145,266,0,0,394,1,3,106,211,106,319,7,1436,1086
1693,6,3.1.108,1,562,1,61,108,169,108,0,169,266,-37,61,431,2,2,270,164,354,211,7,1436,1086
1693,6,4.0.108,0,560,0,29,108,137,0,108,137,266,0,0,394,1,3,156,211,156,319,7,1436,1086
1693,6,5.0.108,0,562,1,93,108,201,0,108,201,266,0,0,394,1,3,311,211,311,319,7,1436,1086
1693,7,0.0.108,1,562,0,52,108,160,0,108,160,266,0,0,431,1,3,243,211,243,319,8,1436,1025
1693,7,1.0.108,0,562,0,37,108,145,0,108,145,266,0,0,431,1,3,106,211,106,319,8,1436,1025
1693,7,3.2.169,0,562,0,73,169,242,169,0,242,266,-37,108,468,3,2,209,292,354,353,8,1436,1025
1693,7,4.0.108,0,562,0,29,108,137,0,108,137,266,0,0,431,1,3,156,211,156,319,8,1436,1025
1693,7,5.0.108,0,562,0,93,108,201,0,108,201,266,0,0,431,1,3,311,211,311,319,8,1436,1025
1693,8,0.1.169,1,562,0,40,169,209,160,9,209,266,0,61,431,2,3,191,103,243,211,9,1436,973
1693,8,1.0.160,0,562,0,37,160,197,0,160,197,266,0,0,431,1,4,106,159,106,319,9,1436,973
1693,8,3.2.169,0,562,0,73,169,242,169,0,242,266,-37,108,468,3,2,209,292,354,353,9,1436,973
1693,8,4.0.160,0,562,0,29,160,189,0,160,189,266,0,0,431,1,4,156,159,156,319,9,1436,973
1693,8,5.0.160,0,562,0,93,160,253,0,160,253,266,0,0,431,1,4,311,159,311,319,9,1436,973
1693,9,0.2.209,0,584,1,47,209,256,209,0,256,266,-77,148,508,3,2,151,292,243,353,10,1436,933
1693,9,1.0.160,0,562,0,37,160,197,0,160,197,266,0,0,431,1,4,106,159,106,319,10,1436,933
1693,9,3.2.169,0,562,0,73,169,242,169,0,242,266,-37,108,468,3,2,209,292,354,353,10,1436,933
1693,9,4.0.160,1,562,0,29,160,189,0,160,189,266,0,0,431,1,4,156,159,156,319,10,1436,933
1693,9,5.0.160,0,562,0,93,160,253,0,160,253,266,0,0,431,1,4,311,159,311,319,10,1436,933
1693,10,0.2.209,0,584,1,47,209,256,209,0,256,266,-77,148,508,3,2,151,292,243,353,11,1436,904
1693,10,1.0.189,0,562,0,37,189,226,0,189,226,266,0,0,431,1,5,106,130,106,319,11,1436,904
1693,10,3.2.169,0,562,0,73,169,242,169,0,242,266,-37,108,468,3,2,209,292,354,353,11,1436,904
1693,10,4.1.209,1,562,0,10,209,219,189,20,219,266,0,61,431,2,4,127,63,156,211,11,1436,904
1693,10,5.0.189,0,562,0,93,189,282,0,189,282,282,0,0,431,1,5,311,130,311,319,11,1436,904
1693,11,0.2.209,0,584,1,47,209,256,209,0,256,266,-77,148,508,3,2,151,292,243,353,12,1436,894
1693,11,1.0.189,0,562,0,37,189,226,0,189,226,266,0,0,431,1,5,106,130,106,319,12,1436,894
1693,11,3.2.169,0,562,0,73,169,242,169,0,242,266,-37,108,468,3,2,209,292,354,353,12,1436,894
1693,11,4.2.219,0,603,2,50,219,269,219,0,269,269,-87,158,518,3,2,117,292,156,353,12,1436,894
1693,11,5.0.189,1,562,0,93,189,282,0,189,282,282,0,0,431,1,5,311,130,311,319,12,1436,894
1693,12,0.2.209,0,584,1,47,209,256,209,0,256,282,-77,148,508,3,2,151,292,243,353,13,1436,801
1693,12,1.0.282,0,562,0,37,282,319,0,282,319,319,0,0,431,1,6,106,37,106,319,13,1436,801
1693,12,3.2.169,0,562,0,73,169,242,169,0,242,282,-37,108,468,3,2,209,292,354,353,13,1436,801
1693,12,4.2.219,0,603,2,50,219,269,219,0,269,282,-87,158,518,3,2,117,292,156,353,13,1436,801
1693,12,5.1.282,1,562,0,44,282,326,282,0,326,326,-63,124,494,2,5,218,53,311,211,13,1436,801
1693,13,0.2.209,0,584,1,47,209,256,209,0,256,326,-77,148,571,3,2,151,292,243,353,14,1436,757
1693,13,1.0.282,1,562,0,37,282,319,0,282,319,326,0,0,494,1,6,106,37,106,319,14,1436,757
1693,13,3.2.169,0,562,0,73,169,242,169,0,242,326,-37,108,531,3,2,209,292,354,353,14,1436,757
1693,13,4.2.219,0,603,2,50,219,269,219,0,269,326,-87,158,581,3,2,117,292,156,353,14,1436,757
1693,13,5.2.326,0,562,0,74,326,400,326,0,400,400,-194,265,688,3,2,174,292,311,353,14,1436,757
1693,14,0.2.209,0,584,1,47,209,256,209,0,256,326,-77,148,571,3,2,151,292,243,353,15,1436,720
1693,14,1.1.326,1,562,0,9,326,335,319,7,335,335,0,124,494,2,6,69,9,106,211,15,1436,720
1693,14,3.2.169,0,562,0,73,169,242,169,0,242,326,-37,108,531,3,2,209,292,354,353,15,1436,720
1693,14,4.2.219,0,603,2,50,219,269,219,0,269,326,-87,158,581,3,2,117,292,156,353,15,1436,720
1693,14,5.2.326,0,562,0,74,326,400,326,0,400,400,-194,265,688,3,2,174,292,311,353,15,1436,720
1693,15,0.2.209,0,584,1,47,209,256,209,0,256,335,-77,148,571,3,2,151,292,243,353,16,1436,711
1693,15,1.2.335,0,598,2,48,335,383,335,0,383,383,-203,274,697,3,2,60,292,106,353,16,1436,711
1693,15,3.2.169,1,562,0,73,169,242,169,0,242,335,-37,108,531,3,2,209,292,354,353,16,1436,711
1693,15,4.2.219,0,603,3,50,219,269,219,0,269,335,-87,158,581,3,2,117,292,156,353,16,1436,711
1693,15,5.2.326,0,562,0,74,326,400,326,0,400,400,-194,265,688,3,2,174,292,311,353,16,1436,711
1693,16,0.2.242,0,562,0,47,242,289,209,33,289,335,0,108,531,3,3,151,219,243,353,17,1436,638
1693,16,1.2.335,0,598,1,48,335,383,335,0,383,383,-93,201,624,3,3,60,219,106,353,17,1436,638
1693,16,3.3.242,1,562,0,68,242,310,242,0,310,335,-75,207,606,4,2,136,167,354,202,17,1436,638
1693,16,4.2.242,0,562,0,50,242,292,219,23,292,335,0,108,531,3,3,117,219,156,353,17,1436,638
1693,16,5.2.326,0,562,0,74,326,400,326,0,400,400,-84,192,615,3,3,174,219,311,353,17,1436,638
1693,17,0.2.242,0,562,0,47,242,289,209,33,289,335,0,108,606,3,3,151,219,243,353,18,1436,570
1693,17,1.2.335,0,598,1,48,335,383,335,0,383,383,-93,201,699,3,3,60,219,106,353,18,1436,570
1693,17,3.4.310,1,562,0,68,310,378,310,0,378,378,-44,211,650,5,2,68,252,354,351,18,1436,570
1693,17,4.2.242,0,562,0,50,242,292,219,23,292,335,0,108,606,3,3,117,219,156,353,18,1436,570
1693,17,5.2.326,0,562,0,74,326,400,326,0,400,400,-84,192,690,3,3,174,219,311,353,18,1436,570
1693,18,0.2.242,1,562,0,47,242,289,209,33,289,378,0,108,650,3,3,151,219,243,353,19,1436,502
1693,18,1.2.335,0,598,1,48,335,383,335,0,383,383,-93,201,743,3,3,60,219,106,353,19,1436,502
1693,18,4.2.242,0,562,0,50,242,292,219,23,292,378,0,108,650,3,3,117,219,156,353,19,1436,502
1693,18,5.2.326,0,562,0,74,326,400,326,0,400,400,-84,192,734,3,3,174,219,311,353,19,1436,502
1693,19,0.3.310,1,562,0,39,310,349,289,21,349,378,0,207,650,4,3,104,99,243,202,20,1436,455
1693,19,1.2.335,0,598,1,48,335,383,335,0,383,383,-46,154,696,3,4,60,172,106,353,20,1436,455
1693,19,4.2.289,0,562,0,50,289,339,219,70,339,378,0,108,650,3,4,117,172,156,353,20,1436,455
1693,19,5.2.326,0,562,0,74,326,400,326,0,400,400,-37,145,687,3,4,174,172,311,353,20,1436,455
1693,20,0.4.378,1,562,0,65,378,443,349,29,443,443,0,211,650,5,3,65,184,243,351,21,1436,416
1693,20,1.2.335,0,598,1,48,335,383,335,0,383,383,-46,154,696,3,4,60,172,106,353,21,1436,416
1693,20,4.2.289,0,562,0,50,289,339,219,70,339,378,0,108,650,3,4,117,172,156,353,21,1436,416
1693,20,5.2.326,0,562,0,74,326,400,326,0,400,400,-37,145,687,3,4,174,172,311,353,21,1436,416
1693,21,1.2.335,0,598,1,48,335,383,335,0,383,443,-46,154,696,3,4,60,172,106,353,22,1436,351
1693,21,4.2.289,1,562,0,50,289,339,219,70,339,443,0,108,650,3,4,117,172,156,353,22,1436,351
1693,21,5.2.326,0,562,0,74,326,400,326,0,400,443,-37,145,687,3,4,174,172,311,353,22,1436,351
1693,22,1.2.339,0,562,0,48,339,387,335,4,387,443,0,108,650,3,5,60,122,106,353,23,1436,301
1693,22,4.3.349,1,562,0,26,349,375,339,10,375,443,0,207,650,4,4,67,60,156,202,23,1436,301
1693,22,5.2.339,0,562,0,74,339,413,326,13,413,443,0,108,650,3,5,174,122,311,353,23,1436,301
1693,23,1.2.339,0,562,0,48,339,387,335,4,387,443,0,108,650,3,5,60,122,106,353,24,1436,275
1693,23,4.4.443,1,562,0,41,443,484,375,68,484,484,0,211,650,5,4,41,119,156,351,24,1436,275
1693,23,5.2.339,0,562,0,74,339,413,326,13,413,443,0,108,650,3,5,174,122,311,353,24,1436,275
1693,24,1.2.339,0,562,0,48,339,387,335,4,387,484,0,108,650,3,5,60,122,106,353,25,1436,234
1693,24,5.2.339,1,562,0,74,339,413,326,13,413,484,0,108,650,3,5,174,122,311,353,25,1436,234
1693,25,1.2.413,0,562,0,48,413,461,335,78,461,484,0,108,650,3,6,60,48,106,353,26,1436,160
1693,25,5.3.413,1,562,0,27,413,440,413,0,440,484,-38,245,688,4,5,100,34,311,202,26,1436,160
1693,26,1.2.413,0,562,0,48,413,461,335,78,461,484,0,108,688,3,6,60,48,106,353,27,1436,133
1693,26,5.4.484,1,562,0,73,484,557,440,44,557,557,0,211,688,5,5,73,78,311,351,27,1436,133
1693,27,1.2.413,1,562,0,48,413,461,335,78,461,557,0,108,688,3,6,60,48,106,353,28,1436,60
1693,28,1.3.461,1,562,0,7,461,468,461,0,468,557,-21,266,709,4,6,12,7,106,202,29,1436,12
1693,29,1.4.557,1,562,0,5,557,562,468,89,562,562,0,211,709,5,6,5,5,106,351,30,1436,5
1694,0,0.0.0,0,475,3,65,0,65,0,0,65,65,0,0,0,1,1,188,332,188,332,1,1205,1205
1694,0,1.0.0,1,448,0,13,0,13,0,0,13,13,0,0,0,1,1,204,332,204,332,1,1205,1205
1694,0,2.0.0,0,475,3,69,0,69,0,0,69,69,0,0,0,1,1,193,332,193,332,1,1205,1205
1694,0,3.0.0,0,460,1,37,0,37,0,0,37,37,0,0,0,1,1,213,332,213,332,1,1205,1205
1694,0,4.0.0,0,462,2,50,0,50,0,0,50,50,0,0,0,1,1,193,332,193,332,1,1205,1205
1694,0,5.0.0,0,493,4,98,0,98,0,0,98,98,0,0,0,1,1,214,332,214,332,1,1205,1205
1694,1,0.0.13,0,460,3,65,13,78,0,13,78,78,0,0,0,1,2,188,319,188,332,2,1205,1192
1694,1,1.1.13,1,448,0,76,13,89,13,0,89,89,-13,13,13,2,1,191,313,204,313,2,1205,1192
1694,1,2.0.13,0,458,2,69,13,82,0,13,82,82,0,0,0,1,2,193,319,193,332,2,1205,1192
1694,1,3.0.13,0,448,0,37,13,50,0,13,50,50,0,0,0,1,2,213,319,213,332,2,1205,1192
1694,1,4.0.13,0,456,1,50,13,63,0,13,63,63,0,0,0,1,2,193,319,193,332,2,1205,1192
1694,1,5.0.13,0,470,4,98,13,111,0,13,111,111,0,0,0,1,2,214,319,214,332,2,1205,1192
1694,2,0.0.13,0,460,3,65,13,78,0,13,78,89,0,0,13,1,2,188,319,188,332,3,1205,1116
1694,2,1.2.89,1,448,0,53,89,142,89,0,142,142,-89,89,102,3,1,115,222,204,222,3,1205,1116
1694,2,2.0.13,0,458,2,69,13,82,0,13,82,89,0,0,13,1,2,193,319,193,332,3,1205,1116
1694,2,3.0.13,0,448,0,37,13,50,0,13,50,89,0,0,13,1,2,213,319,213,332,3,1205,1116
1694,2,4.0.13,0,456,1,50,13,63,0,13,63,89,0,0,13,1,2,193,319,193,332,3,1205,1116
1694,2,5.0.13,0,470,4,98,13,111,0,13,111,111,0,0,13,1,2,214,319,214,332,3,1205,1116
1694,3,0.0.13,0,460,3,65,13,78,0,13,78,142,0,0,102,1,2,188,319,188,332,4,1205,1063
1694,3,1.3.142,1,448,0,48,142,190,142,0,190,190,-142,142,244,4,1,62,155,204,155,4,1205,1063
1694,3,2.0.13,0,458,2,69,13,82,0,13,82,142,0,0,102,1,2,193,319,193,332,4,1205,1063
1694,3,3.0.13,0,448,0,37,13,50,0,13,50,142,0,0,102,1,2,213,319,213,332,4,1205,1063
1694,3,4.0.13,0,456,1,50,13,63,0,13,63,142,0,0,102,1,2,193,319,193,332,4,1205,1063
1694,3,5.0.13,0,470,4,98,13,111,0,13,111,142,0,0,102,1,2,214,319,214,332,4,1205,1063
1694,4,0.0.13,0,460,3,65,13,78,0,13,78,190,0,0,244,1,2,188,319,188,332,5,1205,1015
1694,4,1.4.190,1,448,0,14,190,204,190,0,204,204,-190,190,434,5,1,14,183,204,183,5,1205,1015
1694,4,2.0.13,0,458,2,69,13,82,0,13,82,190,0,0,244,1,2,193,319,193,332,5,1205,1015
1694,4,3.0.13,0,448,0,37,13,50,0,13,50,190,0,0,244,1,2,213,319,213,332,5,1205,1015
1694,4,4.0.13,0,456,1,50,13,63,0,13,63,190,0,0,244,1,2,193,319,193,332,5,1205,1015
1694,4,5.0.13,0,470,4,98,13,111,0,13,111,190,0,0,244,1,2,214,319,214,332,5,1205,1015
1694,5,0.0.13,0,460,3,65,13,78,0,13,78,204,0,0,434,1,2,188,319,188,332,6,1205,1001
1694,5,2.0.13,0,458,2,69,13,82,0,13,82,204,0,0,434,1,2,193,319,193,332,6,1205,1001
1694,5,3.0.13,1,448,0,37,13,50,0,13,50,204,0,0,434,1,2,213,319,213,332,6,1205,1001
1694,5,4.0.13,0,456,1,50,13,63,0,13,63,204,0,0,434,1,2,193,319,193,332,6,1205,1001
1694,5,5.0.13,0,470,4,98,13,111,0,13,111,204,0,0,434,1,2,214,319,214,332,6,1205,1001
1694,6,0.0.50,0,448,0,65,50,115,0,50,115,204,0,0,434,1,3,188,282,188,332,7,1205,964
1694,6,2.0.50,0,448,0,69,50,119,0,50,119,204,0,0,434,1,3,193,282,193,332,7,1205,964
1694,6,3.1.89,1,448,0,99,89,188,50,39,188,204,0,13,434,2,2,176,237,213,313,7,1205,964
1694,6,4.0.50,0,450,1,50,50,100,0,50,100,204,0,0,434,1,3,193,282,193,332,7,1205,964
1694,6,5.0.50,0,456,2,98,50,148,0,50,148,204,0,0,434,1,3,214,282,214,332,7,1205,964
1694,7,0.0.50,0,448,0,65,50,115,0,50,115,204,0,0,434,1,3,188,282,188,332,8,1205,865
1694,7,2.0.50,0,448,0,69,50,119,0,50,119,204,0,0,434,1,3,193,282,193,332,8,1205,865
1694,7,3.2.188,1,448,0,40,188,228,188,0,228,228,-46,135,480,3,2,77,169,213,222,8,1205,865
1694,7,4.0.50,0,450,1,50,50,100,0,50,100,204,0,0,434,1,3,193,282,193,332,8,1205,865
1694,7,5.0.50,0,456,2,98,50,148,0,50,148,204,0,0,434,1,3,214,282,214,332,8,1205,865
1694,8,0.0.50,0,448,0,65,50,115,0,50,115,228,0,0,480,1,3,188,282,188,332,9,1205,825
1694,8,2.0.50,0,448,0,69,50,119,0,50,119,228,0,0,480,1,3,193,282,193,332,9,1205,825
1694,8,3.3.228,1,448,0,27,228,255,228,0,255,255,-38,180,518,4,2,37,107,213,155,9,1205,825
1694,8,4.0.50,0,450,1,50,50,100,0,50,100,228,0,0,480,1,3,193,282,193,332,9,1205,825
1694,8,5.0.50,0,456,2,98,50,148,0,50,148,228,0,0,480,1,3,214,282,214,332,9,1205,825
1694,9,0.0.50,0,448,0,65,50,115,0,50,115,255,0,0,518,1,3,188,282,188,332,10,1205,798
1694,9,2.0.50,0,448,0,69,50,119,0,50,119,255,0,0,518,1,3,193,282,193,332,10,1205,798
1694,9,3.4.255,1,448,0,10,255,265,255,0,265,265,-51,241,569,5,2,10,169,213,183,10,1205,798
1694,9,4.0.50,0,450,1,50,50,100,0,50,100,255,0,0,518,1,3,193,282,193,332,10,1205,798
1694,9,5.0.50,0,456,2,98,50,148,0,50,148,255,0,0,518,1,3,214,282,214,332,10,1205,798
1694,10,0.0.50,0,448,0,65,50,115,0,50,115,265,0,0,569,1,3,188,282,188,332,11,1205,788
1694,10,2.0.50,0,448,0,69,50,119,0,50,119,265,0,0,569,1,3,193,282,193,332,11,1205,788
1694,10,4.0.50,1,450,1,50,50,100,0,50,100,265,0,0,569,1,3,193,282,193,332,11,1205,788
1694,10,5.0.50,0,456,2,98,50,148,0,50,148,265,0,0,569,1,3,214,282,214,332,11,1205,788
1694,11,0.0.100,0,464,1,65,100,165,0,100,165,265,0,0,569,1,4,188,232,188,332,12,1205,738
1694,11,2.0.100,0,450,0,69,100,169,0,100,169,265,0,0,569,1,4,193,232,193,332,12,1205,738
1694,11,4.1.188,1,469,3,61,188,249,100,88,249,265,0,13,569,2,3,143,138,193,313,12,1205,738
1694,11,5.0.100,0,466,2,98,100,198,0,100,198,265,0,0,569,1,4,214,232,214,332,12,1205,738
1694,12,0.0.100,0,478,2,65,100,165,0,100,165,265,0,0,569,1,4,188,232,188,332,13,1205,677
1694,12,2.0.100,0,473,1,69,100,169,0,100,169,265,0,0,569,1,4,193,232,193,332,13,1205,677
1694,12,4.2.249,1,478,2,51,249,300,249,0,300,300,-21,156,590,3,3,82,129,193,222,13,1205,677
1694,12,5.0.100,0,469,0,98,100,198,0,100,198,265,0,0,569,1,4,214,232,214,332,13,1205,677
1694,13,0.0.100,0,478,0,65,100,165,0,100,165,300,0,0,590,1,4,188,232,188,332,14,1205,626
1694,13,2.0.100,0,478,0,69,100,169,0,100,169,300,0,0,590,1,4,193,232,193,332,14,1205,626
1694,13,4.3.300,1,478,0,19,300,319,300,0,319,319,-45,225,635,4,3,31,80,193,155,14,1205,626
1694,13,5.0.100,0,478,0,98,100,198,0,100,198,300,0,0,590,1,4,214,232,214,332,14,1205,626
1694,14,0.0.100,0,478,0,65,100,165,0,100,165,319,0,0,635,1,4,188,232,188,332,15,1205,607
1694,14,2.0.100,0,478,0,69,100,169,0,100,169,319,0,0,635,1,4,193,232,193,332,15,1205,607
1694,14,4.4.319,1,478,0,12,319,331,319,0,331,331,-54,295,689,5,3,12,159,193,183,15,1205,607
1694,14,5.0.100,0,478,0,98,100,198,0,100,198,319,0,0,635,1,4,214,232,214,332,15,1205,607
1694,15,0.0.100,1,478,0,65,100,165,0,100,165,331,0,0,689,1,4,188,232,188,332,16,1205,595
1694,15,2.0.100,0,478,0,69,100,169,0,100,169,331,0,0,689,1,4,193,232,193,332,16,1205,595
1694,15,5.0.100,0,478,0,98,100,198,0,100,198,331,0,0,689,1,4,214,232,214,332,16,1205,595
1694,16,0.1.249,1,478,0,9,249,258,165,84,258,331,0,13,689,2,4,123,77,188,313,17,1205,530
1694,16,2.0.165,0,478,0,69,165,234,0,165,234,331,0,0,689,1,5,193,167,193,332,17,1205,530
1694,16,5.0.165,0,478,0,98,165,263,0,165,263,331,0,0,689,1,5,214,167,214,332,17,1205,530
1694,17,0.2.300,1,516,1,50,300,350,258,42,350,350,0,156,689,3,4,114,78,188,222,18,1205,521
1694,17,2.0.165,0,478,0,69,165,234,0,165,234,331,0,0,689,1,5,193,167,193,332,18,1205,521
1694,17,5.0.165,0,478,0,98,165,263,0,165,263,331,0,0,689,1,5,214,167,214,332,18,1205,521
1694,18,0.3.350,1,542,2,45,350,395,350,0,395,395,-31,256,720,4,4,64,61,188,155,19,1205,471
1694,18,2.0.165,0,516,0,69,165,234,0,165,234,350,0,0,689,1,5,193,167,193,332,19,1205,471
1694,18,5.0.165,0,522,1,98,165,263,0,165,263,350,0,0,689,1,5,214,167,214,332,19,1205,471
1694,19,0.4.395,1,542,0,19,395,414,395,0,414,414,-64,359,784,5,4,19,147,188,183,20,1205,426
1694,19,2.0.165,0,542,0,69,165,234,0,165,234,395,0,0,720,1,5,193,167,193,332,20,1205,426
1694,19,5.0.165,0,542,0,98,165,263,0,165,263,395,0,0,720,1,5,214,167,214,332,20,1205,426
1694,20,2.0.165,1,542,0,69,165,234,0,165,234,414,0,0,784,1,5,193,167,193,332,21,1205,407
1694,20,5.0.165,0,542,0,98,165,263,0,165,263,414,0,0,784,1,5,214,167,214,332,21,1205,407
1694,21,2.1.258,1,542,0,41,258,299,234,24,299,414,0,13,784,2,5,124,68,193,313,22,1205,338
1694,21,5.0.234,0,542,0,98,234,332,0,234,332,414,0,0,784,1,6,214,98,214,332,22,1205,338
1694,22,2.2.350,1,542,0,15,350,365,299,51,365,414,0,156,784,3,5,83,28,193,222,23,1205,297
1694,22,5.0.234,0,542,0,98,234,332,0,234,332,414,0,0,784,1,6,214,98,214,332,23,1205,297
1694,23,2.3.395,1,542,0,4,395,399,365,30,399,414,0,256,784,4,5,68,16,193,155,24,1205,282
1694,23,5.0.234,0,542,0,98,234,332,0,234,332,414,0,0,784,1,6,214,98,214,332,24,1205,282
1694,24,2.4.414,1,542,0,64,414,478,399,15,478,478,0,359,784,5,5,64,128,193,183,25,1205,278
1694,24,5.0.234,0,542,0,98,234,332,0,234,332,414,0,0,784,1,6,214,98,214,332,25,1205,278
1694,25,5.0.234,1,542,0,98,234,332,0,234,332,478,0,0,784,1,6,214,98,214,332,26,1205,214
1694,26,5.1.332,1,542,0,27,332,359,332,0,359,478,-33,46,817,2,6,116,27,214,313,27,1205,116
1694,27,5.2.365,1,542,0,13,365,378,359,6,378,478,0,156,817,3,6,89,13,214,222,28,1205,89
1694,28,5.3.399,1,542,0,12,399,411,378,21,411,478,0,256,817,4,6,76,12,214,155,29,1205,76
1694,29,5.4.478,1,542,0,64,478,542,411,67,542,542,0,359,817,5,6,64,64,214,183,30,1205,64
1695,0,0.0.0,0,573,3,78,0,78,0,0,78,78,0,0,0,1,1,330,347,330,347,1,1573,1573
1695,0,1.0.0,0,599,5,88,0,88,0,0,88,88,0,0,0,1,1,305,347,305,347,1,1573,1573
1695,0,2.0.0,0,545,1,15,0,15,0,0,15,15,0,0,0,1,1,218,347,218,347,1,1573,1573
1695,0,3.0.0,0,578,4,90,0,90,0,0,90,90,0,0,0,1,1,272,347,272,347,1,1573,1573
1695,0,4.0.0,0,567,2,72,0,72,0,0,72,72,0,0,0,1,1,231,347,231,347,1,1573,1573
1695,0,5.0.0,1,534,0,4,0,4,0,0,4,4,0,0,0,1,1,217,347,217,347,1,1573,1573
1695,1,0.0.4,0,556,1,78,4,82,0,4,82,82,0,0,0,1,2,330,343,330,347,2,1573,1569
1695,1,1.0.4,0,575,3,88,4,92,0,4,92,92,0,0,0,1,2,305,343,305,347,2,1573,1569
1695,1,2.0.4,0,534,0,15,4,19,0,4,19,19,0,0,0,1,2,218,343,218,347,2,1573,1569
1695,1,3.0.4,0,556,1,90,4,94,0,4,94,94,0,0,0,1,2,272,343,272,347,2,1573,1569
1695,1,4.0.4,0,564,2,72,4,76,0,4,76,76,0,0,0,1,2,231,343,231,347,2,1573,1569
1695,1,5.1.4,1,534,0,10,4,14,4,0,14,14,-4,4,4,2,1,213,217,217,217,2,1573,1569
1695,2,0.0.4,0,556,1,78,4,82,0,4,82,82,0,0,4,1,2,330,343,330,347,3,1573,1559
1695,2,1.0.4,0,575,3,88,4,92,0,4,92,92,0,0,4,1,2,305,343,305,347,3,1573,1559
1695,2,2.0.4,0,534,0,15,4,19,0,4,19,19,0,0,4,1,2,218,343,218,347,3,1573,1559
1695,2,3.0.4,0,556,1,90,4,94,0,4,94,94,0,0,4,1,2,272,343,272,347,3,1573,1559
1695,2,4.0.4,0,564,2,72,4,76,0,4,76,76,0,0,4,1,2,231,343,231,347,3,1573,1559
1695,2,5.2.14,1,534,0,51,14,65,14,0,65,65,-14,14,18,3,1,203,290,217,290,3,1573,1559
1695,3,0.0.4,0,556,1,78,4,82,0,4,82,82,0,0,18,1,2,330,343,330,347,4,1573,1508
1695,3,1.0.4,0,575,3,88,4,92,0,4,92,92,0,0,18,1,2,305,343,305,347,4,1573,1508
1695,3,2.0.4,0,534,0,15,4,19,0,4,19,65,0,0,18,1,2,218,343,218,347,4,1573,1508
1695,3,3.0.4,0,556,1,90,4,94,0,4,94,94,0,0,18,1,2,272,343,272,347,4,1573,1508
1695,3,4.0.4,0,564,2,72,4,76,0,4,76,76,0,0,18,1,2,231,343,231,347,4,1573,1508
1695,3,5.3.65,1,534,0,96,65,161,65,0,161,161,-65,65,83,4,1,152,407,217,407,4,1573,1508
1695,4,0.0.4,0,556,1,78,4,82,0,4,82,161,0,0,83,1,2,330,343,330,347,5,1573,1412
1695,4,1.0.4,0,575,3,88,4,92,0,4,92,161,0,0,83,1,2,305,343,305,347,5,1573,1412
1695,4,2.0.4,0,534,0,15,4,19,0,4,19,161,0,0,83,1,2,218,343,218,347,5,1573,1412
1695,4,3.0.4,0,556,1,90,4,94,0,4,94,161,0,0,83,1,2,272,343,272,347,5,1573,1412
1695,4,4.0.4,0,564,2,72,4,76,0,4,76,161,0,0,83,1,2,231,343,231,347,5,1573,1412
1695,4,5.4.161,1,534,0,56,161,217,161,0,217,217,-161,161,244,5,1,56,312,217,312,5,1573,1412
1695,5,0.0.4,0,556,1,78,4,82,0,4,82,217,0,0,244,1,2,330,343,330,347,6,1573,1356
1695,5,1.0.4,0,575,3,88,4,92,0,4,92,217,0,0,244,1,2,305,343,305,347,6,1573,1356
1695,5,2.0.4,1,534,0,15,4,19,0,4,19,217,0,0,244,1,2,218,343,218,347,6,1573,1356
1695,5,3.0.4,0,556,1,90,4,94,0,4,94,217,0,0,244,1,2,272,343,272,347,6,1573,1356
1695,5,4.0.4,0,564,2,72,4,76,0,4,76,217,0,0,244,1,2,231,343,231,347,6,1573,1356
1695,6,0.0.19,0,534,0,78,19,97,0,19,97,217,0,0,244,1,3,330,328,330,347,7,1573,1341
1695,6,1.0.19,0,568,3,88,19,107,0,19,107,217,0,0,244,1,3,305,328,305,347,7,1573,1341
1695,6,2.1.19,1,534,0,34,19,53,19,0,53,217,-5,9,249,2,2,203,207,218,217,7,1573,1341
1695,6,3.0.19,0,556,1,90,19,109,0,19,109,217,0,0,244,1,3,272,328,272,347,7,1573,1341
1695,6,4.0.19,0,564,2,72,19,91,0,19,91,217,0,0,244,1,3,231,328,231,347,7,1573,1341
1695,7,0.0.19,0,534,0,78,19,97,0,19,97,217,0,0,249,1,3,330,328,330,347,8,1573,1307
1695,7,1.0.19,0,568,3,88,19,107,0,19,107,217,0,0,249,1,3,305,328,305,347,8,1573,1307
1695,7,2.2.65,1,534,0,67,65,132,53,12,132,217,0,14,249,3,2,169,239,218,290,8,1573,1307
1695,7,3.0.19,0,556,1,90,19,109,0,19,109,217,0,0,249,1,3,272,328,272,347,8,1573,1307
1695,7,4.0.19,0,564,2,72,19,91,0,19,91,217,0,0,249,1,3,231,328,231,347,8,1573,1307
1695,8,0.0.19,0,534,0,78,19,97,0,19,97,217,0,0,249,1,3,330,328,330,347,9,1573,1240
1695,8,1.0.19,0,568,3,88,19,107,0,19,107,217,0,0,249,1,3,305,328,305,347,9,1573,1240
1695,8,2.3.161,1,534,0,72,161,233,132,29,233,233,0,65,249,4,2,102,311,218,407,9,1573,1240
1695,8,3.0.19,0,556,1,90,19,109,0,19,109,217,0,0,249,1,3,272,328,272,347,9,1573,1240
1695,8,4.0.19,0,564,2,72,19,91,0,19,91,217,0,0,249,1,3,231,328,231,347,9,1573,1240
1695,9,0.0.19,0,534,0,78,19,97,0,19,97,233,0,0,249,1,3,330,328,330,347,10,1573,1168
1695,9,1.0.19,0,568,3,88,19,107,0,19,107,233,0,0,249,1,3,305,328,305,347,10,1573,1168
1695,9,2.4.233,1,534,0,30,233,263,233,0,263,263,-16,177,265,5,2,30,256,218,312,10,1573,1168
1695,9,3.0.19,0,556,1,90,19,109,0,19,109,233,0,0,249,1,3,272,328,272,347,10,1573,1168
1695,9,4.0.19,0,564,2,72,19,91,0,19,91,233,0,0,249,1,3,231,328,231,347,10,1573,1168
1695,10,0.0.19,1,534,0,78,19,97,0,19,97,263,0,0,265,1,3,330,328,330,347,11,1573,1138
1695,10,1.0.19,0,568,3,88,19,107,0,19,107,263,0,0,265,1,3,305,328,305,347,11,1573,1138
1695,10,3.0.19,0,556,1,90,19,109,0,19,109,263,0,0,265,1,3,272,328,272,347,11,1573,1138
1695,10,4.0.19,0,564,2,72,19,91,0,19,91,263,0,0,265,1,3,231,328,231,347,11,1573,1138
1695,11,0.1.97,1,534,0,76,97,173,97,0,173,263,-44,53,309,2,3,252,173,330,217,12,1573,1060
1695,11,1.0.97,0,534,0,88,97,185,0,97,185,263,0,0,265,1,4,305,250,305,347,12,1573,1060
1695,11,3.0.97,0,556,1,90,97,187,0,97,187,263,0,0,265,1,4,272,250,272,347,12,1573,1060
1695,11,4.0.97,0,564,2,72,97,169,0,97,169,263,0,0,265,1,4,231,250,231,347,12,1573,1060
1695,12,0.2.173,1,534,0,53,173,226,173,0,226,263,-41,55,350,3,3,176,172,330,290,13,1573,984
1695,12,1.0.97,0,534,0,88,97,185,0,97,185,263,0,0,309,1,4,305,250,305,347,13,1573,984
1695,12,3.0.97,0,556,1,90,97,187,0,97,187,263,0,0,309,1,4,272,250,272,347,13,1573,984
1695,12,4.0.97,0,564,2,72,97,169,0,97,169,263,0,0,309,1,4,231,250,231,347,13,1573,984
1695,13,0.3.233,1,534,0,52,233,285,226,7,285,285,0,65,350,4,3,123,239,330,407,14,1573,931
1695,13,1.0.97,0,534,0,88,97,185,0,97,185,263,0,0,350,1,4,305,250,305,347,14,1573,931
1695,13,3.0.97,0,556,1,90,97,187,0,97,187,263,0,0,350,1,4,272,250,272,347,14,1573,931
1695,13,4.0.97,0,564,2,72,97,169,0,97,169,263,0,0,350,1,4,231,250,231,347,14,1573,931
1695,14,0.4.285,1,534,0,71,285,356,285,0,356,356,-22,199,372,5,3,71,226,330,312,15,1573,879
1695,14,1.0.97,0,534,0,88,97,185,0,97,185,285,0,0,350,1,4,305,250,305,347,15,1573,879
1695,14,3.0.97,0,556,1,90,97,187,0,97,187,285,0,0,350,1,4,272,250,272,347,15,1573,879
1695,14,4.0.97,0,564,2,72,97,169,0,97,169,285,0,0,350,1,4,231,250,231,347,15,1573,879
1695,15,1.0.97,1,534,0,88,97,185,0,97,185,356,0,0,372,1,4,305,250,305,347,16,1573,808
1695,15,3.0.97,0,556,1,90,97,187,0,97,187,356,0,0,372,1,4,272,250,272,347,16,1573,808
1695,15,4.0.97,0,564,2,72,97,169,0,97,169,356,0,0,372,1,4,231,250,231,347,16,1573,808
1695,16,1.1.185,1,534,0,45,185,230,185,0,230,356,-12,65,384,2,4,217,97,305,217,17,1573,720
1695,16,3.0.185,0,561,1,90,185,275,0,185,275,356,0,0,372,1,5,272,162,272,347,17,1573,720
1695,16,4.0.185,0,534,0,72,185,257,0,185,257,356,0,0,372,1,5,231,162,231,347,17,1573,720
1695,17,1.2.230,1,534,0,59,230,289,230,0,289,356,-4,59,388,3,4,172,119,305,290,18,1573,675
1695,17,3.0.185,0,561,1,90,185,275,0,185,275,356,0,0,384,1,5,272,162,272,347,18,1573,675
1695,17,4.0.185,0,534,0,72,185,257,0,185,257,356,0,0,384,1,5,231,162,231,347,18,1573,675
1695,18,1.3.289,1,534,0,90,289,379,289,0,379,379,-4,69,392,4,4,113,187,305,407,19,1573,616
1695,18,3.0.185,0,561,1,90,185,275,0,185,275,356,0,0,388,1,5,272,162,272,347,19,1573,616
1695,18,4.0.185,0,534,0,72,185,257,0,185,257,356,0,0,388,1,5,231,162,231,347,19,1573,616
1695,19,1.4.379,1,534,0,23,379,402,379,0,402,402,-23,222,415,5,4,23,155,305,312,20,1573,526
1695,19,3.0.185,0,561,1,90,185,275,0,185,275,379,0,0,392,1,5,272,162,272,347,20,1573,526
1695,19,4.0.185,0,534,0,72,185,257,0,185,257,379,0,0,392,1,5,231,162,231,347,20,1573,526
1695,20,3.0.185,0,561,1,90,185,275,0,185,275,402,0,0,415,1,5,272,162,272,347,21,1573,503
1695,20,4.0.185,1,534,0,72,185,257,0,185,257,402,0,0,415,1,5,231,162,231,347,21,1573,503
1695,21,3.0.257,0,534,0,90,257,347,0,257,347,402,0,0,415,1,6,272,90,272,347,22,1573,431
1695,21,4.1.257,1,534,0,14,257,271,257,0,271,402,-27,92,442,2,5,159,52,231,217,22,1573,431
1695,22,3.0.257,0,534,0,90,257,347,0,257,347,402,0,0,442,1,6,272,90,272,347,23,1573,417
1695,22,4.2.289,1,534,0,52,289,341,271,18,341,402,0,59,442,3,5,145,60,231,290,23,1573,417
1695,23,3.0.257,0,534,0,90,257,347,0,257,347,402,0,0,442,1,6,272,90,272,347,24,1573,365
1695,23,4.3.379,1,534,0,12,379,391,341,38,391,402,0,69,442,4,5,93,97,231,407,24,1573,365
1695,24,3.0.257,0,534,0,90,257,347,0,257,347,402,0,0,442,1,6,272,90,272,347,25,1573,353
1695,24,4.4.402,1,534,0,81,402,483,391,11,483,483,0,222,442,5,5,81,132,231,312,25,1573,353
1695,25,3.0.257,1,534,0,90,257,347,0,257,347,483,0,0,442,1,6,272,90,272,347,26,1573,272
1695,26,3.1.347,1,534,0,38,347,385,347,0,385,483,-76,168,518,2,6,182,38,272,217,27,1573,182
1695,27,3.2.385,1,534,0,8,385,393,385,0,393,483,-44,103,562,3,6,144,8,272,290,28,1573,144
1695,28,3.3.393,1,534,0,85,393,478,393,0,478,483,-2,71,564,4,6,136,85,272,407,29,1573,136
1695,29,3.4.483,1,534,0,51,483,534,478,5,534,534,0,222,564,5,6,51,51,272,312,30,1573,51
1696,0,0.0.0,0,634,4,91,0,91,0,0,91,91,0,0,0,1,1,274,361,274,361,1,1640,1640
1696,0,1.0.0,0,598,3,63,0,63,0,0,63,63,0,0,0,1,1,204,361,204,361,1,1640,1640
1696,0,2.0.0,0,597,2,61,0,61,0,0,61,61,0,0,0,1,1,246,361,246,361,1,1640,1640
1696,0,3.0.0,0,569,1,44,0,44,0,0,44,44,0,0,0,1,1,331,361,331,361,1,1640,1640
1696,0,4.0.0,0,644,5,94,0,94,0,0,94,94,0,0,0,1,1,268,361,268,361,1,1640,1640
1696,0,5.0.0,1,565,0,8,0,8,0,0,8,8,0,0,0,1,1,317,361,317,361,1,1640,1640
1696,1,0.0.8,0,596,4,91,8,99,0,8,99,99,0,0,0,1,2,274,353,274,361,2,1640,1632
1696,1,1.0.8,0,582,2,63,8,71,0,8,71,71,0,0,0,1,2,204,353,204,361,2,1640,1632
1696,1,2.0.8,0,565,0,61,8,69,0,8,69,69,0,0,0,1,2,246,353,246,361,2,1640,1632
1696,1,3.0.8,0,577,1,44,8,52,0,8,52,52,0,0,0,1,2,331,353,331,361,2,1640,1632
1696,1,4.0.8,0,593,3,94,8,102,0,8,102,102,0,0,0,1,2,268,353,268,361,2,1640,1632
1696,1,5.1.8,1,565,0,92,8,100,8,0,100,100,-8,8,8,2,1,309,318,317,318,2,1640,1632
1696,2,0.0.8,0,596,5,91,8,99,0,8,99,100,0,0,8,1,2,274,353,274,361,3,1640,1540
1696,2,1.0.8,0,582,2,63,8,71,0,8,71,100,0,0,8,1,2,204,353,204,361,3,1640,1540
1696,2,2.0.8,0,565,0,61,8,69,0,8,69,100,0,0,8,1,2,246,353,246,361,3,1640,1540
1696,2,3.0.8,0,578,1,44,8,52,0,8,52,100,0,0,8,1,2,331,353,331,361,3,1640,1540
1696,2,4.0.8,0,593,4,94,8,102,0,8,102,102,0,0,8,1,2,268,353,268,361,3,1640,1540
1696,2,5.2.100,1,592,3,89,100,189,100,0,189,189,-100,100,108,3,1,217,357,317,357,3,1640,1540
1696,3,0.0.8,0,596,2,91,8,99,0,8,99,189,0,0,108,1,2,274,353,274,361,4,1640,1451
1696,3,1.0.8,0,592,0,63,8,71,0,8,71,189,0,0,108,1,2,204,353,204,361,4,1640,1451
1696,3,2.0.8,0,592,0,61,8,69,0,8,69,189,0,0,108,1,2,246,353,246,361,4,1640,1451
1696,3,3.0.8,0,592,0,44,8,52,0,8,52,189,0,0,108,1,2,331,353,331,361,4,1640,1451
1696,3,4.0.8,0,593,1,94,8,102,0,8,102,189,0,0,108,1,2,268,353,268,361,4,1640,1451
1696,3,5.3.189,1,611,3,81,189,270,189,0,270,270,-189,189,297,4,1,128,263,317,263,4,1640,1451
1696,4,0.0.8,0,611,0,91,8,99,0,8,99,270,0,0,297,1,2,274,353,274,361,5,1640,1370
1696,4,1.0.8,0,611,0,63,8,71,0,8,71,270,0,0,297,1,2,204,353,204,361,5,1640,1370
1696,4,2.0.8,0,611,0,61,8,69,0,8,69,270,0,0,297,1,2,246,353,246,361,5,1640,1370
1696,4,3.0.8,0,611,0,44,8,52,0,8,52,270,0,0,297,1,2,331,353,331,361,5,1640,1370
1696,4,4.0.8,0,611,0,94,8,102,0,8,102,270,0,0,297,1,2,268,353,268,361,5,1640,1370
1696,4,5.4.270,1,611,0,47,270,317,270,0,317,317,-270,270,567,5,1,47,341,317,341,5,1640,1370
1696,5,0.0.8,0,611,0,91,8,99,0,8,99,317,0,0,567,1,2,274,353,274,361,6,1640,1323
1696,5,1.0.8,0,611,0,63,8,71,0,8,71,317,0,0,567,1,2,204,353,204,361,6,1640,1323
1696,5,2.0.8,0,611,0,61,8,69,0,8,69,317,0,0,567,1,2,246,353,246,361,6,1640,1323
1696,5,3.0.8,1,611,0,44,8,52,0,8,52,317,0,0,567,1,2,331,353,331,361,6,1640,1323
1696,5,4.0.8,0,611,0,94,8,102,0,8,102,317,0,0,567,1,2,268,353,268,361,6,1640,1323
1696,6,0.0.52,0,611,0,91,52,143,0,52,143,317,0,0,567,1,3,274,309,274,361,7,1640,1279
1696,6,1.0.52,0,611,0,63,52,115,0,52,115,317,0,0,567,1,3,204,309,204,361,7,1640,1279
1696,6,2.0.52,0,611,0,61,52,113,0,52,113,317,0,0,567,1,3,246,309,246,361,7,1640,1279
1696,6,3.1.100,1,611,0,76,100,176,52,48,176,317,0,8,567,2,2,287,226,331,318,7,1640,1279
1696,6,4.0.52,0,611,0,94,52,146,0,52,146,317,0,0,567,1,3,268,309,268,361,7,1640,1279
1696,7,0.0.52,0,611,0,91,52,143,0,52,143,317,0,0,567,1,3,274,309,274,361,8,1640,1203
1696,7,1.0.52,0,611,0,63,52,115,0,52,115,317,0,0,567,1,3,204,309,204,361,8,1640,1203
1696,7,2.0.52,0,611,0,61,52,113,0,52,113,317,0,0,567,1,3,246,309,246,361,8,1640,1203
1696,7,3.2.189,1,611,0,74,189,263,176,13,263,317,0,100,567,3,2,211,268,331,357,8,1640,1203
1696,7,4.0.52,0,611,0,94,52,146,0,52,146,317,0,0,567,1,3,268,309,268,361,8,1640,1203
1696,8,0.0.52,0,611,0,91,52,143,0,52,143,317,0,0,567,1,3,274,309,274,361,9,1640,1129
1696,8,1.0.52,0,611,0,63,52,115,0,52,115,317,0,0,567,1,3,204,309,204,361,9,1640,1129
1696,8,2.0.52,0,611,0,61,52,113,0,52,113,317,0,0,567,1,3,246,309,246,361,9,1640,1129
1696,8,3.3.270,1,611,0,45,270,315,263,7,315,317,0,189,567,4,2,137,182,331,263,9,1640,1129
1696,8,4.0.52,0,611,0,94,52,146,0,52,146,317,0,0,567,1,3,268,309,268,361,9,1640,1129
1696,9,0.0.52,0,611,0,91,52,143,0,52,143,317,0,0,567,1,3,274,309,274,361,10,1640,1084
1696,9,1.0.52,0,611,0,63,52,115,0,52,115,317,0,0,567,1,3,204,309,204,361,10,1640,1084
1696,9,2.0.52,0,611,0,61,52,113,0,52,113,317,0,0,567,1,3,246,309,246,361,10,1640,1084
1696,9,3.4.317,1,611,0,92,317,409,315,2,409,409,0,270,567,5,2,92,294,331,341,10,1640,1084
1696,9,4.0.52,0,611,0,94,52,146,0,52,146,317,0,0,567,1,3,268,309,268,361,10,1640,1084
1696,10,0.0.52,0,611,0,91,52,143,0,52,143,409,0,0,567,1,3,274,309,274,361,11,1640,992
1696,10,1.0.52,0,611,0,63,52,115,0,52,115,409,0,0,567,1,3,204,309,204,361,11,1640,992
1696,10,2.0.52,1,611,0,61,52,113,0,52,113,409,0,0,567,1,3,246,309,246,361,11,1640,992
1696,10,4.0.52,0,611,0,94,52,146,0,52,146,409,0,0,567,1,3,268,309,268,361,11,1640,992
1696,11,0.0.113,0,611,0,91,113,204,0,113,204,409,0,0,567,1,4,274,248,274,361,12,1640,931
1696,11,1.0.113,0,611,0,63,113,176,0,113,176,409,0,0,567,1,4,204,248,204,361,12,1640,931
1696,11,2.1.176,1,611,0,28,176,204,113,63,204,409,0,8,567,2,3,185,150,246,318,12,1640,931
1696,11,4.0.113,0,611,0,94,113,207,0,113,207,409,0,0,567,1,4,268,248,268,361,12,1640,931
1696,12,0.0.113,0,611,0,91,113,204,0,113,204,409,0,0,567,1,4,274,248,274,361,13,1640,903
1696,12,1.0.113,0,611,0,63,113,176,0,113,176,409,0,0,567,1,4,204,248,204,361,13,1640,903
1696,12,2.2.263,1,611,0,21,263,284,204,59,284,409,0,100,567,3,3,157,194,246,357,13,1640,903
1696,12,4.0.113,0,611,0,94,113,207,0,113,207,409,0,0,567,1,4,268,248,268,361,13,1640,903
1696,13,0.0.113,0,611,0,91,113,204,0,113,204,409,0,0,567,1,4,274,248,274,361,14,1640,882
1696,13,1.0.113,0,611,0,63,113,176,0,113,176,409,0,0,567,1,4,204,248,204,361,14,1640,882
1696,13,2.3.315,1,611,0,41,315,356,284,31,356,409,0,189,567,4,3,136,137,246,263,14,1640,882
1696,13,4.0.113,0,611,0,94,113,207,0,113,207,409,0,0,567,1,4,268,248,268,361,14,1640,882
1696,14,0.0.113,0,611,0,91,113,204,0,113,204,409,0,0,567,1,4,274,248,274,361,15,1640,841
1696,14,1.0.113,0,611,0,63,113,176,0,113,176,409,0,0,567,1,4,204,248,204,361,15,1640,841
1696,14,2.4.409,1,611,0,95,409,504,356,53,504,504,0,270,567,5,3,95,202,246,341,15,1640,841
1696,14,4.0.113,0,611,0,94,113,207,0,113,207,409,0,0,567,1,4,268,248,268,361,15,1640,841
1696,15,0.0.113,1,611,0,91,113,204,0,113,204,504,0,0,567,1,4,274,248,274,361,16,1640,746
1696,15,1.0.113,0,611,0,63,113,176,0,113,176,504,0,0,567,1,4,204,248,204,361,16,1640,746
1696,15,4.0.113,0,611,0,94,113,207,0,113,207,504,0,0,567,1,4,268,248,268,361,16,1640,746
1696,16,0.1.204,1,611,0,44,204,248,204,0,248,504,0,8,567,2,4,183,122,274,318,17,1640,655
1696,16,1.0.204,0,611,0,63,204,267,0,204,267,504,0,0,567,1,5,204,157,204,361,17,1640,655
1696,16,4.0.204,0,611,0,94,204,298,0,204,298,504,0,0,567,1,5,268,157,268,361,17,1640,655
1696,17,0.2.284,1,611,0,57,284,341,248,36,341,504,0,100,567,3,4,139,173,274,357,18,1640,611
1696,17,1.0.204,0,611,0,63,204,267,0,204,267,504,0,0,567,1,5,204,157,204,361,18,1640,611
1696,17,4.0.204,0,611,0,94,204,298,0,204,298,504,0,0,567,1,5,268,157,268,361,18,1640,611
1696,18,0.3.356,1,611,0,58,356,414,341,15,414,504,0,189,567,4,4,82,96,274,263,19,1640,554
1696,18,1.0.204,0,611,0,63,204,267,0,204,267,504,0,0,567,1,5,204,157,204,361,19,1640,554
1696,18,4.0.204,0,611,0,94,204,298,0,204,298,504,0,0,567,1,5,268,157,268,361,19,1640,554
1696,19,0.4.504,1,611,0,24,504,528,414,90,528,528,0,270,567,5,4,24,107,274,341,20,1640,496
1696,19,1.0.204,0,611,0,63,204,267,0,204,267,504,0,0,567,1,5,204,157,204,361,20,1640,496
1696,19,4.0.204,0,611,0,94,204,298,0,204,298,504,0,0,567,1,5,268,157,268,361,20,1640,496
1696,20,1.0.204,1,611,0,63,204,267,0,204,267,528,0,0,567,1,5,204,157,204,361,21,1640,472
1696,20,4.0.204,0,611,0,94,204,298,0,204,298,528,0,0,567,1,5,268,157,268,361,21,1640,472
1696,21,1.1.267,1,611,0,13,267,280,267,0,280,528,-19,27,586,2,5,141,78,204,318,22,1640,409
1696,21,4.0.267,0,611,0,94,267,361,0,267,361,528,0,0,567,1,6,268,94,268,361,22,1640,409
1696,22,1.2.341,0,611,0,64,341,405,280,61,405,528,0,100,586,3,5,128,116,204,357,23,1640,396
1696,22,4.0.267,1,611,0,94,267,361,0,267,361,528,0,0,586,1,6,268,94,268,361,23,1640,396
1696,23,1.2.341,1,611,0,64,341,405,280,61,405,528,0,100,586,3,5,128,116,204,357,24,1640,302
1696,23,4.1.361,0,611,0,65,361,426,361,0,426,528,-81,108,667,2,6,174,65,268,318,24,1640,302
1696,24,1.3.414,1,611,0,32,414,446,405,9,446,528,0,189,586,4,5,64,38,204,263,25,1640,238
1696,24,4.1.361,0,611,0,65,361,426,361,0,426,528,-81,108,667,2,6,174,65,268,318,25,1640,238
1696,25,1.4.528,1,611,0,32,528,560,446,82,560,560,0,270,586,5,5,32,83,204,341,26,1640,206
1696,25,4.1.361,0,611,0,65,361,426,361,0,426,528,-81,108,667,2,6,174,65,268,318,26,1640,206
1696,26,4.1.361,1,611,0,65,361,426,361,0,426,560,-81,108,667,2,6,174,65,268,318,27,1640,174
1696,27,4.2.426,1,611,0,52,426,478,426,0,478,560,-21,121,688,3,6,109,52,268,357,28,1640,109
1696,28,4.3.478,1,611,0,6,478,484,478,0,484,560,-32,221,720,4,6,57,6,268,263,29,1640,57
1696,29,4.4.560,1,611,0,51,560,611,484,76,611,611,0,270,720,5,6,51,51,268,341,30,1640,51
1697,0,0.0.0,1,456,0,5,0,5,0,0,5,5,0,0,0,1,1,218,176,218,176,1,1310,1310
1697,0,1.0.0,0,495,4,39,0,39,0,0,39,39,0,0,0,1,1,302,176,302,176,1,1310,1310
1697,0,2.0.0,0,463,1,7,0,7,0,0,7,7,0,0,0,1,1,172,176,172,176,1,1310,1310
1697,0,3.0.0,0,552,5,96,0,96,0,0,96,96,0,0,0,1,1,191,176,191,176,1,1310,1310
1697,0,4.0.0,0,472,3,16,0,16,0,0,16,16,0,0,0,1,1,207,176,207,176,1,1310,1310
1697,0,5.0.0,0,469,2,13,0,13,0,0,13,13,0,0,0,1,1,220,176,220,176,1,1310,1310
1697,1,0.1.5,1,456,0,12,5,17,5,0,17,17,-5,5,5,2,1,213,222,218,222,2,1310,1305
1697,1,1.0.5,0,457,1,39,5,44,0,5,44,44,0,0,0,1,2,302,171,302,176,2,1310,1305
1697,1,2.0.5,0,456,0,7,5,12,0,5,12,12,0,0,0,1,2,172,171,172,176,2,1310,1305
1697,1,3.0.5,0,498,2,96,5,101,0,5,101,101,0,0,0,1,2,191,171,191,176,2,1310,1305
1697,1,4.0.5,0,456,0,16,5,21,0,5,21,21,0,0,0,1,2,207,171,207,176,2,1310,1305
1697,1,5.0.5,0,456,0,13,5,18,0,5,18,18,0,0,0,1,2,220,171,220,176,2,1310,1305
1697,2,0.2.17,0,456,0,60,17,77,17,0,77,77,-17,17,22,3,1,201,325,218,325,3,1310,1293
1697,2,1.0.5,1,457,1,39,5,44,0,5,44,44,0,0,5,1,2,302,171,302,176,3,1310,1293
1697,2,2.0.5,0,456,0,7,5,12,0,5,12,17,0,0,5,1,2,172,171,172,176,3,1310,1293
1697,2,3.0.5,0,498,2,96,5,101,0,5,101,101,0,0,5,1,2,191,171,191,176,3,1310,1293
1697,2,4.0.5,0,456,0,16,5,21,0,5,21,21,0,0,5,1,2,207,171,207,176,3,1310,1293
1697,2,5.0.5,0,456,0,13,5,18,0,5,18,18,0,0,5,1,2,220,171,220,176,3,1310,1293
1697,3,0.2.17,0,457,0,60,17,77,17,0,77,77,-17,17,22,3,1,201,325,218,325,4,1310,1254
1697,3,1.1.44,0,507,3,80,44,124,44,0,124,124,-27,32,32,2,2,263,210,302,222,4,1310,1254
1697,3,2.0.44,0,459,1,7,44,51,0,44,51,51,0,0,5,1,3,172,132,172,176,4,1310,1254
1697,3,3.0.44,0,507,3,96,44,140,0,44,140,140,0,0,5,1,3,191,132,191,176,4,1310,1254
1697,3,4.0.44,0,457,0,16,44,60,0,44,60,60,0,0,5,1,3,207,132,207,176,4,1310,1254
1697,3,5.0.44,1,470,2,13,44,57,0,44,57,57,0,0,5,1,3,220,132,220,176,4,1310,1254
1697,4,0.2.17,0,470,0,60,17,77,17,0,77,77,-17,17,22,3,1,201,325,218,325,5,1310,1241
1697,4,1.1.44,0,507,2,80,44,124,44,0,124,124,-27,32,32,2,2,263,210,302,222,5,1310,1241
1697,4,2.0.57,0,470,0,7,57,64,0,57,64,64,0,0,5,1,4,172,119,172,176,5,1310,1241
1697,4,3.0.57,0,507,2,96,57,153,0,57,153,153,0,0,5,1,4,191,119,191,176,5,1310,1241
1697,4,4.0.57,1,470,0,16,57,73,0,57,73,73,0,0,5,1,4,207,119,207,176,5,1310,1241
1697,4,5.1.57,0,504,1,76,57,133,57,0,133,133,-40,45,45,2,2,207,210,220,222,5,1310,1241
1697,5,0.2.17,0,470,0,60,17,77,17,0,77,77,-17,17,22,3,1,201,325,218,325,6,1310,1225
1697,5,1.1.44,0,507,3,80,44,124,44,0,124,124,-27,32,32,2,2,263,210,302,222,6,1310,1225
1697,5,2.0.73,1,470,0,7,73,80,0,73,80,80,0,0,5,1,5,172,103,172,176,6,1310,1225
1697,5,3.0.73,0,489,1,96,73,169,0,73,169,169,0,0,5,1,5,191,103,191,176,6,1310,1225
1697,5,4.1.73,0,470,0,18,73,91,73,0,91,91,-56,61,61,2,2,191,210,207,222,6,1310,1225
1697,5,5.1.57,0,504,2,76,57,133,57,0,133,133,-40,45,45,2,2,207,210,220,222,6,1310,1225
1697,6,0.2.17,0,470,0,60,17,77,17,0,77,80,-17,17,22,3,1,201,325,218,325,7,1310,1218
1697,6,1.1.44,0,507,3,80,44,124,44,0,124,124,-27,32,32,2,2,263,210,302,222,7,1310,1218
1697,6,2.1.80,0,486,1,21,80,101,80,0,101,101,-63,68,68,2,2,165,210,172,222,7,1310,1218
1697,6,3.0.80,1,470,0,96,80,176,0,80,176,176,0,0,5,1,6,191,96,191,176,7,1310,1218
1697,6,4.1.73,0,470,0,18,73,91,73,0,91,91,-56,61,61,2,2,191,210,207,222,7,1310,1218
1697,6,5.1.57,0,504,2,76,57,133,57,0,133,133,-40,45,45,2,2,207,210,220,222,7,1310,1218
1697,7,0.2.17,0,470,0,60,17,77,17,0,77,176,-17,17,22,3,1,201,325,218,325,8,1310,1122
1697,7,1.1.44,0,507,4,80,44,124,44,0,124,176,-27,32,32,2,2,263,210,302,222,8,1310,1122
1697,7,2.1.80,0,486,1,21,80,101,80,0,101,176,-63,68,68,2,2,165,210,172,222,8,1310,1122
1697,7,3.1.176,0,489,2,15,176,191,176,0,191,191,-159,164,164,2,2,95,210,191,222,8,1310,1122
1697,7,4.1.73,1,470,0,18,73,91,73,0,91,176,-56,61,61,2,2,191,210,207,222,8,1310,1122
1697,7,5.1.57,0,504,3,76,57,133,57,0,133,176,-40,45,45,2,2,207,210,220,222,8,1310,1122
1697,8,0.2.17,0,470,0,60,17,77,17,0,77,176,-17,17,78,3,1,201,325,218,325,9,1310,1104
1697,8,1.1.91,1,489,2,80,91,171,44,47,171,176,0,61,61,2,3,263,192,302,222,9,1310,1104
1697,8,2.1.91,0,470,0,21,91,112,80,11,112,176,0,61,61,2,3,165,192,172,222,9,1310,1104
1697,8,3.1.176,0,489,2,15,176,191,176,0,191,191,-85,146,146,2,3,95,192,191,222,9,1310,1104
1697,8,4.2.91,0,470,0,53,91,144,91,0,144,176,-91,91,152,3,1,173,325,207,325,9,1310,1104
1697,8,5.1.91,0,485,1,76,91,167,57,34,167,176,0,61,61,2,3,207,192,220,222,9,1310,1104
1697,9,0.2.17,0,489,0,60,17,77,17,0,77,176,-17,17,78,3,1,201,325,218,325,10,1310,1024
1697,9,1.2.171,0,489,0,69,171,240,171,0,240,240,-171,171,232,3,1,183,325,302,325,10,1310,1024
1697,9,2.1.171,1,489,0,21,171,192,80,91,192,192,0,61,61,2,4,165,112,172,222,10,1310,1024
1697,9,3.1.176,0,489,0,15,176,191,176,0,191,191,-5,66,66,2,4,95,112,191,222,10,1310,1024
1697,9,4.2.91,0,489,0,53,91,144,91,0,144,176,-91,91,152,3,1,173,325,207,325,10,1310,1024
1697,9,5.1.171,0,489,0,76,171,247,57,114,247,247,0,61,61,2,4,207,112,220,222,10,1310,1024
1697,10,0.2.17,0,489,0,60,17,77,17,0,77,192,-17,17,78,3,1,201,325,218,325,11,1310,1003
1697,10,1.2.171,0,489,0,69,171,240,171,0,240,240,-171,171,232,3,1,183,325,302,325,11,1310,1003
1697,10,2.2.192,0,513,1,73,192,265,192,0,265,265,-192,192,253,3,1,144,325,172,325,11,1310,1003
1697,10,3.1.192,0,489,0,15,192,207,176,16,207,207,0,61,61,2,5,95,91,191,222,11,1310,1003
1697,10,4.2.91,0,489,0,53,91,144,91,0,144,192,-91,91,152,3,1,173,325,207,325,11,1310,1003
1697,10,5.1.192,1,489,0,76,192,268,57,135,268,268,0,61,61,2,5,207,91,220,222,11,1310,1003
1697,11,0.2.17,0,489,0,60,17,77,17,0,77,268,-17,17,78,3,1,201,325,218,325,12,1310,927
1697,11,1.2.171,0,489,0,69,171,240,171,0,240,268,-171,171,232,3,1,183,325,302,325,12,1310,927
1697,11,2.2.192,0,513,2,73,192,265,192,0,265,268,-192,192,253,3,1,144,325,172,325,12,1310,927
1697,11,3.1.268,1,489,0,15,268,283,176,92,283,283,0,61,61,2,6,95,15,191,222,12,1310,927
1697,11,4.2.91,0,489,0,53,91,144,91,0,144,268,-91,91,152,3,1,173,325,207,325,12,1310,927
1697,11,5.2.268,0,506,1,28,268,296,268,0,296,296,-268,268,329,3,1,131,325,220,325,12,1310,927
1697,12,0.2.17,1,489,0,60,17,77,17,0,77,283,-17,17,78,3,1,201,325,218,325,13,1310,912
1697,12,1.2.171,0,489,0,69,171,240,171,0,240,283,-171,171,232,3,1,183,325,302,325,13,1310,912
1697,12,2.2.192,0,513,2,73,192,265,192,0,265,283,-192,192,253,3,1,144,325,172,325,13,1310,912
1697,12,3.2.283,0,517,3,42,283,325,283,0,325,325,-283,283,344,3,1,80,325,191,325,13,1310,912
1697,12,4.2.91,0,489,0,53,91,144,91,0,144,283,-91,91,152,3,1,173,325,207,325,13,1310,912
1697,12,5.2.268,0,506,1,28,268,296,268,0,296,296,-268,268,329,3,1,131,325,220,325,13,1310,912
1697,13,0.3.77,1,489,0,65,77,142,77,0,142,283,-77,77,155,4,1,141,315,218,315,14,1310,852
1697,13,1.2.171,0,489,0,69,171,240,171,0,240,283,-94,111,172,3,2,183,265,302,325,14,1310,852
1697,13,2.2.192,0,513,2,73,192,265,192,0,265,283,-115,132,193,3,2,144,265,172,325,14,1310,852
1697,13,3.2.283,0,517,3,42,283,325,283,0,325,325,-206,223,284,3,2,80,265,191,325,14,1310,852
1697,13,4.2.91,0,489,0,53,91,144,91,0,144,283,-14,31,92,3,2,173,265,207,325,14,1310,852
1697,13,5.2.268,0,506,1,28,268,296,268,0,296,296,-191,208,269,3,2,131,265,220,325,14,1310,852
1697,14,0.4.142,1,489,0,76,142,218,142,0,218,283,-142,142,297,5,1,76,272,218,272,15,1310,787
1697,14,1.2.171,0,489,0,69,171,240,171,0,240,283,-94,111,249,3,2,183,265,302,325,15,1310,787
1697,14,2.2.192,0,513,2,73,192,265,192,0,265,283,-115,132,270,3,2,144,265,172,325,15,1310,787
1697,14,3.2.283,0,517,3,42,283,325,283,0,325,325,-206,223,361,3,2,80,265,191,325,15,1310,787
1697,14,4.2.91,0,489,0,53,91,144,91,0,144,283,-14,31,169,3,2,173,265,207,325,15,1310,787
1697,14,5.2.268,0,506,1,28,268,296,268,0,296,296,-191,208,346,3,2,131,265,220,325,15,1310,787
1697,15,1.2.171,0,489,0,69,171,240,171,0,240,283,-94,111,391,3,2,183,265,302,325,16,1310,711
1697,15,2.2.192,0,513,2,73,192,265,192,0,265,283,-115,132,412,3,2,144,265,172,325,16,1310,711
1697,15,3.2.283,0,517,3,42,283,325,283,0,325,325,-206,223,503,3,2,80,265,191,325,16,1310,711
1697,15,4.2.91,1,489,0,53,91,144,91,0,144,283,-14,31,311,3,2,173,265,207,325,16,1310,711
1697,15,5.2.268,0,506,1,28,268,296,268,0,296,296,-191,208,488,3,2,131,265,220,325,16,1310,711
1697,16,1.2.171,1,489,0,69,171,240,171,0,240,283,-27,58,338,3,3,183,212,302,325,17,1310,658
1697,16,2.2.192,0,513,2,73,192,265,192,0,265,283,-48,79,359,3,3,144,212,172,325,17,1310,658
1697,16,3.2.283,0,517,3,42,283,325,283,0,325,325,-139,170,450,3,3,80,212,191,325,17,1310,658
1697,16,4.3.144,0,489,0,98,144,242,144,0,242,283,-2,79,313,4,2,120,250,207,315,17,1310,658
1697,16,5.2.268,0,506,1,28,268,296,268,0,296,296,-124,155,435,3,3,131,212,220,325,17,1310,658
1697,17,1.3.240,0,528,3,73,240,313,240,0,313,313,-98,175,436,4,2,114,250,302,315,18,1310,589
1697,17,2.2.240,0,489,0,73,240,313,192,48,313,313,0,58,338,3,4,144,143,172,325,18,1310,589
1697,17,3.2.283,0,517,2,42,283,325,283,0,325,325,-43,101,381,3,4,80,143,191,325,18,1310,589
1697,17,4.3.144,0,489,0,98,144,242,144,0,242,283,-2,79,340,4,2,120,250,207,315,18,1310,589
1697,17,5.2.268,1,506,1,28,268,296,268,0,296,296,-28,86,366,3,4,131,143,220,325,18,1310,589
1697,18,1.3.240,0,535,2,73,240,313,240,0,313,313,-98,175,464,4,2,114,250,302,315,19,1310,561
1697,18,2.2.296,1,513,1,73,296,369,192,104,369,369,0,86,366,3,5,144,115,172,325,19,1310,561
1697,18,3.2.296,0,506,0,42,296,338,283,13,338,338,0,86,366,3,5,80,115,191,325,19,1310,561
1697,18,4.3.144,0,506,0,98,144,242,144,0,242,296,-2,79,368,4,2,120,250,207,315,19,1310,561
1697,18,5.3.296,0,535,2,65,296,361,296,0,361,361,-154,231,520,4,2,103,250,220,315,19,1310,561
1697,19,1.3.240,0,535,2,73,240,313,240,0,313,369,-98,175,464,4,2,114,250,302,315,20,1310,488
1697,19,2.3.369,0,516,1,10,369,379,369,0,379,379,-227,304,593,4,2,71,250,172,315,20,1310,488
1697,19,3.2.369,1,513,0,42,369,411,283,86,411,411,0,86,366,3,6,80,42,191,325,20,1310,488
1697,19,4.3.144,0,513,0,98,144,242,144,0,242,369,-2,79,368,4,2,120,250,207,315,20,1310,488
1697,19,5.3.296,0,535,2,65,296,361,296,0,361,369,-154,231,520,4,2,103,250,220,315,20,1310,488
1697,20,1.3.240,0,535,2,73,240,313,240,0,313,411,-98,175,464,4,2,114,250,302,315,21,1310,446
1697,20,2.3.369,0,516,1,10,369,379,369,0,379,411,-227,304,593,4,2,71,250,172,315,21,1310,446
1697,20,3.3.411,0,513,0,4,411,415,411,0,415,415,-269,346,635,4,2,38,250,191,315,21,1310,446
1697,20,4.3.144,1,513,0,98,144,242,144,0,242,411,-2,79,368,4,2,120,250,207,315,21,1310,446
1697,20,5.3.296,0,535,2,65,296,361,296,0,361,411,-154,231,520,4,2,103,250,220,315,21,1310,446
1697,21,1.3.242,0,513,0,73,242,315,240,2,315,411,0,79,368,4,3,114,152,302,315,22,1310,348
1697,21,2.3.369,0,516,1,10,369,379,369,0,379,411,-127,206,495,4,3,71,152,172,315,22,1310,348
1697,21,3.3.411,0,513,0,4,411,415,411,0,415,415,-169,248,537,4,3,38,152,191,315,22,1310,348
1697,21,4.4.242,1,513,0,22,242,264,242,0,264,411,-24,166,392,5,2,22,196,207,272,22,1310,348
1697,21,5.3.296,0,535,2,65,296,361,296,0,361,411,-54,133,422,4,3,103,152,220,315,22,1310,348
1697,22,1.3.242,1,513,0,73,242,315,240,2,315,411,0,79,392,4,3,114,152,302,315,23,1310,326
1697,22,2.3.369,0,516,1,10,369,379,369,0,379,411,-127,206,519,4,3,71,152,172,315,23,1310,326
1697,22,3.3.411,0,513,0,4,411,415,411,0,415,415,-169,248,561,4,3,38,152,191,315,23,1310,326
1697,22,5.3.296,0,535,2,65,296,361,296,0,361,411,-54,133,446,4,3,103,152,220,315,23,1310,326
1697,23,1.4.315,1,513,0,41,315,356,315,0,356,411,-51,217,443,5,3,41,174,302,272,24,1310,253
1697,23,2.3.369,0,516,1,10,369,379,369,0,379,411,-54,133,446,4,4,71,79,172,315,24,1310,253
1697,23,3.3.411,0,513,0,4,411,415,411,0,415,415,-96,175,488,4,4,38,79,191,315,24,1310,253
1697,23,5.3.315,0,513,0,65,315,380,296,19,380,411,0,79,392,4,4,103,79,220,315,24,1310,253
1697,24,2.3.369,0,516,1,10,369,379,369,0,379,411,-54,133,497,4,4,71,79,172,315,25,1310,212
1697,24,3.3.411,0,513,0,4,411,415,411,0,415,415,-96,175,539,4,4,38,79,191,315,25,1310,212
1697,24,5.3.315,1,513,0,65,315,380,296,19,380,411,0,79,443,4,4,103,79,220,315,25,1310,212
1697,25,2.3.380,1,513,0,10,380,390,369,11,390,411,0,79,443,4,5,71,14,172,315,26,1310,147
1697,25,3.3.411,0,513,0,4,411,415,411,0,415,415,-31,110,474,4,5,38,14,191,315,26,1310,147
1697,25,5.4.380,0,513,0,38,380,418,380,0,418,418,-24,241,467,5,4,38,133,220,272,26,1310,147
1697,26,2.4.390,0,523,1,61,390,451,390,0,451,451,-34,251,477,5,4,61,133,172,272,27,1310,137
1697,26,3.3.411,1,513,0,4,411,415,411,0,415,415,-21,100,464,4,6,38,4,191,315,27,1310,137
1697,26,5.4.380,0,513,0,38,380,418,380,0,418,418,-24,241,467,5,4,38,133,220,272,27,1310,137
1697,27,2.4.390,0,523,1,61,390,451,390,0,451,451,-34,251,498,5,4,61,133,172,272,28,1310,133
1697,27,3.4.415,0,548,2,34,415,449,415,0,449,449,-59,276,523,5,4,34,133,191,272,28,1310,133
1697,27,5.4.380,1,513,0,38,380,418,380,0,418,418,-24,241,488,5,4,38,133,220,272,28,1310,133
1697,28,2.4.418,0,513,0,61,418,479,390,28,479,479,0,241,488,5,5,61,95,172,272,29,1310,95
1697,28,3.4.418,1,513,0,34,418,452,415,3,452,452,0,241,488,5,5,34,95,191,272,29,1310,95
1697,29,2.4.452,1,513,0,61,452,513,390,62,513,513,0,241,488,5,6,61,61,172,272,30,1310,61
1698,0,0.0.0,0,549,4,18,0,18,0,0,18,18,0,0,0,1,1,262,192,262,192,1,1480,1480
1698,0,1.0.0,0,531,0,15,0,15,0,0,15,15,0,0,0,1,1,204,192,204,192,1,1480,1480
1698,0,2.0.0,0,536,1,53,0,53,0,0,53,53,0,0,0,1,1,199,192,199,192,1,1480,1480
1698,0,3.0.0,0,537,2,50,0,50,0,0,50,50,0,0,0,1,1,250,192,250,192,1,1480,1480
1698,0,4.0.0,1,556,5,38,0,38,0,0,38,38,0,0,0,1,1,343,192,343,192,1,1480,1480
1698,0,5.0.0,0,542,3,18,0,18,0,0,18,18,0,0,0,1,1,222,192,222,192,1,1480,1480
1698,1,0.0.38,1,559,1,18,38,56,0,38,56,56,0,0,0,1,2,262,154,262,192,2,1480,1442
1698,1,1.0.38,0,556,0,15,38,53,0,38,53,53,0,0,0,1,2,204,154,204,192,2,1480,1442
1698,1,2.0.38,0,559,1,53,38,91,0,38,91,91,0,0,0,1,2,199,154,199,192,2,1480,1442
1698,1,3.0.38,0,559,1,50,38,88,0,38,88,88,0,0,0,1,2,250,154,250,192,2,1480,1442
1698,1,4.1.38,0,559,1,69,38,107,38,0,107,107,-38,38,38,2,1,305,323,343,323,2,1480,1442
1698,1,5.0.38,0,559,1,18,38,56,0,38,56,56,0,0,0,1,2,222,154,222,192,2,1480,1442
1698,2,0.1.56,0,604,1,79,56,135,56,0,135,135,-56,56,56,2,1,244,323,262,323,3,1480,1424
1698,2,1.0.56,0,559,0,15,56,71,0,56,71,71,0,0,0,1,3,204,136,204,192,3,1480,1424
1698,2,2.0.56,0,559,0,53,56,109,0,56,109,109,0,0,0,1,3,199,136,199,192,3,1480,1424
1698,2,3.0.56,0,559,0,50,56,106,0,56,106,106,0,0,0,1,3,250,136,250,192,3,1480,1424
1698,2,4.1.38,0,559,0,69,38,107,38,0,107,107,-38,38,38,2,1,305,323,343,323,3,1480,1424
1698,2,5.0.56,1,559,0,18,56,74,0,56,74,74,0,0,0,1,3,222,136,222,192,3,1480,1424
1698,3,0.1.56,0,604,2,79,56,135,56,0,135,135,-56,56,56,2,1,244,323,262,323,4,1480,1406
1698,3,1.0.74,1,559,0,15,74,89,0,74,89,89,0,0,0,1,4,204,118,204,192,4,1480,1406
1698,3,2.0.74,0,559,0,53,74,127,0,74,127,127,0,0,0,1,4,199,118,199,192,4,1480,1406
1698,3,3.0.74,0,559,0,50,74,124,0,74,124,124,0,0,0,1,4,250,118,250,192,4,1480,1406
1698,3,4.1.38,0,559,0,69,38,107,38,0,107,107,-38,38,38,2,1,305,323,343,323,4,1480,1406
1698,3,5.1.74,0,598,1,59,74,133,74,0,133,133,-74,74,74,2,1,204,323,222,323,4,1480,1406
1698,4,0.1.56,0,604,3,79,56,135,56,0,135,135,-56,56,56,2,1,244,323,262,323,5,1480,1391
1698,4,1.1.89,0,592,1,48,89,137,89,0,137,137,-89,89,89,2,1,189,323,204,323,5,1480,1391
1698,4,2.0.89,0,559,0,53,89,142,0,89,142,142,0,0,0,1,5,199,103,199,192,5,1480,1391
1698,4,3.0.89,1,559,0,50,89,139,0,89,139,139,0,0,0,1,5,250,103,250,192,5,1480,1391
1698,4,4.1.38,0,559,0,69,38,107,38,0,107,107,-38,38,38,2,1,305,323,343,323,5,1480,1391
1698,4,5.1.74,0,602,2,59,74,133,74,0,133,133,-74,74,74,2,1,204,323,222,323,5,1480,1391
1698,5,0.1.56,0,604,2,79,56,135,56,0,135,139,-56,56,56,2,1,244,323,262,323,6,1480,1341
1698,5,1.1.89,0,605,3,48,89,137,89,0,137,139,-89,89,89,2,1,189,323,204,323,6,1480,1341
1698,5,2.0.139,1,559,0,53,139,192,0,139,192,192,0,0,0,1,6,199,53,199,192,6,1480,1341
1698,5,3.1.139,0,559,0,53,139,192,139,0,192,192,-139,139,139,2,1,200,323,250,323,6,1480,1341
1698,5,4.1.38,0,559,0,69,38,107,38,0,107,139,-38,38,38,2,1,305,323,343,323,6,1480,1341
1698,5,5.1.74,0,602,1,59,74,133,74,0,133,139,-74,74,74,2,1,204,323,222,323,6,1480,1341
1698,6,0.1.56,0,604,2,79,56,135,56,0,135,192,-56,56,56,2,1,244,323,262,323,7,1480,1288
1698,6,1.1.89,0,605,3,48,89,137,89,0,137,192,-89,89,89,2,1,189,323,204,323,7,1480,1288
1698,6,2.1.192,0,559,0,15,192,207,192,0,207,207,-192,192,192,2,1,146,323,199,323,7,1480,1288
1698,6,3.1.139,0,559,0,53,139,192,139,0,192,192,-139,139,139,2,1,200,323,250,323,7,1480,1288
1698,6,4.1.38,1,559,0,69,38,107,38,0,107,192,-38,38,38,2,1,305,323,343,323,7,1480,1288
1698,6,5.1.74,0,602,1,59,74,133,74,0,133,192,-74,74,74,2,1,204,323,222,323,7,1480,1288
1698,7,0.1.107,0,559,0,79,107,186,56,51,186,192,0,38,38,2,2,244,254,262,323,8,1480,1219
1698,7,1.1.107,0,559,0,48,107,155,89,18,155,192,0,38,38,2,2,189,254,204,323,8,1480,1219
1698,7,2.1.192,0,559,0,15,192,207,192,0,207,207,-85,123,123,2,2,146,254,199,323,8,1480,1219
1698,7,3.1.139,0,559,0,53,139,192,139,0,192,192,-32,70,70,2,2,200,254,250,323,8,1480,1219
1698,7,4.2.107,1,559,0,54,107,161,107,0,161,192,-107,107,145,3,1,236,295,343,295,8,1480,1219
1698,7,5.1.107,0,559,0,59,107,166,74,33,166,192,0,38,38,2,2,204,254,222,323,8,1480,1219
1698,8,0.1.107,1,559,0,79,107,186,56,51,186,192,0,38,145,2,2,244,254,262,323,9,1480,1165
1698,8,1.1.107,0,559,0,48,107,155,89,18,155,192,0,38,145,2,2,189,254,204,323,9,1480,1165
1698,8,2.1.192,0,559,0,15,192,207,192,0,207,207,-85,123,230,2,2,146,254,199,323,9,1480,1165
1698,8,3.1.139,0,559,0,53,139,192,139,0,192,192,-32,70,177,2,2,200,254,250,323,9,1480,1165
1698,8,4.3.161,0,559,0,91,161,252,161,0,252,252,-161,161,306,4,1,182,369,343,369,9,1480,1165
1698,8,5.1.107,0,559,0,59,107,166,74,33,166,192,0,38,145,2,2,204,254,222,323,9,1480,1165
1698,9,0.2.186,0,560,1,64,186,250,186,0,250,250,-25,132,170,3,2,165,241,262,295,10,1480,1086
1698,9,1.1.186,0,560,1,48,186,234,89,97,234,234,0,38,145,2,3,189,175,204,323,10,1480,1086
1698,9,2.1.192,0,559,0,15,192,207,192,0,207,207,-6,44,151,2,3,146,175,199,323,10,1480,1086
1698,9,3.1.186,0,566,2,53,186,239,139,47,239,239,0,38,145,2,3,200,175,250,323,10,1480,1086
1698,9,4.3.161,0,559,0,91,161,252,161,0,252,252,-161,161,306,4,1,182,369,343,369,10,1480,1086
1698,9,5.1.186,1,568,3,59,186,245,74,112,245,245,0,38,145,2,3,204,175,222,323,10,1480,1086
1698,10,0.2.186,0,568,0,64,186,250,186,0,250,250,-25,132,170,3,2,165,241,262,295,11,1480,1027
1698,10,1.1.245,1,573,1,48,245,293,89,156,293,293,0,38,145,2,4,189,116,204,323,11,1480,1027
1698,10,2.1.245,0,568,0,15,245,260,192,53,260,260,0,38,145,2,4,146,116,199,323,11,1480,1027
1698,10,3.1.245,0,568,0,53,245,298,139,106,298,298,0,38,145,2,4,200,116,250,323,11,1480,1027
1698,10,4.3.161,0,568,0,91,161,252,161,0,252,252,-161,161,306,4,1,182,369,343,369,11,1480,1027
1698,10,5.2.245,0,615,2,66,245,311,245,0,311,311,-84,191,229,3,2,145,241,222,295,11,1480,1027
1698,11,0.2.186,0,573,0,64,186,250,186,0,250,293,-25,132,170,3,2,165,241,262,295,12,1480,979
1698,11,1.2.293,0,600,1,75,293,368,293,0,368,368,-132,239,277,3,2,141,241,204,295,12,1480,979
1698,11,2.1.293,1,573,0,15,293,308,192,101,308,308,0,38,145,2,5,146,68,199,323,12,1480,979
1698,11,3.1.293,0,573,0,53,293,346,139,154,346,346,0,38,145,2,5,200,68,250,323,12,1480,979
1698,11,4.3.161,0,573,0,91,161,252,161,0,252,293,-161,161,306,4,1,182,369,343,369,12,1480,979
1698,11,5.2.245,0,622,2,66,245,311,245,0,311,311,-84,191,229,3,2,145,241,222,295,12,1480,979
1698,12,0.2.186,0,573,0,64,186,250,186,0,250,308,-25,132,170,3,2,165,241,262,295,13,1480,964
1698,12,1.2.293,0,600,2,75,293,368,293,0,368,368,-132,239,277,3,2,141,241,204,295,13,1480,964
1698,12,2.2.308,0,596,1,27,308,335,308,0,335,335,-147,254,292,3,2,131,241,199,295,13,1480,964
1698,12,3.1.308,1,573,0,53,308,361,139,169,361,361,0,38,145,2,6,200,53,250,323,13,1480,964
1698,12,4.3.161,0,573,0,91,161,252,161,0,252,308,-161,161,306,4,1,182,369,343,369,13,1480,964
1698,12,5.2.245,0,622,3,66,245,311,245,0,311,311,-84,191,229,3,2,145,241,222,295,13,1480,964
1698,13,0.2.186,1,573,0,64,186,250,186,0,250,361,-25,132,170,3,2,165,241,262,295,14,1480,911
1698,13,1.2.293,0,600,3,75,293,368,293,0,368,368,-132,239,277,3,2,141,241,204,295,14,1480,911
1698,13,2.2.308,0,596,2,27,308,335,308,0,335,361,-147,254,292,3,2,131,241,199,295,14,1480,911
1698,13,3.2.361,0,588,1,9,361,370,361,0,370,370,-200,307,345,3,2,147,241,250,295,14,1480,911
1698,13,4.3.161,0,573,0,91,161,252,161,0,252,361,-161,161,306,4,1,182,369,343,369,14,1480,911
1698,13,5.2.245,0,622,4,66,245,311,245,0,311,361,-84,191,229,3,2,145,241,222,295,14,1480,911
1698,14,0.3.250,0,677,4,72,250,322,250,0,322,361,-250,250,420,4,1,101,369,262,369,15,1480,847
1698,14,1.2.293,0,600,3,75,293,368,293,0,368,368,-43,175,213,3,3,141,177,204,295,15,1480,847
1698,14,2.2.308,0,596,2,27,308,335,308,0,335,361,-58,190,228,3,3,131,177,199,295,15,1480,847
1698,14,3.2.361,0,588,1,9,361,370,361,0,370,370,-111,243,281,3,3,147,177,250,295,15,1480,847
1698,14,4.3.161,0,573,0,91,161,252,161,0,252,361,-161,161,331,4,1,182,369,343,369,15,1480,847
1698,14,5.2.250,1,573,0,66,250,316,245,5,316,361,0,132,170,3,3,145,177,222,295,15,1480,847
1698,15,0.3.250,0,677,3,72,250,322,250,0,322,361,-250,250,420,4,1,101,369,262,369,16,1480,781
1698,15,1.2.316,0,573,0,75,316,391,293,23,391,391,0,132,170,3,4,141,111,204,295,16,1480,781
1698,15,2.2.316,1,588,1,27,316,343,308,8,343,361,0,132,170,3,4,131,111,199,295,16,1480,781
1698,15,3.2.361,0,588,1,9,361,370,361,0,370,370,-45,177,215,3,4,147,111,250,295,16,1480,781
1698,15,4.3.161,0,573,0,91,161,252,161,0,252,361,-161,161,331,4,1,182,369,343,369,16,1480,781
1698,15,5.3.316,0,620,2,50,316,366,316,0,366,366,-316,316,486,4,1,79,369,222,369,16,1480,781
1698,16,0.3.250,0,677,4,72,250,322,250,0,322,361,-250,250,420,4,1,101,369,262,369,17,1480,754
1698,16,1.2.343,0,600,1,75,343,418,293,50,418,418,0,132,170,3,5,141,84,204,295,17,1480,754
1698,16,2.3.343,0,604,2,78,343,421,343,0,421,421,-343,343,513,4,1,104,369,199,369,17,1480,754
1698,16,3.2.361,1,588,0,9,361,370,361,0,370,370,-18,150,188,3,5,147,84,250,295,17,1480,754
1698,16,4.3.161,0,588,0,91,161,252,161,0,252,361,-161,161,331,4,1,182,369,343,369,17,1480,754
1698,16,5.3.316,0,620,3,50,316,366,316,0,366,366,-316,316,486,4,1,79,369,222,369,17,1480,754
1698,17,0.3.250,0,677,4,72,250,322,250,0,322,370,-250,250,438,4,1,101,369,262,369,18,1480,745
1698,17,1.2.370,1,588,0,75,370,445,293,77,445,445,0,150,188,3,6,141,75,204,295,18,1480,745
1698,17,2.3.343,0,626,3,78,343,421,343,0,421,421,-343,343,531,4,1,104,369,199,369,18,1480,745
1698,17,3.3.370,0,613,1,62,370,432,370,0,432,432,-370,370,558,4,1,138,369,250,369,18,1480,745
1698,17,4.3.161,0,588,0,91,161,252,161,0,252,370,-161,161,349,4,1,182,369,343,369,18,1480,745
1698,17,5.3.316,0,624,2,50,316,366,316,0,366,370,-316,316,504,4,1,79,369,222,369,18,1480,745
1698,18,0.3.250,0,677,4,72,250,322,250,0,322,445,-250,250,438,4,1,101,369,262,369,19,1480,670
1698,18,1.3.445,0,588,0,16,445,461,445,0,461,461,-445,445,633,4,1,66,369,204,369,19,1480,670
1698,18,2.3.343,0,626,3,78,343,421,343,0,421,445,-343,343,531,4,1,104,369,199,369,19,1480,670
1698,18,3.3.370,0,613,1,62,370,432,370,0,432,445,-370,370,558,4,1,138,369,250,369,19,1480,670
1698,18,4.3.161,1,588,0,91,161,252,161,0,252,445,-161,161,349,4,1,182,369,343,369,19,1480,670
1698,18,5.3.316,0,624,2,50,316,366,316,0,366,445,-316,316,504,4,1,79,369,222,369,19,1480,670
1698,19,0.3.252,0,588,0,72,252,324,250,2,324,445,0,161,349,4,2,101,278,262,369,20,1480,579
1698,19,1.3.445,0,588,0,16,445,461,445,0,461,461,-193,354,542,4,2,66,278,204,369,20,1480,579
1698,19,2.3.343,0,626,3,78,343,421,343,0,421,445,-91,252,440,4,2,104,278,199,369,20,1480,579
1698,19,3.3.370,0,613,1,62,370,432,370,0,432,445,-118,279,467,4,2,138,278,250,369,20,1480,579
1698,19,4.4.252,1,588,0,91,252,343,252,0,343,445,-252,252,601,5,1,91,301,343,301,20,1480,579
1698,19,5.3.316,0,624,2,50,316,366,316,0,366,445,-64,225,413,4,2,79,278,222,369,20,1480,579
1698,20,0.3.252,1,588,0,72,252,324,250,2,324,445,0,161,601,4,2,101,278,262,369,21,1480,488
1698,20,1.3.445,0,588,0,16,445,461,445,0,461,461,-193,354,794,4,2,66,278,204,369,21,1480,488
1698,20,2.3.343,0,626,3,78,343,421,343,0,421,445,-91,252,692,4,2,104,278,199,369,21,1480,488
1698,20,3.3.370,0,613,1,62,370,432,370,0,432,445,-118,279,719,4,2,138,278,250,369,21,1480,488
1698,20,5.3.316,0,624,2,50,316,366,316,0,366,445,-64,225,665,4,2,79,278,222,369,21,1480,488
1698,21,0.4.343,1,588,0,29,343,372,324,19,372,445,0,252,601,5,2,29,210,262,301,22,1480,416
1698,21,1.3.445,0,588,0,16,445,461,445,0,461,461,-121,282,722,4,3,66,206,204,369,22,1480,416
1698,21,2.3.343,0,626,2,78,343,421,343,0,421,445,-19,180,620,4,3,104,206,199,369,22,1480,416
1698,21,3.3.370,0,613,1,62,370,432,370,0,432,445,-46,207,647,4,3,138,206,250,369,22,1480,416
1698,21,5.3.324,0,588,0,50,324,374,316,8,374,445,0,161,601,4,3,79,206,222,369,22,1480,416
1698,22,1.3.445,0,588,0,16,445,461,445,0,461,461,-121,282,722,4,3,66,206,204,369,23,1480,387
1698,22,2.3.343,0,626,2,78,343,421,343,0,421,445,-19,180,620,4,3,104,206,199,369,23,1480,387
1698,22,3.3.370,0,613,1,62,370,432,370,0,432,445,-46,207,647,4,3,138,206,250,369,23,1480,387
1698,22,5.3.324,1,588,0,50,324,374,316,8,374,445,0,161,601,4,3,79,206,222,369,23,1480,387
1698,23,1.3.445,0,588,0,16,445,461,445,0,461,461,-71,232,672,4,4,66,156,204,369,24,1480,337
1698,23,2.3.374,0,606,1,78,374,452,343,31,452,452,0,161,601,4,4,104,156,199,369,24,1480,337
1698,23,3.3.374,0,588,0,62,374,436,370,4,436,445,0,161,601,4,4,138,156,250,369,24,1480,337
1698,23,5.4.374,1,588,0,29,374,403,374,0,403,445,-2,254,603,5,3,29,181,222,301,24,1480,337
1698,24,1.3.445,0,588,0,16,445,461,445,0,461,461,-71,232,674,4,4,66,156,204,369,25,1480,308
1698,24,2.3.374,0,606,1,78,374,452,343,31,452,452,0,161,603,4,4,104,156,199,369,25,1480,308
1698,24,3.3.374,1,588,0,62,374,436,370,4,436,445,0,161,603,4,4,138,156,250,369,25,1480,308
1698,25,1.3.445,1,588,0,16,445,461,445,0,461,461,-9,170,612,4,5,66,94,204,369,26,1480,246
1698,25,2.3.436,0,590,1,78,436,514,343,93,514,514,0,161,603,4,5,104,94,199,369,26,1480,246
1698,25,3.4.436,0,588,0,76,436,512,436,0,512,512,-33,287,636,5,4,76,152,250,301,26,1480,246
1698,26,1.4.461,0,613,1,50,461,511,461,0,511,511,-58,312,670,5,4,50,152,204,301,27,1480,230
1698,26,2.3.461,1,588,0,78,461,539,343,118,539,539,0,170,612,4,6,104,78,199,369,27,1480,230
1698,26,3.4.436,0,588,0,76,436,512,436,0,512,512,-33,287,645,5,4,76,152,250,301,27,1480,230
1698,27,1.4.461,0,613,1,50,461,511,461,0,511,539,-58,312,670,5,4,50,152,204,301,28,1480,152
1698,27,2.4.539,0,615,2,26,539,565,539,0,565,565,-136,390,748,5,4,26,152,199,301,28,1480,152
1698,27,3.4.436,1,588,0,76,436,512,436,0,512,539,-33,287,645,5,4,76,152,250,301,28,1480,152
1698,28,1.4.512,1,588,0,50,512,562,461,51,562,562,0,287,645,5,5,50,76,204,301,29,1480,76
1698,28,2.4.539,0,615,1,26,539,565,539,0,565,565,-27,314,672,5,5,26,76,199,301,29,1480,76
1698,29,2.4.562,1,588,0,26,562,588,539,23,588,588,0,287,645,5,6,26,26,199,301,30,1480,26
1699,0,0.0.0,1,556,0,31,0,31,0,0,31,31,0,0,0,1,1,305,305,305,305,1,1548,1548
1699,0,1.0.0,0,600,5,90,0,90,0,0,90,90,0,0,0,1,1,304,305,304,305,1,1548,1548
1699,0,2.0.0,0,573,4,98,0,98,0,0,98,98,0,0,0,1,1,323,305,323,305,1,1548,1548
1699,0,3.0.0,0,560,1,4,0,4,0,0,4,4,0,0,0,1,1,210,305,210,305,1,1548,1548
1699,0,4.0.0,0,568,2,60,0,60,0,0,60,60,0,0,0,1,1,282,305,282,305,1,1548,1548
1699,0,5.0.0,0,569,3,22,0,22,0,0,22,22,0,0,0,1,1,124,305,124,305,1,1548,1548
1699,1,0.1.31,1,556,0,48,31,79,31,0,79,79,-31,31,31,2,1,274,227,305,227,2,1548,1517
1699,1,1.0.31,0,556,0,90,31,121,0,31,121,121,0,0,0,1,2,304,274,304,305,2,1548,1517
1699,1,2.0.31,0,556,0,98,31,129,0,31,129,129,0,0,0,1,2,323,274,323,305,2,1548,1517
1699,1,3.0.31,0,556,0,4,31,35,0,31,35,35,0,0,0,1,2,210,274,210,305,2,1548,1517
1699,1,4.0.31,0,559,1,60,31,91,0,31,91,91,0,0,0,1,2,282,274,282,305,2,1548,1517
1699,1,5.0.31,0,556,0,22,31,53,0,31,53,53,0,0,0,1,2,124,274,124,305,2,1548,1517
1699,2,0.2.79,0,556,0,67,79,146,79,0,146,146,-79,79,110,3,1,226,362,305,362,3,1548,1469
1699,2,1.0.31,0,556,0,90,31,121,0,31,121,121,0,0,31,1,2,304,274,304,305,3,1548,1469
1699,2,2.0.31,0,556,0,98,31,129,0,31,129,129,0,0,31,1,2,323,274,323,305,3,1548,1469
1699,2,3.0.31,1,556,0,4,31,35,0,31,35,79,0,0,31,1,2,210,274,210,305,3,1548,1469
1699,2,4.0.31,0,559,1,60,31,91,0,31,91,91,0,0,31,1,2,282,274,282,305,3,1548,1469
1699,2,5.0.31,0,556,0,22,31,53,0,31,53,79,0,0,31,1,2,124,274,124,305,3,1548,1469
1699,3,0.2.79,0,556,0,67,79,146,79,0,146,146,-79,79,110,3,1,226,362,305,362,4,1548,1465
1699,3,1.0.35,0,556,0,90,35,125,0,35,125,125,0,0,31,1,3,304,270,304,305,4,1548,1465
1699,3,2.0.35,0,556,0,98,35,133,0,35,133,133,0,0,31,1,3,323,270,323,305,4,1548,1465
1699,3,3.1.79,1,556,0,91,79,170,35,44,170,170,0,31,31,2,2,206,179,210,227,4,1548,1465
1699,3,4.0.35,0,559,1,60,35,95,0,35,95,95,0,0,31,1,3,282,270,282,305,4,1548,1465
1699,3,5.0.35,0,556,0,22,35,57,0,35,57,79,0,0,31,1,3,124,270,124,305,4,1548,1465
1699,4,0.2.79,1,556,0,67,79,146,79,0,146,170,-79,79,110,3,1,226,362,305,362,5,1548,1374
1699,4,1.0.35,0,577,2,90,35,125,0,35,125,170,0,0,31,1,3,304,270,304,305,5,1548,1374
1699,4,2.0.35,0,556,0,98,35,133,0,35,133,170,0,0,31,1,3,323,270,323,305,5,1548,1374
1699,4,3.2.170,0,591,4,76,170,246,170,0,246,246,-170,170,201,3,1,115,362,210,362,5,1548,1374
1699,4,4.0.35,0,579,3,60,35,95,0,35,95,170,0,0,31,1,3,282,270,282,305,5,1548,1374
1699,4,5.0.35,0,557,1,22,35,57,0,35,57,170,0,0,31,1,3,124,270,124,305,5,1548,1374
1699,5,0.3.146,1,556,0,78,146,224,146,0,224,224,-146,146,256,4,1,159,322,305,322,6,1548,1307
1699,5,1.0.35,0,577,2,90,35,125,0,35,125,170,0,0,110,1,3,304,270,304,305,6,1548,1307
1699,5,2.0.35,0,556,0,98,35,133,0,35,133,170,0,0,110,1,3,323,270,323,305,6,1548,1307
1699,5,3.2.170,0,591,4,76,170,246,170,0,246,246,-24,103,134,3,2,115,295,210,362,6,1548,1307
1699,5,4.0.35,0,579,3,60,35,95,0,35,95,170,0,0,110,1,3,282,270,282,305,6,1548,1307
1699,5,5.0.35,0,557,1,22,35,57,0,35,57,170,0,0,110,1,3,124,270,124,305,6,1548,1307
1699,6,0.4.224,1,556,0,81,224,305,224,0,305,305,-224,224,480,5,1,81,332,305,332,7,1548,1229
1699,6,1.0.35,0,577,2,90,35,125,0,35,125,224,0,0,256,1,3,304,270,304,305,7,1548,1229
1699,6,2.0.35,0,556,0,98,35,133,0,35,133,224,0,0,256,1,3,323,270,323,305,7,1548,1229
1699,6,3.2.170,0,591,4,76,170,246,170,0,246,246,-24,103,280,3,2,115,295,210,362,7,1548,1229
1699,6,4.0.35,0,579,3,60,35,95,0,35,95,224,0,0,256,1,3,282,270,282,305,7,1548,1229
1699,6,5.0.35,0,557,1,22,35,57,0,35,57,224,0,0,256,1,3,124,270,124,305,7,1548,1229
1699,7,1.0.35,0,577,2,90,35,125,0,35,125,305,0,0,480,1,3,304,270,304,305,8,1548,1148
1699,7,2.0.35,0,556,0,98,35,133,0,35,133,305,0,0,480,1,3,323,270,323,305,8,1548,1148
1699,7,3.2.170,0,591,4,76,170,246,170,0,246,305,-24,103,504,3,2,115,295,210,362,8,1548,1148
1699,7,4.0.35,1,579,3,60,35,95,0,35,95,305,0,0,480,1,3,282,270,282,305,8,1548,1148
1699,7,5.0.35,0,557,1,22,35,57,0,35,57,305,0,0,480,1,3,124,270,124,305,8,1548,1148
1699,8,1.0.95,0,581,1,90,95,185,0,95,185,305,0,0,480,1,4,304,210,304,305,9,1548,1088
1699,8,2.0.95,0,579,0,98,95,193,0,95,193,305,0,0,480,1,4,323,210,323,305,9,1548,1088
1699,8,3.2.170,0,591,2,76,170,246,170,0,246,305,-24,103,504,3,2,115,295,210,362,9,1548,1088
1699,8,4.1.170,1,579,0,21,170,191,95,75,191,305,0,31,480,2,3,222,88,282,227,9,1548,1088
1699,8,5.0.95,0,581,1,22,95,117,0,95,117,305,0,0,480,1,4,124,210,124,305,9,1548,1088
1699,9,1.0.95,1,581,1,90,95,185,0,95,185,305,0,0,480,1,4,304,210,304,305,10,1548,1067
1699,9,2.0.95,0,579,0,98,95,193,0,95,193,305,0,0,480,1,4,323,210,323,305,10,1548,1067
1699,9,3.2.170,0,591,2,76,170,246,170,0,246,305,-24,103,504,3,2,115,295,210,362,10,1548,1067
1699,9,4.2.191,0,581,1,55,191,246,191,0,246,305,-45,124,525,3,2,201,295,282,362,10,1548,1067
1699,9,5.0.95,0,581,1,22,95,117,0,95,117,305,0,0,480,1,4,124,210,124,305,10,1548,1067
1699,10,1.1.191,1,581,0,17,191,208,185,6,208,305,0,31,480,2,4,214,67,304,227,11,1548,977
1699,10,2.0.185,0,581,0,98,185,283,0,185,283,305,0,0,480,1,5,323,120,323,305,11,1548,977
1699,10,3.2.170,0,606,1,76,170,246,170,0,246,305,-24,103,504,3,2,115,295,210,362,11,1548,977
1699,10,4.2.191,0,581,0,55,191,246,191,0,246,305,-45,124,525,3,2,201,295,282,362,11,1548,977
1699,10,5.0.185,0,581,0,22,185,207,0,185,207,305,0,0,480,1,5,124,120,124,305,11,1548,977
1699,11,1.2.208,0,609,2,80,208,288,208,0,288,305,-62,141,542,3,2,197,295,304,362,12,1548,960
1699,11,2.0.185,1,581,0,98,185,283,0,185,283,305,0,0,480,1,5,323,120,323,305,12,1548,960
1699,11,3.2.170,0,607,1,76,170,246,170,0,246,305,-24,103,504,3,2,115,295,210,362,12,1548,960
1699,11,4.2.191,0,581,0,55,191,246,191,0,246,305,-45,124,525,3,2,201,295,282,362,12,1548,960
1699,11,5.0.185,0,581,0,22,185,207,0,185,207,305,0,0,480,1,5,124,120,124,305,12,1548,960
1699,12,1.2.208,0,609,1,80,208,288,208,0,288,305,-62,141,542,3,2,197,295,304,362,13,1548,862
1699,12,2.1.283,1,581,0,8,283,291,283,0,291,305,-75,106,555,2,5,225,50,323,227,13,1548,862
1699,12,3.2.170,0,618,2,76,170,246,170,0,246,305,-24,103,504,3,2,115,295,210,362,13,1548,862
1699,12,4.2.191,0,581,0,55,191,246,191,0,246,305,-45,124,525,3,2,201,295,282,362,13,1548,862
1699,12,5.0.283,0,581,0,22,283,305,0,283,305,305,0,0,480,1,6,124,22,124,305,13,1548,862
1699,13,1.2.208,0,609,2,80,208,288,208,0,288,305,-62,141,617,3,2,197,295,304,362,14,1548,854
1699,13,2.2.291,0,606,1,79,291,370,291,0,370,370,-145,224,700,3,2,217,295,323,362,14,1548,854
1699,13,3.2.170,0,618,3,76,170,246,170,0,246,305,-24,103,579,3,2,115,295,210,362,14,1548,854
1699,13,4.2.191,0,581,0,55,191,246,191,0,246,305,-45,124,600,3,2,201,295,282,362,14,1548,854
1699,13,5.0.283,1,581,0,22,283,305,0,283,305,305,0,0,555,1,6,124,22,124,305,14,1548,854
1699,14,1.2.208,0,609,2,80,208,288,208,0,288,305,-62,141,617,3,2,197,295,304,362,15,1548,832
1699,14,2.2.291,0,606,1,79,291,370,291,0,370,370,-145,224,700,3,2,217,295,323,362,15,1548,832
1699,14,3.2.170,0,618,3,76,170,246,170,0,246,305,-24,103,579,3,2,115,295,210,362,15,1548,832
1699,14,4.2.191,0,581,0,55,191,246,191,0,246,305,-45,124,600,3,2,201,295,282,362,15,1548,832
1699,14,5.1.305,1,581,0,42,305,347,305,0,347,347,-14,120,569,2,6,102,42,124,227,15,1548,832
1699,15,1.2.208,0,609,3,80,208,288,208,0,288,347,-62,141,631,3,2,197,295,304,362,16,1548,790
1699,15,2.2.291,0,606,2,79,291,370,291,0,370,370,-145,224,714,3,2,217,295,323,362,16,1548,790
1699,15,3.2.170,0,618,4,76,170,246,170,0,246,347,-24,103,593,3,2,115,295,210,362,16,1548,790
1699,15,4.2.191,1,581,0,55,191,246,191,0,246,347,-45,124,614,3,2,201,295,282,362,16,1548,790
1699,15,5.2.347,0,587,1,5,347,352,347,0,352,352,-201,280,770,3,2,60,295,124,362,16,1548,790
1699,16,1.2.246,0,581,0,80,246,326,208,38,326,347,0,124,614,3,3,197,240,304,362,17,1548,735
1699,16,2.2.291,0,606,2,79,291,370,291,0,370,370,-45,169,659,3,3,217,240,323,362,17,1548,735
1699,16,3.2.246,0,619,3,76,246,322,170,76,322,347,0,124,614,3,3,115,240,210,362,17,1548,735
1699,16,4.3.246,1,581,0,84,246,330,246,0,330,347,-22,168,636,4,2,146,244,282,322,17,1548,735
1699,16,5.2.347,0,587,1,5,347,352,347,0,352,352,-101,225,715,3,3,60,240,124,362,17,1548,735
1699,17,1.2.246,0,581,0,80,246,326,208,38,326,347,0,124,636,3,3,197,240,304,362,18,1548,651
1699,17,2.2.291,0,606,2,79,291,370,291,0,370,370,-45,169,681,3,3,217,240,323,362,18,1548,651
1699,17,3.2.246,0,619,3,76,246,322,170,76,322,347,0,124,636,3,3,115,240,210,362,18,1548,651
1699,17,4.4.330,1,581,0,62,330,392,330,0,392,392,-25,249,661,5,2,62,251,282,332,18,1548,651
1699,17,5.2.347,0,587,1,5,347,352,347,0,352,352,-101,225,737,3,3,60,240,124,362,18,1548,651
1699,18,1.2.246,1,581,0,80,246,326,208,38,326,392,0,124,661,3,3,197,240,304,362,19,1548,589
1699,18,2.2.291,0,606,2,79,291,370,291,0,370,392,-45,169,706,3,3,217,240,323,362,19,1548,589
1699,18,3.2.246,0,619,3,76,246,322,170,76,322,392,0,124,661,3,3,115,240,210,362,19,1548,589
1699,18,5.2.347,0,587,1,5,347,352,347,0,352,392,-101,225,762,3,3,60,240,124,362,19,1548,589
1699,19,1.3.330,1,581,0,57,330,387,326,4,387,392,0,168,661,4,3,117,160,304,322,20,1548,509
1699,19,2.2.326,0,581,0,79,326,405,291,35,405,405,0,124,661,3,4,217,160,323,362,20,1548,509
1699,19,3.2.326,0,624,2,76,326,402,170,156,402,402,0,124,661,3,4,115,160,210,362,20,1548,509
1699,19,5.2.347,0,587,1,5,347,352,347,0,352,392,-21,145,682,3,4,60,160,124,362,20,1548,509
1699,20,1.4.392,1,581,0,60,392,452,387,5,452,452,0,249,661,5,3,60,189,304,332,21,1548,452
1699,20,2.2.326,0,581,0,79,326,405,291,35,405,405,0,124,661,3,4,217,160,323,362,21,1548,452
1699,20,3.2.326,0,624,2,76,326,402,170,156,402,402,0,124,661,3,4,115,160,210,362,21,1548,452
1699,20,5.2.347,0,587,1,5,347,352,347,0,352,392,-21,145,682,3,4,60,160,124,362,21,1548,452
1699,21,2.2.326,0,581,0,79,326,405,291,35,405,452,0,124,661,3,4,217,160,323,362,22,1548,392
1699,21,3.2.326,1,624,2,76,326,402,170,156,402,452,0,124,661,3,4,115,160,210,362,22,1548,392
1699,21,5.2.347,0,587,1,5,347,352,347,0,352,452,-21,145,682,3,4,60,160,124,362,22,1548,392
1699,22,2.2.402,0,639,1,79,402,481,291,111,481,481,0,124,661,3,5,217,84,323,362,23,1548,316
1699,22,3.3.402,1,624,0,21,402,423,402,0,423,452,-15,183,676,4,4,39,103,210,322,23,1548,316
1699,22,5.2.402,0,624,0,5,402,407,347,55,407,452,0,124,661,3,5,60,84,124,362,23,1548,316
1699,23,2.2.402,0,639,1,79,402,481,291,111,481,481,0,124,676,3,5,217,84,323,362,24,1548,295
1699,23,3.4.452,1,624,0,18,452,470,423,29,470,470,0,249,676,5,4,18,129,210,332,24,1548,295
1699,23,5.2.402,0,624,0,5,402,407,347,55,407,452,0,124,676,3,5,60,84,124,362,24,1548,295
1699,24,2.2.402,1,639,1,79,402,481,291,111,481,481,0,124,676,3,5,217,84,323,362,25,1548,277
1699,24,5.2.402,0,624,0,5,402,407,347,55,407,470,0,124,676,3,5,60,84,124,362,25,1548,277
1699,25,2.3.481,0,639,0,47,481,528,481,0,528,528,-58,241,734,4,5,138,82,323,322,26,1548,198
1699,25,5.2.481,1,639,0,5,481,486,347,134,486,486,0,124,676,3,6,60,5,124,362,26,1548,198
1699,26,2.3.481,1,639,0,47,481,528,481,0,528,528,-58,241,734,4,5,138,82,323,322,27,1548,193
1699,26,5.3.486,0,659,1,35,486,521,486,0,521,521,-63,246,739,4,5,55,82,124,322,27,1548,193
1699,27,2.4.528,0,639,0,91,528,619,528,0,619,619,-58,307,792,5,5,91,111,323,332,28,1548,146
1699,27,5.3.528,1,639,0,35,528,563,486,42,563,563,0,241,734,4,6,55,35,124,322,28,1548,146
1699,28,2.4.528,1,639,0,91,528,619,528,0,619,619,-58,307,792,5,5,91,111,323,332,29,1548,111
1699,28,5.4.563,0,674,1,20,563,583,563,0,583,583,-93,342,827,5,5,20,111,124,332,29,1548,111
1699,29,5.4.619,1,639,0,20,619,639,563,56,639,639,0,307,792,5,6,20,20,124,332,30,1548,20
1700,0,0.0.0,0,587,0,44,0,44,0,0,44,44,0,0,0,1,1,251,319,251,319,1,1518,1518
1700,0,1.0.0,1,596,2,66,0,66,0,0,66,66,0,0,0,1,1,402,319,402,319,1,1518,1518
1700,0,2.0.0,0,598,3,44,0,44,0,0,44,44,0,0,0,1,1,151,319,151,319,1,1518,1518
1700,0,3.0.0,0,588,1,57,0,57,0,0,57,57,0,0,0,1,1,269,319,269,319,1,1518,1518
1700,0,4.0.0,0,635,5,81,0,81,0,0,81,81,0,0,0,1,1,319,319,319,319,1,1518,1518
1700,0,5.0.0,0,603,4,27,0,27,0,0,27,27,0,0,0,1,1,126,319,126,319,1,1518,1518
1700,1,0.0.66,0,596,0,44,66,110,0,66,110,110,0,0,0,1,2,251,253,251,319,2,1518,1452
1700,1,1.1.66,1,623,3,84,66,150,66,0,150,150,-66,66,66,2,1,336,230,402,230,2,1518,1452
1700,1,2.0.66,0,623,3,44,66,110,0,66,110,110,0,0,0,1,2,151,253,151,319,2,1518,1452
1700,1,3.0.66,0,602,1,57,66,123,0,66,123,123,0,0,0,1,2,269,253,269,319,2,1518,1452
1700,1,4.0.66,0,634,4,81,66,147,0,66,147,147,0,0,0,1,2,319,253,319,319,2,1518,1452
1700,1,5.0.66,0,618,2,27,66,93,0,66,93,93,0,0,0,1,2,126,253,126,319,2,1518,1452
1700,2,0.0.66,1,634,2,44,66,110,0,66,110,150,0,0,66,1,2,251,253,251,319,3,1518,1368
1700,2,1.2.150,0,634,2,85,150,235,150,0,235,235,-150,150,216,3,1,252,330,402,330,3,1518,1368
1700,2,2.0.66,0,623,0,44,66,110,0,66,110,150,0,0,66,1,2,151,253,151,319,3,1518,1368
1700,2,3.0.66,0,627,1,57,66,123,0,66,123,150,0,0,66,1,2,269,253,269,319,3,1518,1368
1700,2,4.0.66,0,634,2,81,66,147,0,66,147,150,0,0,66,1,2,319,253,319,319,3,1518,1368
1700,2,5.0.66,0,627,1,27,66,93,0,66,93,150,0,0,66,1,2,126,253,126,319,3,1518,1368
1700,3,0.1.150,1,634,0,16,150,166,110,40,166,166,0,66,66,2,2,207,146,251,230,4,1518,1324
1700,3,1.2.150,0,634,0,85,150,235,150,0,235,235,-150,150,216,3,1,252,330,402,330,4,1518,1324
1700,3,2.0.110,0,634,0,44,110,154,0,110,154,154,0,0,66,1,3,151,209,151,319,4,1518,1324
1700,3,3.0.110,0,634,0,57,110,167,0,110,167,167,0,0,66,1,3,269,209,269,319,4,1518,1324
1700,3,4.0.110,0,634,0,81,110,191,0,110,191,191,0,0,66,1,3,319,209,319,319,4,1518,1324
1700,3,5.0.110,0,634,0,27,110,137,0,110,137,150,0,0,66,1,3,126,209,126,319,4,1518,1324
1700,4,0.2.166,0,636,1,71,166,237,166,0,237,237,-166,166,232,3,1,191,330,251,330,5,1518,1308
1700,4,1.2.150,0,634,0,85,150,235,150,0,235,235,-150,150,216,3,1,252,330,402,330,5,1518,1308
1700,4,2.0.110,0,634,0,44,110,154,0,110,154,166,0,0,66,1,3,151,209,151,319,5,1518,1308
1700,4,3.0.110,1,634,0,57,110,167,0,110,167,167,0,0,66,1,3,269,209,269,319,5,1518,1308
1700,4,4.0.110,0,634,0,81,110,191,0,110,191,191,0,0,66,1,3,319,209,319,319,5,1518,1308
1700,4,5.0.110,0,634,0,27,110,137,0,110,137,166,0,0,66,1,3,126,209,126,319,5,1518,1308
1700,5,0.2.166,0,636,1,71,166,237,166,0,237,237,-166,166,232,3,1,191,330,251,330,6,1518,1251
1700,5,1.2.150,0,634,0,85,150,235,150,0,235,235,-150,150,216,3,1,252,330,402,330,6,1518,1251
1700,5,2.0.167,0,634,0,44,167,211,0,167,211,211,0,0,66,1,4,151,152,151,319,6,1518,1251
1700,5,3.1.167,1,634,0,30,167,197,167,0,197,197,-1,67,67,2,3,212,130,269,230,6,1518,1251
1700,5,4.0.167,0,634,0,81,167,248,0,167,248,248,0,0,66,1,4,319,152,319,319,6,1518,1251
1700,5,5.0.167,0,634,0,27,167,194,0,167,194,194,0,0,66,1,4,126,152,126,319,6,1518,1251
1700,6,0.2.166,0,636,1,71,166,237,166,0,237,237,-166,166,233,3,1,191,330,251,330,7,1518,1221
1700,6,1.2.150,0,634,0,85,150,235,150,0,235,235,-150,150,217,3,1,252,330,402,330,7,1518,1221
1700,6,2.0.167,0,634,0,44,167,211,0,167,211,211,0,0,67,1,4,151,152,151,319,7,1518,1221
1700,6,3.2.197,0,644,2,43,197,240,197,0,240,240,-197,197,264,3,1,182,330,269,330,7,1518,1221
1700,6,4.0.167,1,634,0,81,167,248,0,167,248,248,0,0,67,1,4,319,152,319,319,7,1518,1221
1700,6,5.0.167,0,634,0,27,167,194,0,167,194,197,0,0,67,1,4,126,152,126,319,7,1518,1221
1700,7,0.2.166,0,636,1,71,166,237,166,0,237,248,-166,166,233,3,1,191,330,251,330,8,1518,1140
1700,7,1.2.150,0,634,0,85,150,235,150,0,235,248,-150,150,217,3,1,252,330,402,330,8,1518,1140
1700,7,2.0.248,0,634,0,44,248,292,0,248,292,292,0,0,67,1,5,151,71,151,319,8,1518,1140
1700,7,3.2.197,0,644,2,43,197,240,197,0,240,248,-197,197,264,3,1,182,330,269,330,8,1518,1140
1700,7,4.1.248,0,634,0,73,248,321,248,0,321,321,-51,118,118,2,4,238,100,319,230,8,1518,1140
1700,7,5.0.248,1,634,0,27,248,275,0,248,275,275,0,0,67,1,5,126,71,126,319,8,1518,1140
1700,8,0.2.166,0,636,1,71,166,237,166,0,237,275,-166,166,233,3,1,191,330,251,330,9,1518,1113
1700,8,1.2.150,0,634,0,85,150,235,150,0,235,275,-150,150,217,3,1,252,330,402,330,9,1518,1113
1700,8,2.0.275,1,634,0,44,275,319,0,275,319,319,0,0,67,1,6,151,44,151,319,9,1518,1113
1700,8,3.2.197,0,644,2,43,197,240,197,0,240,275,-197,197,264,3,1,182,330,269,330,9,1518,1113
1700,8,4.1.248,0,634,0,73,248,321,248,0,321,321,-51,118,118,2,4,238,100,319,230,9,1518,1113
1700,8,5.1.275,0,634,0,25,275,300,275,0,300,300,-78,145,145,2,4,99,100,126,230,9,1518,1113
1700,9,0.2.166,0,636,1,71,166,237,166,0,237,319,-166,166,233,3,1,191,330,251,330,10,1518,1069
1700,9,1.2.150,0,634,0,85,150,235,150,0,235,319,-150,150,217,3,1,252,330,402,330,10,1518,1069
1700,9,2.1.319,0,634,0,2,319,321,319,0,321,321,-122,189,189,2,4,107,100,151,230,10,1518,1069
1700,9,3.2.197,0,644,2,43,197,240,197,0,240,319,-197,197,264,3,1,182,330,269,330,10,1518,1069
1700,9,4.1.248,1,634,0,73,248,321,248,0,321,321,-51,118,118,2,4,238,100,319,230,10,1518,1069
1700,9,5.1.275,0,634,0,25,275,300,275,0,300,319,-78,145,145,2,4,99,100,126,230,10,1518,1069
1700,10,0.2.166,0,636,1,71,166,237,166,0,237,321,-166,166,284,3,1,191,330,251,330,11,1518,996
1700,10,1.2.150,0,634,0,85,150,235,150,0,235,321,-150,150,268,3,1,252,330,402,330,11,1518,996
1700,10,2.1.321,1,634,0,2,321,323,319,2,323,323,0,118,118,2,5,107,27,151,230,11,1518,996
1700,10,3.2.197,0,644,3,43,197,240,197,0,240,321,-197,197,315,3,1,182,330,269,330,11,1518,996
1700,10,4.2.321,0,637,2,56,321,377,321,0,377,377,-321,321,439,3,1,165,330,319,330,11,1518,996
1700,10,5.1.321,0,634,0,25,321,346,275,46,346,346,0,118,118,2,5,99,27,126,230,11,1518,996
1700,11,0.2.166,0,636,1,71,166,237,166,0,237,323,-166,166,284,3,1,191,330,251,330,12,1518,994
1700,11,1.2.150,0,634,0,85,150,235,150,0,235,323,-150,150,268,3,1,252,330,402,330,12,1518,994
1700,11,2.2.323,0,634,0,32,323,355,323,0,355,355,-323,323,441,3,1,105,330,151,330,12,1518,994
1700,11,3.2.197,0,644,3,43,197,240,197,0,240,323,-197,197,315,3,1,182,330,269,330,12,1518,994
1700,11,4.2.321,0,637,2,56,321,377,321,0,377,377,-321,321,439,3,1,165,330,319,330,12,1518,994
1700,11,5.1.323,1,634,0,25,323,348,275,48,348,348,0,118,118,2,6,99,25,126,230,12,1518,994
1700,12,0.2.166,0,636,1,71,166,237,166,0,237,348,-166,166,284,3,1,191,330,251,330,13,1518,969
1700,12,1.2.150,1,634,0,85,150,235,150,0,235,348,-150,150,268,3,1,252,330,402,330,13,1518,969
1700,12,2.2.323,0,634,0,32,323,355,323,0,355,355,-323,323,441,3,1,105,330,151,330,13,1518,969
1700,12,3.2.197,0,644,3,43,197,240,197,0,240,348,-197,197,315,3,1,182,330,269,330,13,1518,969
1700,12,4.2.321,0,637,2,56,321,377,321,0,377,377,-321,321,439,3,1,165,330,319,330,13,1518,969
1700,12,5.2.348,0,655,4,43,348,391,348,0,391,391,-348,348,466,3,1,74,330,126,330,13,1518,969
1700,13,0.2.235,0,634,0,71,235,306,166,69,306,348,0,150,268,3,2,191,245,251,330,14,1518,884
1700,13,1.3.235,0,634,0,98,235,333,235,0,333,348,-235,235,503,4,1,167,376,402,376,14,1518,884
1700,13,2.2.323,0,634,0,32,323,355,323,0,355,355,-88,238,356,3,2,105,245,151,330,14,1518,884
1700,13,3.2.235,1,634,0,43,235,278,197,38,278,348,0,150,268,3,2,182,245,269,330,14,1518,884
1700,13,4.2.321,0,637,1,56,321,377,321,0,377,377,-86,236,354,3,2,165,245,319,330,14,1518,884
1700,13,5.2.348,0,655,2,43,348,391,348,0,391,391,-113,263,381,3,2,74,245,126,330,14,1518,884
1700,14,0.2.278,1,634,0,71,278,349,166,112,349,349,0,150,268,3,3,191,202,251,330,15,1518,841
1700,14,1.3.235,0,634,0,98,235,333,235,0,333,348,-235,235,503,4,1,167,376,402,376,15,1518,841
1700,14,2.2.323,0,634,0,32,323,355,323,0,355,355,-45,195,313,3,3,105,202,151,330,15,1518,841
1700,14,3.3.278,0,677,3,80,278,358,278,0,358,358,-278,278,546,4,1,139,376,269,376,15,1518,841
1700,14,4.2.321,0,637,1,56,321,377,321,0,377,377,-43,193,311,3,3,165,202,319,330,15,1518,841
1700,14,5.2.348,0,670,2,43,348,391,348,0,391,391,-70,220,338,3,3,74,202,126,330,15,1518,841
1700,15,0.3.349,0,650,1,85,349,434,349,0,434,434,-349,349,617,4,1,120,376,251,376,16,1518,770
1700,15,1.3.235,0,634,0,98,235,333,235,0,333,349,-235,235,503,4,1,167,376,402,376,16,1518,770
1700,15,2.2.349,0,634,0,32,349,381,323,26,381,381,0,150,268,3,4,105,131,151,330,16,1518,770
1700,15,3.3.278,0,677,2,80,278,358,278,0,358,358,-278,278,546,4,1,139,376,269,376,16,1518,770
1700,15,4.2.349,1,634,0,56,349,405,321,28,405,405,0,150,268,3,4,165,131,319,330,16,1518,770
1700,15,5.2.349,0,634,0,43,349,392,348,1,392,392,0,150,268,3,4,74,131,126,330,16,1518,770
1700,16,0.3.349,0,653,1,85,349,434,349,0,434,434,-349,349,617,4,1,120,376,251,376,17,1518,714
1700,16,1.3.235,0,634,0,98,235,333,235,0,333,405,-235,235,503,4,1,167,376,402,376,17,1518,714
1700,16,2.2.405,1,634,0,32,405,437,323,82,437,437,0,150,268,3,5,105,75,151,330,17,1518,714
1700,16,3.3.278,0,677,2,80,278,358,278,0,358,405,-278,278,546,4,1,139,376,269,376,17,1518,714
1700,16,4.3.405,0,709,3,77,405,482,405,0,482,482,-405,405,673,4,1,109,376,319,376,17,1518,714
1700,16,5.2.405,0,634,0,43,405,448,348,57,448,448,0,150,268,3,5,74,75,126,330,17,1518,714
1700,17,0.3.349,0,653,1,85,349,434,349,0,434,437,-349,349,617,4,1,120,376,251,376,18,1518,682
1700,17,1.3.235,0,634,0,98,235,333,235,0,333,437,-235,235,503,4,1,167,376,402,376,18,1518,682
1700,17,2.3.437,0,653,1,16,437,453,437,0,453,453,-437,437,705,4,1,73,376,151,376,18,1518,682
1700,17,3.3.278,0,677,2,80,278,358,278,0,358,437,-278,278,546,4,1,139,376,269,376,18,1518,682
1700,17,4.3.405,0,709,3,77,405,482,405,0,482,482,-405,405,673,4,1,109,376,319,376,18,1518,682
1700,17,5.2.437,1,634,0,43,437,480,348,89,480,480,0,150,268,3,6,74,43,126,330,18,1518,682
1700,18,0.3.349,0,653,1,85,349,434,349,0,434,480,-349,349,617,4,1,120,376,251,376,19,1518,639
1700,18,1.3.235,1,634,0,98,235,333,235,0,333,480,-235,235,503,4,1,167,376,402,376,19,1518,639
1700,18,2.3.437,0,653,1,16,437,453,437,0,453,480,-437,437,705,4,1,73,376,151,376,19,1518,639
1700,18,3.3.278,0,677,2,80,278,358,278,0,358,480,-278,278,546,4,1,139,376,269,376,19,1518,639
1700,18,4.3.405,0,709,4,77,405,482,405,0,482,482,-405,405,673,4,1,109,376,319,376,19,1518,639
1700,18,5.3.480,0,689,3,20,480,500,480,0,500,500,-480,480,748,4,1,31,376,126,376,19,1518,639
1700,19,0.3.349,0,653,1,85,349,434,349,0,434,480,-16,251,519,4,2,120,278,251,376,20,1518,541
1700,19,1.4.333,1,634,0,69,333,402,333,0,402,480,-333,333,836,5,1,69,263,402,263,20,1518,541
1700,19,2.3.437,0,653,1,16,437,453,437,0,453,480,-104,339,607,4,2,73,278,151,376,20,1518,541
1700,19,3.3.333,0,634,0,80,333,413,278,55,413,480,0,235,503,4,2,139,278,269,376,20,1518,541
1700,19,4.3.405,0,709,3,77,405,482,405,0,482,482,-72,307,575,4,2,109,278,319,376,20,1518,541
1700,19,5.3.480,0,689,2,20,480,500,480,0,500,500,-147,382,650,4,2,31,278,126,376,20,1518,541
1700,20,0.3.349,0,653,1,85,349,434,349,0,434,480,-16,251,852,4,2,120,278,251,376,21,1518,472
1700,20,2.3.437,0,653,1,16,437,453,437,0,453,480,-104,339,940,4,2,73,278,151,376,21,1518,472
1700,20,3.3.333,1,634,0,80,333,413,278,55,413,480,0,235,836,4,2,139,278,269,376,21,1518,472
1700,20,4.3.405,0,709,3,77,405,482,405,0,482,482,-72,307,908,4,2,109,278,319,376,21,1518,472
1700,20,5.3.480,0,689,2,20,480,500,480,0,500,500,-147,382,983,4,2,31,278,126,376,21,1518,472
1700,21,0.3.413,0,634,0,85,413,498,349,64,498,498,0,235,836,4,3,120,198,251,376,22,1518,392
1700,21,2.3.437,0,658,2,16,437,453,437,0,453,480,-24,259,860,4,3,73,198,151,376,22,1518,392
1700,21,3.4.413,1,634,0,59,413,472,413,0,472,480,-11,344,847,5,2,59,194,269,263,22,1518,392
1700,21,4.3.413,0,637,1,77,413,490,405,8,490,490,0,235,836,4,3,109,198,319,376,22,1518,392
1700,21,5.3.480,0,694,3,20,480,500,480,0,500,500,-67,302,903,4,3,31,198,126,376,22,1518,392
1700,22,0.3.413,0,634,0,85,413,498,349,64,498,498,0,235,847,4,3,120,198,251,376,23,1518,333
1700,22,2.3.437,0,658,2,16,437,453,437,0,453,480,-24,259,871,4,3,73,198,151,376,23,1518,333
1700,22,4.3.413,1,637,1,77,413,490,405,8,490,490,0,235,847,4,3,109,198,319,376,23,1518,333
1700,22,5.3.480,0,694,3,20,480,500,480,0,500,500,-67,302,914,4,3,31,198,126,376,23,1518,333
1700,23,0.3.490,0,678,2,85,490,575,349,141,575,575,0,235,847,4,4,120,121,251,376,24,1518,256
1700,23,2.3.490,0,637,0,16,490,506,437,53,506,506,0,235,847,4,4,73,121,151,376,24,1518,256
1700,23,4.4.490,1,637,0,32,490,522,490,0,522,522,-18,362,865,5,3,32,135,319,263,24,1518,256
1700,23,5.3.490,0,646,1,20,490,510,480,10,510,510,0,235,847,4,4,31,121,126,376,24,1518,256
1700,24,0.3.490,0,678,2,85,490,575,349,141,575,575,0,235,865,4,4,120,121,251,376,25,1518,224
1700,24,2.3.490,1,637,0,16,490,506,437,53,506,522,0,235,865,4,4,73,121,151,376,25,1518,224
1700,24,5.3.490,0,646,1,20,490,510,480,10,510,522,0,235,865,4,4,31,121,126,376,25,1518,224
1700,25,0.3.506,1,637,0,85,506,591,349,157,591,591,0,235,865,4,5,120,105,251,376,26,1518,208
1700,25,2.4.522,0,637,0,57,522,579,506,16,579,579,0,362,865,5,4,57,103,151,263,26,1518,208
1700,25,5.3.506,0,646,1,20,506,526,480,26,526,526,0,235,865,4,5,31,105,126,376,26,1518,208
1700,26,0.4.591,0,637,0,35,591,626,591,0,626,626,-69,431,934,5,4,35,103,251,263,27,1518,123
1700,26,2.4.522,0,637,0,57,522,579,506,16,579,591,0,362,865,5,4,57,103,151,263,27,1518,123
1700,26,5.3.591,1,637,0,20,591,611,480,111,611,611,0,235,865,4,6,31,20,126,376,27,1518,123
1700,27,0.4.591,0,637,0,35,591,626,591,0,626,626,-69,431,934,5,4,35,103,251,263,28,1518,103
1700,27,2.4.522,1,637,0,57,522,579,506,16,579,611,0,362,865,5,4,57,103,151,263,28,1518,103
1700,27,5.4.611,0,657,1,11,611,622,611,0,622,622,-89,451,954,5,4,11,103,126,263,28,1518,103
1700,28,0.4.591,1,637,0,35,591,626,591,0,626,626,-12,374,877,5,5,35,46,251,263,29,1518,46
1700,28,5.4.611,0,657,1,11,611,622,611,0,622,622,-32,394,897,5,5,11,46,126,263,29,1518,46
1700,29,5.4.626,1,637,0,11,626,637,611,15,637,637,0,374,877,5,6,11,11,126,263,30,1518,11
1701,0,0.0.0,1,546,4,57,0,57,0,0,57,57,0,0,0,1,1,392,234,392,234,1,1485,1485
1701,0,1.0.0,0,514,2,41,0,41,0,0,41,41,0,0,0,1,1,302,234,302,234,1,1485,1485
1701,0,2.0.0,0,584,5,90,0,90,0,0,90,90,0,0,0,1,1,376,234,376,234,1,1485,1485
1701,0,3.0.0,0,511,1,10,0,10,0,0,10,10,0,0,0,1,1,128,234,128,234,1,1485,1485
1701,0,4.0.0,0,501,0,4,0,4,0,0,4,4,0,0,0,1,1,158,234,158,234,1,1485,1485
1701,0,5.0.0,0,533,3,32,0,32,0,0,32,32,0,0,0,1,1,129,234,129,234,1,1485,1485
1701,1,0.1.57,0,572,3,83,57,140,57,0,140,140,-57,57,57,2,1,335,330,392,330,2,1485,1428
1701,1,1.0.57,1,571,2,41,57,98,0,57,98,98,0,0,0,1,2,302,177,302,234,2,1485,1428
1701,1,2.0.57,0,573,4,90,57,147,0,57,147,147,0,0,0,1,2,376,177,376,234,2,1485,1428
1701,1,3.0.57,0,556,1,10,57,67,0,57,67,67,0,0,0,1,2,128,177,128,234,2,1485,1428
1701,1,4.0.57,0,546,0,4,57,61,0,57,61,61,0,0,0,1,2,158,177,158,234,2,1485,1428
1701,1,5.0.57,0,572,3,32,57,89,0,57,89,89,0,0,0,1,2,129,177,129,234,2,1485,1428
1701,2,0.1.57,0,572,1,83,57,140,57,0,140,140,-57,57,57,2,1,335,330,392,330,3,1485,1387
1701,2,1.1.98,0,590,2,52,98,150,98,0,150,150,-98,98,98,2,1,261,330,302,330,3,1485,1387
1701,2,2.0.98,0,572,1,90,98,188,0,98,188,188,0,0,0,1,3,376,136,376,234,3,1485,1387
1701,2,3.0.98,0,572,1,10,98,108,0,98,108,108,0,0,0,1,3,128,136,128,234,3,1485,1387
1701,2,4.0.98,1,571,0,4,98,102,0,98,102,102,0,0,0,1,3,158,136,158,234,3,1485,1387
1701,2,5.0.98,0,572,1,32,98,130,0,98,130,130,0,0,0,1,3,129,136,129,234,3,1485,1387
1701,3,0.1.57,0,572,1,83,57,140,57,0,140,140,-57,57,57,2,1,335,330,392,330,4,1485,1383
1701,3,1.1.98,0,590,2,52,98,150,98,0,150,150,-98,98,98,2,1,261,330,302,330,4,1485,1383
1701,3,2.0.102,1,571,0,90,102,192,0,102,192,192,0,0,0,1,4,376,132,376,234,4,1485,1383
1701,3,3.0.102,0,571,0,10,102,112,0,102,112,112,0,0,0,1,4,128,132,128,234,4,1485,1383
1701,3,4.1.102,0,571,0,25,102,127,102,0,127,127,-102,102,102,2,1,154,330,158,330,4,1485,1383
1701,3,5.0.102,0,571,0,32,102,134,0,102,134,134,0,0,0,1,4,129,132,129,234,4,1485,1383
1701,4,0.1.57,0,572,1,83,57,140,57,0,140,192,-57,57,57,2,1,335,330,392,330,5,1485,1293
1701,4,1.1.98,0,590,3,52,98,150,98,0,150,192,-98,98,98,2,1,261,330,302,330,5,1485,1293
1701,4,2.1.192,0,582,2,94,192,286,192,0,286,286,-192,192,192,2,1,286,330,376,330,5,1485,1293
1701,4,3.0.192,1,571,0,10,192,202,0,192,202,202,0,0,0,1,5,128,42,128,234,5,1485,1293
1701,4,4.1.102,0,571,0,25,102,127,102,0,127,192,-102,102,102,2,1,154,330,158,330,5,1485,1293
1701,4,5.0.192,0,571,0,32,192,224,0,192,224,224,0,0,0,1,5,129,42,129,234,5,1485,1293
1701,5,0.1.57,0,572,1,83,57,140,57,0,140,202,-57,57,57,2,1,335,330,392,330,6,1485,1283
1701,5,1.1.98,0,590,3,52,98,150,98,0,150,202,-98,98,98,2,1,261,330,302,330,6,1485,1283
1701,5,2.1.192,0,582,2,94,192,286,192,0,286,286,-192,192,192,2,1,286,330,376,330,6,1485,1283
1701,5,3.1.202,0,582,2,67,202,269,202,0,269,269,-202,202,202,2,1,118,330,128,330,6,1485,1283
1701,5,4.1.102,0,571,0,25,102,127,102,0,127,202,-102,102,102,2,1,154,330,158,330,6,1485,1283
1701,5,5.0.202,1,571,0,32,202,234,0,202,234,234,0,0,0,1,6,129,32,129,234,6,1485,1283
1701,6,0.1.57,1,572,1,83,57,140,57,0,140,234,-57,57,57,2,1,335,330,392,330,7,1485,1251
1701,6,1.1.98,0,590,4,52,98,150,98,0,150,234,-98,98,98,2,1,261,330,302,330,7,1485,1251
1701,6,2.1.192,0,582,3,94,192,286,192,0,286,286,-192,192,192,2,1,286,330,376,330,7,1485,1251
1701,6,3.1.202,0,582,3,67,202,269,202,0,269,269,-202,202,202,2,1,118,330,128,330,7,1485,1251
1701,6,4.1.102,0,571,0,25,102,127,102,0,127,234,-102,102,102,2,1,154,330,158,330,7,1485,1251
1701,6,5.1.234,0,575,2,9,234,243,234,0,243,243,-234,234,234,2,1,97,330,129,330,7,1485,1251
1701,7,0.2.140,0,572,0,74,140,214,140,0,214,234,-140,140,197,3,1,252,397,392,397,8,1485,1168
1701,7,1.1.140,1,572,0,52,140,192,98,42,192,234,0,57,57,2,2,261,247,302,330,8,1485,1168
1701,7,2.1.192,0,582,2,94,192,286,192,0,286,286,-52,109,109,2,2,286,247,376,330,8,1485,1168
1701,7,3.1.202,0,582,2,67,202,269,202,0,269,269,-62,119,119,2,2,118,247,128,330,8,1485,1168
1701,7,4.1.140,0,572,0,25,140,165,102,38,165,234,0,57,57,2,2,154,247,158,330,8,1485,1168
1701,7,5.1.234,0,575,1,9,234,243,234,0,243,243,-94,151,151,2,2,97,247,129,330,8,1485,1168
1701,8,0.2.140,0,572,0,74,140,214,140,0,214,234,-140,140,197,3,1,252,397,392,397,9,1485,1116
1701,8,1.2.192,0,619,3,90,192,282,192,0,282,282,-192,192,249,3,1,209,397,302,397,9,1485,1116
1701,8,2.1.192,0,582,2,94,192,286,192,0,286,286,0,57,57,2,3,286,195,376,330,9,1485,1116
1701,8,3.1.202,0,582,2,67,202,269,202,0,269,269,-10,67,67,2,3,118,195,128,330,9,1485,1116
1701,8,4.1.192,1,572,0,25,192,217,102,90,217,234,0,57,57,2,3,154,195,158,330,9,1485,1116
1701,8,5.1.234,0,575,1,9,234,243,234,0,243,243,-42,99,99,2,3,97,195,129,330,9,1485,1116
1701,9,0.2.140,0,572,0,74,140,214,140,0,214,234,-140,140,197,3,1,252,397,392,397,10,1485,1091
1701,9,1.2.192,0,624,2,90,192,282,192,0,282,282,-192,192,249,3,1,209,397,302,397,10,1485,1091
1701,9,2.1.217,1,575,1,94,217,311,192,25,311,311,0,57,57,2,4,286,170,376,330,10,1485,1091
1701,9,3.1.217,0,572,0,67,217,284,202,15,284,284,0,57,57,2,4,118,170,128,330,10,1485,1091
1701,9,4.2.217,0,572,0,56,217,273,217,0,273,273,-217,217,274,3,1,129,397,158,397,10,1485,1091
1701,9,5.1.234,0,575,1,9,234,243,234,0,243,243,-17,74,74,2,4,97,170,129,330,10,1485,1091
1701,10,0.2.140,0,575,0,74,140,214,140,0,214,311,-140,140,197,3,1,252,397,392,397,11,1485,997
1701,10,1.2.192,0,632,3,90,192,282,192,0,282,311,-192,192,249,3,1,209,397,302,397,11,1485,997
1701,10,2.2.311,0,595,2,85,311,396,311,0,396,396,-311,311,368,3,1,192,397,376,397,11,1485,997
1701,10,3.1.311,0,575,0,67,311,378,202,109,378,378,0,57,57,2,5,118,76,128,330,11,1485,997
1701,10,4.2.217,0,578,1,56,217,273,217,0,273,311,-217,217,274,3,1,129,397,158,397,11,1485,997
1701,10,5.1.311,1,575,0,9,311,320,234,77,320,320,0,57,57,2,5,97,76,129,330,11,1485,997
1701,11,0.2.140,0,575,0,74,140,214,140,0,214,320,-140,140,197,3,1,252,397,392,397,12,1485,988
1701,11,1.2.192,0,632,3,90,192,282,192,0,282,320,-192,192,249,3,1,209,397,302,397,12,1485,988
1701,11,2.2.311,0,595,2,85,311,396,311,0,396,396,-311,311,368,3,1,192,397,376,397,12,1485,988
1701,11,3.1.320,1,575,0,67,320,387,202,118,387,387,0,57,57,2,6,118,67,128,330,12,1485,988
1701,11,4.2.217,0,578,1,56,217,273,217,0,273,320,-217,217,274,3,1,129,397,158,397,12,1485,988
1701,11,5.2.320,0,654,4,81,320,401,320,0,401,401,-320,320,377,3,1,88,397,129,397,12,1485,988
1701,12,0.2.140,1,575,0,74,140,214,140,0,214,387,-140,140,197,3,1,252,397,392,397,13,1485,921
1701,12,1.2.192,0,632,4,90,192,282,192,0,282,387,-192,192,249,3,1,209,397,302,397,13,1485,921
1701,12,2.2.311,0,595,3,85,311,396,311,0,396,396,-311,311,368,3,1,192,397,376,397,13,1485,921
1701,12,3.2.387,0,592,2,11,387,398,387,0,398,398,-387,387,444,3,1,51,397,128,397,13,1485,921
1701,12,4.2.217,0,578,1,56,217,273,217,0,273,387,-217,217,274,3,1,129,397,158,397,13,1485,921
1701,12,5.2.320,0,654,5,81,320,401,320,0,401,401,-320,320,377,3,1,88,397,129,397,13,1485,921
1701,13,0.3.214,1,575,0,91,214,305,214,0,305,387,-214,214,411,4,1,178,330,392,330,14,1485,847
1701,13,1.2.214,0,575,0,90,214,304,192,22,304,387,0,140,197,3,2,209,323,302,397,14,1485,847
1701,13,2.2.311,0,595,3,85,311,396,311,0,396,396,-97,237,294,3,2,192,323,376,397,14,1485,847
1701,13,3.2.387,0,592,2,11,387,398,387,0,398,398,-173,313,370,3,2,51,323,128,397,14,1485,847
1701,13,4.2.217,0,578,1,56,217,273,217,0,273,387,-3,143,200,3,2,129,323,158,397,14,1485,847
1701,13,5.2.320,0,654,4,81,320,401,320,0,401,401,-106,246,303,3,2,88,323,129,397,14,1485,847
1701,14,0.4.305,1,575,0,87,305,392,305,0,392,392,-305,305,716,5,1,87,194,392,194,15,1485,756
1701,14,1.2.214,0,575,0,90,214,304,192,22,304,387,0,140,411,3,2,209,323,302,397,15,1485,756
1701,14,2.2.311,0,595,3,85,311,396,311,0,396,396,-97,237,508,3,2,192,323,376,397,15,1485,756
1701,14,3.2.387,0,592,2,11,387,398,387,0,398,398,-173,313,584,3,2,51,323,128,397,15,1485,756
1701,14,4.2.217,0,578,1,56,217,273,217,0,273,387,-3,143,414,3,2,129,323,158,397,15,1485,756
1701,14,5.2.320,0,654,4,81,320,401,320,0,401,401,-106,246,517,3,2,88,323,129,397,15,1485,756
1701,15,1.2.214,1,575,0,90,214,304,192,22,304,392,0,140,716,3,2,209,323,302,397,16,1485,669
1701,15,2.2.311,0,595,3,85,311,396,311,0,396,396,-97,237,813,3,2,192,323,376,397,16,1485,669
1701,15,3.2.387,0,592,2,11,387,398,387,0,398,398,-173,313,889,3,2,51,323,128,397,16,1485,669
1701,15,4.2.217,0,578,1,56,217,273,217,0,273,392,-3,143,719,3,2,129,323,158,397,16,1485,669
1701,15,5.2.320,0,654,4,81,320,401,320,0,401,401,-106,246,822,3,2,88,323,129,397,16,1485,669
1701,16,1.3.305,1,575,0,41,305,346,304,1,346,392,0,214,716,4,2,119,239,302,330,17,1485,579
1701,16,2.2.311,0,595,2,85,311,396,311,0,396,396,-7,147,723,3,3,192,233,376,397,17,1485,579
1701,16,3.2.387,0,592,1,11,387,398,387,0,398,398,-83,223,799,3,3,51,233,128,397,17,1485,579
1701,16,4.2.304,0,575,0,56,304,360,217,87,360,392,0,140,716,3,3,129,233,158,397,17,1485,579
1701,16,5.2.320,0,654,3,81,320,401,320,0,401,401,-16,156,732,3,3,88,233,129,397,17,1485,579
1701,17,1.4.392,1,575,0,78,392,470,346,46,470,470,0,305,716,5,2,78,107,302,194,18,1485,538
1701,17,2.2.311,0,595,2,85,311,396,311,0,396,396,-7,147,723,3,3,192,233,376,397,18,1485,538
1701,17,3.2.387,0,592,1,11,387,398,387,0,398,398,-83,223,799,3,3,51,233,128,397,18,1485,538
1701,17,4.2.304,0,575,0,56,304,360,217,87,360,392,0,140,716,3,3,129,233,158,397,18,1485,538
1701,17,5.2.320,0,654,3,81,320,401,320,0,401,401,-16,156,732,3,3,88,233,129,397,18,1485,538
1701,18,2.2.311,0,595,2,85,311,396,311,0,396,470,-7,147,723,3,3,192,233,376,397,19,1485,460
1701,18,3.2.387,0,592,1,11,387,398,387,0,398,470,-83,223,799,3,3,51,233,128,397,19,1485,460
1701,18,4.2.304,1,575,0,56,304,360,217,87,360,470,0,140,716,3,3,129,233,158,397,19,1485,460
1701,18,5.2.320,0,654,3,81,320,401,320,0,401,470,-16,156,732,3,3,88,233,129,397,19,1485,460
1701,19,2.2.360,1,575,0,85,360,445,311,49,445,470,0,140,716,3,4,192,177,376,397,20,1485,404
1701,19,3.2.387,0,592,1,11,387,398,387,0,398,470,-27,167,743,3,4,51,177,128,397,20,1485,404
1701,19,4.3.360,0,575,0,70,360,430,360,0,430,470,-14,228,730,4,3,73,198,158,330,20,1485,404
1701,19,5.2.360,0,644,2,81,360,441,320,40,441,470,0,140,716,3,4,88,177,129,397,20,1485,404
1701,20,2.3.445,0,575,0,84,445,529,445,0,529,529,-99,313,815,4,3,107,198,376,330,21,1485,319
1701,20,3.2.445,1,575,0,11,445,456,387,58,456,470,0,140,716,3,5,51,92,128,397,21,1485,319
1701,20,4.3.360,0,575,0,70,360,430,360,0,430,470,-14,228,730,4,3,73,198,158,330,21,1485,319
1701,20,5.2.445,0,577,1,81,445,526,320,125,526,526,0,140,716,3,5,88,92,129,397,21,1485,319
1701,21,2.3.445,0,575,0,84,445,529,445,0,529,529,-99,313,815,4,3,107,198,376,330,22,1485,308
1701,21,3.3.456,0,604,1,39,456,495,456,0,495,495,-110,324,826,4,3,40,198,128,330,22,1485,308
1701,21,4.3.360,0,575,0,70,360,430,360,0,430,470,-14,228,730,4,3,73,198,158,330,22,1485,308
1701,21,5.2.456,1,575,0,81,456,537,320,136,537,537,0,140,716,3,6,88,81,129,397,22,1485,308
1701,22,2.3.445,0,575,0,84,445,529,445,0,529,537,-99,313,815,4,3,107,198,376,330,23,1485,227
1701,22,3.3.456,0,604,2,39,456,495,456,0,495,537,-110,324,826,4,3,40,198,128,330,23,1485,227
1701,22,4.3.360,1,575,0,70,360,430,360,0,430,537,-14,228,730,4,3,73,198,158,330,23,1485,227
1701,22,5.3.537,0,582,1,5,537,542,537,0,542,542,-191,405,907,4,3,7,198,129,330,23,1485,227
1701,23,2.3.445,0,575,0,84,445,529,445,0,529,537,-15,243,745,4,4,107,128,376,330,24,1485,157
1701,23,3.3.456,0,604,2,39,456,495,456,0,495,537,-26,254,756,4,4,40,128,128,330,24,1485,157
1701,23,4.4.470,1,575,0,3,470,473,430,40,473,537,0,305,730,5,3,3,29,158,194,24,1485,157
1701,23,5.3.537,0,582,1,5,537,542,537,0,542,542,-107,335,837,4,4,7,128,129,330,24,1485,157
1701,24,2.3.445,1,575,0,84,445,529,445,0,529,537,-15,243,745,4,4,107,128,376,330,25,1485,154
1701,24,3.3.456,0,604,2,39,456,495,456,0,495,537,-26,254,756,4,4,40,128,128,330,25,1485,154
1701,24,5.3.537,0,582,1,5,537,542,537,0,542,542,-107,335,837,4,4,7,128,129,330,25,1485,154
1701,25,2.4.529,1,575,0,23,529,552,529,0,552,552,-56,361,801,5,4,23,26,376,194,26,1485,70
1701,25,3.3.529,0,575,0,39,529,568,456,73,568,568,0,243,745,4,5,40,44,128,330,26,1485,70
1701,25,5.3.537,0,582,1,5,537,542,537,0,542,542,-8,251,753,4,5,7,44,129,330,26,1485,70
1701,26,3.3.529,1,575,0,39,529,568,456,73,568,568,0,243,801,4,5,40,44,128,330,27,1485,47
1701,26,5.3.537,0,582,1,5,537,542,537,0,542,552,-8,251,809,4,5,7,44,129,330,27,1485,47
1701,27,3.4.568,1,575,0,1,568,569,568,0,569,569,-16,377,817,5,5,1,3,128,194,28,1485,8
1701,27,5.3.568,0,575,0,5,568,573,537,31,573,573,0,243,801,4,6,7,5,129,330,28,1485,8
1701,28,5.3.568,1,575,0,5,568,573,537,31,573,573,0,243,817,4,6,7,5,129,330,29,1485,7
1701,29,5.4.573,1,575,0,2,573,575,573,0,575,575,-4,381,821,5,6,2,2,129,194,30,1485,2
1702,0,0.0.0,0,725,5,71,0,71,0,0,71,71,0,0,0,1,1,337,249,337,249,1,1848,1848
1702,0,1.0.0,1,654,0,17,0,17,0,0,17,17,0,0,0,1,1,302,249,302,249,1,1848,1848
1702,0,2.0.0,0,690,4,36,0,36,0,0,36,36,0,0,0,1,1,302,249,302,249,1,1848,1848
1702,0,3.0.0,0,677,2,63,0,63,0,0,63,63,0,0,0,1,1,285,249,285,249,1,1848,1848
1702,0,4.0.0,0,680,3,26,0,26,0,0,26,26,0,0,0,1,1,295,249,295,249,1,1848,1848
1702,0,5.0.0,0,671,1,36,0,36,0,0,36,36,0,0,0,1,1,327,249,327,249,1,1848,1848
1702,1,0.0.17,0,660,2,71,17,88,0,17,88,88,0,0,0,1,2,337,232,337,249,2,1848,1831
1702,1,1.1.17,0,654,0,20,17,37,17,0,37,37,-17,17,17,2,1,285,333,302,333,2,1848,1831
1702,1,2.0.17,0,654,0,36,17,53,0,17,53,53,0,0,0,1,2,302,232,302,249,2,1848,1831
1702,1,3.0.17,0,656,1,63,17,80,0,17,80,80,0,0,0,1,2,285,232,285,249,2,1848,1831
1702,1,4.0.17,0,654,0,26,17,43,0,17,43,43,0,0,0,1,2,295,232,295,249,2,1848,1831
1702,1,5.0.17,1,654,0,36,17,53,0,17,53,53,0,0,0,1,2,327,232,327,249,2,1848,1831
1702,2,0.0.53,0,654,0,71,53,124,0,53,124,124,0,0,0,1,3,337,196,337,249,3,1848,1795
1702,2,1.1.17,0,654,0,20,17,37,17,0,37,53,-17,17,17,2,1,285,333,302,333,3,1848,1795
1702,2,2.0.53,0,654,0,36,53,89,0,53,89,89,0,0,0,1,3,302,196,302,249,3,1848,1795
1702,2,3.0.53,0,654,0,63,53,116,0,53,116,116,0,0,0,1,3,285,196,285,249,3,1848,1795
1702,2,4.0.53,1,654,0,26,53,79,0,53,79,79,0,0,0,1,3,295,196,295,249,3,1848,1795
1702,2,5.1.53,0,654,0,91,53,144,53,0,144,144,-53,53,53,2,1,291,333,327,333,3,1848,1795
1702,3,0.0.79,0,654,0,71,79,150,0,79,150,150,0,0,0,1,4,337,170,337,249,4,1848,1769
1702,3,1.1.17,0,654,0,20,17,37,17,0,37,79,-17,17,17,2,1,285,333,302,333,4,1848,1769
1702,3,2.0.79,1,654,0,36,79,115,0,79,115,115,0,0,0,1,4,302,170,302,249,4,1848,1769
1702,3,3.0.79,0,654,0,63,79,142,0,79,142,142,0,0,0,1,4,285,170,285,249,4,1848,1769
1702,3,4.1.79,0,654,0,77,79,156,79,0,156,156,-79,79,79,2,1,269,333,295,333,4,1848,1769
1702,3,5.1.53,0,654,0,91,53,144,53,0,144,144,-53,53,53,2,1,291,333,327,333,4,1848,1769
1702,4,0.0.115,1,654,0,71,115,186,0,115,186,186,0,0,0,1,5,337,134,337,249,5,1848,1733
1702,4,1.1.17,0,654,0,20,17,37,17,0,37,115,-17,17,17,2,1,285,333,302,333,5,1848,1733
1702,4,2.1.115,0,700,1,88,115,203,115,0,203,203,-115,115,115,2,1,266,333,302,333,5,1848,1733
1702,4,3.0.115,0,654,0,63,115,178,0,115,178,178,0,0,0,1,5,285,134,285,249,5,1848,1733
1702,4,4.1.79,0,654,0,77,79,156,79,0,156,156,-79,79,79,2,1,269,333,295,333,5,1848,1733
1702,4,5.1.53,0,654,0,91,53,144,53,0,144,144,-53,53,53,2,1,291,333,327,333,5,1848,1733
1702,5,0.1.186,0,675,1,51,186,237,186,0,237,237,-186,186,186,2,1,266,333,337,333,6,1848,1662
1702,5,1.1.17,0,654,0,20,17,37,17,0,37,186,-17,17,17,2,1,285,333,302,333,6,1848,1662
1702,5,2.1.115,0,700,2,88,115,203,115,0,203,203,-115,115,115,2,1,266,333,302,333,6,1848,1662
1702,5,3.0.186,1,654,0,63,186,249,0,186,249,249,0,0,0,1,6,285,63,285,249,6,1848,1662
1702,5,4.1.79,0,654,0,77,79,156,79,0,156,186,-79,79,79,2,1,269,333,295,333,6,1848,1662
1702,5,5.1.53,0,654,0,91,53,144,53,0,144,186,-53,53,53,2,1,291,333,327,333,6,1848,1662
1702,6,0.1.186,0,675,1,51,186,237,186,0,237,249,-186,186,186,2,1,266,333,337,333,7,1848,1599
1702,6,1.1.17,1,654,0,20,17,37,17,0,37,249,-17,17,17,2,1,285,333,302,333,7,1848,1599
1702,6,2.1.115,0,700,2,88,115,203,115,0,203,249,-115,115,115,2,1,266,333,302,333,7,1848,1599
1702,6,3.1.249,0,654,0,6,249,255,249,0,255,255,-249,249,249,2,1,222,333,285,333,7,1848,1599
1702,6,4.1.79,0,654,0,77,79,156,79,0,156,249,-79,79,79,2,1,269,333,295,333,7,1848,1599
1702,6,5.1.53,0,654,0,91,53,144,53,0,144,249,-53,53,53,2,1,291,333,327,333,7,1848,1599
1702,7,0.1.186,0,675,1,51,186,237,186,0,237,249,-149,166,166,2,2,266,313,337,333,8,1848,1579
1702,7,1.2.37,1,654,0,96,37,133,37,0,133,249,-37,37,54,3,1,265,365,302,365,8,1848,1579
1702,7,2.1.115,0,700,2,88,115,203,115,0,203,249,-78,95,95,2,2,266,313,302,333,8,1848,1579
1702,7,3.1.249,0,654,0,6,249,255,249,0,255,255,-212,229,229,2,2,222,313,285,333,8,1848,1579
1702,7,4.1.79,0,654,0,77,79,156,79,0,156,249,-42,59,59,2,2,269,313,295,333,8,1848,1579
1702,7,5.1.53,0,654,0,91,53,144,53,0,144,249,-16,33,33,2,2,291,313,327,333,8,1848,1579
1702,8,0.1.186,0,675,1,51,186,237,186,0,237,249,-149,166,203,2,2,266,313,337,333,9,1848,1483
1702,8,1.3.133,0,654,0,82,133,215,133,0,215,249,-133,133,187,4,1,169,481,302,481,9,1848,1483
1702,8,2.1.115,0,700,2,88,115,203,115,0,203,249,-78,95,132,2,2,266,313,302,333,9,1848,1483
1702,8,3.1.249,0,654,0,6,249,255,249,0,255,255,-212,229,266,2,2,222,313,285,333,9,1848,1483
1702,8,4.1.79,0,654,0,77,79,156,79,0,156,249,-42,59,96,2,2,269,313,295,333,9,1848,1483
1702,8,5.1.53,1,654,0,91,53,144,53,0,144,249,-16,33,70,2,2,291,313,327,333,9,1848,1483
1702,9,0.1.186,0,675,1,51,186,237,186,0,237,249,-42,75,112,2,3,266,222,337,333,10,1848,1392
1702,9,1.3.133,0,654,0,82,133,215,133,0,215,249,-133,133,203,4,1,169,481,302,481,10,1848,1392
1702,9,2.1.144,0,654,0,88,144,232,115,29,232,249,0,33,70,2,3,266,222,302,333,10,1848,1392
1702,9,3.1.249,0,654,0,6,249,255,249,0,255,255,-105,138,175,2,3,222,222,285,333,10,1848,1392
1702,9,4.1.144,0,654,0,77,144,221,79,65,221,249,0,33,70,2,3,269,222,295,333,10,1848,1392
1702,9,5.2.144,1,654,0,20,144,164,144,0,164,249,-11,48,81,3,2,200,269,327,365,10,1848,1392
1702,10,0.1.186,0,675,1,51,186,237,186,0,237,249,-42,75,123,2,3,266,222,337,333,11,1848,1372
1702,10,1.3.133,0,654,0,82,133,215,133,0,215,249,-133,133,214,4,1,169,481,302,481,11,1848,1372
1702,10,2.1.144,0,654,0,88,144,232,115,29,232,249,0,33,81,2,3,266,222,302,333,11,1848,1372
1702,10,3.1.249,0,654,0,6,249,255,249,0,255,255,-105,138,186,2,3,222,222,285,333,11,1848,1372
1702,10,4.1.144,1,654,0,77,144,221,79,65,221,249,0,33,81,2,3,269,222,295,333,11,1848,1372
1702,10,5.3.164,0,685,2,88,164,252,164,0,252,252,-164,164,245,4,1,180,481,327,481,11,1848,1372
1702,11,0.1.221,1,654,0,51,221,272,186,35,272,272,0,33,81,2,4,266,145,337,333,12,1848,1295
1702,11,1.3.133,0,654,0,82,133,215,133,0,215,249,-133,133,214,4,1,169,481,302,481,12,1848,1295
1702,11,2.1.221,0,659,1,88,221,309,115,106,309,309,0,33,81,2,4,266,145,302,333,12,1848,1295
1702,11,3.1.249,0,654,0,6,249,255,249,0,255,255,-28,61,109,2,4,222,145,285,333,12,1848,1295
1702,11,4.2.221,0,654,0,57,221,278,221,0,278,278,-57,105,138,3,3,192,249,295,365,12,1848,1295
1702,11,5.3.164,0,685,2,88,164,252,164,0,252,252,-164,164,245,4,1,180,481,327,481,12,1848,1295
1702,12,0.2.272,0,702,3,77,272,349,272,0,349,349,-108,156,189,3,3,215,249,337,365,13,1848,1244
1702,12,1.3.133,0,654,0,82,133,215,133,0,215,272,-133,133,214,4,1,169,481,302,481,13,1848,1244
1702,12,2.1.272,0,656,1,88,272,360,115,157,360,360,0,33,81,2,5,266,94,302,333,13,1848,1244
1702,12,3.1.272,1,654,0,6,272,278,249,23,278,278,0,33,81,2,5,222,94,285,333,13,1848,1244
1702,12,4.2.221,0,654,0,57,221,278,221,0,278,278,-57,105,138,3,3,192,249,295,365,13,1848,1244
1702,12,5.3.164,0,685,2,88,164,252,164,0,252,272,-164,164,245,4,1,180,481,327,481,13,1848,1244
1702,13,0.2.272,0,702,2,77,272,349,272,0,349,349,-108,156,189,3,3,215,249,337,365,14,1848,1238
1702,13,1.3.133,0,654,0,82,133,215,133,0,215,278,-133,133,214,4,1,169,481,302,481,14,1848,1238
1702,13,2.1.278,1,654,0,88,278,366,115,163,366,366,0,33,81,2,6,266,88,302,333,14,1848,1238
1702,13,3.2.278,0,654,0,77,278,355,278,0,355,355,-114,162,195,3,3,216,249,285,365,14,1848,1238
1702,13,4.2.221,0,654,0,57,221,278,221,0,278,278,-57,105,138,3,3,192,249,295,365,14,1848,1238
1702,13,5.3.164,0,685,1,88,164,252,164,0,252,278,-164,164,245,4,1,180,481,327,481,14,1848,1238
1702,14,0.2.272,0,702,2,77,272,349,272,0,349,366,-108,156,189,3,3,215,249,337,365,15,1848,1150
1702,14,1.3.133,0,654,0,82,133,215,133,0,215,366,-133,133,214,4,1,169,481,302,481,15,1848,1150
1702,14,2.2.366,0,654,0,38,366,404,366,0,404,404,-202,250,283,3,3,178,249,302,365,15,1848,1150
1702,14,3.2.278,0,654,0,77,278,355,278,0,355,366,-114,162,195,3,3,216,249,285,365,15,1848,1150
1702,14,4.2.221,1,654,0,57,221,278,221,0,278,366,-57,105,138,3,3,192,249,295,365,15,1848,1150
1702,14,5.3.164,0,685,1,88,164,252,164,0,252,366,-164,164,245,4,1,180,481,327,481,15,1848,1150
1702,15,0.2.278,1,656,1,77,278,355,272,6,355,366,0,105,138,3,4,215,192,337,365,16,1848,1093
1702,15,1.3.133,0,654,0,82,133,215,133,0,215,366,-133,133,271,4,1,169,481,302,481,16,1848,1093
1702,15,2.2.366,0,654,0,38,366,404,366,0,404,404,-88,193,226,3,4,178,192,302,365,16,1848,1093
1702,15,3.2.278,0,654,0,77,278,355,278,0,355,366,0,105,138,3,4,216,192,285,365,16,1848,1093
1702,15,4.3.278,0,711,3,63,278,341,278,0,341,366,-278,278,416,4,1,135,481,295,481,16,1848,1093
1702,15,5.3.164,0,685,2,88,164,252,164,0,252,366,-164,164,302,4,1,180,481,327,481,16,1848,1093
1702,16,0.3.355,0,708,3,98,355,453,355,0,453,453,-355,355,493,4,1,138,481,337,481,17,1848,1016
1702,16,1.3.133,0,656,0,82,133,215,133,0,215,366,-133,133,271,4,1,169,481,302,481,17,1848,1016
1702,16,2.2.366,1,656,0,38,366,404,366,0,404,404,-11,116,149,3,5,178,115,302,365,17,1848,1016
1702,16,3.2.355,0,662,1,77,355,432,278,77,432,432,0,105,138,3,5,216,115,285,365,17,1848,1016
1702,16,4.3.278,0,713,4,63,278,341,278,0,341,366,-278,278,416,4,1,135,481,295,481,17,1848,1016
1702,16,5.3.164,0,687,2,88,164,252,164,0,252,366,-164,164,302,4,1,180,481,327,481,17,1848,1016
1702,17,0.3.355,0,708,3,98,355,453,355,0,453,453,-355,355,504,4,1,138,481,337,481,18,1848,978
1702,17,1.3.133,0,656,0,82,133,215,133,0,215,404,-133,133,282,4,1,169,481,302,481,18,1848,978
1702,17,2.3.404,0,694,2,53,404,457,404,0,457,457,-404,404,553,4,1,140,481,302,481,18,1848,978
1702,17,3.2.404,1,656,0,77,404,481,278,126,481,481,0,116,149,3,6,216,77,285,365,18,1848,978
1702,17,4.3.278,0,713,4,63,278,341,278,0,341,404,-278,278,427,4,1,135,481,295,481,18,1848,978
1702,17,5.3.164,0,687,1,88,164,252,164,0,252,404,-164,164,313,4,1,180,481,327,481,18,1848,978
1702,18,0.3.355,0,708,3,98,355,453,355,0,453,481,-355,355,504,4,1,138,481,337,481,19,1848,901
1702,18,1.3.133,1,656,0,82,133,215,133,0,215,481,-133,133,282,4,1,169,481,302,481,19,1848,901
1702,18,2.3.404,0,694,2,53,404,457,404,0,457,481,-404,404,553,4,1,140,481,302,481,19,1848,901
1702,18,3.3.481,0,716,5,97,481,578,481,0,578,578,-481,481,630,4,1,139,481,285,481,19,1848,901
1702,18,4.3.278,0,713,4,63,278,341,278,0,341,481,-278,278,427,4,1,135,481,295,481,19,1848,901
1702,18,5.3.164,0,687,1,88,164,252,164,0,252,481,-164,164,313,4,1,180,481,327,481,19,1848,901
1702,19,0.3.355,0,708,2,98,355,453,355,0,453,481,-140,273,422,4,2,138,399,337,481,20,1848,819
1702,19,1.4.215,1,656,0,87,215,302,215,0,302,481,-215,215,497,5,1,87,420,302,420,20,1848,819
1702,19,2.3.404,0,694,1,53,404,457,404,0,457,481,-189,322,471,4,2,140,399,302,481,20,1848,819
1702,19,3.3.481,0,716,3,97,481,578,481,0,578,578,-266,399,548,4,2,139,399,285,481,20,1848,819
1702,19,4.3.278,0,717,4,63,278,341,278,0,341,481,-63,196,345,4,2,135,399,295,481,20,1848,819
1702,19,5.3.215,0,656,0,88,215,303,164,51,303,481,0,133,282,4,2,180,399,327,481,20,1848,819
1702,20,0.3.355,0,708,2,98,355,453,355,0,453,481,-140,273,637,4,2,138,399,337,481,21,1848,732
1702,20,2.3.404,0,694,1,53,404,457,404,0,457,481,-189,322,686,4,2,140,399,302,481,21,1848,732
1702,20,3.3.481,0,716,3,97,481,578,481,0,578,578,-266,399,763,4,2,139,399,285,481,21,1848,732
1702,20,4.3.278,0,717,4,63,278,341,278,0,341,481,-63,196,560,4,2,135,399,295,481,21,1848,732
1702,20,5.3.215,1,656,0,88,215,303,164,51,303,481,0,133,497,4,2,180,399,327,481,21,1848,732
1702,21,0.3.355,0,708,2,98,355,453,355,0,453,481,-52,185,549,4,3,138,311,337,481,22,1848,644
1702,21,2.3.404,0,694,1,53,404,457,404,0,457,481,-101,234,598,4,3,140,311,302,481,22,1848,644
1702,21,3.3.481,0,716,3,97,481,578,481,0,578,578,-178,311,675,4,3,139,311,285,481,22,1848,644
1702,21,4.3.303,0,656,0,63,303,366,278,25,366,481,0,133,497,4,3,135,311,295,481,22,1848,644
1702,21,5.4.303,1,656,0,92,303,395,303,0,395,481,-1,216,498,5,2,92,333,327,420,22,1848,644
1702,22,0.3.355,0,708,2,98,355,453,355,0,453,481,-52,185,550,4,3,138,311,337,481,23,1848,552
1702,22,2.3.404,0,694,1,53,404,457,404,0,457,481,-101,234,599,4,3,140,311,302,481,23,1848,552
1702,22,3.3.481,0,716,3,97,481,578,481,0,578,578,-178,311,676,4,3,139,311,285,481,23,1848,552
1702,22,4.3.303,1,656,0,63,303,366,278,25,366,481,0,133,498,4,3,135,311,295,481,23,1848,552
1702,23,0.3.366,0,656,0,98,366,464,355,11,464,481,0,133,498,4,4,138,248,337,481,24,1848,489
1702,23,2.3.404,0,694,1,53,404,457,404,0,457,481,-38,171,536,4,4,140,248,302,481,24,1848,489
1702,23,3.3.481,0,716,2,97,481,578,481,0,578,578,-115,248,613,4,4,139,248,285,481,24,1848,489
1702,23,4.4.395,1,656,0,72,395,467,366,29,467,481,0,216,498,5,3,72,241,295,420,24,1848,489
1702,24,0.3.366,0,656,0,98,366,464,355,11,464,481,0,133,498,4,4,138,248,337,481,25,1848,417
1702,24,2.3.404,1,694,1,53,404,457,404,0,457,481,-38,171,536,4,4,140,248,302,481,25,1848,417
1702,24,3.3.481,0,716,2,97,481,578,481,0,578,578,-115,248,613,4,4,139,248,285,481,25,1848,417
1702,25,0.3.457,0,694,0,98,457,555,355,102,555,555,0,171,536,4,5,138,195,337,481,26,1848,364
1702,25,2.4.467,1,694,0,87,467,554,457,10,554,554,0,216,536,5,4,87,169,302,420,26,1848,364
1702,25,3.3.481,0,716,1,97,481,578,481,0,578,578,-24,195,560,4,5,139,195,285,481,26,1848,364
1702,26,0.3.457,1,694,0,98,457,555,355,102,555,555,0,171,536,4,5,138,195,337,481,27,1848,277
1702,26,3.3.481,0,716,1,97,481,578,481,0,578,578,-24,195,560,4,5,139,195,285,481,27,1848,277
1702,27,0.4.555,1,694,0,40,555,595,555,0,595,595,-1,217,537,5,5,40,82,337,420,28,1848,179
1702,27,3.3.555,0,694,0,97,555,652,481,74,652,652,0,171,536,4,6,139,97,285,481,28,1848,179
1702,28,3.3.555,1,694,0,97,555,652,481,74,652,652,0,171,537,4,6,139,97,285,481,29,1848,139
1702,29,3.4.652,1,694,0,42,652,694,652,0,694,694,-57,274,594,5,6,42,42,285,420,30,1848,42
1703,0,0.0.0,0,644,1,84,0,84,0,0,84,84,0,0,0,1,1,283,363,283,363,1,1721,1721
1703,0,1.0.0,0,656,4,92,0,92,0,0,92,92,0,0,0,1,1,302,363,302,363,1,1721,1721
1703,0,2.0.0,0,694,5,82,0,82,0,0,82,82,0,0,0,1,1,329,363,329,363,1,1721,1721
1703,0,3.0.0,0,618,0,17,0,17,0,0,17,17,0,0,0,1,1,245,363,245,363,1,1721,1721
1703,0,4.0.0,0,649,2,47,0,47,0,0,47,47,0,0,0,1,1,232,363,232,363,1,1721,1721
1703,0,5.0.0,1,653,3,41,0,41,0,0,41,41,0,0,0,1,1,330,363,330,363,1,1721,1721
1703,1,0.0.41,0,685,1,84,41,125,0,41,125,125,0,0,0,1,2,283,322,283,363,2,1721,1680
1703,1,1.0.41,0,696,3,92,41,133,0,41,133,133,0,0,0,1,2,302,322,302,363,2,1721,1680
1703,1,2.0.41,0,696,3,82,41,123,0,41,123,123,0,0,0,1,2,329,322,329,363,2,1721,1680
1703,1,3.0.41,0,653,0,17,41,58,0,41,58,58,0,0,0,1,2,245,322,245,363,2,1721,1680
1703,1,4.0.41,0,690,2,47,41,88,0,41,88,88,0,0,0,1,2,232,322,232,363,2,1721,1680
1703,1,5.1.41,1,685,1,74,41,115,41,0,115,115,-41,41,41,2,1,289,336,330,336,2,1721,1680
1703,2,0.0.41,0,685,0,84,41,125,0,41,125,125,0,0,41,1,2,283,322,283,363,3,1721,1606
1703,2,1.0.41,0,696,1,92,41,133,0,41,133,133,0,0,41,1,2,302,322,302,363,3,1721,1606
1703,2,2.0.41,0,696,1,82,41,123,0,41,123,123,0,0,41,1,2,329,322,329,363,3,1721,1606
1703,2,3.0.41,0,696,1,17,41,58,0,41,58,115,0,0,41,1,2,245,322,245,363,3,1721,1606
1703,2,4.0.41,0,696,1,47,41,88,0,41,88,115,0,0,41,1,2,232,322,232,363,3,1721,1606
1703,2,5.2.115,1,696,1,58,115,173,115,0,173,173,-115,115,156,3,1,215,334,330,334,3,1721,1606
1703,3,0.0.41,0,696,0,84,41,125,0,41,125,173,0,0,156,1,2,283,322,283,363,4,1721,1548
1703,3,1.0.41,0,696,0,92,41,133,0,41,133,173,0,0,156,1,2,302,322,302,363,4,1721,1548
1703,3,2.0.41,0,696,0,82,41,123,0,41,123,173,0,0,156,1,2,329,322,329,363,4,1721,1548
1703,3,3.0.41,0,696,0,17,41,58,0,41,58,173,0,0,156,1,2,245,322,245,363,4,1721,1548
1703,3,4.0.41,0,696,0,47,41,88,0,41,88,173,0,0,156,1,2,232,322,232,363,4,1721,1548
1703,3,5.3.173,1,696,0,73,173,246,173,0,246,246,-173,173,329,4,1,157,238,330,238,4,1721,1548
1703,4,0.0.41,0,696,0,84,41,125,0,41,125,246,0,0,329,1,2,283,322,283,363,5,1721,1475
1703,4,1.0.41,0,696,0,92,41,133,0,41,133,246,0,0,329,1,2,302,322,302,363,5,1721,1475
1703,4,2.0.41,0,696,0,82,41,123,0,41,123,246,0,0,329,1,2,329,322,329,363,5,1721,1475
1703,4,3.0.41,1,696,0,17,41,58,0,41,58,246,0,0,329,1,2,245,322,245,363,5,1721,1475
1703,4,4.0.41,0,696,0,47,41,88,0,41,88,246,0,0,329,1,2,232,322,232,363,5,1721,1475
1703,4,5.4.246,0,696,0,84,246,330,246,0,330,330,-246,246,575,5,1,84,450,330,450,5,1721,1475
1703,5,0.0.58,0,696,0,84,58,142,0,58,142,246,0,0,329,1,3,283,305,283,363,6,1721,1458
1703,5,1.0.58,0,696,0,92,58,150,0,58,150,246,0,0,329,1,3,302,305,302,363,6,1721,1458
1703,5,2.0.58,0,696,0,82,58,140,0,58,140,246,0,0,329,1,3,329,305,329,363,6,1721,1458
1703,5,3.1.115,1,696,0,44,115,159,58,57,159,246,0,41,329,2,2,228,262,245,336,6,1721,1458
1703,5,4.0.58,0,696,0,47,58,105,0,58,105,246,0,0,329,1,3,232,305,232,363,6,1721,1458
1703,5,5.4.246,0,696,0,84,246,330,246,0,330,330,-246,246,575,5,1,84,450,330,450,6,1721,1458
1703,6,0.0.58,0,696,0,84,58,142,0,58,142,246,0,0,329,1,3,283,305,283,363,7,1721,1414
1703,6,1.0.58,0,696,0,92,58,150,0,58,150,246,0,0,329,1,3,302,305,302,363,7,1721,1414
1703,6,2.0.58,0,696,0,82,58,140,0,58,140,246,0,0,329,1,3,329,305,329,363,7,1721,1414
1703,6,3.2.173,1,696,0,44,173,217,159,14,217,246,0,115,329,3,2,184,276,245,334,7,1721,1414
1703,6,4.0.58,0,696,0,47,58,105,0,58,105,246,0,0,329,1,3,232,305,232,363,7,1721,1414
1703,6,5.4.246,0,696,0,84,246,330,246,0,330,330,-246,246,575,5,1,84,450,330,450,7,1721,1414
1703,7,0.0.58,0,696,0,84,58,142,0,58,142,246,0,0,329,1,3,283,305,283,363,8,1721,1370
1703,7,1.0.58,0,696,0,92,58,150,0,58,150,246,0,0,329,1,3,302,305,302,363,8,1721,1370
1703,7,2.0.58,0,696,0,82,58,140,0,58,140,246,0,0,329,1,3,329,305,329,363,8,1721,1370
1703,7,3.3.246,1,696,0,57,246,303,217,29,303,303,0,173,329,4,2,140,165,245,238,8,1721,1370
1703,7,4.0.58,0,696,0,47,58,105,0,58,105,246,0,0,329,1,3,232,305,232,363,8,1721,1370
1703,7,5.4.246,0,696,0,84,246,330,246,0,330,330,-246,246,575,5,1,84,450,330,450,8,1721,1370
1703,8,0.0.58,0,696,0,84,58,142,0,58,142,303,0,0,329,1,3,283,305,283,363,9,1721,1313
1703,8,1.0.58,0,696,0,92,58,150,0,58,150,303,0,0,329,1,3,302,305,302,363,9,1721,1313
1703,8,2.0.58,1,696,0,82,58,140,0,58,140,303,0,0,329,1,3,329,305,329,363,9,1721,1313
1703,8,3.4.303,0,753,1,83,303,386,303,0,386,386,-303,303,632,5,1,83,450,245,450,9,1721,1313
1703,8,4.0.58,0,696,0,47,58,105,0,58,105,303,0,0,329,1,3,232,305,232,363,9,1721,1313
1703,8,5.4.246,0,696,0,84,246,330,246,0,330,330,-246,246,575,5,1,84,450,330,450,9,1721,1313
1703,9,0.0.140,0,696,0,84,140,224,0,140,224,303,0,0,329,1,4,283,223,283,363,10,1721,1231
1703,9,1.0.140,0,696,0,92,140,232,0,140,232,303,0,0,329,1,4,302,223,302,363,10,1721,1231
1703,9,2.1.159,0,696,0,81,159,240,140,19,240,303,0,41,329,2,3,247,218,329,336,10,1721,1231
1703,9,3.4.303,0,753,1,83,303,386,303,0,386,386,-303,303,632,5,1,83,450,245,450,10,1721,1231
1703,9,4.0.140,1,696,0,47,140,187,0,140,187,303,0,0,329,1,4,232,223,232,363,10,1721,1231
1703,9,5.4.246,0,696,0,84,246,330,246,0,330,330,-246,246,575,5,1,84,450,330,450,10,1721,1231
1703,10,0.0.187,1,696,0,84,187,271,0,187,271,303,0,0,329,1,5,283,176,283,363,11,1721,1184
1703,10,1.0.187,0,696,0,92,187,279,0,187,279,303,0,0,329,1,5,302,176,302,363,11,1721,1184
1703,10,2.1.159,0,696,0,81,159,240,140,19,240,303,0,41,329,2,3,247,218,329,336,11,1721,1184
1703,10,3.4.303,0,753,1,83,303,386,303,0,386,386,-303,303,632,5,1,83,450,245,450,11,1721,1184
1703,10,4.1.187,0,696,0,29,187,216,187,0,216,303,-28,69,357,2,3,185,218,232,336,11,1721,1184
1703,10,5.4.246,0,696,0,84,246,330,246,0,330,330,-246,246,575,5,1,84,450,330,450,11,1721,1184
1703,11,0.1.271,0,696,0,20,271,291,271,0,291,303,-112,153,441,2,3,199,218,283,336,12,1721,1100
1703,11,1.0.271,1,696,0,92,271,363,0,271,363,363,0,0,329,1,6,302,92,302,363,12,1721,1100
1703,11,2.1.159,0,696,0,81,159,240,140,19,240,303,0,41,329,2,3,247,218,329,336,12,1721,1100
1703,11,3.4.303,0,753,1,83,303,386,303,0,386,386,-303,303,632,5,1,83,450,245,450,12,1721,1100
1703,11,4.1.187,0,696,0,29,187,216,187,0,216,303,-28,69,357,2,3,185,218,232,336,12,1721,1100
1703,11,5.4.246,0,696,0,84,246,330,246,0,330,330,-246,246,575,5,1,84,450,330,450,12,1721,1100
1703,12,0.1.271,0,696,0,20,271,291,271,0,291,363,-112,153,441,2,3,199,218,283,336,13,1721,1008
1703,12,1.1.363,0,696,0,88,363,451,363,0,451,451,-204,245,533,2,3,210,218,302,336,13,1721,1008
1703,12,2.1.159,1,696,0,81,159,240,140,19,240,363,0,41,329,2,3,247,218,329,336,13,1721,1008
1703,12,3.4.303,0,753,1,83,303,386,303,0,386,386,-303,303,632,5,1,83,450,245,450,13,1721,1008
1703,12,4.1.187,0,696,0,29,187,216,187,0,216,363,-28,69,357,2,3,185,218,232,336,13,1721,1008
1703,12,5.4.246,0,696,0,84,246,330,246,0,330,363,-246,246,575,5,1,84,450,330,450,13,1721,1008
1703,13,0.1.271,0,696,0,20,271,291,271,0,291,363,-31,72,360,2,4,199,137,283,336,14,1721,927
1703,13,1.1.363,0,696,0,88,363,451,363,0,451,451,-123,164,452,2,4,210,137,302,336,14,1721,927
1703,13,2.2.240,0,696,0,91,240,331,240,0,331,363,-23,138,352,3,3,166,232,329,334,14,1721,927
1703,13,3.4.303,0,753,1,83,303,386,303,0,386,386,-303,303,632,5,1,83,450,245,450,14,1721,927
1703,13,4.1.240,1,696,0,29,240,269,187,53,269,363,0,41,329,2,4,185,137,232,336,14,1721,927
1703,13,5.4.246,0,696,0,84,246,330,246,0,330,363,-246,246,575,5,1,84,450,330,450,14,1721,927
1703,14,0.1.271,1,696,0,20,271,291,271,0,291,363,-2,43,331,2,5,199,108,283,336,15,1721,898
1703,14,1.1.363,0,696,0,88,363,451,363,0,451,451,-94,135,423,2,5,210,108,302,336,15,1721,898
1703,14,2.2.240,0,696,0,91,240,331,240,0,331,363,-23,138,352,3,3,166,232,329,334,15,1721,898
1703,14,3.4.303,0,753,1,83,303,386,303,0,386,386,-303,303,632,5,1,83,450,245,450,15,1721,898
1703,14,4.2.269,0,696,0,58,269,327,269,0,327,363,-52,167,381,3,3,156,232,232,334,15,1721,898
1703,14,5.4.246,0,696,0,84,246,330,246,0,330,363,-246,246,575,5,1,84,450,330,450,15,1721,898
1703,15,0.2.291,0,696,0,81,291,372,291,0,372,372,-74,189,405,3,3,179,232,283,334,16,1721,878
1703,15,1.1.363,0,696,0,88,363,451,363,0,451,451,-72,115,403,2,6,210,88,302,336,16,1721,878
1703,15,2.2.240,1,696,0,91,240,331,240,0,331,363,-23,138,354,3,3,166,232,329,334,16,1721,878
1703,15,3.4.303,0,753,1,83,303,386,303,0,386,386,-303,303,634,5,1,83,450,245,450,16,1721,878
1703,15,4.2.269,0,696,0,58,269,327,269,0,327,363,-52,167,383,3,3,156,232,232,334,16,1721,878
1703,15,5.4.246,0,696,0,84,246,330,246,0,330,363,-246,246,577,5,1,84,450,330,450,16,1721,878
1703,16,0.2.331,0,696,0,81,331,412,291,40,412,412,0,138,354,3,4,179,141,283,334,17,1721,787
1703,16,1.1.363,0,696,0,88,363,451,363,0,451,451,-72,115,426,2,6,210,88,302,336,17,1721,787
1703,16,2.3.331,1,696,0,22,331,353,331,0,353,363,-28,201,382,4,3,75,108,329,238,17,1721,787
1703,16,3.4.303,0,753,1,83,303,386,303,0,386,386,-303,303,657,5,1,83,450,245,450,17,1721,787
1703,16,4.2.331,0,696,0,58,331,389,269,62,389,389,0,138,354,3,4,156,141,232,334,17,1721,787
1703,16,5.4.246,0,696,0,84,246,330,246,0,330,363,-246,246,600,5,1,84,450,330,450,17,1721,787
1703,17,0.2.331,0,696,0,81,331,412,291,40,412,412,0,138,382,3,4,179,141,283,334,18,1721,765
1703,17,1.1.363,0,696,0,88,363,451,363,0,451,451,-72,115,454,2,6,210,88,302,336,18,1721,765
1703,17,2.4.353,0,719,1,53,353,406,353,0,406,406,-353,353,735,5,1,53,450,329,450,18,1721,765
1703,17,3.4.303,0,753,2,83,303,386,303,0,386,386,-303,303,685,5,1,83,450,245,450,18,1721,765
1703,17,4.2.331,1,696,0,58,331,389,269,62,389,389,0,138,382,3,4,156,141,232,334,18,1721,765
1703,17,5.4.246,0,696,0,84,246,330,246,0,330,363,-246,246,628,5,1,84,450,330,450,18,1721,765
1703,18,0.2.389,0,696,0,81,389,470,291,98,470,470,0,138,382,3,5,179,83,283,334,19,1721,707
1703,18,1.1.363,0,696,0,88,363,451,363,0,451,451,-72,115,454,2,6,210,88,302,336,19,1721,707
1703,18,2.4.353,0,719,1,53,353,406,353,0,406,406,-353,353,735,5,1,53,450,329,450,19,1721,707
1703,18,3.4.303,0,753,2,83,303,386,303,0,386,389,-303,303,685,5,1,83,450,245,450,19,1721,707
1703,18,4.3.389,1,696,0,56,389,445,389,0,445,445,-36,237,418,4,4,98,86,232,238,19,1721,707
1703,18,5.4.246,0,696,0,84,246,330,246,0,330,389,-246,246,628,5,1,84,450,330,450,19,1721,707
1703,19,0.2.389,1,696,0,81,389,470,291,98,470,470,0,138,418,3,5,179,83,283,334,20,1721,651
1703,19,1.1.363,0,696,0,88,363,451,363,0,451,451,-72,115,490,2,6,210,88,302,336,20,1721,651
1703,19,2.4.353,0,719,1,53,353,406,353,0,406,445,-353,353,771,5,1,53,450,329,450,20,1721,651
1703,19,3.4.303,0,753,3,83,303,386,303,0,386,445,-303,303,721,5,1,83,450,245,450,20,1721,651
1703,19,4.4.445,0,728,2,42,445,487,445,0,487,487,-445,445,863,5,1,42,450,232,450,20,1721,651
1703,19,5.4.246,0,696,0,84,246,330,246,0,330,445,-246,246,664,5,1,84,450,330,450,20,1721,651
1703,20,0.3.470,1,696,0,6,470,476,470,0,476,476,-25,262,443,4,5,98,30,283,238,21,1721,570
1703,20,1.1.363,0,696,0,88,363,451,363,0,451,470,-72,115,490,2,6,210,88,302,336,21,1721,570
1703,20,2.4.353,0,719,1,53,353,406,353,0,406,470,-353,353,771,5,1,53,450,329,450,21,1721,570
1703,20,3.4.303,0,753,3,83,303,386,303,0,386,470,-303,303,721,5,1,83,450,245,450,21,1721,570
1703,20,4.4.445,0,728,2,42,445,487,445,0,487,487,-445,445,863,5,1,42,450,232,450,21,1721,570
1703,20,5.4.246,0,696,0,84,246,330,246,0,330,470,-246,246,664,5,1,84,450,330,450,21,1721,570
1703,21,0.4.476,0,706,1,92,476,568,476,0,568,568,-476,476,919,5,1,92,450,283,450,22,1721,564
1703,21,1.1.363,1,696,0,88,363,451,363,0,451,476,-72,115,515,2,6,210,88,302,336,22,1721,564
1703,21,2.4.353,0,719,2,53,353,406,353,0,406,476,-353,353,796,5,1,53,450,329,450,22,1721,564
1703,21,3.4.303,0,753,4,83,303,386,303,0,386,476,-303,303,746,5,1,83,450,245,450,22,1721,564
1703,21,4.4.445,0,728,3,42,445,487,445,0,487,487,-445,445,888,5,1,42,450,232,450,22,1721,564
1703,21,5.4.246,0,696,0,84,246,330,246,0,330,476,-246,246,689,5,1,84,450,330,450,22,1721,564
1703,22,0.4.476,0,706,1,92,476,568,476,0,568,568,-476,476,991,5,1,92,450,283,450,23,1721,476
1703,22,1.2.470,1,696,0,2,470,472,451,19,472,476,0,138,515,3,6,122,2,302,334,23,1721,476
1703,22,2.4.353,0,719,2,53,353,406,353,0,406,476,-353,353,868,5,1,53,450,329,450,23,1721,476
1703,22,3.4.303,0,753,4,83,303,386,303,0,386,476,-303,303,818,5,1,83,450,245,450,23,1721,476
1703,22,4.4.445,0,728,3,42,445,487,445,0,487,487,-445,445,960,5,1,42,450,232,450,23,1721,476
1703,22,5.4.246,0,696,0,84,246,330,246,0,330,476,-246,246,761,5,1,84,450,330,450,23,1721,476
1703,23,0.4.476,0,706,1,92,476,568,476,0,568,568,-476,476,991,5,1,92,450,283,450,24,1721,474
1703,23,1.3.476,1,696,0,24,476,500,472,4,500,500,0,262,515,4,6,120,24,302,238,24,1721,474
1703,23,2.4.353,0,719,2,53,353,406,353,0,406,476,-353,353,868,5,1,53,450,329,450,24,1721,474
1703,23,3.4.303,0,753,4,83,303,386,303,0,386,476,-303,303,818,5,1,83,450,245,450,24,1721,474
1703,23,4.4.445,0,728,3,42,445,487,445,0,487,487,-445,445,960,5,1,42,450,232,450,24,1721,474
1703,23,5.4.246,0,696,0,84,246,330,246,0,330,476,-246,246,761,5,1,84,450,330,450,24,1721,474
1703,24,0.4.476,0,706,1,92,476,568,476,0,568,568,-476,476,991,5,1,92,450,283,450,25,1721,450
1703,24,1.4.500,0,730,4,96,500,596,500,0,596,596,-500,500,1015,5,1,96,450,302,450,25,1721,450
1703,24,2.4.353,0,719,2,53,353,406,353,0,406,500,-353,353,868,5,1,53,450,329,450,25,1721,450
1703,24,3.4.303,0,753,5,83,303,386,303,0,386,500,-303,303,818,5,1,83,450,245,450,25,1721,450
1703,24,4.4.445,0,728,3,42,445,487,445,0,487,500,-445,445,960,5,1,42,450,232,450,25,1721,450
1703,24,5.4.246,1,696,0,84,246,330,246,0,330,500,-246,246,761,5,1,84,450,330,450,25,1721,450
1703,25,0.4.476,0,706,1,92,476,568,476,0,568,568,-146,392,907,5,2,92,366,283,450,26,1721,366
1703,25,1.4.500,0,730,4,96,500,596,500,0,596,596,-170,416,931,5,2,96,366,302,450,26,1721,366
1703,25,2.4.353,1,719,2,53,353,406,353,0,406,500,-23,269,784,5,2,53,366,329,450,26,1721,366
1703,25,3.4.330,0,696,0,83,330,413,303,27,413,500,0,246,761,5,2,83,366,245,450,26,1721,366
1703,25,4.4.445,0,728,3,42,445,487,445,0,487,500,-115,361,876,5,2,42,366,232,450,26,1721,366
1703,26,0.4.476,0,789,3,92,476,568,476,0,568,568,-70,339,854,5,3,92,313,283,450,27,1721,313
1703,26,1.4.500,0,730,1,96,500,596,500,0,596,596,-94,363,878,5,3,96,313,302,450,27,1721,313
1703,26,3.4.406,1,719,0,83,406,489,303,103,489,500,0,269,784,5,3,83,313,245,450,27,1721,313
1703,26,4.4.445,0,758,2,42,445,487,445,0,487,500,-39,308,823,5,3,42,313,232,450,27,1721,313
1703,27,0.4.489,0,719,0,92,489,581,476,13,581,581,0,269,784,5,4,92,230,283,450,28,1721,230
1703,27,1.4.500,0,730,1,96,500,596,500,0,596,596,-11,280,795,5,4,96,230,302,450,28,1721,230
1703,27,4.4.489,1,719,0,42,489,531,445,44,531,531,0,269,784,5,4,42,230,232,450,28,1721,230
1703,28,0.4.531,1,719,0,92,531,623,476,55,623,623,0,269,784,5,5,92,188,283,450,29,1721,188
1703,28,1.4.531,0,719,0,96,531,627,500,31,627,627,0,269,784,5,5,96,188,302,450,29,1721,188
1703,29,1.4.623,1,719,0,96,623,719,500,123,719,719,0,269,784,5,6,96,96,302,450,30,1721,96
1704,0,0.0.0,0,613,5,97,0,97,0,0,97,97,0,0,0,1,1,325,378,325,378,1,1592,1592
1704,0,1.0.0,0,577,3,68,0,68,0,0,68,68,0,0,0,1,1,203,378,203,378,1,1592,1592
1704,0,2.0.0,0,531,0,28,0,28,0,0,28,28,0,0,0,1,1,256,378,256,378,1,1592,1592
1704,0,3.0.0,0,601,4,70,0,70,0,0,70,70,0,0,0,1,1,206,378,206,378,1,1592,1592
1704,0,4.0.0,0,572,2,69,0,69,0,0,69,69,0,0,0,1,1,270,378,270,378,1,1592,1592
1704,0,5.0.0,1,549,1,46,0,46,0,0,46,46,0,0,0,1,1,332,378,332,378,1,1592,1592
1704,1,0.0.46,0,591,3,97,46,143,0,46,143,143,0,0,0,1,2,325,332,325,378,2,1592,1546
1704,1,1.0.46,0,566,2,68,46,114,0,46,114,114,0,0,0,1,2,203,332,203,378,2,1592,1546
1704,1,2.0.46,1,549,0,28,46,74,0,46,74,74,0,0,0,1,2,256,332,256,378,2,1592,1546
1704,1,3.0.46,0,601,4,70,46,116,0,46,116,116,0,0,0,1,2,206,332,206,378,2,1592,1546
1704,1,4.0.46,0,561,1,69,46,115,0,46,115,115,0,0,0,1,2,270,332,270,378,2,1592,1546
1704,1,5.1.46,0,549,0,57,46,103,46,0,103,103,-46,46,46,2,1,286,437,332,437,2,1592,1546
1704,2,0.0.74,0,551,1,97,74,171,0,74,171,171,0,0,0,1,3,325,304,325,378,3,1592,1518
1704,2,1.0.74,0,560,2,68,74,142,0,74,142,142,0,0,0,1,3,203,304,203,378,3,1592,1518
1704,2,2.1.74,0,577,3,75,74,149,74,0,149,149,-74,74,74,2,1,228,437,256,437,3,1592,1518
1704,2,3.0.74,0,595,4,70,74,144,0,74,144,144,0,0,0,1,3,206,304,206,378,3,1592,1518
1704,2,4.0.74,1,549,0,69,74,143,0,74,143,143,0,0,0,1,3,270,304,270,378,3,1592,1518
1704,2,5.1.46,0,549,0,57,46,103,46,0,103,103,-46,46,46,2,1,286,437,332,437,3,1592,1518
1704,3,0.0.143,1,549,0,97,143,240,0,143,240,240,0,0,0,1,4,325,235,325,378,4,1592,1449
1704,3,1.0.143,0,568,1,68,143,211,0,143,211,211,0,0,0,1,4,203,235,203,378,4,1592,1449
1704,3,2.1.74,0,577,2,75,74,149,74,0,149,149,-74,74,74,2,1,228,437,256,437,4,1592,1449
1704,3,3.0.143,0,595,4,70,143,213,0,143,213,213,0,0,0,1,4,206,235,206,378,4,1592,1449
1704,3,4.1.143,0,589,3,80,143,223,143,0,223,223,-143,143,143,2,1,201,437,270,437,4,1592,1449
1704,3,5.1.46,0,549,0,57,46,103,46,0,103,143,-46,46,46,2,1,286,437,332,437,4,1592,1449
1704,4,0.1.240,0,613,4,87,240,327,240,0,327,327,-240,240,240,2,1,228,437,325,437,5,1592,1352
1704,4,1.0.240,1,549,0,68,240,308,0,240,308,308,0,0,0,1,5,203,138,203,378,5,1592,1352
1704,4,2.1.74,0,577,2,75,74,149,74,0,149,240,-74,74,74,2,1,228,437,256,437,5,1592,1352
1704,4,3.0.240,0,562,1,70,240,310,0,240,310,310,0,0,0,1,5,206,138,206,378,5,1592,1352
1704,4,4.1.143,0,589,3,80,143,223,143,0,223,240,-143,143,143,2,1,201,437,270,437,5,1592,1352
1704,4,5.1.46,0,549,0,57,46,103,46,0,103,240,-46,46,46,2,1,286,437,332,437,5,1592,1352
1704,5,0.1.240,0,613,3,87,240,327,240,0,327,327,-240,240,240,2,1,228,437,325,437,6,1592,1284
1704,5,1.1.308,0,618,4,56,308,364,308,0,364,364,-308,308,308,2,1,135,437,203,437,6,1592,1284
1704,5,2.1.74,0,577,1,75,74,149,74,0,149,308,-74,74,74,2,1,228,437,256,437,6,1592,1284
1704,5,3.0.308,1,549,0,70,308,378,0,308,378,378,0,0,0,1,6,206,70,206,378,6,1592,1284
1704,5,4.1.143,0,589,2,80,143,223,143,0,223,308,-143,143,143,2,1,201,437,270,437,6,1592,1284
1704,5,5.1.46,0,549,0,57,46,103,46,0,103,308,-46,46,46,2,1,286,437,332,437,6,1592,1284
1704,6,0.1.240,0,613,4,87,240,327,240,0,327,378,-240,240,240,2,1,228,437,325,437,7,1592,1214
1704,6,1.1.308,0,618,5,56,308,364,308,0,364,378,-308,308,308,2,1,135,437,203,437,7,1592,1214
1704,6,2.1.74,0,577,1,75,74,149,74,0,149,378,-74,74,74,2,1,228,437,256,437,7,1592,1214
1704,6,3.1.378,0,595,3,82,378,460,378,0,460,460,-378,378,378,2,1,136,437,206,437,7,1592,1214
1704,6,4.1.143,0,589,2,80,143,223,143,0,223,378,-143,143,143,2,1,201,437,270,437,7,1592,1214
1704,6,5.1.46,1,549,0,57,46,103,46,0,103,378,-46,46,46,2,1,286,437,332,437,7,1592,1214
1704,7,0.1.240,0,613,3,87,240,327,240,0,327,378,-137,183,183,2,2,228,380,325,437,8,1592,1157
1704,7,1.1.308,0,618,4,56,308,364,308,0,364,378,-205,251,251,2,2,135,380,203,437,8,1592,1157
1704,7,2.1.103,0,549,0,75,103,178,74,29,178,378,0,46,46,2,2,228,380,256,437,8,1592,1157
1704,7,3.1.378,0,595,2,82,378,460,378,0,460,460,-275,321,321,2,2,136,380,206,437,8,1592,1157
1704,7,4.1.143,0,589,1,80,143,223,143,0,223,378,-40,86,86,2,2,201,380,270,437,8,1592,1157
1704,7,5.2.103,1,549,0,96,103,199,103,0,199,378,-103,103,149,3,1,229,302,332,302,8,1592,1157
1704,8,0.1.240,0,613,3,87,240,327,240,0,327,378,-137,183,286,2,2,228,380,325,437,9,1592,1061
1704,8,1.1.308,0,618,4,56,308,364,308,0,364,378,-205,251,354,2,2,135,380,203,437,9,1592,1061
1704,8,2.1.103,0,549,0,75,103,178,74,29,178,378,0,46,149,2,2,228,380,256,437,9,1592,1061
1704,8,3.1.378,0,595,2,82,378,460,378,0,460,460,-275,321,424,2,2,136,380,206,437,9,1592,1061
1704,8,4.1.143,0,589,1,80,143,223,143,0,223,378,-40,86,189,2,2,201,380,270,437,9,1592,1061
1704,8,5.3.199,1,549,0,58,199,257,199,0,257,378,-199,199,348,4,1,133,291,332,291,9,1592,1061
1704,9,0.1.240,0,613,3,87,240,327,240,0,327,378,-137,183,485,2,2,228,380,325,437,10,1592,1003
1704,9,1.1.308,0,618,4,56,308,364,308,0,364,378,-205,251,553,2,2,135,380,203,437,10,1592,1003
1704,9,2.1.103,0,549,0,75,103,178,74,29,178,378,0,46,348,2,2,228,380,256,437,10,1592,1003
1704,9,3.1.378,0,595,2,82,378,460,378,0,460,460,-275,321,623,2,2,136,380,206,437,10,1592,1003
1704,9,4.1.143,0,589,1,80,143,223,143,0,223,378,-40,86,388,2,2,201,380,270,437,10,1592,1003
1704,9,5.4.257,1,549,0,75,257,332,257,0,332,378,-257,257,605,5,1,75,184,332,184,10,1592,1003
1704,10,0.1.240,0,613,3,87,240,327,240,0,327,378,-137,183,742,2,2,228,380,325,437,11,1592,928
1704,10,1.1.308,0,618,4,56,308,364,308,0,364,378,-205,251,810,2,2,135,380,203,437,11,1592,928
1704,10,2.1.103,1,549,0,75,103,178,74,29,178,378,0,46,605,2,2,228,380,256,437,11,1592,928
1704,10,3.1.378,0,595,2,82,378,460,378,0,460,460,-275,321,880,2,2,136,380,206,437,11,1592,928
1704,10,4.1.143,0,589,1,80,143,223,143,0,223,378,-40,86,645,2,2,201,380,270,437,11,1592,928
1704,11,0.1.240,0,613,2,87,240,327,240,0,327,378,-62,108,667,2,3,228,305,325,437,12,1592,853
1704,11,1.1.308,0,618,3,56,308,364,308,0,364,378,-130,176,735,2,3,135,305,203,437,12,1592,853
1704,11,2.2.199,1,549,0,44,199,243,178,21,243,378,0,103,605,3,2,153,206,256,302,12,1592,853
1704,11,3.1.378,0,595,1,82,378,460,378,0,460,460,-200,246,805,2,3,136,305,206,437,12,1592,853
1704,11,4.1.178,0,549,0,80,178,258,143,35,258,378,0,46,605,2,3,201,305,270,437,12,1592,853
1704,12,0.1.240,0,613,2,87,240,327,240,0,327,378,-62,108,667,2,3,228,305,325,437,13,1592,809
1704,12,1.1.308,0,618,3,56,308,364,308,0,364,378,-130,176,735,2,3,135,305,203,437,13,1592,809
1704,12,2.3.257,1,549,0,90,257,347,243,14,347,378,0,199,605,4,2,109,233,256,291,13,1592,809
1704,12,3.1.378,0,595,1,82,378,460,378,0,460,460,-200,246,805,2,3,136,305,206,437,13,1592,809
1704,12,4.1.178,0,549,0,80,178,258,143,35,258,378,0,46,605,2,3,201,305,270,437,13,1592,809
1704,13,0.1.240,0,613,2,87,240,327,240,0,327,378,-62,108,667,2,3,228,305,325,437,14,1592,719
1704,13,1.1.308,0,618,3,56,308,364,308,0,364,378,-130,176,735,2,3,135,305,203,437,14,1592,719
1704,13,2.4.347,1,549,0,19,347,366,347,0,366,378,-15,272,620,5,2,19,109,256,184,14,1592,719
1704,13,3.1.378,0,595,1,82,378,460,378,0,460,460,-200,246,805,2,3,136,305,206,437,14,1592,719
1704,13,4.1.178,0,549,0,80,178,258,143,35,258,378,0,46,605,2,3,201,305,270,437,14,1592,719
1704,14,0.1.240,0,613,2,87,240,327,240,0,327,378,-62,108,682,2,3,228,305,325,437,15,1592,700
1704,14,1.1.308,0,618,3,56,308,364,308,0,364,378,-130,176,750,2,3,135,305,203,437,15,1592,700
1704,14,3.1.378,0,595,1,82,378,460,378,0,460,460,-200,246,820,2,3,136,305,206,437,15,1592,700
1704,14,4.1.178,1,549,0,80,178,258,143,35,258,378,0,46,620,2,3,201,305,270,437,15,1592,700
1704,15,0.1.258,0,549,0,87,258,345,240,18,345,378,0,46,620,2,4,228,225,325,437,16,1592,620
1704,15,1.1.308,0,618,2,56,308,364,308,0,364,378,-50,96,670,2,4,135,225,203,437,16,1592,620
1704,15,3.1.378,0,595,1,82,378,460,378,0,460,460,-120,166,740,2,4,136,225,206,437,16,1592,620
1704,15,4.2.258,1,549,0,59,258,317,258,0,317,378,-15,118,635,3,3,121,162,270,302,16,1592,620
1704,16,0.1.258,0,549,0,87,258,345,240,18,345,378,0,46,635,2,4,228,225,325,437,17,1592,561
1704,16,1.1.308,0,618,2,56,308,364,308,0,364,378,-50,96,685,2,4,135,225,203,437,17,1592,561
1704,16,3.1.378,0,595,1,82,378,460,378,0,460,460,-120,166,755,2,4,136,225,206,437,17,1592,561
1704,16,4.3.347,1,549,0,49,347,396,317,30,396,396,0,199,635,4,3,62,143,270,291,17,1592,561
1704,17,0.1.258,0,549,0,87,258,345,240,18,345,396,0,46,635,2,4,228,225,325,437,18,1592,512
1704,17,1.1.308,0,618,2,56,308,364,308,0,364,396,-50,96,685,2,4,135,225,203,437,18,1592,512
1704,17,3.1.378,0,595,1,82,378,460,378,0,460,460,-120,166,755,2,4,136,225,206,437,18,1592,512
1704,17,4.4.396,1,549,0,13,396,409,396,0,409,409,-30,302,665,5,3,13,90,270,184,18,1592,512
1704,18,0.1.258,1,549,0,87,258,345,240,18,345,409,0,46,665,2,4,228,225,325,437,19,1592,499
1704,18,1.1.308,0,618,2,56,308,364,308,0,364,409,-50,96,715,2,4,135,225,203,437,19,1592,499
1704,18,3.1.378,0,595,1,82,378,460,378,0,460,460,-120,166,785,2,4,136,225,206,437,19,1592,499
1704,19,0.2.345,1,549,0,84,345,429,345,0,429,429,-28,146,693,3,4,141,103,325,302,20,1592,412
1704,19,1.1.345,0,549,0,56,345,401,308,37,401,409,0,46,665,2,5,135,138,203,437,20,1592,412
1704,19,3.1.378,0,595,1,82,378,460,378,0,460,460,-33,79,698,2,5,136,138,206,437,20,1592,412
1704,20,0.3.429,1,549,0,12,429,441,429,0,441,441,-33,232,726,4,4,57,94,325,291,21,1592,328
1704,20,1.1.345,0,549,0,56,345,401,308,37,401,429,0,46,693,2,5,135,138,203,437,21,1592,328
1704,20,3.1.378,0,595,1,82,378,460,378,0,460,460,-33,79,726,2,5,136,138,206,437,21,1592,328
1704,21,0.4.441,1,549,0,45,441,486,441,0,486,486,-32,334,758,5,4,45,77,325,184,22,1592,316
1704,21,1.1.345,0,549,0,56,345,401,308,37,401,441,0,46,726,2,5,135,138,203,437,22,1592,316
1704,21,3.1.378,0,595,1,82,378,460,378,0,460,460,-33,79,759,2,5,136,138,206,437,22,1592,316
1704,22,1.1.345,1,549,0,56,345,401,308,37,401,486,0,46,758,2,5,135,138,203,437,23,1592,271
1704,22,3.1.378,0,595,1,82,378,460,378,0,460,486,-33,79,791,2,5,136,138,206,437,23,1592,271
1704,23,1.2.429,1,549,0,7,429,436,401,28,436,486,0,146,758,3,5,79,19,203,302,24,1592,215
1704,23,3.1.401,0,549,0,82,401,483,378,23,483,486,0,46,758,2,6,136,82,206,437,24,1592,215
1704,24,1.3.441,1,549,0,66,441,507,436,5,507,507,0,232,758,4,5,72,82,203,291,25,1592,208
1704,24,3.1.401,0,549,0,82,401,483,378,23,483,486,0,46,758,2,6,136,82,206,437,25,1592,208
1704,25,1.4.507,1,549,0,6,507,513,507,0,513,513,-21,355,779,5,5,6,32,203,184,26,1592,142
1704,25,3.1.401,0,549,0,82,401,483,378,23,483,507,0,46,758,2,6,136,82,206,437,26,1592,142
1704,26,3.1.401,1,549,0,82,401,483,378,23,483,513,0,46,779,2,6,136,82,206,437,27,1592,136
1704,27,3.2.483,1,549,0,12,483,495,483,0,495,513,-47,193,826,3,6,54,12,206,302,28,1592,54
1704,28,3.3.507,1,549,0,16,507,523,495,12,523,523,0,232,826,4,6,42,16,206,291,29,1592,42
1704,29,3.4.523,1,549,0,26,523,549,523,0,549,549,-10,365,836,5,6,26,26,206,184,30,1592,26
1705,0,0.0.0,1,584,0,11,0,11,0,0,11,11,0,0,0,1,1,270,292,270,292,1,1560,1560
1705,0,1.0.0,0,626,3,44,0,44,0,0,44,44,0,0,0,1,1,104,292,104,292,1,1560,1560
1705,0,2.0.0,0,657,5,73,0,73,0,0,73,73,0,0,0,1,1,381,292,381,292,1,1560,1560
1705,0,3.0.0,0,607,1,23,0,23,0,0,23,23,0,0,0,1,1,263,292,263,292,1,1560,1560
1705,0,4.0.0,0,637,4,91,0,91,0,0,91,91,0,0,0,1,1,308,292,308,292,1,1560,1560
1705,0,5.0.0,0,621,2,50,0,50,0,0,50,50,0,0,0,1,1,234,292,234,292,1,1560,1560
1705,1,0.1.11,1,584,0,55,11,66,11,0,66,66,-11,11,11,2,1,259,242,270,242,2,1560,1549
1705,1,1.0.11,0,600,1,44,11,55,0,11,55,55,0,0,0,1,2,104,281,104,292,2,1560,1549
1705,1,2.0.11,0,609,2,73,11,84,0,11,84,84,0,0,0,1,2,381,281,381,292,2,1560,1549
1705,1,3.0.11,0,584,0,23,11,34,0,11,34,34,0,0,0,1,2,263,281,263,292,2,1560,1549
1705,1,4.0.11,0,584,0,91,11,102,0,11,102,102,0,0,0,1,2,308,281,308,292,2,1560,1549
1705,1,5.0.11,0,584,0,50,11,61,0,11,61,61,0,0,0,1,2,234,281,234,292,2,1560,1549
1705,2,0.2.66,0,584,0,88,66,154,66,0,154,154,-66,66,77,3,1,204,369,270,369,3,1560,1494
1705,2,1.0.11,0,600,1,44,11,55,0,11,55,66,0,0,11,1,2,104,281,104,292,3,1560,1494
1705,2,2.0.11,0,609,2,73,11,84,0,11,84,84,0,0,11,1,2,381,281,381,292,3,1560,1494
1705,2,3.0.11,1,584,0,23,11,34,0,11,34,66,0,0,11,1,2,263,281,263,292,3,1560,1494
1705,2,4.0.11,0,584,0,91,11,102,0,11,102,102,0,0,11,1,2,308,281,308,292,3,1560,1494
1705,2,5.0.11,0,584,0,50,11,61,0,11,61,66,0,0,11,1,2,234,281,234,292,3,1560,1494
1705,3,0.2.66,0,584,0,88,66,154,66,0,154,154,-66,66,77,3,1,204,369,270,369,4,1560,1471
1705,3,1.0.34,0,600,2,44,34,78,0,34,78,78,0,0,11,1,3,104,258,104,292,4,1560,1471
1705,3,2.0.34,0,620,3,73,34,107,0,34,107,107,0,0,11,1,3,381,258,381,292,4,1560,1471
1705,3,3.1.66,1,584,0,21,66,87,34,32,87,87,0,11,11,2,2,240,187,263,242,4,1560,1471
1705,3,4.0.34,0,584,0,91,34,125,0,34,125,125,0,0,11,1,3,308,258,308,292,4,1560,1471
1705,3,5.0.34,0,588,1,50,34,84,0,34,84,84,0,0,11,1,3,234,258,234,292,4,1560,1471
1705,4,0.2.66,0,584,0,88,66,154,66,0,154,154,-66,66,77,3,1,204,369,270,369,5,1560,1450
1705,4,1.0.34,0,600,2,44,34,78,0,34,78,87,0,0,11,1,3,104,258,104,292,5,1560,1450
1705,4,2.0.34,1,620,3,73,34,107,0,34,107,107,0,0,11,1,3,381,258,381,292,5,1560,1450
1705,4,3.2.87,0,650,4,78,87,165,87,0,165,165,-87,87,98,3,1,219,369,263,369,5,1560,1450
1705,4,4.0.34,0,584,0,91,34,125,0,34,125,125,0,0,11,1,3,308,258,308,292,5,1560,1450
1705,4,5.0.34,0,588,1,50,34,84,0,34,84,87,0,0,11,1,3,234,258,234,292,5,1560,1450
1705,5,0.2.66,0,620,0,88,66,154,66,0,154,154,-66,66,77,3,1,204,369,270,369,6,1560,1377
1705,5,1.0.107,0,620,0,44,107,151,0,107,151,151,0,0,11,1,4,104,185,104,292,6,1560,1377
1705,5,2.1.107,1,620,0,68,107,175,107,0,175,175,-20,31,31,2,3,308,166,381,242,6,1560,1377
1705,5,3.2.87,0,650,1,78,87,165,87,0,165,165,-87,87,98,3,1,219,369,263,369,6,1560,1377
1705,5,4.0.107,0,620,0,91,107,198,0,107,198,198,0,0,11,1,4,308,185,308,292,6,1560,1377
1705,5,5.0.107,0,620,0,50,107,157,0,107,157,157,0,0,11,1,4,234,185,234,292,6,1560,1377
1705,6,0.2.66,0,620,0,88,66,154,66,0,154,175,-66,66,97,3,1,204,369,270,369,7,1560,1309
1705,6,1.0.107,0,620,0,44,107,151,0,107,151,175,0,0,31,1,4,104,185,104,292,7,1560,1309
1705,6,2.2.175,0,645,1,97,175,272,175,0,272,272,-175,175,206,3,1,240,369,381,369,7,1560,1309
1705,6,3.2.87,0,650,2,78,87,165,87,0,165,175,-87,87,118,3,1,219,369,263,369,7,1560,1309
1705,6,4.0.107,0,620,0,91,107,198,0,107,198,198,0,0,31,1,4,308,185,308,292,7,1560,1309
1705,6,5.0.107,1,620,0,50,107,157,0,107,157,175,0,0,31,1,4,234,185,234,292,7,1560,1309
1705,7,0.2.66,0,620,0,88,66,154,66,0,154,175,-66,66,97,3,1,204,369,270,369,8,1560,1259
1705,7,1.0.157,0,620,0,44,157,201,0,157,201,201,0,0,31,1,5,104,135,104,292,8,1560,1259
1705,7,2.2.175,0,645,1,97,175,272,175,0,272,272,-175,175,206,3,1,240,369,381,369,8,1560,1259
1705,7,3.2.87,0,650,2,78,87,165,87,0,165,175,-87,87,118,3,1,219,369,263,369,8,1560,1259
1705,7,4.0.157,0,620,0,91,157,248,0,157,248,248,0,0,31,1,5,308,135,308,292,8,1560,1259
1705,7,5.1.175,1,620,0,41,175,216,157,18,216,216,0,31,31,2,4,184,98,234,242,8,1560,1259
1705,8,0.2.66,0,620,0,88,66,154,66,0,154,216,-66,66,97,3,1,204,369,270,369,9,1560,1218
1705,8,1.0.157,0,620,0,44,157,201,0,157,201,216,0,0,31,1,5,104,135,104,292,9,1560,1218
1705,8,2.2.175,0,645,1,97,175,272,175,0,272,272,-175,175,206,3,1,240,369,381,369,9,1560,1218
1705,8,3.2.87,0,650,3,78,87,165,87,0,165,216,-87,87,118,3,1,219,369,263,369,9,1560,1218
1705,8,4.0.157,1,620,0,91,157,248,0,157,248,248,0,0,31,1,5,308,135,308,292,9,1560,1218
1705,8,5.2.216,0,648,2,34,216,250,216,0,250,250,-216,216,247,3,1,143,369,234,369,9,1560,1218
1705,9,0.2.66,0,620,0,88,66,154,66,0,154,248,-66,66,97,3,1,204,369,270,369,10,1560,1127
1705,9,1.0.248,0,620,0,44,248,292,0,248,292,292,0,0,31,1,6,104,44,104,292,10,1560,1127
1705,9,2.2.175,0,645,1,97,175,272,175,0,272,272,-175,175,206,3,1,240,369,381,369,10,1560,1127
1705,9,3.2.87,0,650,2,78,87,165,87,0,165,248,-87,87,118,3,1,219,369,263,369,10,1560,1127
1705,9,4.1.248,1,620,0,33,248,281,248,0,281,281,-32,63,63,2,5,217,57,308,242,10,1560,1127
1705,9,5.2.216,0,650,2,34,216,250,216,0,250,250,-216,216,247,3,1,143,369,234,369,10,1560,1127
1705,10,0.2.66,0,620,0,88,66,154,66,0,154,281,-66,66,129,3,1,204,369,270,369,11,1560,1094
1705,10,1.0.248,1,620,0,44,248,292,0,248,292,292,0,0,63,1,6,104,44,104,292,11,1560,1094
1705,10,2.2.175,0,645,1,97,175,272,175,0,272,281,-175,175,238,3,1,240,369,381,369,11,1560,1094
1705,10,3.2.87,0,650,2,78,87,165,87,0,165,281,-87,87,150,3,1,219,369,263,369,11,1560,1094
1705,10,4.2.281,0,620,0,59,281,340,281,0,340,340,-281,281,344,3,1,184,369,308,369,11,1560,1094
1705,10,5.2.216,0,650,2,34,216,250,216,0,250,281,-216,216,279,3,1,143,369,234,369,11,1560,1094
1705,11,0.2.66,0,620,0,88,66,154,66,0,154,292,-66,66,129,3,1,204,369,270,369,12,1560,1050
1705,11,1.1.292,1,620,0,24,292,316,292,0,316,316,-11,74,74,2,6,60,24,104,242,12,1560,1050
1705,11,2.2.175,0,645,1,97,175,272,175,0,272,292,-175,175,238,3,1,240,369,381,369,12,1560,1050
1705,11,3.2.87,0,650,2,78,87,165,87,0,165,292,-87,87,150,3,1,219,369,263,369,12,1560,1050
1705,11,4.2.281,0,620,0,59,281,340,281,0,340,340,-281,281,344,3,1,184,369,308,369,12,1560,1050
1705,11,5.2.216,0,650,2,34,216,250,216,0,250,292,-216,216,279,3,1,143,369,234,369,12,1560,1050
1705,12,0.2.66,1,620,0,88,66,154,66,0,154,316,-66,66,140,3,1,204,369,270,369,13,1560,1026
1705,12,1.2.316,0,628,1,13,316,329,316,0,329,329,-316,316,390,3,1,36,369,104,369,13,1560,1026
1705,12,2.2.175,0,645,2,97,175,272,175,0,272,316,-175,175,249,3,1,240,369,381,369,13,1560,1026
1705,12,3.2.87,0,650,3,78,87,165,87,0,165,316,-87,87,161,3,1,219,369,263,369,13,1560,1026
1705,12,4.2.281,0,620,0,59,281,340,281,0,340,340,-281,281,355,3,1,184,369,308,369,13,1560,1026
1705,12,5.2.216,0,650,3,34,216,250,216,0,250,316,-216,216,290,3,1,143,369,234,369,13,1560,1026
1705,13,0.3.154,1,620,0,19,154,173,154,0,173,316,-154,154,294,4,1,116,246,270,246,14,1560,938
1705,13,1.2.316,0,628,1,13,316,329,316,0,329,329,-162,228,302,3,2,36,281,104,369,14,1560,938
1705,13,2.2.175,0,645,2,97,175,272,175,0,272,316,-21,87,161,3,2,240,281,381,369,14,1560,938
1705,13,3.2.154,0,620,0,78,154,232,87,67,232,316,0,66,140,3,2,219,281,263,369,14,1560,938
1705,13,4.2.281,0,620,0,59,281,340,281,0,340,340,-127,193,267,3,2,184,281,308,369,14,1560,938
1705,13,5.2.216,0,650,3,34,216,250,216,0,250,316,-62,128,202,3,2,143,281,234,369,14,1560,938
1705,14,0.4.173,0,620,0,97,173,270,173,0,270,316,-173,173,467,5,1,97,411,270,411,15,1560,919
1705,14,1.2.316,0,628,1,13,316,329,316,0,329,329,-162,228,456,3,2,36,281,104,369,15,1560,919
1705,14,2.2.175,0,645,2,97,175,272,175,0,272,316,-21,87,315,3,2,240,281,381,369,15,1560,919
1705,14,3.2.154,1,620,0,78,154,232,87,67,232,316,0,66,294,3,2,219,281,263,369,15,1560,919
1705,14,4.2.281,0,620,0,59,281,340,281,0,340,340,-127,193,421,3,2,184,281,308,369,15,1560,919
1705,14,5.2.216,0,650,3,34,216,250,216,0,250,316,-62,128,356,3,2,143,281,234,369,15,1560,919
1705,15,0.4.173,0,620,0,97,173,270,173,0,270,316,-173,173,467,5,1,97,411,270,411,16,1560,841
1705,15,1.2.316,0,628,1,13,316,329,316,0,329,329,-84,150,378,3,3,36,203,104,369,16,1560,841
1705,15,2.2.232,0,635,2,97,232,329,175,57,329,329,0,66,294,3,3,240,203,381,369,16,1560,841
1705,15,3.3.232,1,620,0,74,232,306,232,0,306,316,-59,213,353,4,2,141,227,263,246,16,1560,841
1705,15,4.2.281,0,620,0,59,281,340,281,0,340,340,-49,115,343,3,3,184,203,308,369,16,1560,841
1705,15,5.2.232,0,620,0,34,232,266,216,16,266,316,0,66,294,3,3,143,203,234,369,16,1560,841
1705,16,0.4.173,0,620,0,97,173,270,173,0,270,316,-173,173,526,5,1,97,411,270,411,17,1560,767
1705,16,1.2.316,0,628,1,13,316,329,316,0,329,329,-84,150,437,3,3,36,203,104,369,17,1560,767
1705,16,2.2.232,1,635,2,97,232,329,175,57,329,329,0,66,353,3,3,240,203,381,369,17,1560,767
1705,16,3.4.306,0,620,0,67,306,373,306,0,373,373,-306,306,659,5,1,67,411,263,411,17,1560,767
1705,16,4.2.281,0,620,0,59,281,340,281,0,340,340,-49,115,402,3,3,184,203,308,369,17,1560,767
1705,16,5.2.232,0,620,0,34,232,266,216,16,266,316,0,66,353,3,3,143,203,234,369,17,1560,767
1705,17,0.4.173,0,635,0,97,173,270,173,0,270,329,-173,173,526,5,1,97,411,270,411,18,1560,670
1705,17,1.2.329,0,635,0,13,329,342,316,13,342,342,0,66,353,3,4,36,106,104,369,18,1560,670
1705,17,2.3.329,0,635,0,59,329,388,329,0,388,388,-23,236,376,4,3,143,153,381,246,18,1560,670
1705,17,3.4.306,0,635,0,67,306,373,306,0,373,373,-306,306,659,5,1,67,411,263,411,18,1560,670
1705,17,4.2.329,0,635,0,59,329,388,281,48,388,388,0,66,353,3,4,184,106,308,369,18,1560,670
1705,17,5.2.329,1,635,0,34,329,363,216,113,363,363,0,66,353,3,4,143,106,234,369,18,1560,670
1705,18,0.4.173,0,635,0,97,173,270,173,0,270,363,-173,173,526,5,1,97,411,270,411,19,1560,636
1705,18,1.2.363,0,635,0,13,363,376,316,47,376,376,0,66,353,3,5,36,72,104,369,19,1560,636
1705,18,2.3.329,0,635,0,59,329,388,329,0,388,388,-23,236,376,4,3,143,153,381,246,19,1560,636
1705,18,3.4.306,0,635,0,67,306,373,306,0,373,373,-306,306,659,5,1,67,411,263,411,19,1560,636
1705,18,4.2.363,1,635,0,59,363,422,281,82,422,422,0,66,353,3,5,184,72,308,369,19,1560,636
1705,18,5.3.363,0,653,1,43,363,406,363,0,406,406,-57,270,410,4,3,109,153,234,246,19,1560,636
1705,19,0.4.173,0,635,0,97,173,270,173,0,270,422,-173,173,526,5,1,97,411,270,411,20,1560,577
1705,19,1.2.422,1,635,0,13,422,435,316,106,435,435,0,66,353,3,6,36,13,104,369,20,1560,577
1705,19,2.3.329,0,635,0,59,329,388,329,0,388,422,-23,236,376,4,3,143,153,381,246,20,1560,577
1705,19,3.4.306,0,635,0,67,306,373,306,0,373,422,-306,306,659,5,1,67,411,263,411,20,1560,577
1705,19,4.3.422,0,635,0,43,422,465,422,0,465,465,-116,329,469,4,3,125,153,308,246,20,1560,577
1705,19,5.3.363,0,653,1,43,363,406,363,0,406,422,-57,270,410,4,3,109,153,234,246,20,1560,577
1705,20,0.4.173,0,635,0,97,173,270,173,0,270,435,-173,173,526,5,1,97,411,270,411,21,1560,564
1705,20,1.3.435,0,635,0,8,435,443,435,0,443,443,-129,342,482,4,3,23,153,104,246,21,1560,564
1705,20,2.3.329,1,635,0,59,329,388,329,0,388,435,-23,236,376,4,3,143,153,381,246,21,1560,564
1705,20,3.4.306,0,635,0,67,306,373,306,0,373,435,-306,306,659,5,1,67,411,263,411,21,1560,564
1705,20,4.3.422,0,635,0,43,422,465,422,0,465,465,-116,329,469,4,3,125,153,308,246,21,1560,564
1705,20,5.3.363,0,653,1,43,363,406,363,0,406,435,-57,270,410,4,3,109,153,234,246,21,1560,564
1705,21,0.4.173,0,635,0,97,173,270,173,0,270,435,-173,173,549,5,1,97,411,270,411,22,1560,505
1705,21,1.3.435,0,635,0,8,435,443,435,0,443,443,-47,283,423,4,4,23,94,104,246,22,1560,505
1705,21,2.4.388,0,635,0,84,388,472,388,0,472,472,-388,388,764,5,1,84,411,381,411,22,1560,505
1705,21,3.4.306,0,635,0,67,306,373,306,0,373,435,-306,306,682,5,1,67,411,263,411,22,1560,505
1705,21,4.3.422,0,635,0,43,422,465,422,0,465,465,-34,270,410,4,4,125,94,308,246,22,1560,505
1705,21,5.3.388,1,635,0,43,388,431,363,25,431,435,0,236,376,4,4,109,94,234,246,22,1560,505
1705,22,0.4.173,0,635,0,97,173,270,173,0,270,435,-173,173,549,5,1,97,411,270,411,23,1560,462
1705,22,1.3.435,0,635,0,8,435,443,435,0,443,443,-4,240,380,4,5,23,51,104,246,23,1560,462
1705,22,2.4.388,0,635,0,84,388,472,388,0,472,472,-388,388,764,5,1,84,411,381,411,23,1560,462
1705,22,3.4.306,0,635,0,67,306,373,306,0,373,435,-306,306,682,5,1,67,411,263,411,23,1560,462
1705,22,4.3.431,1,635,0,43,431,474,422,9,474,474,0,236,376,4,5,125,51,308,246,23,1560,462
1705,22,5.4.431,0,678,1,66,431,497,431,0,497,497,-431,431,807,5,1,66,411,234,411,23,1560,462
1705,23,0.4.173,0,635,0,97,173,270,173,0,270,474,-173,173,549,5,1,97,411,270,411,24,1560,419
1705,23,1.3.474,1,635,0,8,474,482,435,39,482,482,0,236,376,4,6,23,8,104,246,24,1560,419
1705,23,2.4.388,0,635,0,84,388,472,388,0,472,474,-388,388,764,5,1,84,411,381,411,24,1560,419
1705,23,3.4.306,0,635,0,67,306,373,306,0,373,474,-306,306,682,5,1,67,411,263,411,24,1560,419
1705,23,4.4.474,0,637,1,82,474,556,474,0,556,556,-474,474,850,5,1,82,411,308,411,24,1560,419
1705,23,5.4.431,0,678,2,66,431,497,431,0,497,497,-431,431,807,5,1,66,411,234,411,24,1560,419
1705,24,0.4.173,1,635,0,97,173,270,173,0,270,482,-173,173,549,5,1,97,411,270,411,25,1560,411
1705,24,1.4.482,0,645,2,15,482,497,482,0,497,497,-482,482,858,5,1,15,411,104,411,25,1560,411
1705,24,2.4.388,0,635,0,84,388,472,388,0,472,482,-388,388,764,5,1,84,411,381,411,25,1560,411
1705,24,3.4.306,0,635,0,67,306,373,306,0,373,482,-306,306,682,5,1,67,411,263,411,25,1560,411
1705,24,4.4.474,0,637,1,82,474,556,474,0,556,556,-474,474,850,5,1,82,411,308,411,25,1560,411
1705,24,5.4.431,0,678,3,66,431,497,431,0,497,497,-431,431,807,5,1,66,411,234,411,25,1560,411
1705,25,1.4.482,0,645,2,15,482,497,482,0,497,497,-212,385,761,5,2,15,314,104,411,26,1560,314
1705,25,2.4.388,0,635,0,84,388,472,388,0,472,482,-118,291,667,5,2,84,314,381,411,26,1560,314
1705,25,3.4.306,1,635,0,67,306,373,306,0,373,482,-36,209,585,5,2,67,314,263,411,26,1560,314
1705,25,4.4.474,0,637,1,82,474,556,474,0,556,556,-204,377,753,5,2,82,314,308,411,26,1560,314
1705,25,5.4.431,0,678,3,66,431,497,431,0,497,497,-161,334,710,5,2,66,314,234,411,26,1560,314
1705,26,1.4.482,0,645,2,15,482,497,482,0,497,497,-109,318,694,5,3,15,247,104,411,27,1560,247
1705,26,2.4.388,1,635,0,84,388,472,388,0,472,482,-15,224,600,5,3,84,247,381,411,27,1560,247
1705,26,4.4.474,0,637,1,82,474,556,474,0,556,556,-101,310,686,5,3,82,247,308,411,27,1560,247
1705,26,5.4.431,0,678,3,66,431,497,431,0,497,497,-58,267,643,5,3,66,247,234,411,27,1560,247
1705,27,1.4.482,0,645,2,15,482,497,482,0,497,497,-10,234,610,5,4,15,163,104,411,28,1560,163
1705,27,4.4.474,0,637,1,82,474,556,474,0,556,556,-2,226,602,5,4,82,163,308,411,28,1560,163
1705,27,5.4.472,1,635,0,66,472,538,431,41,538,538,0,224,600,5,4,66,163,234,411,28,1560,163
1705,28,1.4.538,1,635,0,15,538,553,482,56,553,553,0,224,600,5,5,15,97,104,411,29,1560,97
1705,28,4.4.538,0,635,0,82,538,620,474,64,620,620,0,224,600,5,5,82,97,308,411,29,1560,97
1705,29,4.4.553,1,635,0,82,553,635,474,79,635,635,0,224,600,5,6,82,82,308,411,30,1560,82
1706,0,0.0.0,0,456,0,24,0,24,0,0,24,24,0,0,0,1,1,215,208,215,208,1,1331,1331
1706,0,1.0.0,0,475,3,19,0,19,0,0,19,19,0,0,0,1,1,201,208,201,208,1,1331,1331
1706,0,2.0.0,0,469,1,20,0,20,0,0,20,20,0,0,0,1,1,209,208,209,208,1,1331,1331
1706,0,3.0.0,0,532,5,76,0,76,0,0,76,76,0,0,0,1,1,224,208,224,208,1,1331,1331
1706,0,4.0.0,1,470,2,14,0,14,0,0,14,14,0,0,0,1,1,247,208,247,208,1,1331,1331
1706,0,5.0.0,0,487,4,55,0,55,0,0,55,55,0,0,0,1,1,235,208,235,208,1,1331,1331
1706,1,0.0.14,0,470,0,24,14,38,0,14,38,38,0,0,0,1,2,215,194,215,208,2,1331,1317
1706,1,1.0.14,0,478,1,19,14,33,0,14,33,33,0,0,0,1,2,201,194,201,208,2,1331,1317
1706,1,2.0.14,1,478,1,20,14,34,0,14,34,34,0,0,0,1,2,209,194,209,208,2,1331,1317
1706,1,3.0.14,0,481,2,76,14,90,0,14,90,90,0,0,0,1,2,224,194,224,208,2,1331,1317
1706,1,4.1.14,0,478,1,84,14,98,14,0,98,98,-14,14,14,2,1,233,343,247,343,2,1331,1317
1706,1,5.0.14,0,478,1,55,14,69,0,14,69,69,0,0,0,1,2,235,194,235,208,2,1331,1317
1706,2,0.0.34,0,480,1,24,34,58,0,34,58,58,0,0,0,1,3,215,174,215,208,3,1331,1297
1706,2,1.0.34,1,478,0,19,34,53,0,34,53,53,0,0,0,1,3,201,174,201,208,3,1331,1297
1706,2,2.1.34,0,483,2,62,34,96,34,0,96,96,-34,34,34,2,1,189,343,209,343,3,1331,1297
1706,2,3.0.34,0,483,2,76,34,110,0,34,110,110,0,0,0,1,3,224,174,224,208,3,1331,1297
1706,2,4.1.14,0,478,0,84,14,98,14,0,98,98,-14,14,14,2,1,233,343,247,343,3,1331,1297
1706,2,5.0.34,0,478,0,55,34,89,0,34,89,89,0,0,0,1,3,235,174,235,208,3,1331,1297
1706,3,0.0.53,1,480,1,24,53,77,0,53,77,77,0,0,0,1,4,215,155,215,208,4,1331,1278
1706,3,1.1.53,0,532,4,91,53,144,53,0,144,144,-53,53,53,2,1,182,343,201,343,4,1331,1278
1706,3,2.1.34,0,483,2,62,34,96,34,0,96,96,-34,34,34,2,1,189,343,209,343,4,1331,1278
1706,3,3.0.53,0,484,3,76,53,129,0,53,129,129,0,0,0,1,4,224,155,224,208,4,1331,1278
1706,3,4.1.14,0,478,0,84,14,98,14,0,98,98,-14,14,14,2,1,233,343,247,343,4,1331,1278
1706,3,5.0.53,0,478,0,55,53,108,0,53,108,108,0,0,0,1,4,235,155,235,208,4,1331,1278
1706,4,0.1.77,0,509,3,23,77,100,77,0,100,100,-77,77,77,2,1,191,343,215,343,5,1331,1254
1706,4,1.1.53,0,532,4,91,53,144,53,0,144,144,-53,53,53,2,1,182,343,201,343,5,1331,1254
1706,4,2.1.34,0,483,2,62,34,96,34,0,96,96,-34,34,34,2,1,189,343,209,343,5,1331,1254
1706,4,3.0.77,0,481,1,76,77,153,0,77,153,153,0,0,0,1,5,224,131,224,208,5,1331,1254
1706,4,4.1.14,0,480,0,84,14,98,14,0,98,98,-14,14,14,2,1,233,343,247,343,5,1331,1254
1706,4,5.0.77,1,480,0,55,77,132,0,77,132,132,0,0,0,1,5,235,131,235,208,5,1331,1254
1706,5,0.1.77,0,509,3,23,77,100,77,0,100,132,-77,77,77,2,1,191,343,215,343,6,1331,1199
1706,5,1.1.53,0,532,4,91,53,144,53,0,144,144,-53,53,53,2,1,182,343,201,343,6,1331,1199
1706,5,2.1.34,0,483,2,62,34,96,34,0,96,132,-34,34,34,2,1,189,343,209,343,6,1331,1199
1706,5,3.0.132,1,480,0,76,132,208,0,132,208,208,0,0,0,1,6,224,76,224,208,6,1331,1199
1706,5,4.1.14,0,480,0,84,14,98,14,0,98,132,-14,14,14,2,1,233,343,247,343,6,1331,1199
1706,5,5.1.132,0,481,1,24,132,156,132,0,156,156,-132,132,132,2,1,180,343,235,343,6,1331,1199
1706,6,0.1.77,1,509,4,23,77,100,77,0,100,208,-77,77,77,2,1,191,343,215,343,7,1331,1123
1706,6,1.1.53,0,532,5,91,53,144,53,0,144,208,-53,53,53,2,1,182,343,201,343,7,1331,1123
1706,6,2.1.34,0,483,2,62,34,96,34,0,96,208,-34,34,34,2,1,189,343,209,343,7,1331,1123
1706,6,3.1.208,0,490,3,59,208,267,208,0,267,267,-208,208,208,2,1,148,343,224,343,7,1331,1123
1706,6,4.1.14,0,480,0,84,14,98,14,0,98,208,-14,14,14,2,1,233,343,247,343,7,1331,1123
1706,6,5.1.132,0,481,1,24,132,156,132,0,156,208,-132,132,132,2,1,180,343,235,343,7,1331,1123
1706,7,0.2.100,1,509,0,91,100,191,100,0,191,208,-100,100,177,3,1,168,337,215,337,8,1331,1100
1706,7,1.1.100,0,509,0,91,100,191,53,47,191,208,0,77,77,2,2,182,320,201,343,8,1331,1100
1706,7,2.1.100,0,509,0,62,100,162,34,66,162,208,0,77,77,2,2,189,320,209,343,8,1331,1100
1706,7,3.1.208,0,520,1,59,208,267,208,0,267,267,-108,185,185,2,2,148,320,224,343,8,1331,1100
1706,7,4.1.100,0,509,0,84,100,184,14,86,184,208,0,77,77,2,2,233,320,247,343,8,1331,1100
1706,7,5.1.132,0,541,2,24,132,156,132,0,156,208,-32,109,109,2,2,180,320,235,343,8,1331,1100
1706,8,0.3.191,1,509,0,26,191,217,191,0,217,217,-191,191,368,4,1,77,200,215,200,9,1331,1009
1706,8,1.1.100,0,509,0,91,100,191,53,47,191,208,0,77,177,2,2,182,320,201,343,9,1331,1009
1706,8,2.1.100,0,509,0,62,100,162,34,66,162,208,0,77,177,2,2,189,320,209,343,9,1331,1009
1706,8,3.1.208,0,520,1,59,208,267,208,0,267,267,-108,185,285,2,2,148,320,224,343,9,1331,1009
1706,8,4.1.100,0,509,0,84,100,184,14,86,184,208,0,77,177,2,2,233,320,247,343,9,1331,1009
1706,8,5.1.132,0,541,2,24,132,156,132,0,156,208,-32,109,209,2,2,180,320,235,343,9,1331,1009
1706,9,0.4.217,1,509,0,51,217,268,217,0,268,268,-217,217,585,5,1,51,243,215,243,10,1331,983
1706,9,1.1.100,0,509,0,91,100,191,53,47,191,217,0,77,368,2,2,182,320,201,343,10,1331,983
1706,9,2.1.100,0,509,0,62,100,162,34,66,162,217,0,77,368,2,2,189,320,209,343,10,1331,983
1706,9,3.1.208,0,520,1,59,208,267,208,0,267,267,-108,185,476,2,2,148,320,224,343,10,1331,983
1706,9,4.1.100,0,509,0,84,100,184,14,86,184,217,0,77,368,2,2,233,320,247,343,10,1331,983
1706,9,5.1.132,0,541,2,24,132,156,132,0,156,217,-32,109,400,2,2,180,320,235,343,10,1331,983
1706,10,1.1.100,0,509,0,91,100,191,53,47,191,268,0,77,585,2,2,182,320,201,343,11,1331,932
1706,10,2.1.100,0,509,0,62,100,162,34,66,162,268,0,77,585,2,2,189,320,209,343,11,1331,932
1706,10,3.1.208,0,520,1,59,208,267,208,0,267,268,-108,185,693,2,2,148,320,224,343,11,1331,932
1706,10,4.1.100,1,509,0,84,100,184,14,86,184,268,0,77,585,2,2,233,320,247,343,11,1331,932
1706,10,5.1.132,0,541,2,24,132,156,132,0,156,268,-32,109,617,2,2,180,320,235,343,11,1331,932
1706,11,1.1.184,0,513,1,91,184,275,53,131,275,275,0,77,585,2,3,182,236,201,343,12,1331,848
1706,11,2.1.184,1,509,0,62,184,246,34,150,246,268,0,77,585,2,3,189,236,209,343,12,1331,848
1706,11,3.1.208,0,520,2,59,208,267,208,0,267,268,-24,101,609,2,3,148,236,224,343,12,1331,848
1706,11,4.2.191,0,509,0,60,191,251,184,7,251,268,0,100,585,3,2,149,246,247,337,12,1331,848
1706,11,5.1.184,0,509,0,24,184,208,132,52,208,268,0,77,585,2,3,180,236,235,343,12,1331,848
1706,12,1.1.246,0,526,1,91,246,337,53,193,337,337,0,77,585,2,4,182,174,201,343,13,1331,786
1706,12,2.2.246,0,539,3,50,246,296,246,0,296,296,-55,155,640,3,2,127,246,209,337,13,1331,786
1706,12,3.1.246,0,530,2,59,246,305,208,38,305,305,0,77,585,2,4,148,174,224,343,13,1331,786
1706,12,4.2.191,0,509,0,60,191,251,184,7,251,268,0,100,585,3,2,149,246,247,337,13,1331,786
1706,12,5.1.246,1,509,0,24,246,270,132,114,270,270,0,77,585,2,4,180,174,235,343,13,1331,786
1706,13,1.1.270,1,509,0,91,270,361,53,217,361,361,0,77,585,2,5,182,150,201,343,14,1331,762
1706,13,2.2.246,0,544,3,50,246,296,246,0,296,296,-55,155,640,3,2,127,246,209,337,14,1331,762
1706,13,3.1.270,0,526,2,59,270,329,208,62,329,329,0,77,585,2,5,148,150,224,343,14,1331,762
1706,13,4.2.191,0,509,0,60,191,251,184,7,251,270,0,100,585,3,2,149,246,247,337,14,1331,762
1706,13,5.2.270,0,512,1,72,270,342,270,0,342,342,-79,179,664,3,2,156,246,235,337,14,1331,762
1706,14,1.2.361,0,518,2,18,361,379,361,0,379,379,-170,270,755,3,2,91,246,201,337,15,1331,671
1706,14,2.2.246,0,544,3,50,246,296,246,0,296,361,-55,155,640,3,2,127,246,209,337,15,1331,671
1706,14,3.1.361,1,509,0,59,361,420,208,153,420,420,0,77,585,2,6,148,59,224,343,15,1331,671
1706,14,4.2.191,0,509,0,60,191,251,184,7,251,361,0,100,585,3,2,149,246,247,337,15,1331,671
1706,14,5.2.270,0,512,1,72,270,342,270,0,342,361,-79,179,664,3,2,156,246,235,337,15,1331,671
1706,15,1.2.361,0,518,2,18,361,379,361,0,379,420,-170,270,755,3,2,91,246,201,337,16,1331,612
1706,15,2.2.246,0,544,3,50,246,296,246,0,296,420,-55,155,640,3,2,127,246,209,337,16,1331,612
1706,15,3.2.420,0,509,0,46,420,466,420,0,466,466,-229,329,814,3,2,89,246,224,337,16,1331,612
1706,15,4.2.191,1,509,0,60,191,251,184,7,251,420,0,100,585,3,2,149,246,247,337,16,1331,612
1706,15,5.2.270,0,512,1,72,270,342,270,0,342,420,-79,179,664,3,2,156,246,235,337,16,1331,612
1706,16,1.2.361,0,518,2,18,361,379,361,0,379,420,-110,210,695,3,3,91,186,201,337,17,1331,552
1706,16,2.2.251,0,509,0,50,251,301,246,5,301,420,0,100,585,3,3,127,186,209,337,17,1331,552
1706,16,3.2.420,0,509,0,46,420,466,420,0,466,466,-169,269,754,3,3,89,186,224,337,17,1331,552
1706,16,4.3.251,1,509,0,36,251,287,251,0,287,420,-34,225,619,4,2,89,174,247,200,17,1331,552
1706,16,5.2.270,0,512,1,72,270,342,270,0,342,420,-19,119,604,3,3,156,186,235,337,17,1331,552
1706,17,1.2.361,0,518,2,18,361,379,361,0,379,420,-110,210,729,3,3,91,186,201,337,18,1331,516
1706,17,2.2.251,0,509,0,50,251,301,246,5,301,420,0,100,619,3,3,127,186,209,337,18,1331,516
1706,17,3.2.420,0,509,0,46,420,466,420,0,466,466,-169,269,788,3,3,89,186,224,337,18,1331,516
1706,17,4.4.287,1,509,0,53,287,340,287,0,340,420,-19,236,638,5,2,53,192,247,243,18,1331,516
1706,17,5.2.270,0,512,1,72,270,342,270,0,342,420,-19,119,638,3,3,156,186,235,337,18,1331,516
1706,18,1.2.361,0,518,2,18,361,379,361,0,379,420,-110,210,748,3,3,91,186,201,337,19,1331,463
1706,18,2.2.251,1,509,0,50,251,301,246,5,301,420,0,100,638,3,3,127,186,209,337,19,1331,463
1706,18,3.2.420,0,509,0,46,420,466,420,0,466,466,-169,269,807,3,3,89,186,224,337,19,1331,463
1706,18,5.2.270,0,512,1,72,270,342,270,0,342,420,-19,119,657,3,3,156,186,235,337,19,1331,463
1706,19,1.2.361,0,544,1,18,361,379,361,0,379,420,-60,160,698,3,4,91,136,201,337,20,1331,413
1706,19,2.3.301,1,509,0,28,301,329,301,0,329,420,-14,239,652,4,3,77,138,209,200,20,1331,413
1706,19,3.2.420,0,509,0,46,420,466,420,0,466,466,-119,219,757,3,4,89,136,224,337,20,1331,413
1706,19,5.2.301,0,509,0,72,301,373,270,31,373,420,0,100,638,3,4,156,136,235,337,20,1331,413
1706,20,1.2.361,0,544,1,18,361,379,361,0,379,420,-60,160,712,3,4,91,136,201,337,21,1331,385
1706,20,2.4.340,1,509,0,49,340,389,329,11,389,420,0,236,652,5,3,49,139,209,243,21,1331,385
1706,20,3.2.420,0,509,0,46,420,466,420,0,466,466,-119,219,771,3,4,89,136,224,337,21,1331,385
1706,20,5.2.301,0,509,0,72,301,373,270,31,373,420,0,100,652,3,4,156,136,235,337,21,1331,385
1706,21,1.2.361,0,544,1,18,361,379,361,0,379,420,-60,160,712,3,4,91,136,201,337,22,1331,336
1706,21,3.2.420,0,509,0,46,420,466,420,0,466,466,-119,219,771,3,4,89,136,224,337,22,1331,336
1706,21,5.2.301,1,509,0,72,301,373,270,31,373,420,0,100,652,3,4,156,136,235,337,22,1331,336
1706,22,1.2.373,0,509,0,18,373,391,361,12,391,420,0,100,652,3,5,91,64,201,337,23,1331,264
1706,22,3.2.420,0,509,0,46,420,466,420,0,466,466,-47,147,699,3,5,89,64,224,337,23,1331,264
1706,22,5.3.373,1,509,0,27,373,400,373,0,400,420,-44,283,696,4,4,84,110,235,200,23,1331,264
1706,23,1.2.373,0,509,0,18,373,391,361,12,391,420,0,100,696,3,5,91,64,201,337,24,1331,237
1706,23,3.2.420,0,509,0,46,420,466,420,0,466,466,-47,147,743,3,5,89,64,224,337,24,1331,237
1706,23,5.4.400,1,509,0,57,400,457,400,0,457,457,-11,247,707,5,4,57,90,235,243,24,1331,237
1706,24,1.2.373,1,509,0,18,373,391,361,12,391,457,0,100,707,3,5,91,64,201,337,25,1331,180
1706,24,3.2.420,0,509,0,46,420,466,420,0,466,466,-47,147,754,3,5,89,64,224,337,25,1331,180
1706,25,1.3.400,1,509,0,49,400,449,391,9,449,457,0,283,707,4,5,73,83,201,200,26,1331,162
1706,25,3.2.420,0,509,0,46,420,466,420,0,466,466,-29,129,736,3,6,89,46,224,337,26,1331,162
1706,26,1.4.457,1,509,0,24,457,481,449,8,481,481,0,247,707,5,5,24,33,201,243,27,1331,113
1706,26,3.2.420,0,509,0,46,420,466,420,0,466,466,-29,129,736,3,6,89,46,224,337,27,1331,113
1706,27,3.2.420,1,509,0,46,420,466,420,0,466,481,-29,129,736,3,6,89,46,224,337,28,1331,89
1706,28,3.3.466,1,509,0,34,466,500,466,0,500,500,-17,300,753,4,6,43,34,224,200,29,1331,43
1706,29,3.4.500,1,509,0,9,500,509,500,0,509,509,-19,266,772,5,6,9,9,224,243,30,1331,9
1707,0,0.0.0,0,548,3,37,0,37,0,0,37,37,0,0,0,1,1,257,321,257,321,1,1398,1398
1707,0,1.0.0,0,570,5,94,0,94,0,0,94,94,0,0,0,1,1,301,321,301,321,1,1398,1398
1707,0,2.0.0,0,541,2,65,0,65,0,0,65,65,0,0,0,1,1,235,321,235,321,1,1398,1398
1707,0,3.0.0,1,512,0,30,0,30,0,0,30,30,0,0,0,1,1,282,321,282,321,1,1398,1398
1707,0,4.0.0,0,517,1,35,0,35,0,0,35,35,0,0,0,1,1,185,321,185,321,1,1398,1398
1707,0,5.0.0,0,559,4,60,0,60,0,0,60,60,0,0,0,1,1,138,321,138,321,1,1398,1398
1707,1,0.0.30,1,534,2,37,30,67,0,30,67,67,0,0,0,1,2,257,291,257,321,2,1398,1368
1707,1,1.0.30,0,512,0,94,30,124,0,30,124,124,0,0,0,1,2,301,291,301,321,2,1398,1368
1707,1,2.0.30,0,527,1,65,30,95,0,30,95,95,0,0,0,1,2,235,291,235,321,2,1398,1368
1707,1,3.1.30,0,512,0,97,30,127,30,0,127,127,-30,30,30,2,1,252,346,282,346,2,1398,1368
1707,1,4.0.30,0,512,0,35,30,65,0,30,65,65,0,0,0,1,2,185,291,185,321,2,1398,1368
1707,1,5.0.30,0,536,3,60,30,90,0,30,90,90,0,0,0,1,2,138,291,138,321,2,1398,1368
1707,2,0.1.67,0,578,3,90,67,157,67,0,157,157,-67,67,67,2,1,220,346,257,346,3,1398,1331
1707,2,1.0.67,0,546,2,94,67,161,0,67,161,161,0,0,0,1,3,301,254,301,321,3,1398,1331
1707,2,2.0.67,0,534,0,65,67,132,0,67,132,132,0,0,0,1,3,235,254,235,321,3,1398,1331
1707,2,3.1.30,0,534,0,97,30,127,30,0,127,127,-30,30,30,2,1,252,346,282,346,3,1398,1331
1707,2,4.0.67,1,534,0,35,67,102,0,67,102,102,0,0,0,1,3,185,254,185,321,3,1398,1331
1707,2,5.0.67,0,536,1,60,67,127,0,67,127,127,0,0,0,1,3,138,254,138,321,3,1398,1331
1707,3,0.1.67,0,592,4,90,67,157,67,0,157,157,-67,67,67,2,1,220,346,257,346,4,1398,1296
1707,3,1.0.102,0,544,2,94,102,196,0,102,196,196,0,0,0,1,4,301,219,301,321,4,1398,1296
1707,3,2.0.102,1,534,0,65,102,167,0,102,167,167,0,0,0,1,4,235,219,235,321,4,1398,1296
1707,3,3.1.30,0,534,0,97,30,127,30,0,127,127,-30,30,30,2,1,252,346,282,346,4,1398,1296
1707,3,4.1.102,0,578,3,37,102,139,102,0,139,139,-102,102,102,2,1,150,346,185,346,4,1398,1296
1707,3,5.0.102,0,539,1,60,102,162,0,102,162,162,0,0,0,1,4,138,219,138,321,4,1398,1296
1707,4,0.1.67,0,592,3,90,67,157,67,0,157,167,-67,67,67,2,1,220,346,257,346,5,1398,1231
1707,4,1.0.167,1,541,1,94,167,261,0,167,261,261,0,0,0,1,5,301,154,301,321,5,1398,1231
1707,4,2.1.167,0,534,0,55,167,222,167,0,222,222,-167,167,167,2,1,170,346,235,346,5,1398,1231
1707,4,3.1.30,0,534,0,97,30,127,30,0,127,167,-30,30,30,2,1,252,346,282,346,5,1398,1231
1707,4,4.1.102,0,578,2,37,102,139,102,0,139,167,-102,102,102,2,1,150,346,185,346,5,1398,1231
1707,4,5.0.167,0,534,0,60,167,227,0,167,227,227,0,0,0,1,5,138,154,138,321,5,1398,1231
1707,5,0.1.67,0,593,3,90,67,157,67,0,157,261,-67,67,67,2,1,220,346,257,346,6,1398,1137
1707,5,1.1.261,0,548,1,60,261,321,261,0,321,321,-261,261,261,2,1,207,346,301,346,6,1398,1137
1707,5,2.1.167,0,541,0,55,167,222,167,0,222,261,-167,167,167,2,1,170,346,235,346,6,1398,1137
1707,5,3.1.30,0,541,0,97,30,127,30,0,127,261,-30,30,30,2,1,252,346,282,346,6,1398,1137
1707,5,4.1.102,0,578,2,37,102,139,102,0,139,261,-102,102,102,2,1,150,346,185,346,6,1398,1137
1707,5,5.0.261,1,541,0,60,261,321,0,261,321,321,0,0,0,1,6,138,60,138,321,6,1398,1137
1707,6,0.1.67,0,593,3,90,67,157,67,0,157,321,-67,67,67,2,1,220,346,257,346,7,1398,1077
1707,6,1.1.261,0,548,1,60,261,321,261,0,321,321,-261,261,261,2,1,207,346,301,346,7,1398,1077
1707,6,2.1.167,0,541,0,55,167,222,167,0,222,321,-167,167,167,2,1,170,346,235,346,7,1398,1077
1707,6,3.1.30,1,541,0,97,30,127,30,0,127,321,-30,30,30,2,1,252,346,282,346,7,1398,1077
1707,6,4.1.102,0,578,2,37,102,139,102,0,139,321,-102,102,102,2,1,150,346,185,346,7,1398,1077
1707,6,5.1.321,0,541,0,7,321,328,321,0,328,328,-321,321,321,2,1,78,346,138,346,7,1398,1077
1707,7,0.1.127,0,541,0,90,127,217,67,60,217,321,0,30,30,2,2,220,249,257,346,8,1398,980
1707,7,1.1.261,0,548,1,60,261,321,261,0,321,321,-134,164,164,2,2,207,249,301,346,8,1398,980
1707,7,2.1.167,0,541,0,55,167,222,167,0,222,321,-40,70,70,2,2,170,249,235,346,8,1398,980
1707,7,3.2.127,1,541,0,13,127,140,127,0,140,321,-127,127,157,3,1,155,206,282,206,8,1398,980
1707,7,4.1.127,0,541,0,37,127,164,102,25,164,321,0,30,30,2,2,150,249,185,346,8,1398,980
1707,7,5.1.321,0,541,0,7,321,328,321,0,328,328,-194,224,224,2,2,78,249,138,346,8,1398,980
1707,8,0.1.127,0,541,0,90,127,217,67,60,217,321,0,30,157,2,2,220,249,257,346,9,1398,967
1707,8,1.1.261,0,548,1,60,261,321,261,0,321,321,-134,164,291,2,2,207,249,301,346,9,1398,967
1707,8,2.1.167,0,541,0,55,167,222,167,0,222,321,-40,70,197,2,2,170,249,235,346,9,1398,967
1707,8,3.3.140,1,541,0,92,140,232,140,0,232,321,-140,140,297,4,1,142,352,282,352,9,1398,967
1707,8,4.1.127,0,541,0,37,127,164,102,25,164,321,0,30,157,2,2,150,249,185,346,9,1398,967
1707,8,5.1.321,0,541,0,7,321,328,321,0,328,328,-194,224,351,2,2,78,249,138,346,9,1398,967
1707,9,0.1.127,0,541,0,90,127,217,67,60,217,321,0,30,297,2,2,220,249,257,346,10,1398,875
1707,9,1.1.261,0,548,1,60,261,321,261,0,321,321,-134,164,431,2,2,207,249,301,346,10,1398,875
1707,9,2.1.167,0,541,0,55,167,222,167,0,222,321,-40,70,337,2,2,170,249,235,346,10,1398,875
1707,9,3.4.232,1,541,0,50,232,282,232,0,282,321,-232,232,529,5,1,50,173,282,173,10,1398,875
1707,9,4.1.127,0,541,0,37,127,164,102,25,164,321,0,30,297,2,2,150,249,185,346,10,1398,875
1707,9,5.1.321,0,541,0,7,321,328,321,0,328,328,-194,224,491,2,2,78,249,138,346,10,1398,875
1707,10,0.1.127,0,541,0,90,127,217,67,60,217,321,0,30,529,2,2,220,249,257,346,11,1398,825
1707,10,1.1.261,0,548,1,60,261,321,261,0,321,321,-134,164,663,2,2,207,249,301,346,11,1398,825
1707,10,2.1.167,0,541,0,55,167,222,167,0,222,321,-40,70,569,2,2,170,249,235,346,11,1398,825
1707,10,4.1.127,1,541,0,37,127,164,102,25,164,321,0,30,529,2,2,150,249,185,346,11,1398,825
1707,10,5.1.321,0,541,0,7,321,328,321,0,328,328,-194,224,723,2,2,78,249,138,346,11,1398,825
1707,11,0.1.164,0,549,2,90,164,254,67,97,254,321,0,30,529,2,3,220,212,257,346,12,1398,788
1707,11,1.1.261,0,548,1,60,261,321,261,0,321,321,-97,127,626,2,3,207,212,301,346,12,1398,788
1707,11,2.1.167,0,541,0,55,167,222,167,0,222,321,-3,33,532,2,3,170,212,235,346,12,1398,788
1707,11,4.2.164,1,541,0,61,164,225,164,0,225,321,-24,151,553,3,2,113,193,185,206,12,1398,788
1707,11,5.1.321,0,541,0,7,321,328,321,0,328,328,-157,187,686,2,3,78,212,138,346,12,1398,788
1707,12,0.1.164,0,549,2,90,164,254,67,97,254,321,0,30,553,2,3,220,212,257,346,13,1398,727
1707,12,1.1.261,0,548,1,60,261,321,261,0,321,321,-97,127,650,2,3,207,212,301,346,13,1398,727
1707,12,2.1.167,0,541,0,55,167,222,167,0,222,321,-3,33,556,2,3,170,212,235,346,13,1398,727
1707,12,4.3.232,1,541,0,29,232,261,225,7,261,321,0,140,553,4,2,52,260,185,352,13,1398,727
1707,12,5.1.321,0,541,0,7,321,328,321,0,328,328,-157,187,710,2,3,78,212,138,346,13,1398,727
1707,13,0.1.164,0,549,2,90,164,254,67,97,254,321,0,30,553,2,3,220,212,257,346,14,1398,698
1707,13,1.1.261,0,548,1,60,261,321,261,0,321,321,-97,127,650,2,3,207,212,301,346,14,1398,698
1707,13,2.1.167,0,541,0,55,167,222,167,0,222,321,-3,33,556,2,3,170,212,235,346,14,1398,698
1707,13,4.4.282,1,541,0,23,282,305,261,21,305,321,0,232,553,5,2,23,123,185,173,14,1398,698
1707,13,5.1.321,0,541,0,7,321,328,321,0,328,328,-157,187,710,2,3,78,212,138,346,14,1398,698
1707,14,0.1.164,1,549,2,90,164,254,67,97,254,321,0,30,553,2,3,220,212,257,346,15,1398,675
1707,14,1.1.261,0,548,1,60,261,321,261,0,321,321,-97,127,650,2,3,207,212,301,346,15,1398,675
1707,14,2.1.167,0,541,0,55,167,222,167,0,222,321,-3,33,556,2,3,170,212,235,346,15,1398,675
1707,14,5.1.321,0,541,0,7,321,328,321,0,328,328,-157,187,710,2,3,78,212,138,346,15,1398,675
1707,15,0.2.254,0,588,2,94,254,348,254,0,348,348,-29,180,582,3,3,130,132,257,206,16,1398,585
1707,15,1.1.261,0,579,1,60,261,321,261,0,321,321,-7,37,560,2,4,207,122,301,346,16,1398,585
1707,15,2.1.254,1,549,0,55,254,309,167,87,309,321,0,30,553,2,4,170,122,235,346,16,1398,585
1707,15,5.1.321,0,549,0,7,321,328,321,0,328,328,-67,97,620,2,4,78,122,138,346,16,1398,585
1707,16,0.2.254,0,588,1,94,254,348,254,0,348,348,-29,180,582,3,3,130,132,257,206,17,1398,530
1707,16,1.1.309,0,549,0,60,309,369,261,48,369,369,0,30,553,2,5,207,67,301,346,17,1398,530
1707,16,2.2.309,1,549,0,4,309,313,309,0,313,321,-84,235,637,3,3,115,132,235,206,17,1398,530
1707,16,5.1.321,0,549,0,7,321,328,321,0,328,328,-12,42,565,2,5,78,67,138,346,17,1398,530
1707,17,0.2.313,0,569,1,94,313,407,254,59,407,407,0,235,637,3,4,130,128,257,206,18,1398,526
1707,17,1.1.309,1,549,0,60,309,369,261,48,369,369,0,30,637,2,5,207,67,301,346,18,1398,526
1707,17,2.3.313,0,549,0,96,313,409,313,0,409,409,-52,192,689,4,3,111,231,235,352,18,1398,526
1707,17,5.1.321,0,549,0,7,321,328,321,0,328,328,-12,42,649,2,5,78,67,138,346,18,1398,526
1707,18,0.2.313,0,569,1,94,313,407,254,59,407,407,0,235,637,3,4,130,128,257,206,19,1398,466
1707,18,1.2.369,0,549,0,23,369,392,369,0,392,392,-56,291,693,3,4,147,128,301,206,19,1398,466
1707,18,2.3.313,0,549,0,96,313,409,313,0,409,409,-52,192,689,4,3,111,231,235,352,19,1398,466
1707,18,5.1.369,1,549,0,7,369,376,321,48,376,376,0,30,637,2,6,78,7,138,346,19,1398,466
1707,19,0.2.313,0,569,1,94,313,407,254,59,407,407,0,235,637,3,4,130,128,257,206,20,1398,459
1707,19,1.2.369,1,549,0,23,369,392,369,0,392,392,-56,291,693,3,4,147,128,301,206,20,1398,459
1707,19,2.3.313,0,549,0,96,313,409,313,0,409,409,-52,192,689,4,3,111,231,235,352,20,1398,459
1707,19,5.2.376,0,549,0,11,376,387,376,0,387,387,-63,298,700,3,4,71,128,138,206,20,1398,459
1707,20,0.2.392,0,585,1,94,392,486,254,138,486,486,0,291,693,3,5,130,105,257,206,21,1398,436
1707,20,1.3.392,0,627,2,91,392,483,392,0,483,483,-131,271,824,4,3,124,231,301,352,21,1398,436
1707,20,2.3.313,0,549,0,96,313,409,313,0,409,409,-52,192,745,4,3,111,231,235,352,21,1398,436
1707,20,5.2.392,1,549,0,11,392,403,376,16,403,403,0,291,693,3,5,71,105,138,206,21,1398,436
1707,21,0.2.403,1,549,0,94,403,497,254,149,497,497,0,291,693,3,6,130,94,257,206,22,1398,425
1707,21,1.3.392,0,627,1,91,392,483,392,0,483,483,-131,271,824,4,3,124,231,301,352,22,1398,425
1707,21,2.3.313,0,549,0,96,313,409,313,0,409,409,-52,192,745,4,3,111,231,235,352,22,1398,425
1707,21,5.3.403,0,638,2,12,403,415,403,0,415,415,-142,282,835,4,3,60,231,138,352,22,1398,425
1707,22,0.3.497,0,640,3,32,497,529,497,0,529,529,-236,376,929,4,3,36,231,257,352,23,1398,331
1707,22,1.3.392,0,627,1,91,392,483,392,0,483,497,-131,271,824,4,3,124,231,301,352,23,1398,331
1707,22,2.3.313,1,549,0,96,313,409,313,0,409,497,-52,192,745,4,3,111,231,235,352,23,1398,331
1707,22,5.3.403,0,638,2,12,403,415,403,0,415,497,-142,282,835,4,3,60,231,138,352,23,1398,331
1707,23,0.3.497,0,653,2,32,497,529,497,0,529,529,-88,280,833,4,4,36,135,257,352,24,1398,235
1707,23,1.3.409,0,585,1,91,409,500,392,17,500,500,0,192,745,4,4,124,135,301,352,24,1398,235
1707,23,2.4.409,1,549,0,15,409,424,409,0,424,497,-104,336,849,5,3,15,100,235,173,24,1398,235
1707,23,5.3.409,0,549,0,12,409,421,403,6,421,497,0,192,745,4,4,60,135,138,352,24,1398,235
1707,24,0.3.497,0,653,2,32,497,529,497,0,529,529,-88,280,937,4,4,36,135,257,352,25,1398,220
1707,24,1.3.409,0,585,1,91,409,500,392,17,500,500,0,192,849,4,4,124,135,301,352,25,1398,220
1707,24,5.3.409,1,549,0,12,409,421,403,6,421,497,0,192,849,4,4,60,135,138,352,25,1398,220
1707,25,0.3.497,0,653,1,32,497,529,497,0,529,529,-76,268,925,4,5,36,123,257,352,26,1398,208
1707,25,1.3.421,0,549,0,91,421,512,392,29,512,512,0,192,849,4,5,124,123,301,352,26,1398,208
1707,25,5.4.424,1,549,0,48,424,472,421,3,472,497,0,336,849,5,4,48,85,138,173,26,1398,208
1707,26,0.3.497,0,653,1,32,497,529,497,0,529,529,-76,268,925,4,5,36,123,257,352,27,1398,160
1707,26,1.3.421,1,549,0,91,421,512,392,29,512,512,0,192,849,4,5,124,123,301,352,27,1398,160
1707,27,0.3.512,0,549,0,32,512,544,497,15,544,544,0,192,849,4,6,36,32,257,352,28,1398,69
1707,27,1.4.512,1,549,0,33,512,545,512,0,545,545,-40,376,889,5,5,33,37,301,173,28,1398,69
1707,28,0.3.512,1,549,0,32,512,544,497,15,544,545,0,192,889,4,6,36,32,257,352,29,1398,36
1707,29,0.4.545,1,549,0,4,545,549,544,1,549,549,0,376,889,5,6,4,4,257,173,30,1398,4
1708,0,0.0.0,0,633,3,50,0,50,0,0,50,50,0,0,0,1,1,302,336,302,336,1,1766,1766
1708,0,1.0.0,0,628,1,70,0,70,0,0,70,70,0,0,0,1,1,202,336,202,336,1,1766,1766
1708,0,2.0.0,1,589,0,12,0,12,0,0,12,12,0,0,0,1,1,262,336,262,336,1,1766,1766
1708,0,3.0.0,0,651,5,83,0,83,0,0,83,83,0,0,0,1,1,341,336,341,336,1,1766,1766
1708,0,4.0.0,0,630,2,57,0,57,0,0,57,57,0,0,0,1,1,321,336,321,336,1,1766,1766
1708,0,5.0.0,0,647,4,64,0,64,0,0,64,64,0,0,0,1,1,338,336,338,336,1,1766,1766
1708,1,0.0.12,0,590,1,50,12,62,0,12,62,62,0,0,0,1,2,302,324,302,336,2,1766,1754
1708,1,1.0.12,0,617,3,70,12,82,0,12,82,82,0,0,0,1,2,202,324,202,336,2,1766,1754
1708,1,2.1.12,1,589,0,49,12,61,12,0,61,61,-12,12,12,2,1,250,350,262,350,2,1766,1754
1708,1,3.0.12,0,609,2,83,12,95,0,12,95,95,0,0,0,1,2,341,324,341,336,2,1766,1754
1708,1,4.0.12,0,589,0,57,12,69,0,12,69,69,0,0,0,1,2,321,324,321,336,2,1766,1754
1708,1,5.0.12,0,632,4,64,12,76,0,12,76,76,0,0,0,1,2,338,324,338,336,2,1766,1754
1708,2,0.0.12,0,590,1,50,12,62,0,12,62,62,0,0,12,1,2,302,324,302,336,3,1766,1705
1708,2,1.0.12,0,617,3,70,12,82,0,12,82,82,0,0,12,1,2,202,324,202,336,3,1766,1705
1708,2,2.2.61,1,589,0,56,61,117,61,0,117,117,-61,61,73,3,1,201,373,262,373,3,1766,1705
1708,2,3.0.12,0,609,2,83,12,95,0,12,95,95,0,0,12,1,2,341,324,341,336,3,1766,1705
1708,2,4.0.12,0,589,0,57,12,69,0,12,69,69,0,0,12,1,2,321,324,321,336,3,1766,1705
1708,2,5.0.12,0,632,4,64,12,76,0,12,76,76,0,0,12,1,2,338,324,338,336,3,1766,1705
1708,3,0.0.12,0,590,1,50,12,62,0,12,62,117,0,0,73,1,2,302,324,302,336,4,1766,1649
1708,3,1.0.12,0,617,3,70,12,82,0,12,82,117,0,0,73,1,2,202,324,202,336,4,1766,1649
1708,3,2.3.117,1,589,0,65,117,182,117,0,182,182,-117,117,190,4,1,145,306,262,306,4,1766,1649
1708,3,3.0.12,0,609,2,83,12,95,0,12,95,117,0,0,73,1,2,341,324,341,336,4,1766,1649
1708,3,4.0.12,0,589,0,57,12,69,0,12,69,117,0,0,73,1,2,321,324,321,336,4,1766,1649
1708,3,5.0.12,0,632,4,64,12,76,0,12,76,117,0,0,73,1,2,338,324,338,336,4,1766,1649
1708,4,0.0.12,0,590,1,50,12,62,0,12,62,182,0,0,190,1,2,302,324,302,336,5,1766,1584
1708,4,1.0.12,0,617,3,70,12,82,0,12,82,182,0,0,190,1,2,202,324,202,336,5,1766,1584
1708,4,2.4.182,1,589,0,80,182,262,182,0,262,262,-182,182,372,5,1,80,401,262,401,5,1766,1584
1708,4,3.0.12,0,609,2,83,12,95,0,12,95,182,0,0,190,1,2,341,324,341,336,5,1766,1584
1708,4,4.0.12,0,589,0,57,12,69,0,12,69,182,0,0,190,1,2,321,324,321,336,5,1766,1584
1708,4,5.0.12,0,632,4,64,12,76,0,12,76,182,0,0,190,1,2,338,324,338,336,5,1766,1584
1708,5,0.0.12,0,590,1,50,12,62,0,12,62,262,0,0,372,1,2,302,324,302,336,6,1766,1504
1708,5,1.0.12,0,617,3,70,12,82,0,12,82,262,0,0,372,1,2,202,324,202,336,6,1766,1504
1708,5,3.0.12,0,609,2,83,12,95,0,12,95,262,0,0,372,1,2,341,324,341,336,6,1766,1504
1708,5,4.0.12,1,589,0,57,12,69,0,12,69,262,0,0,372,1,2,321,324,321,336,6,1766,1504
1708,5,5.0.12,0,632,4,64,12,76,0,12,76,262,0,0,372,1,2,338,324,338,336,6,1766,1504
1708,6,0.0.69,0,611,1,50,69,119,0,69,119,262,0,0,372,1,3,302,267,302,336,7,1766,1447
1708,6,1.0.69,0,612,2,70,69,139,0,69,139,262,0,0,372,1,3,202,267,202,336,7,1766,1447
1708,6,3.0.69,0,589,0,83,69,152,0,69,152,262,0,0,372,1,3,341,267,341,336,7,1766,1447
1708,6,4.1.69,0,589,0,88,69,157,69,0,157,262,-8,20,380,2,2,264,301,321,350,7,1766,1447
1708,6,5.0.69,1,623,3,64,69,133,0,69,133,262,0,0,372,1,3,338,267,338,336,7,1766,1447
1708,7,0.0.133,1,633,1,50,133,183,0,133,183,262,0,0,372,1,4,302,203,302,336,8,1766,1383
1708,7,1.0.133,0,623,0,70,133,203,0,133,203,262,0,0,372,1,4,202,203,202,336,8,1766,1383
1708,7,3.0.133,0,623,0,83,133,216,0,133,216,262,0,0,372,1,4,341,203,341,336,8,1766,1383
1708,7,4.1.69,0,623,0,88,69,157,69,0,157,262,-8,20,380,2,2,264,301,321,350,8,1766,1383
1708,7,5.1.133,0,689,2,90,133,223,133,0,223,262,-72,84,444,2,2,274,301,338,350,8,1766,1383
1708,8,0.1.183,0,644,1,59,183,242,183,0,242,262,-122,134,494,2,2,252,301,302,350,9,1766,1333
1708,8,1.0.183,0,646,2,70,183,253,0,183,253,262,0,0,372,1,5,202,153,202,336,9,1766,1333
1708,8,3.0.183,1,633,0,83,183,266,0,183,266,266,0,0,372,1,5,341,153,341,336,9,1766,1333
1708,8,4.1.69,0,633,0,88,69,157,69,0,157,262,-8,20,380,2,2,264,301,321,350,9,1766,1333
1708,8,5.1.133,0,689,3,90,133,223,133,0,223,262,-72,84,444,2,2,274,301,338,350,9,1766,1333
1708,9,0.1.183,0,644,1,59,183,242,183,0,242,266,-122,134,494,2,2,252,301,302,350,10,1766,1250
1708,9,1.0.266,1,633,0,70,266,336,0,266,336,336,0,0,372,1,6,202,70,202,336,10,1766,1250
1708,9,3.1.266,0,633,0,36,266,302,266,0,302,302,-205,217,577,2,2,258,301,341,350,10,1766,1250
1708,9,4.1.69,0,633,0,88,69,157,69,0,157,266,-8,20,380,2,2,264,301,321,350,10,1766,1250
1708,9,5.1.133,0,689,2,90,133,223,133,0,223,266,-72,84,444,2,2,274,301,338,350,10,1766,1250
1708,10,0.1.183,0,644,1,59,183,242,183,0,242,336,-122,134,494,2,2,252,301,302,350,11,1766,1180
1708,10,1.1.336,0,633,0,28,336,364,336,0,364,364,-275,287,647,2,2,132,301,202,350,11,1766,1180
1708,10,3.1.266,0,633,0,36,266,302,266,0,302,336,-205,217,577,2,2,258,301,341,350,11,1766,1180
1708,10,4.1.69,1,633,0,88,69,157,69,0,157,336,-8,20,380,2,2,264,301,321,350,11,1766,1180
1708,10,5.1.133,0,689,2,90,133,223,133,0,223,336,-72,84,444,2,2,274,301,338,350,11,1766,1180
1708,11,0.1.183,0,644,1,59,183,242,183,0,242,336,-26,46,406,2,3,252,213,302,350,12,1766,1092
1708,11,1.1.336,0,633,0,28,336,364,336,0,364,364,-179,199,559,2,3,132,213,202,350,12,1766,1092
1708,11,3.1.266,0,633,0,36,266,302,266,0,302,336,-109,129,489,2,3,258,213,341,350,12,1766,1092
1708,11,4.2.157,0,633,0,62,157,219,157,0,219,336,-40,101,420,3,2,176,317,321,373,12,1766,1092
1708,11,5.1.157,1,633,0,90,157,247,133,24,247,336,0,20,380,2,3,274,213,338,350,12,1766,1092
1708,12,0.1.247,1,654,1,59,247,306,183,64,306,336,0,20,380,2,4,252,123,302,350,13,1766,1002
1708,12,1.1.336,0,633,0,28,336,364,336,0,364,364,-89,109,469,2,4,132,123,202,350,13,1766,1002
1708,12,3.1.266,0,633,0,36,266,302,266,0,302,336,-19,39,399,2,4,258,123,341,350,13,1766,1002
1708,12,4.2.157,0,633,0,62,157,219,157,0,219,336,-40,101,420,3,2,176,317,321,373,13,1766,1002
1708,12,5.2.247,0,633,0,49,247,296,247,0,296,336,-130,191,510,3,2,184,317,338,373,13,1766,1002
1708,13,0.2.306,0,654,0,98,306,404,306,0,404,404,-189,250,569,3,2,193,317,302,373,14,1766,943
1708,13,1.1.336,0,654,0,28,336,364,336,0,364,364,-30,50,410,2,5,132,64,202,350,14,1766,943
1708,13,3.1.306,1,654,0,36,306,342,266,40,342,342,0,20,380,2,5,258,64,341,350,14,1766,943
1708,13,4.2.157,0,654,0,62,157,219,157,0,219,336,-40,101,420,3,2,176,317,321,373,14,1766,943
1708,13,5.2.247,0,654,0,49,247,296,247,0,296,336,-130,191,510,3,2,184,317,338,373,14,1766,943
1708,14,0.2.306,0,654,0,98,306,404,306,0,404,404,-189,250,569,3,2,193,317,302,373,15,1766,907
1708,14,1.1.342,1,654,0,28,342,370,336,6,370,370,0,20,380,2,6,132,28,202,350,15,1766,907
1708,14,3.2.342,0,663,1,80,342,422,342,0,422,422,-225,286,605,3,2,222,317,341,373,15,1766,907
1708,14,4.2.157,0,654,0,62,157,219,157,0,219,342,-40,101,420,3,2,176,317,321,373,15,1766,907
1708,14,5.2.247,0,654,0,49,247,296,247,0,296,342,-130,191,510,3,2,184,317,338,373,15,1766,907
1708,15,0.2.306,0,654,0,98,306,404,306,0,404,404,-189,250,569,3,2,193,317,302,373,16,1766,879
1708,15,1.2.370,0,676,2,28,370,398,370,0,398,398,-253,314,633,3,2,104,317,202,373,16,1766,879
1708,15,3.2.342,0,663,1,80,342,422,342,0,422,422,-225,286,605,3,2,222,317,341,373,16,1766,879
1708,15,4.2.157,1,654,0,62,157,219,157,0,219,370,-40,101,420,3,2,176,317,321,373,16,1766,879
1708,15,5.2.247,0,654,0,49,247,296,247,0,296,370,-130,191,510,3,2,184,317,338,373,16,1766,879
1708,16,0.2.306,0,654,0,98,306,404,306,0,404,404,-87,188,507,3,3,193,255,302,373,17,1766,817
1708,16,1.2.370,0,676,2,28,370,398,370,0,398,398,-151,252,571,3,3,104,255,202,373,17,1766,817
1708,16,3.2.342,0,663,1,80,342,422,342,0,422,422,-123,224,543,3,3,222,255,341,373,17,1766,817
1708,16,4.3.219,1,654,0,22,219,241,219,0,241,370,-37,154,457,4,2,114,241,321,306,17,1766,817
1708,16,5.2.247,0,654,0,49,247,296,247,0,296,370,-28,129,448,3,3,184,255,338,373,17,1766,817
1708,17,0.2.306,0,654,0,98,306,404,306,0,404,404,-87,188,544,3,3,193,255,302,373,18,1766,795
1708,17,1.2.370,0,676,2,28,370,398,370,0,398,398,-151,252,608,3,3,104,255,202,373,18,1766,795
1708,17,3.2.342,0,663,1,80,342,422,342,0,422,422,-123,224,580,3,3,222,255,341,373,18,1766,795
1708,17,4.4.262,1,654,0,92,262,354,241,21,354,370,0,182,457,5,2,92,321,321,401,18,1766,795
1708,17,5.2.247,0,654,0,49,247,296,247,0,296,370,-28,129,485,3,3,184,255,338,373,18,1766,795
1708,18,0.2.306,0,654,0,98,306,404,306,0,404,404,-87,188,544,3,3,193,255,302,373,19,1766,703
1708,18,1.2.370,0,676,2,28,370,398,370,0,398,398,-151,252,608,3,3,104,255,202,373,19,1766,703
1708,18,3.2.342,0,663,1,80,342,422,342,0,422,422,-123,224,580,3,3,222,255,341,373,19,1766,703
1708,18,5.2.247,1,654,0,49,247,296,247,0,296,370,-28,129,485,3,3,184,255,338,373,19,1766,703
1708,19,0.2.306,0,654,0,98,306,404,306,0,404,404,-10,139,495,3,4,193,206,302,373,20,1766,654
1708,19,1.2.370,0,676,2,28,370,398,370,0,398,398,-74,203,559,3,4,104,206,202,373,20,1766,654
1708,19,3.2.342,0,663,1,80,342,422,342,0,422,422,-46,175,531,3,4,222,206,341,373,20,1766,654
1708,19,5.3.296,1,654,0,96,296,392,296,0,392,392,-55,209,540,4,3,135,219,338,306,20,1766,654
1708,20,0.2.306,0,654,0,98,306,404,306,0,404,404,-10,139,550,3,4,193,206,302,373,21,1766,558
1708,20,1.2.370,0,676,2,28,370,398,370,0,398,398,-74,203,614,3,4,104,206,202,373,21,1766,558
1708,20,3.2.342,0,663,1,80,342,422,342,0,422,422,-46,175,586,3,4,222,206,341,373,21,1766,558
1708,20,5.4.392,1,654,0,39,392,431,392,0,431,431,-38,220,578,5,3,39,229,338,401,21,1766,558
1708,21,0.2.306,0,654,0,98,306,404,306,0,404,431,-10,139,588,3,4,193,206,302,373,22,1766,519
1708,21,1.2.370,0,676,2,28,370,398,370,0,398,431,-74,203,652,3,4,104,206,202,373,22,1766,519
1708,21,3.2.342,1,663,1,80,342,422,342,0,422,431,-46,175,624,3,4,222,206,341,373,22,1766,519
1708,22,0.2.422,0,663,0,98,422,520,306,116,520,520,0,175,624,3,5,193,126,302,373,23,1766,439
1708,22,1.2.422,0,663,0,28,422,450,370,52,450,450,0,175,624,3,5,104,126,202,373,23,1766,439
1708,22,3.3.422,1,663,0,51,422,473,422,0,473,473,-30,239,654,4,4,142,123,341,306,23,1766,439
1708,23,0.2.422,0,663,0,98,422,520,306,116,520,520,0,175,654,3,5,193,126,302,373,24,1766,388
1708,23,1.2.422,1,663,0,28,422,450,370,52,450,473,0,175,654,3,5,104,126,202,373,24,1766,388
1708,23,3.4.473,0,663,0,91,473,564,473,0,564,564,-42,262,696,5,4,91,190,341,401,24,1766,388
1708,24,0.2.450,0,663,0,98,450,548,306,144,548,548,0,175,654,3,6,193,98,302,373,25,1766,360
1708,24,1.3.473,1,663,0,33,473,506,450,23,506,506,0,239,654,4,5,76,72,202,306,25,1766,360
1708,24,3.4.473,0,663,0,91,473,564,473,0,564,564,-42,262,696,5,4,91,190,341,401,25,1766,360
1708,25,0.2.450,1,663,0,98,450,548,306,144,548,548,0,175,654,3,6,193,98,302,373,26,1766,327
1708,25,1.4.506,0,696,1,43,506,549,506,0,549,549,-75,295,729,5,4,43,190,202,401,26,1766,327
1708,25,3.4.473,0,663,0,91,473,564,473,0,564,564,-42,262,696,5,4,91,190,341,401,26,1766,327
1708,26,0.3.548,1,663,0,39,548,587,548,0,587,587,-42,281,696,4,6,95,39,302,306,27,1766,229
1708,26,1.4.506,0,696,1,43,506,549,506,0,549,549,-75,295,729,5,4,43,190,202,401,27,1766,229
1708,26,3.4.473,0,663,0,91,473,564,473,0,564,564,-42,262,696,5,4,91,190,341,401,27,1766,229
1708,27,0.4.587,0,686,1,56,587,643,587,0,643,643,-156,376,852,5,4,56,190,302,401,28,1766,190
1708,27,1.4.506,0,696,2,43,506,549,506,0,549,587,-75,295,771,5,4,43,190,202,401,28,1766,190
1708,27,3.4.473,1,663,0,91,473,564,473,0,564,587,-42,262,738,5,4,91,190,341,401,28,1766,190
1708,28,0.4.587,0,686,1,56,587,643,587,0,643,643,-23,285,761,5,5,56,99,302,401,29,1766,99
1708,28,1.4.564,1,663,0,43,564,607,506,58,607,607,0,262,738,5,5,43,99,202,401,29,1766,99
1708,29,0.4.607,1,663,0,56,607,663,587,20,663,663,0,262,738,5,6,56,56,302,401,30,1766,56
1709,0,0.0.0,0,595,5,63,0,63,0,0,63,63,0,0,0,1,1,146,350,146,350,1,1438,1438
1709,0,1.0.0,1,541,0,46,0,46,0,0,46,46,0,0,0,1,1,301,350,301,350,1,1438,1438
1709,0,2.0.0,0,555,3,57,0,57,0,0,57,57,0,0,0,1,1,189,350,189,350,1,1438,1438
1709,0,3.0.0,0,551,2,36,0,36,0,0,36,36,0,0,0,1,1,202,350,202,350,1,1438,1438
1709,0,4.0.0,0,577,4,79,0,79,0,0,79,79,0,0,0,1,1,260,350,260,350,1,1438,1438
1709,0,5.0.0,0,544,1,69,0,69,0,0,69,69,0,0,0,1,1,340,350,340,350,1,1438,1438
1709,1,0.0.46,0,577,4,63,46,109,0,46,109,109,0,0,0,1,2,146,304,146,350,2,1438,1392
1709,1,1.1.46,0,541,0,95,46,141,46,0,141,141,-46,46,46,2,1,255,353,301,353,2,1438,1392
1709,1,2.0.46,0,561,3,57,46,103,0,46,103,103,0,0,0,1,2,189,304,189,350,2,1438,1392
1709,1,3.0.46,0,559,2,36,46,82,0,46,82,82,0,0,0,1,2,202,304,202,350,2,1438,1392
1709,1,4.0.46,0,551,1,79,46,125,0,46,125,125,0,0,0,1,2,260,304,260,350,2,1438,1392
1709,1,5.0.46,1,541,0,69,46,115,0,46,115,115,0,0,0,1,2,340,304,340,350,2,1438,1392
1709,2,0.0.115,0,559,1,63,115,178,0,115,178,178,0,0,0,1,3,146,235,146,350,3,1438,1323
1709,2,1.1.46,0,541,0,95,46,141,46,0,141,141,-46,46,46,2,1,255,353,301,353,3,1438,1323
1709,2,2.0.115,0,541,0,57,115,172,0,115,172,172,0,0,0,1,3,189,235,189,350,3,1438,1323
1709,2,3.0.115,1,559,1,36,115,151,0,115,151,151,0,0,0,1,3,202,235,202,350,3,1438,1323
1709,2,4.0.115,0,541,0,79,115,194,0,115,194,194,0,0,0,1,3,260,235,260,350,3,1438,1323
1709,2,5.1.115,0,590,2,73,115,188,115,0,188,188,-115,115,115,2,1,271,353,340,353,3,1438,1323
1709,3,0.0.151,0,564,1,63,151,214,0,151,214,214,0,0,0,1,4,146,199,146,350,4,1438,1287
1709,3,1.1.46,0,559,0,95,46,141,46,0,141,151,-46,46,46,2,1,255,353,301,353,4,1438,1287
1709,3,2.0.151,0,559,0,57,151,208,0,151,208,208,0,0,0,1,4,189,199,189,350,4,1438,1287
1709,3,3.1.151,0,599,2,74,151,225,151,0,225,225,-151,151,151,2,1,166,353,202,353,4,1438,1287
1709,3,4.0.151,1,564,1,79,151,230,0,151,230,230,0,0,0,1,4,260,199,260,350,4,1438,1287
1709,3,5.1.115,0,605,3,73,115,188,115,0,188,188,-115,115,115,2,1,271,353,340,353,4,1438,1287
1709,4,0.0.230,0,564,0,63,230,293,0,230,293,293,0,0,0,1,5,146,120,146,350,5,1438,1208
1709,4,1.1.46,0,564,0,95,46,141,46,0,141,230,-46,46,46,2,1,255,353,301,353,5,1438,1208
1709,4,2.0.230,1,564,0,57,230,287,0,230,287,287,0,0,0,1,5,189,120,189,350,5,1438,1208
1709,4,3.1.151,0,599,1,74,151,225,151,0,225,230,-151,151,151,2,1,166,353,202,353,5,1438,1208
1709,4,4.1.230,0,564,0,41,230,271,230,0,271,271,-230,230,230,2,1,181,353,260,353,5,1438,1208
1709,4,5.1.115,0,605,2,73,115,188,115,0,188,230,-115,115,115,2,1,271,353,340,353,5,1438,1208
1709,5,0.0.287,1,564,0,63,287,350,0,287,350,350,0,0,0,1,6,146,63,146,350,6,1438,1151
1709,5,1.1.46,0,564,0,95,46,141,46,0,141,287,-46,46,46,2,1,255,353,301,353,6,1438,1151
1709,5,2.1.287,0,564,0,43,287,330,287,0,330,330,-287,287,287,2,1,132,353,189,353,6,1438,1151
1709,5,3.1.151,0,599,1,74,151,225,151,0,225,287,-151,151,151,2,1,166,353,202,353,6,1438,1151
1709,5,4.1.230,0,564,0,41,230,271,230,0,271,287,-230,230,230,2,1,181,353,260,353,6,1438,1151
1709,5,5.1.115,0,605,2,73,115,188,115,0,188,287,-115,115,115,2,1,271,353,340,353,6,1438,1151
1709,6,0.1.350,0,564,0,27,350,377,350,0,377,377,-350,350,350,2,1,83,353,146,353,7,1438,1088
1709,6,1.1.46,1,564,0,95,46,141,46,0,141,350,-46,46,46,2,1,255,353,301,353,7,1438,1088
1709,6,2.1.287,0,564,0,43,287,330,287,0,330,350,-287,287,287,2,1,132,353,189,353,7,1438,1088
1709,6,3.1.151,0,599,1,74,151,225,151,0,225,350,-151,151,151,2,1,166,353,202,353,7,1438,1088
1709,6,4.1.230,0,564,0,41,230,271,230,0,271,350,-230,230,230,2,1,181,353,260,353,7,1438,1088
1709,6,5.1.115,0,605,2,73,115,188,115,0,188,350,-115,115,115,2,1,271,353,340,353,7,1438,1088
1709,7,0.1.350,0,564,0,27,350,377,350,0,377,377,-209,255,255,2,2,83,258,146,353,8,1438,993
1709,7,1.2.141,1,564,0,34,141,175,141,0,175,350,-141,141,187,3,1,160,241,301,241,8,1438,993
1709,7,2.1.287,0,564,0,43,287,330,287,0,330,350,-146,192,192,2,2,132,258,189,353,8,1438,993
1709,7,3.1.151,0,599,1,74,151,225,151,0,225,350,-10,56,56,2,2,166,258,202,353,8,1438,993
1709,7,4.1.230,0,564,0,41,230,271,230,0,271,350,-89,135,135,2,2,181,258,260,353,8,1438,993
1709,7,5.1.141,0,564,0,73,141,214,115,26,214,350,0,46,46,2,2,271,258,340,353,8,1438,993
1709,8,0.1.350,0,564,0,27,350,377,350,0,377,377,-209,255,396,2,2,83,258,146,353,9,1438,959
1709,8,1.3.175,1,564,0,74,175,249,175,0,249,350,-175,175,362,4,1,126,260,301,260,9,1438,959
1709,8,2.1.287,0,564,0,43,287,330,287,0,330,350,-146,192,333,2,2,132,258,189,353,9,1438,959
1709,8,3.1.151,0,599,1,74,151,225,151,0,225,350,-10,56,197,2,2,166,258,202,353,9,1438,959
1709,8,4.1.230,0,564,0,41,230,271,230,0,271,350,-89,135,276,2,2,181,258,260,353,9,1438,959
1709,8,5.1.141,0,564,0,73,141,214,115,26,214,350,0,46,187,2,2,271,258,340,353,9,1438,959
1709,9,0.1.350,0,564,0,27,350,377,350,0,377,377,-209,255,571,2,2,83,258,146,353,10,1438,885
1709,9,1.4.249,1,564,0,52,249,301,249,0,301,350,-249,249,611,5,1,52,234,301,234,10,1438,885
1709,9,2.1.287,0,564,0,43,287,330,287,0,330,350,-146,192,508,2,2,132,258,189,353,10,1438,885
1709,9,3.1.151,0,599,1,74,151,225,151,0,225,350,-10,56,372,2,2,166,258,202,353,10,1438,885
1709,9,4.1.230,0,564,0,41,230,271,230,0,271,350,-89,135,451,2,2,181,258,260,353,10,1438,885
1709,9,5.1.141,0,564,0,73,141,214,115,26,214,350,0,46,362,2,2,271,258,340,353,10,1438,885
1709,10,0.1.350,0,564,0,27,350,377,350,0,377,377,-209,255,820,2,2,83,258,146,353,11,1438,833
1709,10,2.1.287,0,564,0,43,287,330,287,0,330,350,-146,192,757,2,2,132,258,189,353,11,1438,833
1709,10,3.1.151,0,599,1,74,151,225,151,0,225,350,-10,56,621,2,2,166,258,202,353,11,1438,833
1709,10,4.1.230,0,564,0,41,230,271,230,0,271,350,-89,135,700,2,2,181,258,260,353,11,1438,833
1709,10,5.1.141,1,564,0,73,141,214,115,26,214,350,0,46,611,2,2,271,258,340,353,11,1438,833
1709,11,0.1.350,0,564,0,27,350,377,350,0,377,377,-136,182,747,2,3,83,185,146,353,12,1438,760
1709,11,2.1.287,0,564,0,43,287,330,287,0,330,350,-73,119,684,2,3,132,185,189,353,12,1438,760
1709,11,3.1.214,0,564,0,74,214,288,151,63,288,350,0,46,611,2,3,166,185,202,353,12,1438,760
1709,11,4.1.230,0,564,0,41,230,271,230,0,271,350,-16,62,627,2,3,181,185,260,353,12,1438,760
1709,11,5.2.214,1,564,0,87,214,301,214,0,301,350,-39,180,650,3,2,198,207,340,241,12,1438,760
1709,12,0.1.350,0,564,0,27,350,377,350,0,377,377,-136,182,786,2,3,83,185,146,353,13,1438,673
1709,12,2.1.287,0,564,0,43,287,330,287,0,330,350,-73,119,723,2,3,132,185,189,353,13,1438,673
1709,12,3.1.214,0,564,0,74,214,288,151,63,288,350,0,46,650,2,3,166,185,202,353,13,1438,673
1709,12,4.1.230,0,564,0,41,230,271,230,0,271,350,-16,62,666,2,3,181,185,260,353,13,1438,673
1709,12,5.3.301,1,564,0,81,301,382,301,0,382,382,-52,227,702,4,2,111,186,340,260,13,1438,673
1709,13,0.1.350,0,564,0,27,350,377,350,0,377,382,-136,182,838,2,3,83,185,146,353,14,1438,592
1709,13,2.1.287,0,564,0,43,287,330,287,0,330,382,-73,119,775,2,3,132,185,189,353,14,1438,592
1709,13,3.1.214,0,564,0,74,214,288,151,63,288,382,0,46,702,2,3,166,185,202,353,14,1438,592
1709,13,4.1.230,0,564,0,41,230,271,230,0,271,382,-16,62,718,2,3,181,185,260,353,14,1438,592
1709,13,5.4.382,1,564,0,30,382,412,382,0,412,412,-81,330,783,5,2,30,182,340,234,14,1438,592
1709,14,0.1.350,0,564,0,27,350,377,350,0,377,412,-136,182,919,2,3,83,185,146,353,15,1438,562
1709,14,2.1.287,0,564,0,43,287,330,287,0,330,412,-73,119,856,2,3,132,185,189,353,15,1438,562
1709,14,3.1.214,0,564,0,74,214,288,151,63,288,412,0,46,783,2,3,166,185,202,353,15,1438,562
1709,14,4.1.230,1,564,0,41,230,271,230,0,271,412,-16,62,799,2,3,181,185,260,353,15,1438,562
1709,15,0.1.350,0,564,0,27,350,377,350,0,377,412,-79,141,878,2,4,83,144,146,353,16,1438,521
1709,15,2.1.287,0,564,0,43,287,330,287,0,330,412,-16,78,815,2,4,132,144,189,353,16,1438,521
1709,15,3.1.271,0,564,0,74,271,345,151,120,345,412,0,62,799,2,4,166,144,202,353,16,1438,521
1709,15,4.2.301,1,564,0,62,301,363,271,30,363,412,0,180,799,3,3,140,120,260,241,16,1438,521
1709,16,0.1.350,0,564,0,27,350,377,350,0,377,412,-79,141,878,2,4,83,144,146,353,17,1438,459
1709,16,2.1.287,0,564,0,43,287,330,287,0,330,412,-16,78,815,2,4,132,144,189,353,17,1438,459
1709,16,3.1.271,0,564,0,74,271,345,151,120,345,412,0,62,799,2,4,166,144,202,353,17,1438,459
1709,16,4.3.382,1,564,0,15,382,397,363,19,397,412,0,227,799,4,3,78,105,260,260,17,1438,459
1709,17,0.1.350,0,564,0,27,350,377,350,0,377,412,-79,141,878,2,4,83,144,146,353,18,1438,444
1709,17,2.1.287,0,564,0,43,287,330,287,0,330,412,-16,78,815,2,4,132,144,189,353,18,1438,444
1709,17,3.1.271,0,564,0,74,271,345,151,120,345,412,0,62,799,2,4,166,144,202,353,18,1438,444
1709,17,4.4.412,1,564,0,63,412,475,397,15,475,475,0,330,799,5,3,63,152,260,234,18,1438,444
1709,18,0.1.350,0,564,0,27,350,377,350,0,377,475,-79,141,878,2,4,83,144,146,353,19,1438,381
1709,18,2.1.287,0,564,0,43,287,330,287,0,330,475,-16,78,815,2,4,132,144,189,353,19,1438,381
1709,18,3.1.271,1,564,0,74,271,345,151,120,345,475,0,62,799,2,4,166,144,202,353,19,1438,381
1709,19,0.1.350,0,564,0,27,350,377,350,0,377,475,-5,67,804,2,5,83,70,146,353,20,1438,307
1709,19,2.1.345,0,564,0,43,345,388,287,58,388,475,0,62,799,2,5,132,70,189,353,20,1438,307
1709,19,3.2.363,1,564,0,47,363,410,345,18,410,475,0,180,799,3,4,92,58,202,241,20,1438,307
1709,20,0.1.350,0,564,0,27,350,377,350,0,377,475,-5,67,804,2,5,83,70,146,353,21,1438,260
1709,20,2.1.345,0,564,0,43,345,388,287,58,388,475,0,62,799,2,5,132,70,189,353,21,1438,260
1709,20,3.3.410,1,564,0,11,410,421,410,0,421,475,-13,240,812,4,4,45,90,202,260,21,1438,260
1709,21,0.1.350,0,564,0,27,350,377,350,0,377,475,-5,67,817,2,5,83,70,146,353,22,1438,249
1709,21,2.1.345,0,564,0,43,345,388,287,58,388,475,0,62,812,2,5,132,70,189,353,22,1438,249
1709,21,3.4.475,1,564,0,34,475,509,421,54,509,509,0,330,812,5,4,34,89,202,234,22,1438,249
1709,22,0.1.350,0,564,0,27,350,377,350,0,377,509,-5,67,817,2,5,83,70,146,353,23,1438,215
1709,22,2.1.345,1,564,0,43,345,388,287,58,388,509,0,62,812,2,5,132,70,189,353,23,1438,215
1709,23,0.1.388,0,564,0,27,388,415,350,38,415,509,0,62,812,2,6,83,27,146,353,24,1438,172
1709,23,2.2.410,1,564,0,9,410,419,388,22,419,509,0,180,812,3,5,89,11,189,241,24,1438,172
1709,24,0.1.388,0,564,0,27,388,415,350,38,415,509,0,62,812,2,6,83,27,146,353,25,1438,163
1709,24,2.3.421,1,564,0,34,421,455,419,2,455,509,0,240,812,4,5,80,79,189,260,25,1438,163
1709,25,0.1.388,0,564,0,27,388,415,350,38,415,509,0,62,812,2,6,83,27,146,353,26,1438,129
1709,25,2.4.509,1,564,0,46,509,555,455,54,555,555,0,330,812,5,5,46,55,189,234,26,1438,129
1709,26,0.1.388,1,564,0,27,388,415,350,38,415,555,0,62,812,2,6,83,27,146,353,27,1438,83
1709,27,0.2.419,1,564,0,2,419,421,415,4,421,555,0,180,812,3,6,56,2,146,241,28,1438,56
1709,28,0.3.455,1,564,0,45,455,500,421,34,500,555,0,240,812,4,6,54,45,146,260,29,1438,54
1709,29,0.4.555,1,564,0,9,555,564,500,55,564,564,0,330,812,5,6,9,9,146,234,30,1438,9
1710,0,0.0.0,0,517,3,76,0,76,0,0,76,76,0,0,0,1,1,289,265,289,265,1,1305,1305
1710,0,1.0.0,0,471,2,22,0,22,0,0,22,22,0,0,0,1,1,202,265,202,265,1,1305,1305
1710,0,2.0.0,0,464,1,3,0,3,0,0,3,3,0,0,0,1,1,115,265,115,265,1,1305,1305
1710,0,3.0.0,0,530,5,89,0,89,0,0,89,89,0,0,0,1,1,260,265,260,265,1,1305,1305
1710,0,4.0.0,1,461,0,1,0,1,0,0,1,1,0,0,0,1,1,197,265,197,265,1,1305,1305
1710,0,5.0.0,0,522,4,74,0,74,0,0,74,74,0,0,0,1,1,242,265,242,265,1,1305,1305
1710,1,0.0.1,0,473,2,76,1,77,0,1,77,77,0,0,0,1,2,289,264,289,265,2,1305,1304
1710,1,1.0.1,1,461,0,22,1,23,0,1,23,23,0,0,0,1,2,202,264,202,265,2,1305,1304
1710,1,2.0.1,0,464,1,3,1,4,0,1,4,4,0,0,0,1,2,115,264,115,265,2,1305,1304
1710,1,3.0.1,0,461,0,89,1,90,0,1,90,90,0,0,0,1,2,260,264,260,265,2,1305,1304
1710,1,4.1.1,0,461,0,92,1,93,1,0,93,93,-1,1,1,2,1,196,354,197,354,2,1305,1304
1710,1,5.0.1,0,478,3,74,1,75,0,1,75,75,0,0,0,1,2,242,264,242,265,2,1305,1304
1710,2,0.0.23,0,467,2,76,23,99,0,23,99,99,0,0,0,1,3,289,242,289,265,3,1305,1282
1710,2,1.1.23,0,475,3,63,23,86,23,0,86,86,-23,23,23,2,1,180,354,202,354,3,1305,1282
1710,2,2.0.23,1,464,1,3,23,26,0,23,26,26,0,0,0,1,3,115,242,115,265,3,1305,1282
1710,2,3.0.23,0,461,0,89,23,112,0,23,112,112,0,0,0,1,3,260,242,260,265,3,1305,1282
1710,2,4.1.1,0,461,0,92,1,93,1,0,93,93,-1,1,1,2,1,196,354,197,354,3,1305,1282
1710,2,5.0.23,0,478,4,74,23,97,0,23,97,97,0,0,0,1,3,242,242,242,265,3,1305,1282
1710,3,0.0.26,1,467,1,76,26,102,0,26,102,102,0,0,0,1,4,289,239,289,265,4,1305,1279
1710,3,1.1.23,0,475,2,63,23,86,23,0,86,86,-23,23,23,2,1,180,354,202,354,4,1305,1279
1710,3,2.1.26,0,492,4,36,26,62,26,0,62,62,-26,26,26,2,1,112,354,115,354,4,1305,1279
1710,3,3.0.26,0,464,0,89,26,115,0,26,115,115,0,0,0,1,4,260,239,260,265,4,1305,1279
1710,3,4.1.1,0,464,0,92,1,93,1,0,93,93,-1,1,1,2,1,196,354,197,354,4,1305,1279
1710,3,5.0.26,0,478,3,74,26,100,0,26,100,100,0,0,0,1,4,242,239,242,265,4,1305,1279
1710,4,0.1.102,0,487,2,94,102,196,102,0,196,196,-102,102,102,2,1,213,354,289,354,5,1305,1203
1710,4,1.1.23,0,487,2,63,23,86,23,0,86,102,-23,23,23,2,1,180,354,202,354,5,1305,1203
1710,4,2.1.26,0,499,3,36,26,62,26,0,62,102,-26,26,26,2,1,112,354,115,354,5,1305,1203
1710,4,3.0.102,0,467,0,89,102,191,0,102,191,191,0,0,0,1,5,260,163,260,265,5,1305,1203
1710,4,4.1.1,0,467,0,92,1,93,1,0,93,102,-1,1,1,2,1,196,354,197,354,5,1305,1203
1710,4,5.0.102,1,484,1,74,102,176,0,102,176,176,0,0,0,1,5,242,163,242,265,5,1305,1203
1710,5,0.1.102,0,491,1,94,102,196,102,0,196,196,-102,102,102,2,1,213,354,289,354,6,1305,1129
1710,5,1.1.23,0,497,2,63,23,86,23,0,86,176,-23,23,23,2,1,180,354,202,354,6,1305,1129
1710,5,2.1.26,0,500,3,36,26,62,26,0,62,176,-26,26,26,2,1,112,354,115,354,6,1305,1129
1710,5,3.0.176,1,484,0,89,176,265,0,176,265,265,0,0,0,1,6,260,89,260,265,6,1305,1129
1710,5,4.1.1,0,484,0,92,1,93,1,0,93,176,-1,1,1,2,1,196,354,197,354,6,1305,1129
1710,5,5.1.176,0,529,4,56,176,232,176,0,232,232,-176,176,176,2,1,168,354,242,354,6,1305,1129
1710,6,0.1.102,0,491,1,94,102,196,102,0,196,265,-102,102,102,2,1,213,354,289,354,7,1305,1040
1710,6,1.1.23,1,497,2,63,23,86,23,0,86,265,-23,23,23,2,1,180,354,202,354,7,1305,1040
1710,6,2.1.26,0,500,3,36,26,62,26,0,62,265,-26,26,26,2,1,112,354,115,354,7,1305,1040
1710,6,3.1.265,0,484,0,13,265,278,265,0,278,278,-265,265,265,2,1,171,354,260,354,7,1305,1040
1710,6,4.1.1,0,484,0,92,1,93,1,0,93,265,-1,1,1,2,1,196,354,197,354,7,1305,1040
1710,6,5.1.176,0,529,4,56,176,232,176,0,232,265,-176,176,176,2,1,168,354,242,354,7,1305,1040
1710,7,0.1.102,0,509,2,94,102,196,102,0,196,265,-16,39,39,2,2,213,291,289,354,8,1305,977
1710,7,1.2.86,1,497,0,39,86,125,86,0,125,265,-86,86,109,3,1,117,210,202,210,8,1305,977
1710,7,2.1.86,0,497,0,36,86,122,26,60,122,265,0,23,23,2,2,112,291,115,354,8,1305,977
1710,7,3.1.265,0,509,2,13,265,278,265,0,278,278,-179,202,202,2,2,171,291,260,354,8,1305,977
1710,7,4.1.86,0,506,1,92,86,178,1,85,178,265,0,23,23,2,2,196,291,197,354,8,1305,977
1710,7,5.1.176,0,561,3,56,176,232,176,0,232,265,-90,113,113,2,2,168,291,242,354,8,1305,977
1710,8,0.1.102,0,509,2,94,102,196,102,0,196,265,-16,39,125,2,2,213,291,289,354,9,1305,938
1710,8,1.3.125,1,497,0,17,125,142,125,0,142,265,-125,125,234,4,1,78,214,202,214,9,1305,938
1710,8,2.1.86,0,497,0,36,86,122,26,60,122,265,0,23,109,2,2,112,291,115,354,9,1305,938
1710,8,3.1.265,0,509,2,13,265,278,265,0,278,278,-179,202,288,2,2,171,291,260,354,9,1305,938
1710,8,4.1.86,0,506,1,92,86,178,1,85,178,265,0,23,109,2,2,196,291,197,354,9,1305,938
1710,8,5.1.176,0,561,3,56,176,232,176,0,232,265,-90,113,199,2,2,168,291,242,354,9,1305,938
1710,9,0.1.102,0,509,2,94,102,196,102,0,196,265,-16,39,250,2,2,213,291,289,354,10,1305,921
1710,9,1.4.142,1,497,0,61,142,203,142,0,203,265,-142,142,376,5,1,61,262,202,262,10,1305,921
1710,9,2.1.86,0,497,0,36,86,122,26,60,122,265,0,23,234,2,2,112,291,115,354,10,1305,921
1710,9,3.1.265,0,509,2,13,265,278,265,0,278,278,-179,202,413,2,2,171,291,260,354,10,1305,921
1710,9,4.1.86,0,506,1,92,86,178,1,85,178,265,0,23,234,2,2,196,291,197,354,10,1305,921
1710,9,5.1.176,0,561,3,56,176,232,176,0,232,265,-90,113,324,2,2,168,291,242,354,10,1305,921
1710,10,0.1.102,0,509,2,94,102,196,102,0,196,265,-16,39,392,2,2,213,291,289,354,11,1305,860
1710,10,2.1.86,1,497,0,36,86,122,26,60,122,265,0,23,376,2,2,112,291,115,354,11,1305,860
1710,10,3.1.265,0,509,2,13,265,278,265,0,278,278,-179,202,555,2,2,171,291,260,354,11,1305,860
1710,10,4.1.86,0,506,1,92,86,178,1,85,178,265,0,23,376,2,2,196,291,197,354,11,1305,860
1710,10,5.1.176,0,561,3,56,176,232,176,0,232,265,-90,113,466,2,2,168,291,242,354,11,1305,860
1710,11,0.1.122,0,497,0,94,122,216,102,20,216,265,0,23,376,2,3,213,255,289,354,12,1305,824
1710,11,2.2.125,1,497,0,62,125,187,122,3,187,265,0,86,376,3,2,76,171,115,210,12,1305,824
1710,11,3.1.265,0,530,2,13,265,278,265,0,278,278,-143,166,519,2,3,171,255,260,354,12,1305,824
1710,11,4.1.122,0,523,1,92,122,214,1,121,214,265,0,23,376,2,3,196,255,197,354,12,1305,824
1710,11,5.1.176,0,561,3,56,176,232,176,0,232,265,-54,77,430,2,3,168,255,242,354,12,1305,824
1710,12,0.1.122,0,497,0,94,122,216,102,20,216,265,0,23,376,2,3,213,255,289,354,13,1305,762
1710,12,2.3.187,1,497,0,3,187,190,187,0,190,265,-45,170,421,4,2,14,197,115,214,13,1305,762
1710,12,3.1.265,0,530,2,13,265,278,265,0,278,278,-143,166,519,2,3,171,255,260,354,13,1305,762
1710,12,4.1.122,0,523,1,92,122,214,1,121,214,265,0,23,376,2,3,196,255,197,354,13,1305,762
1710,12,5.1.176,0,561,3,56,176,232,176,0,232,265,-54,77,430,2,3,168,255,242,354,13,1305,762
1710,13,0.1.122,0,497,0,94,122,216,102,20,216,265,0,23,421,2,3,213,255,289,354,14,1305,759
1710,13,2.4.203,1,497,0,11,203,214,190,13,214,265,0,142,421,5,2,11,201,115,262,14,1305,759
1710,13,3.1.265,0,530,2,13,265,278,265,0,278,278,-143,166,564,2,3,171,255,260,354,14,1305,759
1710,13,4.1.122,0,523,1,92,122,214,1,121,214,265,0,23,421,2,3,196,255,197,354,14,1305,759
1710,13,5.1.176,0,561,3,56,176,232,176,0,232,265,-54,77,475,2,3,168,255,242,354,14,1305,759
1710,14,0.1.122,0,497,0,94,122,216,102,20,216,265,0,23,421,2,3,213,255,289,354,15,1305,748
1710,14,3.1.265,0,530,2,13,265,278,265,0,278,278,-143,166,564,2,3,171,255,260,354,15,1305,748
1710,14,4.1.122,1,523,1,92,122,214,1,121,214,265,0,23,421,2,3,196,255,197,354,15,1305,748
1710,14,5.1.176,0,561,3,56,176,232,176,0,232,265,-54,77,475,2,3,168,255,242,354,15,1305,748
1710,15,0.1.214,0,531,1,94,214,308,102,112,308,308,0,23,421,2,4,213,163,289,354,16,1305,656
1710,15,3.1.265,0,540,2,13,265,278,265,0,278,278,-51,74,472,2,4,171,163,260,354,16,1305,656
1710,15,4.2.214,1,523,0,63,214,277,214,0,277,277,-27,113,448,3,3,104,109,197,210,16,1305,656
1710,15,5.1.214,0,523,0,56,214,270,176,38,270,270,0,23,421,2,4,168,163,242,354,16,1305,656
1710,16,0.1.214,0,531,1,94,214,308,102,112,308,308,0,23,448,2,4,213,163,289,354,17,1305,593
1710,16,3.1.265,0,540,2,13,265,278,265,0,278,278,-51,74,499,2,4,171,163,260,354,17,1305,593
1710,16,4.3.277,1,523,0,8,277,285,277,0,285,285,-87,257,535,4,3,41,194,197,214,17,1305,593
1710,16,5.1.214,0,523,0,56,214,270,176,38,270,277,0,23,448,2,4,168,163,242,354,17,1305,593
1710,17,0.1.214,0,531,1,94,214,308,102,112,308,308,0,23,535,2,4,213,163,289,354,18,1305,585
1710,17,3.1.265,0,540,2,13,265,278,265,0,278,285,-51,74,586,2,4,171,163,260,354,18,1305,585
1710,17,4.4.285,1,523,0,33,285,318,285,0,318,318,-71,213,606,5,3,33,190,197,262,18,1305,585
1710,17,5.1.214,0,523,0,56,214,270,176,38,270,285,0,23,535,2,4,168,163,242,354,18,1305,585
1710,18,0.1.214,1,531,1,94,214,308,102,112,308,318,0,23,606,2,4,213,163,289,354,19,1305,552
1710,18,3.1.265,0,540,2,13,265,278,265,0,278,318,-51,74,657,2,4,171,163,260,354,19,1305,552
1710,18,5.1.214,0,523,0,56,214,270,176,38,270,318,0,23,606,2,4,168,163,242,354,19,1305,552
1710,19,0.2.308,1,531,0,6,308,314,308,0,314,318,-31,144,637,3,4,119,46,289,210,20,1305,458
1710,19,3.1.308,0,531,0,13,308,321,265,43,321,321,0,23,606,2,5,171,69,260,354,20,1305,458
1710,19,5.1.308,0,556,1,56,308,364,176,132,364,364,0,23,606,2,5,168,69,242,354,20,1305,458
1710,20,0.3.314,0,531,0,52,314,366,314,0,366,366,-29,286,666,4,4,113,186,289,214,21,1305,452
1710,20,3.1.308,1,531,0,13,308,321,265,43,321,321,0,23,637,2,5,171,69,260,354,21,1305,452
1710,20,5.1.308,0,556,1,56,308,364,176,132,364,364,0,23,637,2,5,168,69,242,354,21,1305,452
1710,21,0.3.314,0,531,0,52,314,366,314,0,366,366,-29,286,666,4,4,113,186,289,214,22,1305,439
1710,21,3.2.321,1,531,0,14,321,335,321,0,335,335,-7,151,644,3,5,158,40,260,210,22,1305,439
1710,21,5.1.321,0,531,0,56,321,377,176,145,377,377,0,23,637,2,6,168,56,242,354,22,1305,439
1710,22,0.3.314,0,531,0,52,314,366,314,0,366,366,-29,286,673,4,4,113,186,289,214,23,1305,425
1710,22,3.3.335,0,561,1,69,335,404,335,0,404,404,-50,307,694,4,4,144,186,260,214,23,1305,425
1710,22,5.1.321,1,531,0,56,321,377,176,145,377,377,0,23,644,2,6,168,56,242,354,23,1305,425
1710,23,0.3.314,0,531,0,52,314,366,314,0,366,377,-29,286,673,4,4,113,186,289,214,24,1305,369
1710,23,3.3.335,0,561,1,69,335,404,335,0,404,404,-50,307,694,4,4,144,186,260,214,24,1305,369
1710,23,5.2.377,1,531,0,26,377,403,377,0,403,403,-42,193,686,3,6,112,26,242,210,24,1305,369
1710,24,0.3.314,1,531,0,52,314,366,314,0,366,403,-29,286,715,4,4,113,186,289,214,25,1305,343
1710,24,3.3.335,0,561,1,69,335,404,335,0,404,404,-50,307,736,4,4,144,186,260,214,25,1305,343
1710,24,5.3.403,0,612,2,65,403,468,403,0,468,468,-118,375,804,4,4,86,186,242,214,25,1305,343
1710,25,0.4.366,1,531,0,61,366,427,366,0,427,427,-48,261,763,5,4,61,157,289,262,26,1305,291
1710,25,3.3.366,0,531,0,69,366,435,335,31,435,435,0,286,715,4,5,144,134,260,214,26,1305,291
1710,25,5.3.403,0,612,1,65,403,468,403,0,468,468,-37,323,752,4,5,86,134,242,214,26,1305,291
1710,26,3.3.366,1,531,0,69,366,435,335,31,435,435,0,286,763,4,5,144,134,260,214,27,1305,230
1710,26,5.3.403,0,612,1,65,403,468,403,0,468,468,-37,323,800,4,5,86,134,242,214,27,1305,230
1710,27,3.4.435,1,531,0,75,435,510,435,0,510,510,-8,269,771,5,5,75,96,260,262,28,1305,161
1710,27,5.3.435,0,531,0,65,435,500,403,32,500,500,0,286,763,4,6,86,65,242,214,28,1305,161
1710,28,5.3.435,1,531,0,65,435,500,403,32,500,510,0,286,771,4,6,86,65,242,214,29,1305,86
1710,29,5.4.510,1,531,0,21,510,531,500,10,531,531,0,269,771,5,6,21,21,242,262,30,1305,21
1711,0,0.0.0,0,527,1,89,0,89,0,0,89,89,0,0,0,1,1,233,378,233,378,1,1374,1374
1711,0,1.0.0,0,522,0,96,0,96,0,0,96,96,0,0,0,1,1,300,378,300,378,1,1374,1374
1711,0,2.0.0,1,522,0,49,0,49,0,0,49,49,0,0,0,1,1,241,378,241,378,1,1374,1374
1711,0,3.0.0,0,522,0,43,0,43,0,0,43,43,0,0,0,1,1,220,378,220,378,1,1374,1374
1711,0,4.0.0,0,522,0,23,0,23,0,0,23,23,0,0,0,1,1,136,378,136,378,1,1374,1374
1711,0,5.0.0,0,522,0,78,0,78,0,0,78,78,0,0,0,1,1,244,378,244,378,1,1374,1374
1711,1,0.0.49,0,527,2,89,49,138,0,49,138,138,0,0,0,1,2,233,329,233,378,2,1374,1325
1711,1,1.0.49,0,526,1,96,49,145,0,49,145,145,0,0,0,1,2,300,329,300,378,2,1374,1325
1711,1,2.1.49,1,522,0,30,49,79,49,0,79,79,-49,49,49,2,1,192,258,241,258,2,1374,1325
1711,1,3.0.49,0,522,0,43,49,92,0,49,92,92,0,0,0,1,2,220,329,220,378,2,1374,1325
1711,1,4.0.49,0,522,0,23,49,72,0,49,72,72,0,0,0,1,2,136,329,136,378,2,1374,1325
1711,1,5.0.49,0,522,0,78,49,127,0,49,127,127,0,0,0,1,2,244,329,244,378,2,1374,1325
1711,2,0.0.49,0,527,2,89,49,138,0,49,138,138,0,0,49,1,2,233,329,233,378,3,1374,1295
1711,2,1.0.49,0,526,1,96,49,145,0,49,145,145,0,0,49,1,2,300,329,300,378,3,1374,1295
1711,2,2.2.79,1,522,0,15,79,94,79,0,94,94,-79,79,128,3,1,162,277,241,277,3,1374,1295
1711,2,3.0.49,0,522,0,43,49,92,0,49,92,92,0,0,49,1,2,220,329,220,378,3,1374,1295
1711,2,4.0.49,0,522,0,23,49,72,0,49,72,79,0,0,49,1,2,136,329,136,378,3,1374,1295
1711,2,5.0.49,0,522,0,78,49,127,0,49,127,127,0,0,49,1,2,244,329,244,378,3,1374,1295
1711,3,0.0.49,0,527,2,89,49,138,0,49,138,138,0,0,128,1,2,233,329,233,378,4,1374,1280
1711,3,1.0.49,0,526,1,96,49,145,0,49,145,145,0,0,128,1,2,300,329,300,378,4,1374,1280
1711,3,2.3.94,1,522,0,71,94,165,94,0,165,165,-94,94,222,4,1,147,267,241,267,4,1374,1280
1711,3,3.0.49,0,522,0,43,49,92,0,49,92,94,0,0,128,1,2,220,329,220,378,4,1374,1280
1711,3,4.0.49,0,522,0,23,49,72,0,49,72,94,0,0,128,1,2,136,329,136,378,4,1374,1280
1711,3,5.0.49,0,522,0,78,49,127,0,49,127,127,0,0,128,1,2,244,329,244,378,4,1374,1280
1711,4,0.0.49,0,527,2,89,49,138,0,49,138,165,0,0,222,1,2,233,329,233,378,5,1374,1209
1711,4,1.0.49,0,526,1,96,49,145,0,49,145,165,0,0,222,1,2,300,329,300,378,5,1374,1209
1711,4,2.4.165,1,522,0,76,165,241,165,0,241,241,-165,165,387,5,1,76,194,241,194,5,1374,1209
1711,4,3.0.49,0,522,0,43,49,92,0,49,92,165,0,0,222,1,2,220,329,220,378,5,1374,1209
1711,4,4.0.49,0,522,0,23,49,72,0,49,72,165,0,0,222,1,2,136,329,136,378,5,1374,1209
1711,4,5.0.49,0,522,0,78,49,127,0,49,127,165,0,0,222,1,2,244,329,244,378,5,1374,1209
1711,5,0.0.49,0,527,2,89,49,138,0,49,138,241,0,0,387,1,2,233,329,233,378,6,1374,1133
1711,5,1.0.49,0,526,1,96,49,145,0,49,145,241,0,0,387,1,2,300,329,300,378,6,1374,1133
1711,5,3.0.49,1,522,0,43,49,92,0,49,92,241,0,0,387,1,2,220,329,220,378,6,1374,1133
1711,5,4.0.49,0,522,0,23,49,72,0,49,72,241,0,0,387,1,2,136,329,136,378,6,1374,1133
1711,5,5.0.49,0,522,0,78,49,127,0,49,127,241,0,0,387,1,2,244,329,244,378,6,1374,1133
1711,6,0.0.92,0,527,1,89,92,181,0,92,181,241,0,0,387,1,3,233,286,233,378,7,1374,1090
1711,6,1.0.92,0,522,0,96,92,188,0,92,188,241,0,0,387,1,3,300,286,300,378,7,1374,1090
1711,6,3.1.92,1,522,0,51,92,143,92,0,143,241,-13,62,400,2,2,177,228,220,258,7,1374,1090
1711,6,4.0.92,0,522,0,23,92,115,0,92,115,241,0,0,387,1,3,136,286,136,378,7,1374,1090
1711,6,5.0.92,0,522,0,78,92,170,0,92,170,241,0,0,387,1,3,244,286,244,378,7,1374,1090
1711,7,0.0.92,0,527,1,89,92,181,0,92,181,241,0,0,400,1,3,233,286,233,378,8,1374,1039
1711,7,1.0.92,0,522,0,96,92,188,0,92,188,241,0,0,400,1,3,300,286,300,378,8,1374,1039
1711,7,3.2.143,1,522,0,81,143,224,143,0,224,241,-49,128,449,3,2,126,262,220,277,8,1374,1039
1711,7,4.0.92,0,522,0,23,92,115,0,92,115,241,0,0,400,1,3,136,286,136,378,8,1374,1039
1711,7,5.0.92,0,522,0,78,92,170,0,92,170,241,0,0,400,1,3,244,286,244,378,8,1374,1039
1711,8,0.0.92,0,527,1,89,92,181,0,92,181,241,0,0,449,1,3,233,286,233,378,9,1374,958
1711,8,1.0.92,0,522,0,96,92,188,0,92,188,241,0,0,449,1,3,300,286,300,378,9,1374,958
1711,8,3.3.224,1,522,0,28,224,252,224,0,252,252,-59,153,508,4,2,45,196,220,267,9,1374,958
1711,8,4.0.92,0,522,0,23,92,115,0,92,115,241,0,0,449,1,3,136,286,136,378,9,1374,958
1711,8,5.0.92,0,522,0,78,92,170,0,92,170,241,0,0,449,1,3,244,286,244,378,9,1374,958
1711,9,0.0.92,0,527,1,89,92,181,0,92,181,252,0,0,508,1,3,233,286,233,378,10,1374,930
1711,9,1.0.92,0,522,0,96,92,188,0,92,188,252,0,0,508,1,3,300,286,300,378,10,1374,930
1711,9,3.4.252,1,522,0,17,252,269,252,0,269,269,-11,176,519,5,2,17,118,220,194,10,1374,930
1711,9,4.0.92,0,522,0,23,92,115,0,92,115,252,0,0,508,1,3,136,286,136,378,10,1374,930
1711,9,5.0.92,0,522,0,78,92,170,0,92,170,252,0,0,508,1,3,244,286,244,378,10,1374,930
1711,10,0.0.92,0,527,1,89,92,181,0,92,181,269,0,0,519,1,3,233,286,233,378,11,1374,913
1711,10,1.0.92,0,522,0,96,92,188,0,92,188,269,0,0,519,1,3,300,286,300,378,11,1374,913
1711,10,4.0.92,1,522,0,23,92,115,0,92,115,269,0,0,519,1,3,136,286,136,378,11,1374,913
1711,10,5.0.92,0,522,0,78,92,170,0,92,170,269,0,0,519,1,3,244,286,244,378,11,1374,913
1711,11,0.0.115,0,544,1,89,115,204,0,115,204,269,0,0,519,1,4,233,263,233,378,12,1374,890
1711,11,1.0.115,0,522,0,96,115,211,0,115,211,269,0,0,519,1,4,300,263,300,378,12,1374,890
1711,11,4.1.143,1,522,0,44,143,187,115,28,187,269,0,62,519,2,3,113,177,136,258,12,1374,890
1711,11,5.0.115,0,522,0,78,115,193,0,115,193,269,0,0,519,1,4,244,263,244,378,12,1374,890
1711,12,0.0.115,0,544,1,89,115,204,0,115,204,269,0,0,519,1,4,233,263,233,378,13,1374,846
1711,12,1.0.115,0,522,0,96,115,211,0,115,211,269,0,0,519,1,4,300,263,300,378,13,1374,846
1711,12,4.2.224,1,522,0,64,224,288,187,37,288,288,0,128,519,3,3,69,181,136,277,13,1374,846
1711,12,5.0.115,0,522,0,78,115,193,0,115,193,269,0,0,519,1,4,244,263,244,378,13,1374,846
1711,13,0.0.115,0,544,1,89,115,204,0,115,204,288,0,0,519,1,4,233,263,233,378,14,1374,782
1711,13,1.0.115,0,522,0,96,115,211,0,115,211,288,0,0,519,1,4,300,263,300,378,14,1374,782
1711,13,4.3.288,1,522,0,1,288,289,288,0,289,289,-36,189,555,4,3,5,168,136,267,14,1374,782
1711,13,5.0.115,0,544,1,78,115,193,0,115,193,288,0,0,519,1,4,244,263,244,378,14,1374,782
1711,14,0.0.115,0,544,1,89,115,204,0,115,204,289,0,0,555,1,4,233,263,233,378,15,1374,781
1711,14,1.0.115,0,522,0,96,115,211,0,115,211,289,0,0,555,1,4,300,263,300,378,15,1374,781
1711,14,4.4.289,1,522,0,4,289,293,289,0,293,293,-20,196,575,5,3,4,101,136,194,15,1374,781
1711,14,5.0.115,0,544,1,78,115,193,0,115,193,289,0,0,555,1,4,244,263,244,378,15,1374,781
1711,15,0.0.115,0,544,1,89,115,204,0,115,204,293,0,0,575,1,4,233,263,233,378,16,1374,777
1711,15,1.0.115,1,522,0,96,115,211,0,115,211,293,0,0,575,1,4,300,263,300,378,16,1374,777
1711,15,5.0.115,0,544,1,78,115,193,0,115,193,293,0,0,575,1,4,244,263,244,378,16,1374,777
1711,16,0.0.211,0,544,1,89,211,300,0,211,300,300,0,0,575,1,5,233,167,233,378,17,1374,681
1711,16,1.1.211,1,522,0,32,211,243,211,0,243,293,-24,86,599,2,4,204,133,300,258,17,1374,681
1711,16,5.0.211,0,522,0,78,211,289,0,211,289,293,0,0,575,1,5,244,167,244,378,17,1374,681
1711,17,0.0.211,0,544,1,89,211,300,0,211,300,300,0,0,599,1,5,233,167,233,378,18,1374,649
1711,17,1.2.288,1,522,0,44,288,332,243,45,332,332,0,128,599,3,4,172,117,300,277,18,1374,649
1711,17,5.0.211,0,522,0,78,211,289,0,211,289,293,0,0,599,1,5,244,167,244,378,18,1374,649
1711,18,0.0.211,0,544,1,89,211,300,0,211,300,332,0,0,599,1,5,233,167,233,378,19,1374,605
1711,18,1.3.332,1,522,0,58,332,390,332,0,390,390,-43,232,642,4,4,128,167,300,267,19,1374,605
1711,18,5.0.211,0,522,0,78,211,289,0,211,289,332,0,0,599,1,5,244,167,244,378,19,1374,605
1711,19,0.0.211,0,544,1,89,211,300,0,211,300,390,0,0,642,1,5,233,167,233,378,20,1374,547
1711,19,1.4.390,1,522,0,70,390,460,390,0,460,460,-97,293,739,5,4,70,97,300,194,20,1374,547
1711,19,5.0.211,0,522,0,78,211,289,0,211,289,390,0,0,642,1,5,244,167,244,378,20,1374,547
1711,20,0.0.211,0,544,1,89,211,300,0,211,300,460,0,0,739,1,5,233,167,233,378,21,1374,477
1711,20,5.0.211,1,522,0,78,211,289,0,211,289,460,0,0,739,1,5,244,167,244,378,21,1374,477
1711,21,0.0.289,1,522,0,89,289,378,0,289,378,460,0,0,739,1,6,233,89,233,378,22,1374,399
1711,21,5.1.289,0,522,0,39,289,328,289,0,328,460,-46,132,785,2,5,166,101,244,258,22,1374,399
1711,22,0.1.378,0,522,0,62,378,440,378,0,440,460,-135,221,874,2,5,144,101,233,258,23,1374,310
1711,22,5.1.289,1,522,0,39,289,328,289,0,328,460,-46,132,785,2,5,166,101,244,258,23,1374,310
1711,23,0.1.378,0,522,0,62,378,440,378,0,440,460,-50,182,835,2,6,144,62,233,258,24,1374,271
1711,23,5.2.332,1,522,0,64,332,396,328,4,396,460,0,128,785,3,5,127,73,244,277,24,1374,271
1711,24,0.1.378,0,522,0,62,378,440,378,0,440,460,-50,182,835,2,6,144,62,233,258,25,1374,207
1711,24,5.3.396,1,522,0,50,396,446,396,0,446,460,-6,238,791,4,5,63,109,244,267,25,1374,207
1711,25,0.1.378,0,522,0,62,378,440,378,0,440,460,-50,182,841,2,6,144,62,233,258,26,1374,157
1711,25,5.4.460,1,522,0,13,460,473,446,14,473,473,0,293,791,5,5,13,27,244,194,26,1374,157
1711,26,0.1.378,1,522,0,62,378,440,378,0,440,473,-50,182,841,2,6,144,62,233,258,27,1374,144
1711,27,0.2.440,1,522,0,9,440,449,440,0,449,473,-44,172,885,3,6,82,9,233,277,28,1374,82
1711,28,0.3.449,1,522,0,59,449,508,449,0,508,508,-3,241,888,4,6,73,59,233,267,29,1374,73
1711,29,0.4.508,1,522,0,14,508,522,508,0,522,522,-35,328,923,5,6,14,14,233,194,30,1374,14
1712,0,0.0.0,0,591,0,3,0,3,0,0,3,3,0,0,0,1,1,178,393,178,393,1,1741,1741
1712,0,1.0.0,0,634,2,72,0,72,0,0,72,72,0,0,0,1,1,399,393,399,393,1,1741,1741
1712,0,2.0.0,0,648,3,94,0,94,0,0,94,94,0,0,0,1,1,267,393,267,393,1,1741,1741
1712,0,3.0.0,0,676,5,96,0,96,0,0,96,96,0,0,0,1,1,377,393,377,393,1,1741,1741
1712,0,4.0.0,1,619,1,45,0,45,0,0,45,45,0,0,0,1,1,372,393,372,393,1,1741,1741
1712,0,5.0.0,0,674,4,83,0,83,0,0,83,83,0,0,0,1,1,148,393,148,393,1,1741,1741
1712,1,0.0.45,0,619,0,3,45,48,0,45,48,48,0,0,0,1,2,178,348,178,393,2,1741,1696
1712,1,1.0.45,0,629,1,72,45,117,0,45,117,117,0,0,0,1,2,399,348,399,393,2,1741,1696
1712,1,2.0.45,0,630,2,94,45,139,0,45,139,139,0,0,0,1,2,267,348,267,393,2,1741,1696
1712,1,3.0.45,0,652,4,96,45,141,0,45,141,141,0,0,0,1,2,377,348,377,393,2,1741,1696
1712,1,4.1.45,1,629,1,96,45,141,45,0,141,141,-45,45,45,2,1,327,360,372,360,2,1741,1696
1712,1,5.0.45,0,641,3,83,45,128,0,45,128,128,0,0,0,1,2,148,348,148,393,2,1741,1696
1712,2,0.0.45,0,629,0,3,45,48,0,45,48,141,0,0,45,1,2,178,348,178,393,3,1741,1600
1712,2,1.0.45,0,629,0,72,45,117,0,45,117,141,0,0,45,1,2,399,348,399,393,3,1741,1600
1712,2,2.0.45,0,630,1,94,45,139,0,45,139,141,0,0,45,1,2,267,348,267,393,3,1741,1600
1712,2,3.0.45,0,652,4,96,45,141,0,45,141,141,0,0,45,1,2,377,348,377,393,3,1741,1600
1712,2,4.2.141,1,651,3,65,141,206,141,0,206,206,-141,141,186,3,1,231,247,372,247,3,1741,1600
1712,2,5.0.45,0,641,2,83,45,128,0,45,128,141,0,0,45,1,2,148,348,148,393,3,1741,1600
1712,3,0.0.45,0,651,0,3,45,48,0,45,48,206,0,0,186,1,2,178,348,178,393,4,1741,1535
1712,3,1.0.45,1,651,0,72,45,117,0,45,117,206,0,0,186,1,2,399,348,399,393,4,1741,1535
1712,3,2.0.45,0,651,0,94,45,139,0,45,139,206,0,0,186,1,2,267,348,267,393,4,1741,1535
1712,3,3.0.45,0,652,1,96,45,141,0,45,141,206,0,0,186,1,2,377,348,377,393,4,1741,1535
1712,3,4.3.206,0,651,0,93,206,299,206,0,299,299,-206,206,392,4,1,166,418,372,418,4,1741,1535
1712,3,5.0.45,0,653,2,83,45,128,0,45,128,206,0,0,186,1,2,148,348,148,393,4,1741,1535
1712,4,0.0.117,1,651,0,3,117,120,0,117,120,206,0,0,186,1,3,178,276,178,393,5,1741,1463
1712,4,1.1.141,0,651,0,99,141,240,117,24,240,240,0,45,186,2,2,327,264,399,360,5,1741,1463
1712,4,2.0.117,0,651,0,94,117,211,0,117,211,211,0,0,186,1,3,267,276,267,393,5,1741,1463
1712,4,3.0.117,0,651,0,96,117,213,0,117,213,213,0,0,186,1,3,377,276,377,393,5,1741,1463
1712,4,4.3.206,0,651,0,93,206,299,206,0,299,299,-206,206,392,4,1,166,418,372,418,5,1741,1463
1712,4,5.0.117,0,653,1,83,117,200,0,117,200,206,0,0,186,1,3,148,276,148,393,5,1741,1463
1712,5,0.1.141,0,651,0,30,141,171,120,21,171,206,0,45,186,2,2,175,264,178,360,6,1741,1460
1712,5,1.1.141,0,651,0,99,141,240,117,24,240,240,0,45,186,2,2,327,264,399,360,6,1741,1460
1712,5,2.0.120,0,651,0,94,120,214,0,120,214,214,0,0,186,1,4,267,273,267,393,6,1741,1460
1712,5,3.0.120,1,651,0,96,120,216,0,120,216,216,0,0,186,1,4,377,273,377,393,6,1741,1460
1712,5,4.3.206,0,651,0,93,206,299,206,0,299,299,-206,206,392,4,1,166,418,372,418,6,1741,1460
1712,5,5.0.120,0,653,1,83,120,203,0,120,203,206,0,0,186,1,4,148,273,148,393,6,1741,1460
1712,6,0.1.141,0,651,0,30,141,171,120,21,171,216,0,45,186,2,2,175,264,178,360,7,1741,1364
1712,6,1.1.141,0,651,0,99,141,240,117,24,240,240,0,45,186,2,2,327,264,399,360,7,1741,1364
1712,6,2.0.216,1,651,0,94,216,310,0,216,310,310,0,0,186,1,5,267,177,267,393,7,1741,1364
1712,6,3.1.216,0,672,2,89,216,305,216,0,305,305,-75,120,261,2,2,281,264,377,360,7,1741,1364
1712,6,4.3.206,0,651,0,93,206,299,206,0,299,299,-206,206,392,4,1,166,418,372,418,7,1741,1364
1712,6,5.0.216,0,653,1,83,216,299,0,216,299,299,0,0,186,1,5,148,177,148,393,7,1741,1364
1712,7,0.1.141,0,651,0,30,141,171,120,21,171,310,0,45,186,2,2,175,264,178,360,8,1741,1270
1712,7,1.1.141,0,651,0,99,141,240,117,24,240,310,0,45,186,2,2,327,264,399,360,8,1741,1270
1712,7,2.1.310,0,651,0,23,310,333,310,0,333,333,-169,214,355,2,2,173,264,267,360,8,1741,1270
1712,7,3.1.216,0,672,1,89,216,305,216,0,305,310,-75,120,261,2,2,281,264,377,360,8,1741,1270
1712,7,4.3.206,0,651,0,93,206,299,206,0,299,310,-206,206,392,4,1,166,418,372,418,8,1741,1270
1712,7,5.0.310,1,651,0,83,310,393,0,310,393,393,0,0,186,1,6,148,83,148,393,8,1741,1270
1712,8,0.1.141,0,651,0,30,141,171,120,21,171,393,0,45,186,2,2,175,264,178,360,9,1741,1187
1712,8,1.1.141,1,651,0,99,141,240,117,24,240,393,0,45,186,2,2,327,264,399,360,9,1741,1187
1712,8,2.1.310,0,651,0,23,310,333,310,0,333,393,-169,214,355,2,2,173,264,267,360,9,1741,1187
1712,8,3.1.216,0,672,1,89,216,305,216,0,305,393,-75,120,261,2,2,281,264,377,360,9,1741,1187
1712,8,4.3.206,0,651,0,93,206,299,206,0,299,393,-206,206,392,4,1,166,418,372,418,9,1741,1187
1712,8,5.1.393,0,651,0,23,393,416,393,0,416,416,-252,297,438,2,2,65,264,148,360,9,1741,1187
1712,9,0.1.240,0,651,0,30,240,270,120,120,270,393,0,45,186,2,3,175,165,178,360,10,1741,1088
1712,9,1.2.240,1,651,0,50,240,290,240,0,290,393,-34,175,220,3,2,228,182,399,247,10,1741,1088
1712,9,2.1.310,0,651,0,23,310,333,310,0,333,393,-70,115,256,2,3,173,165,267,360,10,1741,1088
1712,9,3.1.240,0,651,0,89,240,329,216,24,329,393,0,45,186,2,3,281,165,377,360,10,1741,1088
1712,9,4.3.206,0,651,0,93,206,299,206,0,299,393,-206,206,392,4,1,166,418,372,418,10,1741,1088
1712,9,5.1.393,0,651,0,23,393,416,393,0,416,416,-153,198,339,2,3,65,165,148,360,10,1741,1088
1712,10,0.1.240,1,651,0,30,240,270,120,120,270,393,0,45,220,2,3,175,165,178,360,11,1741,1038
1712,10,1.3.290,0,735,1,99,290,389,290,0,389,393,-290,290,510,4,1,178,418,399,418,11,1741,1038
1712,10,2.1.310,0,651,0,23,310,333,310,0,333,393,-70,115,290,2,3,173,165,267,360,11,1741,1038
1712,10,3.1.240,0,651,0,89,240,329,216,24,329,393,0,45,220,2,3,281,165,377,360,11,1741,1038
1712,10,4.3.206,0,651,0,93,206,299,206,0,299,393,-206,206,426,4,1,166,418,372,418,11,1741,1038
1712,10,5.1.393,0,651,0,23,393,416,393,0,416,416,-153,198,373,2,3,65,165,148,360,11,1741,1038
1712,11,0.2.290,1,651,0,13,290,303,270,20,303,393,0,175,220,3,3,145,132,178,247,12,1741,1008
1712,11,1.3.290,0,735,1,99,290,389,290,0,389,393,-290,290,510,4,1,178,418,399,418,12,1741,1008
1712,11,2.1.310,0,651,0,23,310,333,310,0,333,393,-40,85,260,2,4,173,135,267,360,12,1741,1008
1712,11,3.1.270,0,651,0,89,270,359,216,54,359,393,0,45,220,2,4,281,135,377,360,12,1741,1008
1712,11,4.3.206,0,651,0,93,206,299,206,0,299,393,-206,206,426,4,1,166,418,372,418,12,1741,1008
1712,11,5.1.393,0,651,0,23,393,416,393,0,416,416,-123,168,343,2,4,65,135,148,360,12,1741,1008
1712,12,0.3.303,0,655,1,65,303,368,303,0,368,393,-303,303,523,4,1,132,418,178,418,13,1741,995
1712,12,1.3.290,0,735,2,99,290,389,290,0,389,393,-290,290,510,4,1,178,418,399,418,13,1741,995
1712,12,2.1.310,0,651,0,23,310,333,310,0,333,393,-40,85,260,2,4,173,135,267,360,13,1741,995
1712,12,3.1.270,1,651,0,89,270,359,216,54,359,393,0,45,220,2,4,281,135,377,360,13,1741,995
1712,12,4.3.206,0,651,0,93,206,299,206,0,299,393,-206,206,426,4,1,166,418,372,418,13,1741,995
1712,12,5.1.393,0,651,0,23,393,416,393,0,416,416,-123,168,343,2,4,65,135,148,360,13,1741,995
1712,13,0.3.303,0,655,2,65,303,368,303,0,368,393,-303,303,523,4,1,132,418,178,418,14,1741,906
1712,13,1.3.290,0,735,3,99,290,389,290,0,389,393,-290,290,510,4,1,178,418,399,418,14,1741,906
1712,13,2.1.359,1,651,0,23,359,382,310,49,382,393,0,45,220,2,5,173,46,267,360,14,1741,906
1712,13,3.2.359,0,653,1,48,359,407,359,0,407,407,-56,231,276,3,4,192,119,377,247,14,1741,906
1712,13,4.3.206,0,651,0,93,206,299,206,0,299,393,-206,206,426,4,1,166,418,372,418,14,1741,906
1712,13,5.1.393,0,651,0,23,393,416,393,0,416,416,-34,79,254,2,5,65,46,148,360,14,1741,906
1712,14,0.3.303,0,655,2,65,303,368,303,0,368,393,-303,303,523,4,1,132,418,178,418,15,1741,883
1712,14,1.3.290,0,735,3,99,290,389,290,0,389,393,-290,290,510,4,1,178,418,399,418,15,1741,883
1712,14,2.2.382,0,651,0,68,382,450,382,0,450,450,-79,254,299,3,4,150,119,267,247,15,1741,883
1712,14,3.2.359,1,653,1,48,359,407,359,0,407,407,-56,231,276,3,4,192,119,377,247,15,1741,883
1712,14,4.3.206,0,651,0,93,206,299,206,0,299,393,-206,206,426,4,1,166,418,372,418,15,1741,883
1712,14,5.1.393,0,651,0,23,393,416,393,0,416,416,-11,56,231,2,6,65,23,148,360,15,1741,883
1712,15,0.3.303,0,657,1,65,303,368,303,0,368,407,-303,303,579,4,1,132,418,178,418,16,1741,835
1712,15,1.3.290,0,735,3,99,290,389,290,0,389,407,-290,290,566,4,1,178,418,399,418,16,1741,835
1712,15,2.2.407,1,653,0,68,407,475,382,25,475,475,0,231,276,3,5,150,71,267,247,16,1741,835
1712,15,3.3.407,0,669,2,86,407,493,407,0,493,493,-407,407,683,4,1,144,418,377,418,16,1741,835
1712,15,4.3.206,0,653,0,93,206,299,206,0,299,407,-206,206,482,4,1,166,418,372,418,16,1741,835
1712,15,5.1.393,0,653,0,23,393,416,393,0,416,416,-11,56,287,2,6,65,23,148,360,16,1741,835
1712,16,0.3.303,0,657,1,65,303,368,303,0,368,475,-303,303,579,4,1,132,418,178,418,17,1741,767
1712,16,1.3.290,0,735,4,99,290,389,290,0,389,475,-290,290,566,4,1,178,418,399,418,17,1741,767
1712,16,2.3.475,0,663,2,40,475,515,475,0,515,515,-475,475,751,4,1,82,418,267,418,17,1741,767
1712,16,3.3.407,0,669,3,86,407,493,407,0,493,493,-407,407,683,4,1,144,418,377,418,17,1741,767
1712,16,4.3.206,0,653,0,93,206,299,206,0,299,475,-206,206,482,4,1,166,418,372,418,17,1741,767
1712,16,5.1.393,1,653,0,23,393,416,393,0,416,475,-11,56,287,2,6,65,23,148,360,17,1741,767
1712,17,0.3.303,0,657,1,65,303,368,303,0,368,475,-303,303,590,4,1,132,418,178,418,18,1741,744
1712,17,1.3.290,0,735,4,99,290,389,290,0,389,475,-290,290,577,4,1,178,418,399,418,18,1741,744
1712,17,2.3.475,0,663,2,40,475,515,475,0,515,515,-475,475,762,4,1,82,418,267,418,18,1741,744
1712,17,3.3.407,0,669,3,86,407,493,407,0,493,493,-407,407,694,4,1,144,418,377,418,18,1741,744
1712,17,4.3.206,0,653,0,93,206,299,206,0,299,475,-206,206,493,4,1,166,418,372,418,18,1741,744
1712,17,5.2.475,1,653,0,3,475,478,416,59,478,478,0,231,287,3,6,42,3,148,247,18,1741,744
1712,18,0.3.303,0,657,1,65,303,368,303,0,368,478,-303,303,590,4,1,132,418,178,418,19,1741,741
1712,18,1.3.290,0,735,5,99,290,389,290,0,389,478,-290,290,577,4,1,178,418,399,418,19,1741,741
1712,18,2.3.475,0,663,2,40,475,515,475,0,515,515,-475,475,762,4,1,82,418,267,418,19,1741,741
1712,18,3.3.407,0,669,3,86,407,493,407,0,493,493,-407,407,694,4,1,144,418,377,418,19,1741,741
1712,18,4.3.206,1,653,0,93,206,299,206,0,299,478,-206,206,493,4,1,166,418,372,418,19,1741,741
1712,18,5.3.478,0,697,4,35,478,513,478,0,513,513,-478,478,765,4,1,39,418,148,418,19,1741,741
1712,19,0.3.303,0,657,1,65,303,368,303,0,368,478,-4,210,497,4,2,132,325,178,418,20,1741,648
1712,19,1.3.299,0,653,0,99,299,398,290,9,398,478,0,206,493,4,2,178,325,399,418,20,1741,648
1712,19,2.3.475,0,663,2,40,475,515,475,0,515,515,-176,382,669,4,2,82,325,267,418,20,1741,648
1712,19,3.3.407,0,669,3,86,407,493,407,0,493,493,-108,314,601,4,2,144,325,377,418,20,1741,648
1712,19,4.4.299,1,653,0,73,299,372,299,0,372,478,-299,299,792,5,1,73,323,372,323,20,1741,648
1712,19,5.3.478,0,697,4,35,478,513,478,0,513,513,-179,385,672,4,2,39,325,148,418,20,1741,648
1712,20,0.3.303,0,657,1,65,303,368,303,0,368,478,-4,210,796,4,2,132,325,178,418,21,1741,575
1712,20,1.3.299,1,653,0,99,299,398,290,9,398,478,0,206,792,4,2,178,325,399,418,21,1741,575
1712,20,2.3.475,0,663,2,40,475,515,475,0,515,515,-176,382,968,4,2,82,325,267,418,21,1741,575
1712,20,3.3.407,0,669,3,86,407,493,407,0,493,493,-108,314,900,4,2,144,325,377,418,21,1741,575
1712,20,5.3.478,0,697,4,35,478,513,478,0,513,513,-179,385,971,4,2,39,325,148,418,21,1741,575
1712,21,0.3.398,0,653,0,65,398,463,303,95,463,478,0,206,792,4,3,132,226,178,418,22,1741,476
1712,21,1.4.398,1,653,0,79,398,477,398,0,477,478,-26,325,818,5,2,79,250,399,323,22,1741,476
1712,21,2.3.475,0,663,1,40,475,515,475,0,515,515,-77,283,869,4,3,82,226,267,418,22,1741,476
1712,21,3.3.407,0,669,2,86,407,493,407,0,493,493,-9,215,801,4,3,144,226,377,418,22,1741,476
1712,21,5.3.478,0,697,3,35,478,513,478,0,513,513,-80,286,872,4,3,39,226,148,418,22,1741,476
1712,22,0.3.398,1,653,0,65,398,463,303,95,463,478,0,206,818,4,3,132,226,178,418,23,1741,397
1712,22,2.3.475,0,663,1,40,475,515,475,0,515,515,-77,283,895,4,3,82,226,267,418,23,1741,397
1712,22,3.3.407,0,669,2,86,407,493,407,0,493,493,-9,215,827,4,3,144,226,377,418,23,1741,397
1712,22,5.3.478,0,697,3,35,478,513,478,0,513,513,-80,286,898,4,3,39,226,148,418,23,1741,397
1712,23,0.4.477,0,653,0,67,477,544,463,14,544,544,0,325,818,5,3,67,171,178,323,24,1741,332
1712,23,2.3.475,0,663,1,40,475,515,475,0,515,515,-12,218,830,4,4,82,161,267,418,24,1741,332
1712,23,3.3.463,1,653,0,86,463,549,407,56,549,549,0,206,818,4,4,144,161,377,418,24,1741,332
1712,23,5.3.478,0,697,2,35,478,513,478,0,513,513,-15,221,833,4,4,39,161,148,418,24,1741,332
1712,24,0.4.477,0,653,0,67,477,544,463,14,544,549,0,325,818,5,3,67,171,178,323,25,1741,246
1712,24,2.3.549,1,653,0,40,549,589,475,74,589,589,0,206,818,4,5,82,75,267,418,25,1741,246
1712,24,3.4.549,0,653,0,58,549,607,549,0,607,607,-72,397,890,5,3,58,171,377,323,25,1741,246
1712,24,5.3.549,0,666,1,35,549,584,478,71,584,584,0,206,818,4,5,39,75,148,418,25,1741,246
1712,25,0.4.477,0,653,0,67,477,544,463,14,544,589,0,325,818,5,3,67,171,178,323,26,1741,206
1712,25,2.4.589,0,693,1,42,589,631,589,0,631,631,-112,437,930,5,3,42,171,267,323,26,1741,206
1712,25,3.4.549,0,653,0,58,549,607,549,0,607,607,-72,397,890,5,3,58,171,377,323,26,1741,206
1712,25,5.3.589,1,653,0,35,589,624,478,111,624,624,0,206,818,4,6,39,35,148,418,26,1741,206
1712,26,0.4.477,0,653,0,67,477,544,463,14,544,624,0,325,818,5,3,67,171,178,323,27,1741,171
1712,26,2.4.589,0,693,2,42,589,631,589,0,631,631,-112,437,930,5,3,42,171,267,323,27,1741,171
1712,26,3.4.549,1,653,0,58,549,607,549,0,607,624,-72,397,890,5,3,58,171,377,323,27,1741,171
1712,26,5.4.624,0,670,1,4,624,628,624,0,628,628,-147,472,965,5,3,4,171,148,323,27,1741,171
1712,27,0.4.477,1,653,0,67,477,544,463,14,607,624,67,330,823,5,4,67,113,178,323,28,1741,113
1712,27,2.4.607,0,653,0,42,607,649,589,18,649,649,0,397,890,5,4,42,113,267,323,28,1741,113
1712,27,5.4.624,0,670,1,4,624,628,624,0,628,628,-17,414,907,5,4,4,113,148,323,28,1741,113
1712,28,2.4.607,1,653,0,42,607,649,589,18,649,649,0,330,823,5,5,42,46,267,323,29,1741,46
1712,28,5.4.624,0,670,1,4,624,628,624,0,628,628,-17,347,840,5,5,4,46,148,323,29,1741,46
1712,29,5.4.649,1,653,0,4,649,653,624,25,653,653,0,330,823,5,6,4,4,148,323,30,1741,4
1713,0,0.0.0,1,526,1,16,0,16,0,0,16,16,0,0,0,1,1,222,308,222,308,1,1414,1414
1713,0,1.0.0,0,549,2,48,0,48,0,0,48,48,0,0,0,1,1,300,308,300,308,1,1414,1414
1713,0,2.0.0,0,556,4,41,0,41,0,0,41,41,0,0,0,1,1,95,308,95,308,1,1414,1414
1713,0,3.0.0,0,522,0,49,0,49,0,0,49,49,0,0,0,1,1,238,308,238,308,1,1414,1414
1713,0,4.0.0,0,557,5,66,0,66,0,0,66,66,0,0,0,1,1,310,308,310,308,1,1414,1414
1713,0,5.0.0,0,553,3,88,0,88,0,0,88,88,0,0,0,1,1,249,308,249,308,1,1414,1414
1713,1,0.1.16,0,533,1,98,16,114,16,0,114,114,-16,16,16,2,1,206,264,222,264,2,1414,1398
1713,1,1.0.16,1,554,2,48,16,64,0,16,64,64,0,0,0,1,2,300,292,300,308,2,1414,1398
1713,1,2.0.16,0,556,3,41,16,57,0,16,57,57,0,0,0,1,2,95,292,95,308,2,1414,1398
1713,1,3.0.16,0,526,0,49,16,65,0,16,65,65,0,0,0,1,2,238,292,238,308,2,1414,1398
1713,1,4.0.16,0,569,4,66,16,82,0,16,82,82,0,0,0,1,2,310,292,310,308,2,1414,1398
1713,1,5.0.16,0,533,1,88,16,104,0,16,104,104,0,0,0,1,2,249,292,249,308,2,1414,1398
1713,2,0.1.16,0,554,0,98,16,114,16,0,114,114,-16,16,16,2,1,206,264,222,264,3,1414,1350
1713,2,1.1.64,1,571,2,67,64,131,64,0,131,131,-64,64,64,2,1,252,264,300,264,3,1414,1350
1713,2,2.0.64,0,580,3,41,64,105,0,64,105,105,0,0,0,1,3,95,244,95,308,3,1414,1350
1713,2,3.0.64,0,556,1,49,64,113,0,64,113,113,0,0,0,1,3,238,244,238,308,3,1414,1350
1713,2,4.0.64,0,580,3,66,64,130,0,64,130,130,0,0,0,1,3,310,244,310,308,3,1414,1350
1713,2,5.0.64,0,554,0,88,64,152,0,64,152,152,0,0,0,1,3,249,244,249,308,3,1414,1350
1713,3,0.1.131,0,580,2,98,131,229,16,115,229,229,0,64,64,2,2,206,197,222,264,4,1414,1283
1713,3,1.2.131,1,580,2,55,131,186,131,0,186,186,-131,131,195,3,1,185,214,300,214,4,1414,1283
1713,3,2.0.64,0,580,2,41,64,105,0,64,105,131,0,0,64,1,3,95,244,95,308,4,1414,1283
1713,3,3.0.64,0,573,1,49,64,113,0,64,113,131,0,0,64,1,3,238,244,238,308,4,1414,1283
1713,3,4.0.64,0,580,2,66,64,130,0,64,130,131,0,0,64,1,3,310,244,310,308,4,1414,1283
1713,3,5.0.64,0,571,0,88,64,152,0,64,152,152,0,0,64,1,3,249,244,249,308,4,1414,1283
1713,4,0.1.131,0,580,0,98,131,229,16,115,229,229,0,64,195,2,2,206,197,222,264,5,1414,1228
1713,4,1.3.186,1,580,0,42,186,228,186,0,228,228,-186,186,381,4,1,130,276,300,276,5,1414,1228
1713,4,2.0.64,0,580,0,41,64,105,0,64,105,186,0,0,195,1,3,95,244,95,308,5,1414,1228
1713,4,3.0.64,0,580,0,49,64,113,0,64,113,186,0,0,195,1,3,238,244,238,308,5,1414,1228
1713,4,4.0.64,0,580,0,66,64,130,0,64,130,186,0,0,195,1,3,310,244,310,308,5,1414,1228
1713,4,5.0.64,0,580,0,88,64,152,0,64,152,186,0,0,195,1,3,249,244,249,308,5,1414,1228
1713,5,0.1.131,0,580,0,98,131,229,16,115,229,229,0,64,381,2,2,206,197,222,264,6,1414,1186
1713,5,1.4.228,1,580,0,88,228,316,228,0,316,316,-228,228,609,5,1,88,352,300,352,6,1414,1186
1713,5,2.0.64,0,580,0,41,64,105,0,64,105,228,0,0,381,1,3,95,244,95,308,6,1414,1186
1713,5,3.0.64,0,580,0,49,64,113,0,64,113,228,0,0,381,1,3,238,244,238,308,6,1414,1186
1713,5,4.0.64,0,580,0,66,64,130,0,64,130,228,0,0,381,1,3,310,244,310,308,6,1414,1186
1713,5,5.0.64,0,580,0,88,64,152,0,64,152,228,0,0,381,1,3,249,244,249,308,6,1414,1186
1713,6,0.1.131,1,580,0,98,131,229,16,115,229,316,0,64,609,2,2,206,197,222,264,7,1414,1098
1713,6,2.0.64,0,580,0,41,64,105,0,64,105,316,0,0,609,1,3,95,244,95,308,7,1414,1098
1713,6,3.0.64,0,580,0,49,64,113,0,64,113,316,0,0,609,1,3,238,244,238,308,7,1414,1098
1713,6,4.0.64,0,580,0,66,64,130,0,64,130,316,0,0,609,1,3,310,244,310,308,7,1414,1098
1713,6,5.0.64,0,580,0,88,64,152,0,64,152,316,0,0,609,1,3,249,244,249,308,7,1414,1098
1713,7,0.2.229,1,580,0,16,229,245,229,0,245,316,-43,174,652,3,2,108,159,222,214,8,1414,1000
1713,7,2.0.64,0,580,0,41,64,105,0,64,105,316,0,0,609,1,3,95,244,95,308,8,1414,1000
1713,7,3.0.64,0,580,0,49,64,113,0,64,113,316,0,0,609,1,3,238,244,238,308,8,1414,1000
1713,7,4.0.64,0,580,0,66,64,130,0,64,130,316,0,0,609,1,3,310,244,310,308,8,1414,1000
1713,7,5.0.64,0,580,0,88,64,152,0,64,152,316,0,0,609,1,3,249,244,249,308,8,1414,1000
1713,8,0.3.245,1,581,1,72,245,317,245,0,317,317,-17,203,669,4,2,92,234,222,276,9,1414,984
1713,8,2.0.64,0,580,0,41,64,105,0,64,105,316,0,0,652,1,3,95,244,95,308,9,1414,984
1713,8,3.0.64,0,580,0,49,64,113,0,64,113,316,0,0,652,1,3,238,244,238,308,9,1414,984
1713,8,4.0.64,0,580,0,66,64,130,0,64,130,316,0,0,652,1,3,310,244,310,308,9,1414,984
1713,8,5.0.64,0,580,0,88,64,152,0,64,152,316,0,0,652,1,3,249,244,249,308,9,1414,984
1713,9,0.4.317,1,581,0,20,317,337,317,0,337,337,-1,229,670,5,2,20,264,222,352,10,1414,912
1713,9,2.0.64,0,581,0,41,64,105,0,64,105,317,0,0,669,1,3,95,244,95,308,10,1414,912
1713,9,3.0.64,0,581,0,49,64,113,0,64,113,317,0,0,669,1,3,238,244,238,308,10,1414,912
1713,9,4.0.64,0,581,0,66,64,130,0,64,130,317,0,0,669,1,3,310,244,310,308,10,1414,912
1713,9,5.0.64,0,581,0,88,64,152,0,64,152,317,0,0,669,1,3,249,244,249,308,10,1414,912
1713,10,2.0.64,0,581,0,41,64,105,0,64,105,337,0,0,670,1,3,95,244,95,308,11,1414,892
1713,10,3.0.64,0,581,0,49,64,113,0,64,113,337,0,0,670,1,3,238,244,238,308,11,1414,892
1713,10,4.0.64,1,581,0,66,64,130,0,64,130,337,0,0,670,1,3,310,244,310,308,11,1414,892
1713,10,5.0.64,0,581,0,88,64,152,0,64,152,337,0,0,670,1,3,249,244,249,308,11,1414,892
1713,11,2.0.130,0,581,0,41,130,171,0,130,171,337,0,0,670,1,4,95,178,95,308,12,1414,826
1713,11,3.0.130,0,581,0,49,130,179,0,130,179,337,0,0,670,1,4,238,178,238,308,12,1414,826
1713,11,4.1.229,1,588,1,48,229,277,130,99,277,337,0,64,670,2,3,244,99,310,264,12,1414,826
1713,11,5.0.130,0,581,0,88,130,218,0,130,218,337,0,0,670,1,4,249,178,249,308,12,1414,826
1713,12,2.0.130,0,588,0,41,130,171,0,130,171,337,0,0,670,1,4,95,178,95,308,13,1414,778
1713,12,3.0.130,0,588,0,49,130,179,0,130,179,337,0,0,670,1,4,238,178,238,308,13,1414,778
1713,12,4.2.277,1,647,1,65,277,342,277,0,342,342,-32,206,702,3,3,196,143,310,214,13,1414,778
1713,12,5.0.130,0,588,0,88,130,218,0,130,218,337,0,0,670,1,4,249,178,249,308,13,1414,778
1713,13,2.0.130,0,647,0,41,130,171,0,130,171,342,0,0,702,1,4,95,178,95,308,14,1414,713
1713,13,3.0.130,1,647,0,49,130,179,0,130,179,342,0,0,702,1,4,238,178,238,308,14,1414,713
1713,13,4.3.342,0,673,1,87,342,429,342,0,429,429,-25,228,727,4,3,131,162,310,276,14,1414,713
1713,13,5.0.130,0,647,0,88,130,218,0,130,218,342,0,0,702,1,4,249,178,249,308,14,1414,713
1713,14,2.0.179,0,647,0,41,179,220,0,179,220,342,0,0,702,1,5,95,129,95,308,15,1414,664
1713,14,3.1.277,1,647,0,28,277,305,179,98,305,342,0,64,702,2,4,189,51,238,264,15,1414,664
1713,14,4.3.342,0,673,1,87,342,429,342,0,429,429,-25,228,727,4,3,131,162,310,276,15,1414,664
1713,14,5.0.179,0,647,0,88,179,267,0,179,267,342,0,0,702,1,5,249,129,249,308,15,1414,664
1713,15,2.0.179,0,647,0,41,179,220,0,179,220,342,0,0,702,1,5,95,129,95,308,16,1414,636
1713,15,3.2.342,1,648,1,16,342,358,305,37,358,358,0,206,702,3,4,161,78,238,214,16,1414,636
1713,15,4.3.342,0,673,2,87,342,429,342,0,429,429,-25,228,727,4,3,131,162,310,276,16,1414,636
1713,15,5.0.179,0,647,0,88,179,267,0,179,267,342,0,0,702,1,5,249,129,249,308,16,1414,636
1713,16,2.0.179,0,648,0,41,179,220,0,179,220,358,0,0,702,1,5,95,129,95,308,17,1414,620
1713,16,3.3.358,0,648,0,46,358,404,358,0,404,404,-41,244,743,4,3,145,162,238,276,17,1414,620
1713,16,4.3.342,0,673,1,87,342,429,342,0,429,429,-25,228,727,4,3,131,162,310,276,17,1414,620
1713,16,5.0.179,1,648,0,88,179,267,0,179,267,358,0,0,702,1,5,249,129,249,308,17,1414,620
1713,17,2.0.267,0,648,0,41,267,308,0,267,308,358,0,0,702,1,6,95,41,95,308,18,1414,532
1713,17,3.3.358,0,648,0,46,358,404,358,0,404,404,-41,244,743,4,3,145,162,238,276,18,1414,532
1713,17,4.3.342,0,673,1,87,342,429,342,0,429,429,-25,228,727,4,3,131,162,310,276,18,1414,532
1713,17,5.1.305,1,648,0,6,305,311,267,38,311,358,0,64,702,2,5,161,23,249,264,18,1414,532
1713,18,2.0.267,0,648,0,41,267,308,0,267,308,358,0,0,702,1,6,95,41,95,308,19,1414,526
1713,18,3.3.358,0,648,0,46,358,404,358,0,404,404,-41,244,743,4,3,145,162,238,276,19,1414,526
1713,18,4.3.342,0,673,1,87,342,429,342,0,429,429,-25,228,727,4,3,131,162,310,276,19,1414,526
1713,18,5.2.358,1,648,0,41,358,399,311,47,399,399,0,206,702,3,5,155,62,249,214,19,1414,526
1713,19,2.0.267,1,648,0,41,267,308,0,267,308,399,0,0,702,1,6,95,41,95,308,20,1414,485
1713,19,3.3.358,0,648,0,46,358,404,358,0,404,404,-41,244,743,4,3,145,162,238,276,20,1414,485
1713,19,4.3.342,0,673,2,87,342,429,342,0,429,429,-25,228,727,4,3,131,162,310,276,20,1414,485
1713,19,5.3.399,0,663,1,20,399,419,399,0,419,419,-82,285,784,4,3,114,162,249,276,20,1414,485
1713,20,2.1.311,1,648,0,17,311,328,308,3,328,399,0,64,702,2,6,54,17,95,264,21,1414,444
1713,20,3.3.358,0,648,0,46,358,404,358,0,404,404,-41,244,743,4,3,145,162,238,276,21,1414,444
1713,20,4.3.342,0,673,2,87,342,429,342,0,429,429,-25,228,727,4,3,131,162,310,276,21,1414,444
1713,20,5.3.399,0,663,1,20,399,419,399,0,419,419,-82,285,784,4,3,114,162,249,276,21,1414,444
1713,21,2.2.399,1,648,0,21,399,420,328,71,420,420,0,206,702,3,6,37,21,95,214,22,1414,427
1713,21,3.3.358,0,648,0,46,358,404,358,0,404,404,-41,244,743,4,3,145,162,238,276,22,1414,427
1713,21,4.3.342,0,673,2,87,342,429,342,0,429,429,-25,228,727,4,3,131,162,310,276,22,1414,427
1713,21,5.3.399,0,663,1,20,399,419,399,0,419,419,-82,285,784,4,3,114,162,249,276,22,1414,427
1713,22,2.3.420,0,648,0,9,420,429,420,0,429,429,-103,306,805,4,3,16,162,95,276,23,1414,406
1713,22,3.3.358,1,648,0,46,358,404,358,0,404,420,-41,244,743,4,3,145,162,238,276,23,1414,406
1713,22,4.3.342,0,673,2,87,342,429,342,0,429,429,-25,228,727,4,3,131,162,310,276,23,1414,406
1713,22,5.3.399,0,663,1,20,399,419,399,0,419,420,-82,285,784,4,3,114,162,249,276,23,1414,406
1713,23,2.3.420,0,648,0,9,420,429,420,0,429,429,-16,260,759,4,4,16,116,95,276,24,1414,360
1713,23,3.4.404,0,648,0,99,404,503,404,0,503,503,-67,296,810,5,3,99,244,238,352,24,1414,360
1713,23,4.3.404,0,648,0,87,404,491,342,62,491,491,0,244,743,4,4,131,116,310,276,24,1414,360
1713,23,5.3.404,1,648,0,20,404,424,399,5,424,424,0,244,743,4,4,114,116,249,276,24,1414,360
1713,24,2.3.424,0,648,0,9,424,433,420,4,433,433,0,244,743,4,5,16,96,95,276,25,1414,340
1713,24,3.4.404,0,648,0,99,404,503,404,0,503,503,-67,296,810,5,3,99,244,238,352,25,1414,340
1713,24,4.3.424,1,648,0,87,424,511,342,82,511,511,0,244,743,4,5,131,96,310,276,25,1414,340
1713,24,5.4.424,0,668,1,94,424,518,424,0,518,518,-87,316,830,5,3,94,244,249,352,25,1414,340
1713,25,2.3.511,1,648,0,9,511,520,420,91,520,520,0,244,743,4,6,16,9,95,276,26,1414,253
1713,25,3.4.404,0,648,0,99,404,503,404,0,503,511,-67,296,810,5,3,99,244,238,352,26,1414,253
1713,25,4.4.511,0,656,1,44,511,555,511,0,555,555,-174,403,917,5,3,44,244,310,352,26,1414,253
1713,25,5.4.424,0,668,2,94,424,518,424,0,518,518,-87,316,830,5,3,94,244,249,352,26,1414,253
1713,26,2.4.520,0,665,2,7,520,527,520,0,527,527,-183,412,926,5,3,7,244,95,352,27,1414,244
1713,26,3.4.404,1,648,0,99,404,503,404,0,503,520,-67,296,810,5,3,99,244,238,352,27,1414,244
1713,26,4.4.511,0,656,1,44,511,555,511,0,555,555,-174,403,917,5,3,44,244,310,352,27,1414,244
1713,26,5.4.424,0,668,3,94,424,518,424,0,518,520,-87,316,830,5,3,94,244,249,352,27,1414,244
1713,27,2.4.520,0,665,2,7,520,527,520,0,527,527,-17,313,827,5,4,7,145,95,352,28,1414,145
1713,27,4.4.511,1,656,1,44,511,555,511,0,555,555,-8,304,818,5,4,44,145,310,352,28,1414,145
1713,27,5.4.503,0,648,0,94,503,597,424,79,597,597,0,296,810,5,4,94,145,249,352,28,1414,145
1713,28,2.4.555,1,656,0,7,555,562,520,35,562,562,0,304,818,5,5,7,101,95,352,29,1414,101
1713,28,5.4.555,0,656,0,94,555,649,424,131,649,649,0,304,818,5,5,94,101,249,352,29,1414,101
1713,29,5.4.562,1,656,0,94,562,656,424,138,656,656,0,304,818,5,6,94,94,249,352,30,1414,94
1714,0,0.0.0,0,585,1,29,0,29,0,0,29,29,0,0,0,1,1,265,322,265,322,1,1678,1678
1714,0,1.0.0,1,583,0,24,0,24,0,0,24,24,0,0,0,1,1,299,322,299,322,1,1678,1678
1714,0,2.0.0,0,629,3,86,0,86,0,0,86,86,0,0,0,1,1,319,322,319,322,1,1678,1678
1714,0,3.0.0,0,586,2,3,0,3,0,0,3,3,0,0,0,1,1,197,322,197,322,1,1678,1678
1714,0,4.0.0,0,671,5,88,0,88,0,0,88,88,0,0,0,1,1,249,322,249,322,1,1678,1678
1714,0,5.0.0,0,664,4,92,0,92,0,0,92,92,0,0,0,1,1,349,322,349,322,1,1678,1678
1714,1,0.0.24,0,583,0,29,24,53,0,24,53,53,0,0,0,1,2,265,298,265,322,2,1678,1654
1714,1,1.1.24,1,583,0,35,24,59,24,0,59,59,-24,24,24,2,1,275,266,299,266,2,1678,1654
1714,1,2.0.24,0,583,0,86,24,110,0,24,110,110,0,0,0,1,2,319,298,319,322,2,1678,1654
1714,1,3.0.24,0,583,0,3,24,27,0,24,27,27,0,0,0,1,2,197,298,197,322,2,1678,1654
1714,1,4.0.24,0,600,2,88,24,112,0,24,112,112,0,0,0,1,2,249,298,249,322,2,1678,1654
1714,1,5.0.24,0,593,1,92,24,116,0,24,116,116,0,0,0,1,2,349,298,349,322,2,1678,1654
1714,2,0.0.24,0,583,0,29,24,53,0,24,53,59,0,0,24,1,2,265,298,265,322,3,1678,1619
1714,2,1.2.59,1,583,0,60,59,119,59,0,119,119,-59,59,83,3,1,240,380,299,380,3,1678,1619
1714,2,2.0.24,0,583,0,86,24,110,0,24,110,110,0,0,24,1,2,319,298,319,322,3,1678,1619
1714,2,3.0.24,0,583,0,3,24,27,0,24,27,59,0,0,24,1,2,197,298,197,322,3,1678,1619
1714,2,4.0.24,0,600,2,88,24,112,0,24,112,112,0,0,24,1,2,249,298,249,322,3,1678,1619
1714,2,5.0.24,0,593,1,92,24,116,0,24,116,116,0,0,24,1,2,349,298,349,322,3,1678,1619
1714,3,0.0.24,0,583,0,29,24,53,0,24,53,119,0,0,83,1,2,265,298,265,322,4,1678,1559
1714,3,1.3.119,1,583,0,83,119,202,119,0,202,202,-119,119,202,4,1,180,329,299,329,4,1678,1559
1714,3,2.0.24,0,583,0,86,24,110,0,24,110,119,0,0,83,1,2,319,298,319,322,4,1678,1559
1714,3,3.0.24,0,583,0,3,24,27,0,24,27,119,0,0,83,1,2,197,298,197,322,4,1678,1559
1714,3,4.0.24,0,600,2,88,24,112,0,24,112,119,0,0,83,1,2,249,298,249,322,4,1678,1559
1714,3,5.0.24,0,593,1,92,24,116,0,24,116,119,0,0,83,1,2,349,298,349,322,4,1678,1559
1714,4,0.0.24,0,583,0,29,24,53,0,24,53,202,0,0,202,1,2,265,298,265,322,5,1678,1476
1714,4,1.4.202,1,583,0,97,202,299,202,0,299,299,-202,202,404,5,1,97,381,299,381,5,1678,1476
1714,4,2.0.24,0,583,0,86,24,110,0,24,110,202,0,0,202,1,2,319,298,319,322,5,1678,1476
1714,4,3.0.24,0,583,0,3,24,27,0,24,27,202,0,0,202,1,2,197,298,197,322,5,1678,1476
1714,4,4.0.24,0,600,2,88,24,112,0,24,112,202,0,0,202,1,2,249,298,249,322,5,1678,1476
1714,4,5.0.24,0,593,1,92,24,116,0,24,116,202,0,0,202,1,2,349,298,349,322,5,1678,1476
1714,5,0.0.24,1,583,0,29,24,53,0,24,53,299,0,0,404,1,2,265,298,265,322,6,1678,1379
1714,5,2.0.24,0,583,0,86,24,110,0,24,110,299,0,0,404,1,2,319,298,319,322,6,1678,1379
1714,5,3.0.24,0,583,0,3,24,27,0,24,27,299,0,0,404,1,2,197,298,197,322,6,1678,1379
1714,5,4.0.24,0,600,2,88,24,112,0,24,112,299,0,0,404,1,2,249,298,249,322,6,1678,1379
1714,5,5.0.24,0,593,1,92,24,116,0,24,116,299,0,0,404,1,2,349,298,349,322,6,1678,1379
1714,6,0.1.59,1,583,0,66,59,125,53,6,125,299,0,24,404,2,2,236,231,265,266,7,1678,1350
1714,6,2.0.53,0,583,0,86,53,139,0,53,139,299,0,0,404,1,3,319,269,319,322,7,1678,1350
1714,6,3.0.53,0,583,0,3,53,56,0,53,56,299,0,0,404,1,3,197,269,197,322,7,1678,1350
1714,6,4.0.53,0,600,2,88,53,141,0,53,141,299,0,0,404,1,3,249,269,249,322,7,1678,1350
1714,6,5.0.53,0,598,1,92,53,145,0,53,145,299,0,0,404,1,3,349,269,349,322,7,1678,1350
1714,7,0.2.125,1,583,0,19,125,144,125,0,144,299,-6,65,410,3,2,170,320,265,380,8,1678,1284
1714,7,2.0.53,0,583,0,86,53,139,0,53,139,299,0,0,404,1,3,319,269,319,322,8,1678,1284
1714,7,3.0.53,0,583,0,3,53,56,0,53,56,299,0,0,404,1,3,197,269,197,322,8,1678,1284
1714,7,4.0.53,0,600,2,88,53,141,0,53,141,299,0,0,404,1,3,249,269,249,322,8,1678,1284
1714,7,5.0.53,0,598,1,92,53,145,0,53,145,299,0,0,404,1,3,349,269,349,322,8,1678,1284
1714,8,0.3.202,1,583,0,79,202,281,144,58,281,299,0,119,410,4,2,151,246,265,329,9,1678,1265
1714,8,2.0.53,0,583,0,86,53,139,0,53,139,299,0,0,410,1,3,319,269,319,322,9,1678,1265
1714,8,3.0.53,0,583,0,3,53,56,0,53,56,299,0,0,410,1,3,197,269,197,322,9,1678,1265
1714,8,4.0.53,0,600,2,88,53,141,0,53,141,299,0,0,410,1,3,249,269,249,322,9,1678,1265
1714,8,5.0.53,0,598,1,92,53,145,0,53,145,299,0,0,410,1,3,349,269,349,322,9,1678,1265
1714,9,0.4.299,1,583,0,72,299,371,281,18,371,371,0,202,410,5,2,72,284,265,381,10,1678,1186
1714,9,2.0.53,0,583,0,86,53,139,0,53,139,299,0,0,410,1,3,319,269,319,322,10,1678,1186
1714,9,3.0.53,0,583,0,3,53,56,0,53,56,299,0,0,410,1,3,197,269,197,322,10,1678,1186
1714,9,4.0.53,0,600,2,88,53,141,0,53,141,299,0,0,410,1,3,249,269,249,322,10,1678,1186
1714,9,5.0.53,0,598,1,92,53,145,0,53,145,299,0,0,410,1,3,349,269,349,322,10,1678,1186
1714,10,2.0.53,0,583,0,86,53,139,0,53,139,371,0,0,410,1,3,319,269,319,322,11,1678,1114
1714,10,3.0.53,1,583,0,3,53,56,0,53,56,371,0,0,410,1,3,197,269,197,322,11,1678,1114
1714,10,4.0.53,0,600,2,88,53,141,0,53,141,371,0,0,410,1,3,249,269,249,322,11,1678,1114
1714,10,5.0.53,0,598,1,92,53,145,0,53,145,371,0,0,410,1,3,349,269,349,322,11,1678,1114
1714,11,2.0.56,0,583,0,86,56,142,0,56,142,371,0,0,410,1,4,319,266,319,322,12,1678,1111
1714,11,3.1.125,1,592,1,66,125,191,56,69,191,371,0,24,410,2,3,194,165,197,266,12,1678,1111
1714,11,4.0.56,0,596,3,88,56,144,0,56,144,371,0,0,410,1,4,249,266,249,322,12,1678,1111
1714,11,5.0.56,0,595,2,92,56,148,0,56,148,371,0,0,410,1,4,349,266,349,322,12,1678,1111
1714,12,2.0.56,0,592,0,86,56,142,0,56,142,371,0,0,410,1,4,319,266,319,322,13,1678,1045
1714,12,3.2.191,0,595,1,82,191,273,191,0,273,371,-47,112,457,3,3,128,301,197,380,13,1678,1045
1714,12,4.0.56,0,596,2,88,56,144,0,56,144,371,0,0,410,1,4,249,266,249,322,13,1678,1045
1714,12,5.0.56,1,595,1,92,56,148,0,56,148,371,0,0,410,1,4,349,266,349,322,13,1678,1045
1714,13,2.0.148,0,595,0,86,148,234,0,148,234,371,0,0,410,1,5,319,174,319,322,14,1678,953
1714,13,3.2.191,0,595,0,82,191,273,191,0,273,371,-47,112,457,3,3,128,301,197,380,14,1678,953
1714,13,4.0.148,0,603,1,88,148,236,0,148,236,371,0,0,410,1,5,249,174,249,322,14,1678,953
1714,13,5.1.191,1,603,1,88,191,279,148,43,279,371,0,24,410,2,4,257,99,349,266,14,1678,953
1714,14,2.0.148,1,603,0,86,148,234,0,148,234,371,0,0,410,1,5,319,174,319,322,15,1678,865
1714,14,3.2.191,0,603,0,82,191,273,191,0,273,371,-47,112,457,3,3,128,301,197,380,15,1678,865
1714,14,4.0.148,0,603,0,88,148,236,0,148,236,371,0,0,410,1,5,249,174,249,322,15,1678,865
1714,14,5.2.279,0,603,0,79,279,358,279,0,358,371,-135,200,545,3,3,169,301,349,380,15,1678,865
1714,15,2.1.279,1,603,0,10,279,289,234,45,289,371,0,24,410,2,5,233,11,319,266,16,1678,779
1714,15,3.2.191,0,603,0,82,191,273,191,0,273,371,-47,112,457,3,3,128,301,197,380,16,1678,779
1714,15,4.0.234,0,603,0,88,234,322,0,234,322,371,0,0,410,1,6,249,88,249,322,16,1678,779
1714,15,5.2.279,0,603,0,79,279,358,279,0,358,371,-135,200,545,3,3,169,301,349,380,16,1678,779
1714,16,2.2.289,0,611,1,74,289,363,289,0,363,371,-145,210,555,3,3,223,301,319,380,17,1678,769
1714,16,3.2.191,0,603,0,82,191,273,191,0,273,371,-47,112,457,3,3,128,301,197,380,17,1678,769
1714,16,4.0.234,1,603,0,88,234,322,0,234,322,371,0,0,410,1,6,249,88,249,322,17,1678,769
1714,16,5.2.279,0,603,0,79,279,358,279,0,358,371,-135,200,545,3,3,169,301,349,380,17,1678,769
1714,17,2.2.289,0,611,1,74,289,363,289,0,363,371,-145,210,555,3,3,223,301,319,380,18,1678,681
1714,17,3.2.191,0,603,0,82,191,273,191,0,273,371,-47,112,457,3,3,128,301,197,380,18,1678,681
1714,17,4.1.322,1,603,0,1,322,323,322,0,323,371,-33,57,443,2,6,161,1,249,266,18,1678,681
1714,17,5.2.279,0,603,0,79,279,358,279,0,358,371,-135,200,545,3,3,169,301,349,380,18,1678,681
1714,18,2.2.289,0,611,1,74,289,363,289,0,363,371,-145,210,588,3,3,223,301,319,380,19,1678,680
1714,18,3.2.191,1,603,0,82,191,273,191,0,273,371,-47,112,490,3,3,128,301,197,380,19,1678,680
1714,18,4.2.323,0,691,2,66,323,389,323,0,389,389,-179,244,622,3,3,160,301,249,380,19,1678,680
1714,18,5.2.279,0,603,0,79,279,358,279,0,358,371,-135,200,578,3,3,169,301,349,380,19,1678,680
1714,19,2.2.289,0,611,1,74,289,363,289,0,363,371,-16,128,506,3,4,223,219,319,380,20,1678,598
1714,19,3.3.281,1,603,0,5,281,286,273,8,286,371,0,119,490,4,3,46,167,197,329,20,1678,598
1714,19,4.2.323,0,691,2,66,323,389,323,0,389,389,-50,162,540,3,4,160,219,249,380,20,1678,598
1714,19,5.2.279,0,603,0,79,279,358,279,0,358,371,-6,118,496,3,4,169,219,349,380,20,1678,598
1714,20,2.2.289,0,611,1,74,289,363,289,0,363,371,-16,128,506,3,4,223,219,319,380,21,1678,593
1714,20,3.4.371,1,603,0,41,371,412,286,85,412,412,0,202,490,5,3,41,212,197,381,21,1678,593
1714,20,4.2.323,0,691,2,66,323,389,323,0,389,389,-50,162,540,3,4,160,219,249,380,21,1678,593
1714,20,5.2.279,0,603,0,79,279,358,279,0,358,371,-6,118,496,3,4,169,219,349,380,21,1678,593
1714,21,2.2.289,0,611,1,74,289,363,289,0,363,412,-16,128,506,3,4,223,219,319,380,22,1678,552
1714,21,4.2.323,0,691,2,66,323,389,323,0,389,412,-50,162,540,3,4,160,219,249,380,22,1678,552
1714,21,5.2.279,1,603,0,79,279,358,279,0,358,412,-6,118,496,3,4,169,219,349,380,22,1678,552
1714,22,2.2.358,0,603,0,74,358,432,289,69,432,432,0,118,496,3,5,223,140,319,380,23,1678,473
1714,22,4.2.358,0,653,1,66,358,424,323,35,424,424,0,118,496,3,5,160,140,249,380,23,1678,473
1714,22,5.3.358,1,603,0,5,358,363,358,0,363,412,-72,191,568,4,4,90,162,349,329,23,1678,473
1714,23,2.2.358,0,603,0,74,358,432,289,69,432,432,0,118,568,3,5,223,140,319,380,24,1678,468
1714,23,4.2.358,0,653,1,66,358,424,323,35,424,424,0,118,568,3,5,160,140,249,380,24,1678,468
1714,23,5.4.412,1,603,0,85,412,497,363,49,497,497,0,202,568,5,4,85,171,349,381,24,1678,468
1714,24,2.2.358,1,603,0,74,358,432,289,69,432,497,0,118,568,3,5,223,140,319,380,25,1678,383
1714,24,4.2.358,0,653,1,66,358,424,323,35,424,497,0,118,568,3,5,160,140,249,380,25,1678,383
1714,25,2.3.432,0,603,0,77,432,509,432,0,509,509,-69,260,637,4,5,149,157,319,329,26,1678,309
1714,25,4.2.432,1,603,0,66,432,498,323,109,498,498,0,118,568,3,6,160,66,249,380,26,1678,309
1714,26,2.3.432,1,603,0,77,432,509,432,0,509,509,-69,260,637,4,5,149,157,319,329,27,1678,243
1714,26,4.3.498,0,727,1,80,498,578,498,0,578,578,-135,326,703,4,5,94,157,249,329,27,1678,243
1714,27,2.4.509,1,603,0,72,509,581,509,0,581,581,-12,214,649,5,5,72,86,319,381,28,1678,166
1714,27,4.3.509,0,603,0,80,509,589,498,11,589,589,0,260,637,4,6,94,80,249,329,28,1678,166
1714,28,4.3.509,1,603,0,80,509,589,498,11,589,589,0,260,649,4,6,94,80,249,329,29,1678,94
1714,29,4.4.589,1,603,0,14,589,603,589,0,603,603,-8,222,657,5,6,14,14,249,381,30,1678,14
1715,0,0.0.0,0,534,3,42,0,42,0,0,42,42,0,0,0,1,1,209,338,209,338,1,1451,1451
1715,0,1.0.0,0,589,5,99,0,99,0,0,99,99,0,0,0,1,1,201,338,201,338,1,1451,1451
1715,0,2.0.0,0,497,0,33,0,33,0,0,33,33,0,0,0,1,1,148,338,148,338,1,1451,1451
1715,0,3.0.0,0,498,1,56,0,56,0,0,56,56,0,0,0,1,1,257,338,257,338,1,1451,1451
1715,0,4.0.0,1,500,2,11,0,11,0,0,11,11,0,0,0,1,1,286,338,286,338,1,1451,1451
1715,0,5.0.0,0,583,4,97,0,97,0,0,97,97,0,0,0,1,1,350,338,350,338,1,1451,1451
1715,1,0.0.11,0,533,3,42,11,53,0,11,53,53,0,0,0,1,2,209,327,209,338,2,1451,1440
1715,1,1.0.11,0,583,4,99,11,110,0,11,110,110,0,0,0,1,2,201,327,201,338,2,1451,1440
1715,1,2.0.11,0,500,0,33,11,44,0,11,44,44,0,0,0,1,2,148,327,148,338,2,1451,1440
1715,1,3.0.11,0,509,1,56,11,67,0,11,67,67,0,0,0,1,2,257,327,257,338,2,1451,1440
1715,1,4.1.11,1,500,0,52,11,63,11,0,63,63,-11,11,11,2,1,275,170,286,170,2,1451,1440
1715,1,5.0.11,0,520,2,97,11,108,0,11,108,108,0,0,0,1,2,350,327,350,338,2,1451,1440
1715,2,0.0.11,0,533,4,42,11,53,0,11,53,63,0,0,11,1,2,209,327,209,338,3,1451,1388
1715,2,1.0.11,0,583,5,99,11,110,0,11,110,110,0,0,11,1,2,201,327,201,338,3,1451,1388
1715,2,2.0.11,0,500,0,33,11,44,0,11,44,63,0,0,11,1,2,148,327,148,338,3,1451,1388
1715,2,3.0.11,0,509,1,56,11,67,0,11,67,67,0,0,11,1,2,257,327,257,338,3,1451,1388
1715,2,4.2.63,1,517,2,67,63,130,63,0,130,130,-63,63,74,3,1,223,251,286,251,3,1451,1388
1715,2,5.0.11,0,520,3,97,11,108,0,11,108,108,0,0,11,1,2,350,327,350,338,3,1451,1388
1715,3,0.0.11,0,533,2,42,11,53,0,11,53,130,0,0,74,1,2,209,327,209,338,4,1451,1321
1715,3,1.0.11,0,583,3,99,11,110,0,11,110,130,0,0,74,1,2,201,327,201,338,4,1451,1321
1715,3,2.0.11,0,517,0,33,11,44,0,11,44,130,0,0,74,1,2,148,327,148,338,4,1451,1321
1715,3,3.0.11,0,517,0,56,11,67,0,11,67,130,0,0,74,1,2,257,327,257,338,4,1451,1321
1715,3,4.3.130,1,517,0,73,130,203,130,0,203,203,-130,130,204,4,1,156,380,286,380,4,1451,1321
1715,3,5.0.11,0,520,1,97,11,108,0,11,108,130,0,0,74,1,2,350,327,350,338,4,1451,1321
1715,4,0.0.11,0,533,2,42,11,53,0,11,53,203,0,0,204,1,2,209,327,209,338,5,1451,1248
1715,4,1.0.11,0,583,3,99,11,110,0,11,110,203,0,0,204,1,2,201,327,201,338,5,1451,1248
1715,4,2.0.11,0,517,0,33,11,44,0,11,44,203,0,0,204,1,2,148,327,148,338,5,1451,1248
1715,4,3.0.11,0,517,0,56,11,67,0,11,67,203,0,0,204,1,2,257,327,257,338,5,1451,1248
1715,4,4.4.203,1,517,0,83,203,286,203,0,286,286,-203,203,407,5,1,83,312,286,312,5,1451,1248
1715,4,5.0.11,0,520,1,97,11,108,0,11,108,203,0,0,204,1,2,350,327,350,338,5,1451,1248
1715,5,0.0.11,0,533,2,42,11,53,0,11,53,286,0,0,407,1,2,209,327,209,338,6,1451,1165
1715,5,1.0.11,0,583,3,99,11,110,0,11,110,286,0,0,407,1,2,201,327,201,338,6,1451,1165
1715,5,2.0.11,0,517,0,33,11,44,0,11,44,286,0,0,407,1,2,148,327,148,338,6,1451,1165
1715,5,3.0.11,1,517,0,56,11,67,0,11,67,286,0,0,407,1,2,257,327,257,338,6,1451,1165
1715,5,5.0.11,0,520,1,97,11,108,0,11,108,286,0,0,407,1,2,350,327,350,338,6,1451,1165
1715,6,0.0.67,0,533,1,42,67,109,0,67,109,286,0,0,407,1,3,209,271,209,338,7,1451,1109
1715,6,1.0.67,0,583,2,99,67,166,0,67,166,286,0,0,407,1,3,201,271,201,338,7,1451,1109
1715,6,2.0.67,0,517,0,33,67,100,0,67,100,286,0,0,407,1,3,148,271,148,338,7,1451,1109
1715,6,3.1.67,1,517,0,5,67,72,67,0,72,286,-4,15,411,2,2,201,118,257,170,7,1451,1109
1715,6,5.0.67,0,517,0,97,67,164,0,67,164,286,0,0,407,1,3,350,271,350,338,7,1451,1109
1715,7,0.0.67,0,533,1,42,67,109,0,67,109,286,0,0,411,1,3,209,271,209,338,8,1451,1104
1715,7,1.0.67,0,583,2,99,67,166,0,67,166,286,0,0,411,1,3,201,271,201,338,8,1451,1104
1715,7,2.0.67,0,517,0,33,67,100,0,67,100,286,0,0,411,1,3,148,271,148,338,8,1451,1104
1715,7,3.2.130,1,517,0,50,130,180,72,58,180,286,0,63,411,3,2,196,184,257,251,8,1451,1104
1715,7,5.0.67,0,517,0,97,67,164,0,67,164,286,0,0,411,1,3,350,271,350,338,8,1451,1104
1715,8,0.0.67,0,533,1,42,67,109,0,67,109,286,0,0,411,1,3,209,271,209,338,9,1451,1054
1715,8,1.0.67,0,583,2,99,67,166,0,67,166,286,0,0,411,1,3,201,271,201,338,9,1451,1054
1715,8,2.0.67,0,517,0,33,67,100,0,67,100,286,0,0,411,1,3,148,271,148,338,9,1451,1054
1715,8,3.3.203,1,517,0,63,203,266,180,23,266,286,0,130,411,4,2,146,307,257,380,9,1451,1054
1715,8,5.0.67,0,517,0,97,67,164,0,67,164,286,0,0,411,1,3,350,271,350,338,9,1451,1054
1715,9,0.0.67,0,533,1,42,67,109,0,67,109,286,0,0,411,1,3,209,271,209,338,10,1451,991
1715,9,1.0.67,0,583,2,99,67,166,0,67,166,286,0,0,411,1,3,201,271,201,338,10,1451,991
1715,9,2.0.67,0,517,0,33,67,100,0,67,100,286,0,0,411,1,3,148,271,148,338,10,1451,991
1715,9,3.4.286,1,517,0,83,286,369,266,20,369,369,0,203,411,5,2,83,229,257,312,10,1451,991
1715,9,5.0.67,0,517,0,97,67,164,0,67,164,286,0,0,411,1,3,350,271,350,338,10,1451,991
1715,10,0.0.67,0,533,1,42,67,109,0,67,109,369,0,0,411,1,3,209,271,209,338,11,1451,908
1715,10,1.0.67,0,583,2,99,67,166,0,67,166,369,0,0,411,1,3,201,271,201,338,11,1451,908
1715,10,2.0.67,0,517,0,33,67,100,0,67,100,369,0,0,411,1,3,148,271,148,338,11,1451,908
1715,10,5.0.67,1,517,0,97,67,164,0,67,164,369,0,0,411,1,3,350,271,350,338,11,1451,908
1715,11,0.0.164,0,517,0,42,164,206,0,164,206,369,0,0,411,1,4,209,174,209,338,12,1451,811
1715,11,1.0.164,0,517,0,99,164,263,0,164,263,369,0,0,411,1,4,201,174,201,338,12,1451,811
1715,11,2.0.164,0,517,0,33,164,197,0,164,197,369,0,0,411,1,4,148,174,148,338,12,1451,811
1715,11,5.1.164,1,517,0,71,164,235,164,0,235,369,-92,107,503,2,3,253,113,350,170,12,1451,811
1715,12,0.0.164,0,517,0,42,164,206,0,164,206,369,0,0,503,1,4,209,174,209,338,13,1451,740
1715,12,1.0.164,0,517,0,99,164,263,0,164,263,369,0,0,503,1,4,201,174,201,338,13,1451,740
1715,12,2.0.164,0,517,0,33,164,197,0,164,197,369,0,0,503,1,4,148,174,148,338,13,1451,740
1715,12,5.2.235,1,517,0,18,235,253,235,0,253,369,-55,118,558,3,3,182,134,350,251,13,1451,740
1715,13,0.0.164,0,517,0,42,164,206,0,164,206,369,0,0,558,1,4,209,174,209,338,14,1451,722
1715,13,1.0.164,0,517,0,99,164,263,0,164,263,369,0,0,558,1,4,201,174,201,338,14,1451,722
1715,13,2.0.164,0,517,0,33,164,197,0,164,197,369,0,0,558,1,4,148,174,148,338,14,1451,722
1715,13,5.3.266,1,517,0,88,266,354,253,13,354,369,0,130,558,4,3,164,244,350,380,14,1451,722
1715,14,0.0.164,0,517,0,42,164,206,0,164,206,369,0,0,558,1,4,209,174,209,338,15,1451,634
1715,14,1.0.164,0,517,0,99,164,263,0,164,263,369,0,0,558,1,4,201,174,201,338,15,1451,634
1715,14,2.0.164,0,517,0,33,164,197,0,164,197,369,0,0,558,1,4,148,174,148,338,15,1451,634
1715,14,5.4.369,1,517,0,76,369,445,354,15,445,445,0,203,558,5,3,76,146,350,312,15,1451,634
1715,15,0.0.164,1,517,0,42,164,206,0,164,206,445,0,0,558,1,4,209,174,209,338,16,1451,558
1715,15,1.0.164,0,517,0,99,164,263,0,164,263,445,0,0,558,1,4,201,174,201,338,16,1451,558
1715,15,2.0.164,0,517,0,33,164,197,0,164,197,445,0,0,558,1,4,148,174,148,338,16,1451,558
1715,16,0.1.235,1,517,0,34,235,269,206,29,269,445,0,107,558,2,4,167,42,209,170,17,1451,516
1715,16,1.0.206,0,530,1,99,206,305,0,206,305,445,0,0,558,1,5,201,132,201,338,17,1451,516
1715,16,2.0.206,0,517,0,33,206,239,0,206,239,445,0,0,558,1,5,148,132,148,338,17,1451,516
1715,17,0.2.269,1,517,0,23,269,292,269,0,292,445,-16,134,574,3,4,133,116,209,251,18,1451,482
1715,17,1.0.206,0,530,1,99,206,305,0,206,305,445,0,0,558,1,5,201,132,201,338,18,1451,482
1715,17,2.0.206,0,517,0,33,206,239,0,206,239,445,0,0,558,1,5,148,132,148,338,18,1451,482
1715,18,0.3.354,0,530,1,85,354,439,292,62,439,445,0,130,574,4,4,110,156,209,380,19,1451,459
1715,18,1.0.206,0,530,1,99,206,305,0,206,305,445,0,0,574,1,5,201,132,201,338,19,1451,459
1715,18,2.0.206,1,517,0,33,206,239,0,206,239,445,0,0,574,1,5,148,132,148,338,19,1451,459
1715,19,0.3.354,0,530,1,85,354,439,292,62,439,445,0,130,574,4,4,110,156,209,380,20,1451,426
1715,19,1.0.239,0,517,0,99,239,338,0,239,338,445,0,0,574,1,6,201,99,201,338,20,1451,426
1715,19,2.1.269,1,517,0,4,269,273,239,30,273,445,0,107,574,2,5,115,8,148,170,20,1451,426
1715,20,0.3.354,0,530,1,85,354,439,292,62,439,445,0,130,574,4,4,110,156,209,380,21,1451,422
1715,20,1.0.239,0,517,0,99,239,338,0,239,338,445,0,0,574,1,6,201,99,201,338,21,1451,422
1715,20,2.2.292,1,517,0,27,292,319,273,19,319,445,0,134,574,3,5,111,93,148,251,21,1451,422
1715,21,0.3.354,0,530,1,85,354,439,292,62,439,445,0,130,574,4,4,110,156,209,380,22,1451,395
1715,21,1.0.239,0,517,0,99,239,338,0,239,338,445,0,0,574,1,6,201,99,201,338,22,1451,395
1715,21,2.3.354,1,517,0,46,354,400,319,35,400,445,0,130,574,4,4,84,156,148,380,22,1451,395
1715,22,0.3.400,0,517,0,85,400,485,292,108,485,485,0,130,574,4,5,110,110,209,380,23,1451,349
1715,22,1.0.239,0,517,0,99,239,338,0,239,338,445,0,0,574,1,6,201,99,201,338,23,1451,349
1715,22,2.4.445,1,517,0,38,445,483,400,45,483,483,0,203,574,5,4,38,70,148,312,23,1451,349
1715,23,0.3.400,1,517,0,85,400,485,292,108,485,485,0,130,574,4,5,110,110,209,380,24,1451,311
1715,23,1.0.239,0,517,0,99,239,338,0,239,338,483,0,0,574,1,6,201,99,201,338,24,1451,311
1715,24,0.4.485,1,517,0,25,485,510,485,0,510,510,-2,205,576,5,5,25,32,209,312,25,1451,226
1715,24,1.0.239,0,517,0,99,239,338,0,239,338,485,0,0,574,1,6,201,99,201,338,25,1451,226
1715,25,1.0.239,1,517,0,99,239,338,0,239,338,510,0,0,576,1,6,201,99,201,338,26,1451,201
1715,26,1.1.338,1,517,0,4,338,342,338,0,342,510,-65,172,641,2,6,102,4,201,170,27,1451,102
1715,27,1.2.342,1,517,0,66,342,408,342,0,408,510,-23,157,664,3,6,98,66,201,251,28,1451,98
1715,28,1.3.485,1,517,0,25,485,510,408,77,510,510,0,130,664,4,6,32,25,201,380,29,1451,32
1715,29,1.4.510,1,517,0,7,510,517,510,0,517,517,0,205,664,5,6,7,7,201,312,30,1451,7
1716,0,0.0.0,0,448,0,55,0,55,0,0,55,55,0,0,0,1,1,252,253,252,253,1,1422,1422
1716,0,1.0.0,0,492,1,75,0,75,0,0,75,75,0,0,0,1,1,300,253,300,253,1,1422,1422
1716,0,2.0.0,0,512,2,78,0,78,0,0,78,78,0,0,0,1,1,273,253,273,253,1,1422,1422
1716,0,3.0.0,0,448,0,10,0,10,0,0,10,10,0,0,0,1,1,118,253,118,253,1,1422,1422
1716,0,4.0.0,0,448,0,32,0,32,0,0,32,32,0,0,0,1,1,225,253,225,253,1,1422,1422
1716,0,5.0.0,1,448,0,3,0,3,0,0,3,3,0,0,0,1,1,254,253,254,253,1,1422,1422
1716,1,0.0.3,0,448,0,55,3,58,0,3,58,58,0,0,0,1,2,252,250,252,253,2,1422,1419
1716,1,1.0.3,0,455,2,75,3,78,0,3,78,78,0,0,0,1,2,300,250,300,253,2,1422,1419
1716,1,2.0.3,0,486,3,78,3,81,0,3,81,81,0,0,0,1,2,273,250,273,253,2,1422,1419
1716,1,3.0.3,0,448,0,10,3,13,0,3,13,13,0,0,0,1,2,118,250,118,253,2,1422,1419
1716,1,4.0.3,0,449,1,32,3,35,0,3,35,35,0,0,0,1,2,225,250,225,253,2,1422,1419
1716,1,5.1.3,1,448,0,55,3,58,3,0,58,58,-3,3,3,2,1,251,272,254,272,2,1422,1419
1716,2,0.0.3,0,448,0,55,3,58,0,3,58,58,0,0,3,1,2,252,250,252,253,3,1422,1364
1716,2,1.0.3,0,455,1,75,3,78,0,3,78,78,0,0,3,1,2,300,250,300,253,3,1422,1364
1716,2,2.0.3,0,486,2,78,3,81,0,3,81,81,0,0,3,1,2,273,250,273,253,3,1422,1364
1716,2,3.0.3,0,448,0,10,3,13,0,3,13,58,0,0,3,1,2,118,250,118,253,3,1422,1364
1716,2,4.0.3,0,455,1,32,3,35,0,3,35,58,0,0,3,1,2,225,250,225,253,3,1422,1364
1716,2,5.2.58,1,455,1,56,58,114,58,0,114,114,-58,58,61,3,1,196,318,254,318,3,1422,1364
1716,3,0.0.3,0,455,0,55,3,58,0,3,58,114,0,0,61,1,2,252,250,252,253,4,1422,1308
1716,3,1.0.3,0,455,0,75,3,78,0,3,78,114,0,0,61,1,2,300,250,300,253,4,1422,1308
1716,3,2.0.3,0,486,1,78,3,81,0,3,81,114,0,0,61,1,2,273,250,273,253,4,1422,1308
1716,3,3.0.3,0,455,0,10,3,13,0,3,13,114,0,0,61,1,2,118,250,118,253,4,1422,1308
1716,3,4.0.3,0,455,0,32,3,35,0,3,35,114,0,0,61,1,2,225,250,225,253,4,1422,1308
1716,3,5.3.114,1,455,0,73,114,187,114,0,187,187,-114,114,175,4,1,140,336,254,336,4,1422,1308
1716,4,0.0.3,0,455,0,55,3,58,0,3,58,187,0,0,175,1,2,252,250,252,253,5,1422,1235
1716,4,1.0.3,0,455,0,75,3,78,0,3,78,187,0,0,175,1,2,300,250,300,253,5,1422,1235
1716,4,2.0.3,0,486,1,78,3,81,0,3,81,187,0,0,175,1,2,273,250,273,253,5,1422,1235
1716,4,3.0.3,0,455,0,10,3,13,0,3,13,187,0,0,175,1,2,118,250,118,253,5,1422,1235
1716,4,4.0.3,0,455,0,32,3,35,0,3,35,187,0,0,175,1,2,225,250,225,253,5,1422,1235
1716,4,5.4.187,1,455,0,67,187,254,187,0,254,254,-187,187,362,5,1,67,243,254,243,5,1422,1235
1716,5,0.0.3,0,455,0,55,3,58,0,3,58,254,0,0,362,1,2,252,250,252,253,6,1422,1168
1716,5,1.0.3,0,455,0,75,3,78,0,3,78,254,0,0,362,1,2,300,250,300,253,6,1422,1168
1716,5,2.0.3,0,486,1,78,3,81,0,3,81,254,0,0,362,1,2,273,250,273,253,6,1422,1168
1716,5,3.0.3,0,455,0,10,3,13,0,3,13,254,0,0,362,1,2,118,250,118,253,6,1422,1168
1716,5,4.0.3,1,455,0,32,3,35,0,3,35,254,0,0,362,1,2,225,250,225,253,6,1422,1168
1716,6,0.0.35,0,455,0,55,35,90,0,35,90,254,0,0,362,1,3,252,218,252,253,7,1422,1136
1716,6,1.0.35,0,455,0,75,35,110,0,35,110,254,0,0,362,1,3,300,218,300,253,7,1422,1136
1716,6,2.0.35,0,486,1,78,35,113,0,35,113,254,0,0,362,1,3,273,218,273,253,7,1422,1136
1716,6,3.0.35,0,455,0,10,35,45,0,35,45,254,0,0,362,1,3,118,218,118,253,7,1422,1136
1716,6,4.1.58,1,455,0,5,58,63,35,23,63,254,0,3,362,2,2,193,217,225,272,7,1422,1136
1716,7,0.0.35,0,455,0,55,35,90,0,35,90,254,0,0,362,1,3,252,218,252,253,8,1422,1131
1716,7,1.0.35,0,455,0,75,35,110,0,35,110,254,0,0,362,1,3,300,218,300,253,8,1422,1131
1716,7,2.0.35,0,486,2,78,35,113,0,35,113,254,0,0,362,1,3,273,218,273,253,8,1422,1131
1716,7,3.0.35,0,455,0,10,35,45,0,35,45,254,0,0,362,1,3,118,218,118,253,8,1422,1131
1716,7,4.2.114,1,465,1,68,114,182,63,51,182,254,0,58,362,3,2,188,262,225,318,8,1422,1131
1716,8,0.0.35,0,465,0,55,35,90,0,35,90,254,0,0,362,1,3,252,218,252,253,9,1422,1063
1716,8,1.0.35,0,465,0,75,35,110,0,35,110,254,0,0,362,1,3,300,218,300,253,9,1422,1063
1716,8,2.0.35,0,486,1,78,35,113,0,35,113,254,0,0,362,1,3,273,218,273,253,9,1422,1063
1716,8,3.0.35,0,465,0,10,35,45,0,35,45,254,0,0,362,1,3,118,218,118,253,9,1422,1063
1716,8,4.3.187,1,465,0,66,187,253,182,5,253,254,0,114,362,4,2,120,263,225,336,9,1422,1063
1716,9,0.0.35,0,465,0,55,35,90,0,35,90,254,0,0,362,1,3,252,218,252,253,10,1422,997
1716,9,1.0.35,0,465,0,75,35,110,0,35,110,254,0,0,362,1,3,300,218,300,253,10,1422,997
1716,9,2.0.35,0,486,1,78,35,113,0,35,113,254,0,0,362,1,3,273,218,273,253,10,1422,997
1716,9,3.0.35,0,465,0,10,35,45,0,35,45,254,0,0,362,1,3,118,218,118,253,10,1422,997
1716,9,4.4.254,1,465,0,54,254,308,253,1,308,308,0,187,362,5,2,54,176,225,243,10,1422,997
1716,10,0.0.35,1,465,0,55,35,90,0,35,90,308,0,0,362,1,3,252,218,252,253,11,1422,943
1716,10,1.0.35,0,465,0,75,35,110,0,35,110,308,0,0,362,1,3,300,218,300,253,11,1422,943
1716,10,2.0.35,0,486,1,78,35,113,0,35,113,308,0,0,362,1,3,273,218,273,253,11,1422,943
1716,10,3.0.35,0,465,0,10,35,45,0,35,45,308,0,0,362,1,3,118,218,118,253,11,1422,943
1716,11,0.1.90,1,465,0,2,90,92,90,0,92,308,-27,30,389,2,3,197,212,252,272,12,1422,888
1716,11,1.0.90,0,474,1,75,90,165,0,90,165,308,0,0,362,1,4,300,163,300,253,12,1422,888
1716,11,2.0.90,0,519,2,78,90,168,0,90,168,308,0,0,362,1,4,273,163,273,253,12,1422,888
1716,11,3.0.90,0,465,0,10,90,100,0,90,100,308,0,0,362,1,4,118,163,118,253,12,1422,888
1716,12,0.2.182,1,465,0,26,182,208,92,90,208,308,0,58,389,3,3,195,194,252,318,13,1422,886
1716,12,1.0.90,0,474,1,75,90,165,0,90,165,308,0,0,389,1,4,300,163,300,253,13,1422,886
1716,12,2.0.90,0,519,2,78,90,168,0,90,168,308,0,0,389,1,4,273,163,273,253,13,1422,886
1716,12,3.0.90,0,465,0,10,90,100,0,90,100,308,0,0,389,1,4,118,163,118,253,13,1422,886
1716,13,0.3.253,1,467,1,92,253,345,208,45,345,345,0,114,389,4,3,169,197,252,336,14,1422,860
1716,13,1.0.90,0,474,2,75,90,165,0,90,165,308,0,0,389,1,4,300,163,300,253,14,1422,860
1716,13,2.0.90,0,519,3,78,90,168,0,90,168,308,0,0,389,1,4,273,163,273,253,14,1422,860
1716,13,3.0.90,0,465,0,10,90,100,0,90,100,308,0,0,389,1,4,118,163,118,253,14,1422,860
1716,14,0.4.345,1,467,0,77,345,422,345,0,422,422,-37,224,426,5,3,77,122,252,243,15,1422,768
1716,14,1.0.90,0,474,1,75,90,165,0,90,165,345,0,0,389,1,4,300,163,300,253,15,1422,768
1716,14,2.0.90,0,519,2,78,90,168,0,90,168,345,0,0,389,1,4,273,163,273,253,15,1422,768
1716,14,3.0.90,0,467,0,10,90,100,0,90,100,345,0,0,389,1,4,118,163,118,253,15,1422,768
1716,15,1.0.90,1,474,1,75,90,165,0,90,165,422,0,0,426,1,4,300,163,300,253,16,1422,691
1716,15,2.0.90,0,519,2,78,90,168,0,90,168,422,0,0,426,1,4,273,163,273,253,16,1422,691
1716,15,3.0.90,0,467,0,10,90,100,0,90,100,422,0,0,426,1,4,118,163,118,253,16,1422,691
1716,16,1.1.165,0,474,0,71,165,236,165,0,236,422,-73,103,499,2,4,225,210,300,272,17,1422,616
1716,16,2.0.165,0,484,1,78,165,243,0,165,243,422,0,0,426,1,5,273,88,273,253,17,1422,616
1716,16,3.0.165,1,474,0,10,165,175,0,165,175,422,0,0,426,1,5,118,88,118,253,17,1422,616
1716,17,1.1.165,0,474,0,71,165,236,165,0,236,422,-73,103,499,2,4,225,210,300,272,18,1422,606
1716,17,2.0.175,1,474,0,78,175,253,0,175,253,422,0,0,426,1,6,273,78,273,253,18,1422,606
1716,17,3.1.175,0,484,1,43,175,218,175,0,218,422,-83,113,509,2,4,108,210,118,272,18,1422,606
1716,18,1.1.165,1,474,0,71,165,236,165,0,236,422,-73,103,499,2,4,225,210,300,272,19,1422,528
1716,18,2.1.253,0,494,2,96,253,349,253,0,349,422,-161,191,587,2,4,195,210,273,272,19,1422,528
1716,18,3.1.175,0,484,1,43,175,218,175,0,218,422,-83,113,509,2,4,108,210,118,272,19,1422,528
1716,19,1.2.236,1,474,0,71,236,307,236,0,307,422,-28,86,527,3,4,154,168,300,318,20,1422,457
1716,19,2.1.253,0,494,1,96,253,349,253,0,349,422,-17,120,516,2,5,195,139,273,272,20,1422,457
1716,19,3.1.236,0,474,0,43,236,279,175,61,279,422,0,103,499,2,5,108,139,118,272,20,1422,457
1716,20,1.3.345,1,474,0,67,345,412,307,38,412,422,0,114,527,4,4,83,105,300,336,21,1422,386
1716,20,2.1.253,0,494,1,96,253,349,253,0,349,422,-17,120,544,2,5,195,139,273,272,21,1422,386
1716,20,3.1.236,0,474,0,43,236,279,175,61,279,422,0,103,527,2,5,108,139,118,272,21,1422,386
1716,21,1.4.422,1,474,0,16,422,438,412,10,438,438,0,224,527,5,4,16,45,300,243,22,1422,319
1716,21,2.1.253,0,494,1,96,253,349,253,0,349,422,-17,120,544,2,5,195,139,273,272,22,1422,319
1716,21,3.1.236,0,474,0,43,236,279,175,61,279,422,0,103,527,2,5,108,139,118,272,22,1422,319
1716,22,2.1.253,0,494,1,96,253,349,253,0,349,438,-17,120,544,2,5,195,139,273,272,23,1422,303
1716,22,3.1.236,1,474,0,43,236,279,175,61,279,438,0,103,527,2,5,108,139,118,272,23,1422,303
1716,23,2.1.279,0,474,0,96,279,375,253,26,375,438,0,103,527,2,6,195,96,273,272,24,1422,260
1716,23,3.2.307,1,474,0,17,307,324,279,28,324,438,0,86,527,3,5,65,97,118,318,24,1422,260
1716,24,2.1.279,0,474,0,96,279,375,253,26,375,438,0,103,527,2,6,195,96,273,272,25,1422,243
1716,24,3.3.412,1,474,0,23,412,435,324,88,435,438,0,114,527,4,5,48,38,118,336,25,1422,243
1716,25,2.1.279,0,474,0,96,279,375,253,26,375,438,0,103,527,2,6,195,96,273,272,26,1422,220
1716,25,3.4.438,1,474,0,25,438,463,435,3,463,463,0,224,527,5,5,25,29,118,243,26,1422,220
1716,26,2.1.279,1,474,0,96,279,375,253,26,375,463,0,103,527,2,6,195,96,273,272,27,1422,195
1716,27,2.2.375,1,474,0,80,375,455,375,0,455,463,-51,137,578,3,6,99,80,273,318,28,1422,99
1716,28,2.3.455,1,474,0,15,455,470,455,0,470,470,-20,134,598,4,6,19,15,273,336,29,1422,19
1716,29,2.4.470,1,474,0,4,470,474,470,0,474,474,-7,231,605,5,6,4,4,273,243,30,1422,4
1717,0,0.0.0,0,626,4,68,0,68,0,0,68,68,0,0,0,1,1,295,265,295,265,1,1682,1682
1717,0,1.0.0,0,621,2,50,0,50,0,0,50,50,0,0,0,1,1,199,265,199,265,1,1682,1682
1717,0,2.0.0,0,595,1,24,0,24,0,0,24,24,0,0,0,1,1,298,265,298,265,1,1682,1682
1717,0,3.0.0,0,633,5,62,0,62,0,0,62,62,0,0,0,1,1,374,265,374,265,1,1682,1682
1717,0,4.0.0,0,625,3,54,0,54,0,0,54,54,0,0,0,1,1,261,265,261,265,1,1682,1682
1717,0,5.0.0,1,571,0,7,0,7,0,0,7,7,0,0,0,1,1,255,265,255,265,1,1682,1682
1717,1,0.0.7,0,590,2,68,7,75,0,7,75,75,0,0,0,1,2,295,258,295,265,2,1682,1675
1717,1,1.0.7,0,594,4,50,7,57,0,7,57,57,0,0,0,1,2,199,258,199,265,2,1682,1675
1717,1,2.0.7,1,571,0,24,7,31,0,7,31,31,0,0,0,1,2,298,258,298,265,2,1682,1675
1717,1,3.0.7,0,588,1,62,7,69,0,7,69,69,0,0,0,1,2,374,258,374,265,2,1682,1675
1717,1,4.0.7,0,592,3,54,7,61,0,7,61,61,0,0,0,1,2,261,258,261,265,2,1682,1675
1717,1,5.1.7,0,571,0,38,7,45,7,0,45,45,-7,7,7,2,1,248,373,255,373,2,1682,1675
1717,2,0.0.31,0,574,1,68,31,99,0,31,99,99,0,0,0,1,3,295,234,295,265,3,1682,1651
1717,2,1.0.31,0,579,2,50,31,81,0,31,81,81,0,0,0,1,3,199,234,199,265,3,1682,1651
1717,2,2.1.31,0,602,4,90,31,121,31,0,121,121,-31,31,31,2,1,274,373,298,373,3,1682,1651
1717,2,3.0.31,1,571,0,62,31,93,0,31,93,93,0,0,0,1,3,374,234,374,265,3,1682,1651
1717,2,4.0.31,0,583,3,54,31,85,0,31,85,85,0,0,0,1,3,261,234,261,265,3,1682,1651
1717,2,5.1.7,0,571,0,38,7,45,7,0,45,45,-7,7,7,2,1,248,373,255,373,3,1682,1651
1717,3,0.0.93,0,571,0,68,93,161,0,93,161,161,0,0,0,1,4,295,172,295,265,4,1682,1589
1717,3,1.0.93,0,571,0,50,93,143,0,93,143,143,0,0,0,1,4,199,172,199,265,4,1682,1589
1717,3,2.1.31,0,605,1,90,31,121,31,0,121,121,-31,31,31,2,1,274,373,298,373,4,1682,1589
1717,3,3.1.93,0,612,2,81,93,174,93,0,174,174,-93,93,93,2,1,312,373,374,373,4,1682,1589
1717,3,4.0.93,1,571,0,54,93,147,0,93,147,147,0,0,0,1,4,261,172,261,265,4,1682,1589
1717,3,5.1.7,0,571,0,38,7,45,7,0,45,93,-7,7,7,2,1,248,373,255,373,4,1682,1589
1717,4,0.0.147,1,571,0,68,147,215,0,147,215,215,0,0,0,1,5,295,118,295,265,5,1682,1535
1717,4,1.0.147,0,587,1,50,147,197,0,147,197,197,0,0,0,1,5,199,118,199,265,5,1682,1535
1717,4,2.1.31,0,608,3,90,31,121,31,0,121,147,-31,31,31,2,1,274,373,298,373,5,1682,1535
1717,4,3.1.93,0,612,4,81,93,174,93,0,174,174,-93,93,93,2,1,312,373,374,373,5,1682,1535
1717,4,4.1.147,0,602,2,56,147,203,147,0,203,203,-147,147,147,2,1,207,373,261,373,5,1682,1535
1717,4,5.1.7,0,571,0,38,7,45,7,0,45,147,-7,7,7,2,1,248,373,255,373,5,1682,1535
1717,5,0.1.215,0,621,4,69,215,284,215,0,284,284,-215,215,215,2,1,227,373,295,373,6,1682,1467
1717,5,1.0.215,1,571,0,50,215,265,0,215,265,265,0,0,0,1,6,199,50,199,265,6,1682,1467
1717,5,2.1.31,0,608,2,90,31,121,31,0,121,215,-31,31,31,2,1,274,373,298,373,6,1682,1467
1717,5,3.1.93,0,612,3,81,93,174,93,0,174,215,-93,93,93,2,1,312,373,374,373,6,1682,1467
1717,5,4.1.147,0,602,1,56,147,203,147,0,203,215,-147,147,147,2,1,207,373,261,373,6,1682,1467
1717,5,5.1.7,0,571,0,38,7,45,7,0,45,215,-7,7,7,2,1,248,373,255,373,6,1682,1467
1717,6,0.1.215,0,621,5,69,215,284,215,0,284,284,-215,215,215,2,1,227,373,295,373,7,1682,1417
1717,6,1.1.265,0,591,1,39,265,304,265,0,304,304,-265,265,265,2,1,149,373,199,373,7,1682,1417
1717,6,2.1.31,0,608,3,90,31,121,31,0,121,265,-31,31,31,2,1,274,373,298,373,7,1682,1417
1717,6,3.1.93,0,612,4,81,93,174,93,0,174,265,-93,93,93,2,1,312,373,374,373,7,1682,1417
1717,6,4.1.147,0,602,2,56,147,203,147,0,203,265,-147,147,147,2,1,207,373,261,373,7,1682,1417
1717,6,5.1.7,1,571,0,38,7,45,7,0,45,265,-7,7,7,2,1,248,373,255,373,7,1682,1417
1717,7,0.1.215,0,621,4,69,215,284,215,0,284,284,-170,177,177,2,2,227,335,295,373,8,1682,1379
1717,7,1.1.265,0,591,1,39,265,304,265,0,304,304,-220,227,227,2,2,149,335,199,373,8,1682,1379
1717,7,2.1.45,0,571,0,90,45,135,31,14,135,265,0,7,7,2,2,274,335,298,373,8,1682,1379
1717,7,3.1.93,0,612,3,81,93,174,93,0,174,265,-48,55,55,2,2,312,335,374,373,8,1682,1379
1717,7,4.1.147,0,602,2,56,147,203,147,0,203,265,-102,109,109,2,2,207,335,261,373,8,1682,1379
1717,7,5.2.45,1,571,0,94,45,139,45,0,139,265,-45,45,52,3,1,210,385,255,385,8,1682,1379
1717,8,0.1.215,0,621,4,69,215,284,215,0,284,284,-170,177,222,2,2,227,335,295,373,9,1682,1285
1717,8,1.1.265,0,591,1,39,265,304,265,0,304,304,-220,227,272,2,2,149,335,199,373,9,1682,1285
1717,8,2.1.45,0,571,0,90,45,135,31,14,135,265,0,7,52,2,2,274,335,298,373,9,1682,1285
1717,8,3.1.93,0,612,3,81,93,174,93,0,174,265,-48,55,100,2,2,312,335,374,373,9,1682,1285
1717,8,4.1.147,0,602,2,56,147,203,147,0,203,265,-102,109,154,2,2,207,335,261,373,9,1682,1285
1717,8,5.3.139,1,571,0,58,139,197,139,0,197,265,-139,139,191,4,1,116,388,255,388,9,1682,1285
1717,9,0.1.215,0,621,4,69,215,284,215,0,284,284,-170,177,361,2,2,227,335,295,373,10,1682,1227
1717,9,1.1.265,0,591,1,39,265,304,265,0,304,304,-220,227,411,2,2,149,335,199,373,10,1682,1227
1717,9,2.1.45,0,571,0,90,45,135,31,14,135,265,0,7,191,2,2,274,335,298,373,10,1682,1227
1717,9,3.1.93,0,612,3,81,93,174,93,0,174,265,-48,55,239,2,2,312,335,374,373,10,1682,1227
1717,9,4.1.147,0,602,2,56,147,203,147,0,203,265,-102,109,293,2,2,207,335,261,373,10,1682,1227
1717,9,5.4.197,1,571,0,58,197,255,197,0,255,265,-197,197,388,5,1,58,271,255,271,10,1682,1227
1717,10,0.1.215,0,621,4,69,215,284,215,0,284,284,-170,177,558,2,2,227,335,295,373,11,1682,1169
1717,10,1.1.265,0,591,1,39,265,304,265,0,304,304,-220,227,608,2,2,149,335,199,373,11,1682,1169
1717,10,2.1.45,1,571,0,90,45,135,31,14,135,265,0,7,388,2,2,274,335,298,373,11,1682,1169
1717,10,3.1.93,0,612,3,81,93,174,93,0,174,265,-48,55,436,2,2,312,335,374,373,11,1682,1169
1717,10,4.1.147,0,602,2,56,147,203,147,0,203,265,-102,109,490,2,2,207,335,261,373,11,1682,1169
1717,11,0.1.215,0,621,3,69,215,284,215,0,284,284,-80,87,468,2,3,227,245,295,373,12,1682,1079
1717,11,1.1.265,0,591,1,39,265,304,265,0,304,304,-130,137,518,2,3,149,245,199,373,12,1682,1079
1717,11,2.2.139,1,571,0,33,139,172,135,4,172,265,0,45,388,3,2,184,291,298,385,12,1682,1079
1717,11,3.1.135,0,571,0,81,135,216,93,42,216,265,0,7,388,2,3,312,245,374,373,12,1682,1079
1717,11,4.1.147,0,602,2,56,147,203,147,0,203,265,-12,19,400,2,3,207,245,261,373,12,1682,1079
1717,12,0.1.215,0,621,3,69,215,284,215,0,284,284,-80,87,468,2,3,227,245,295,373,13,1682,1046
1717,12,1.1.265,0,591,1,39,265,304,265,0,304,304,-130,137,518,2,3,149,245,199,373,13,1682,1046
1717,12,2.3.197,0,571,0,83,197,280,172,25,280,280,0,139,388,4,2,151,330,298,388,13,1682,1046
1717,12,3.1.135,1,571,0,81,135,216,93,42,216,265,0,7,388,2,3,312,245,374,373,13,1682,1046
1717,12,4.1.147,0,602,2,56,147,203,147,0,203,265,-12,19,400,2,3,207,245,261,373,13,1682,1046
1717,13,0.1.216,0,571,0,69,216,285,215,1,285,285,0,7,388,2,4,227,164,295,373,14,1682,965
1717,13,1.1.265,0,591,2,39,265,304,265,0,304,304,-49,56,437,2,4,149,164,199,373,14,1682,965
1717,13,2.3.197,0,571,0,83,197,280,172,25,280,280,0,139,388,4,2,151,330,298,388,14,1682,965
1717,13,3.2.216,0,571,0,84,216,300,216,0,300,300,-44,89,432,3,3,231,258,374,385,14,1682,965
1717,13,4.1.216,1,587,1,56,216,272,147,69,272,272,0,7,388,2,4,207,164,261,373,14,1682,965
1717,14,0.1.272,1,587,0,69,272,341,215,57,341,341,0,7,388,2,5,227,108,295,373,15,1682,909
1717,14,1.1.272,0,593,1,39,272,311,265,7,311,311,0,7,388,2,5,149,108,199,373,15,1682,909
1717,14,2.3.197,0,587,0,83,197,280,172,25,280,280,0,139,388,4,2,151,330,298,388,15,1682,909
1717,14,3.2.216,0,587,0,84,216,300,216,0,300,300,-44,89,432,3,3,231,258,374,385,15,1682,909
1717,14,4.2.272,0,658,2,68,272,340,272,0,340,340,-100,145,488,3,3,151,258,261,385,15,1682,909
1717,15,0.2.341,0,587,0,30,341,371,341,0,371,371,-169,214,557,3,3,158,258,295,385,16,1682,840
1717,15,1.1.341,1,587,0,39,341,380,265,76,380,380,0,7,388,2,6,149,39,199,373,16,1682,840
1717,15,2.3.197,0,587,0,83,197,280,172,25,280,341,0,139,388,4,2,151,330,298,388,16,1682,840
1717,15,3.2.216,0,587,0,84,216,300,216,0,300,341,-44,89,432,3,3,231,258,374,385,16,1682,840
1717,15,4.2.272,0,658,1,68,272,340,272,0,340,341,-100,145,488,3,3,151,258,261,385,16,1682,840
1717,16,0.2.341,0,587,0,30,341,371,341,0,371,380,-169,214,557,3,3,158,258,295,385,17,1682,801
1717,16,1.2.380,0,607,1,76,380,456,380,0,456,456,-208,253,596,3,3,110,258,199,385,17,1682,801
1717,16,2.3.197,0,587,0,83,197,280,172,25,280,380,0,139,388,4,2,151,330,298,388,17,1682,801
1717,16,3.2.216,1,587,0,84,216,300,216,0,300,380,-44,89,432,3,3,231,258,374,385,17,1682,801
1717,16,4.2.272,0,658,2,68,272,340,272,0,340,380,-100,145,488,3,3,151,258,261,385,17,1682,801
1717,17,0.2.341,1,587,0,30,341,371,341,0,371,380,-41,130,473,3,4,158,174,295,385,18,1682,717
1717,17,1.2.380,0,607,2,76,380,456,380,0,456,456,-80,169,512,3,4,110,174,199,385,18,1682,717
1717,17,2.3.197,0,587,0,83,197,280,172,25,280,380,0,139,432,4,2,151,330,298,388,18,1682,717
1717,17,3.3.300,0,587,0,81,300,381,300,0,381,381,-103,242,535,4,2,147,330,374,388,18,1682,717
1717,17,4.2.300,0,588,1,68,300,368,272,28,368,380,0,89,432,3,4,151,174,261,385,18,1682,717
1717,18,0.3.371,0,649,2,98,371,469,371,0,469,469,-174,313,647,4,2,128,330,295,388,19,1682,687
1717,18,1.2.380,0,607,1,76,380,456,380,0,456,456,-9,139,482,3,5,110,144,199,385,19,1682,687
1717,18,2.3.197,0,587,0,83,197,280,172,25,280,380,0,139,473,4,2,151,330,298,388,19,1682,687
1717,18,3.3.300,0,587,0,81,300,381,300,0,381,381,-103,242,576,4,2,147,330,374,388,19,1682,687
1717,18,4.2.371,1,587,0,68,371,439,272,99,439,439,0,130,473,3,5,151,144,261,385,19,1682,687
1717,19,0.3.371,0,665,2,98,371,469,371,0,469,469,-174,313,647,4,2,128,330,295,388,20,1682,619
1717,19,1.2.439,0,587,0,76,439,515,380,59,515,515,0,130,473,3,6,110,76,199,385,20,1682,619
1717,19,2.3.197,1,587,0,83,197,280,172,25,280,439,0,139,473,4,2,151,330,298,388,20,1682,619
1717,19,3.3.300,0,587,0,81,300,381,300,0,381,439,-103,242,576,4,2,147,330,374,388,20,1682,619
1717,19,4.3.439,0,651,1,59,439,498,439,0,498,498,-242,381,715,4,2,83,330,261,388,20,1682,619
1717,20,0.3.371,0,665,2,98,371,469,371,0,469,469,-91,230,564,4,3,128,247,295,388,21,1682,536
1717,20,1.2.439,0,587,0,76,439,515,380,59,515,515,0,130,473,3,6,110,76,199,385,21,1682,536
1717,20,2.4.280,1,587,0,68,280,348,280,0,348,439,-25,222,498,5,2,68,213,298,271,21,1682,536
1717,20,3.3.300,0,587,0,81,300,381,300,0,381,439,-20,159,493,4,3,147,247,374,388,21,1682,536
1717,20,4.3.439,0,651,1,59,439,498,439,0,498,498,-159,298,632,4,3,83,247,261,388,21,1682,536
1717,21,0.3.371,0,665,2,98,371,469,371,0,469,469,-91,230,589,4,3,128,247,295,388,22,1682,468
1717,21,1.2.439,0,587,0,76,439,515,380,59,515,515,0,130,498,3,6,110,76,199,385,22,1682,468
1717,21,3.3.300,1,587,0,81,300,381,300,0,381,439,-20,159,518,4,3,147,247,374,388,22,1682,468
1717,21,4.3.439,0,651,1,59,439,498,439,0,498,498,-159,298,657,4,3,83,247,261,388,22,1682,468
1717,22,0.3.381,0,587,0,98,381,479,371,10,479,479,0,159,518,4,4,128,166,295,388,23,1682,387
1717,22,1.2.439,0,587,0,76,439,515,380,59,515,515,0,130,518,3,6,110,76,199,385,23,1682,387
1717,22,3.4.381,1,587,0,66,381,447,381,0,447,447,-33,255,551,5,3,66,145,374,271,23,1682,387
1717,22,4.3.439,0,651,1,59,439,498,439,0,498,498,-58,217,576,4,4,83,166,261,388,23,1682,387
1717,23,0.3.381,1,587,0,98,381,479,371,10,479,479,0,159,551,4,4,128,166,295,388,24,1682,321
1717,23,1.2.439,0,587,0,76,439,515,380,59,515,515,0,130,551,3,6,110,76,199,385,24,1682,321
1717,23,4.3.439,0,651,1,59,439,498,439,0,498,498,-58,217,609,4,4,83,166,261,388,24,1682,321
1717,24,0.4.479,1,587,0,30,479,509,479,0,509,509,-32,287,583,5,4,30,79,295,271,25,1682,223
1717,24,1.2.439,0,587,0,76,439,515,380,59,515,515,0,130,551,3,6,110,76,199,385,25,1682,223
1717,24,4.3.479,0,587,0,59,479,538,439,40,538,538,0,159,551,4,5,83,68,261,388,25,1682,223
1717,25,1.2.439,0,587,0,76,439,515,380,59,515,515,0,130,583,3,6,110,76,199,385,26,1682,193
1717,25,4.3.479,1,587,0,59,479,538,439,40,538,538,0,159,583,4,5,83,68,261,388,26,1682,193
1717,26,1.2.439,0,587,0,76,439,515,380,59,515,538,0,130,583,3,6,110,76,199,385,27,1682,134
1717,26,4.4.538,1,587,0,24,538,562,538,0,562,562,-29,316,612,5,5,24,49,261,271,27,1682,134
1717,27,1.2.439,1,587,0,76,439,515,380,59,515,562,0,130,612,3,6,110,76,199,385,28,1682,110
1717,28,1.3.538,1,587,0,9,538,547,515,23,547,562,0,159,612,4,6,34,9,199,388,29,1682,34
1717,29,1.4.562,1,587,0,25,562,587,547,15,587,587,0,316,612,5,6,25,25,199,271,30,1682,25
1718,0,0.0.0,0,533,3,81,0,81,0,0,81,81,0,0,0,1,1,241,281,241,281,1,1356,1356
1718,0,1.0.0,0,516,0,26,0,26,0,0,26,26,0,0,0,1,1,199,281,199,281,1,1356,1356
1718,0,2.0.0,0,530,2,70,0,70,0,0,70,70,0,0,0,1,1,324,281,324,281,1,1356,1356
1718,0,3.0.0,0,524,1,16,0,16,0,0,16,16,0,0,0,1,1,135,281,135,281,1,1356,1356
1718,0,4.0.0,0,516,0,76,0,76,0,0,76,76,0,0,0,1,1,299,281,299,281,1,1356,1356
1718,0,5.0.0,1,516,0,12,0,12,0,0,12,12,0,0,0,1,1,158,281,158,281,1,1356,1356
1718,1,0.0.12,0,533,3,81,12,93,0,12,93,93,0,0,0,1,2,241,269,241,281,2,1356,1344
1718,1,1.0.12,0,516,0,26,12,38,0,12,38,38,0,0,0,1,2,199,269,199,281,2,1356,1344
1718,1,2.0.12,0,530,2,70,12,82,0,12,82,82,0,0,0,1,2,324,269,324,281,2,1356,1344
1718,1,3.0.12,0,524,1,16,12,28,0,12,28,28,0,0,0,1,2,135,269,135,281,2,1356,1344
1718,1,4.0.12,0,516,0,76,12,88,0,12,88,88,0,0,0,1,2,299,269,299,281,2,1356,1344
1718,1,5.1.12,1,516,0,21,12,33,12,0,33,33,-12,12,12,2,1,146,177,158,177,2,1356,1344
1718,2,0.0.12,0,533,3,81,12,93,0,12,93,93,0,0,12,1,2,241,269,241,281,3,1356,1323
1718,2,1.0.12,0,516,0,26,12,38,0,12,38,38,0,0,12,1,2,199,269,199,281,3,1356,1323
1718,2,2.0.12,0,530,2,70,12,82,0,12,82,82,0,0,12,1,2,324,269,324,281,3,1356,1323
1718,2,3.0.12,0,524,1,16,12,28,0,12,28,33,0,0,12,1,2,135,269,135,281,3,1356,1323
1718,2,4.0.12,0,516,0,76,12,88,0,12,88,88,0,0,12,1,2,299,269,299,281,3,1356,1323
1718,2,5.2.33,1,516,0,33,33,66,33,0,66,66,-33,33,45,3,1,125,352,158,352,3,1356,1323
1718,3,0.0.12,0,533,3,81,12,93,0,12,93,93,0,0,45,1,2,241,269,241,281,4,1356,1290
1718,3,1.0.12,0,516,0,26,12,38,0,12,38,66,0,0,45,1,2,199,269,199,281,4,1356,1290
1718,3,2.0.12,0,530,2,70,12,82,0,12,82,82,0,0,45,1,2,324,269,324,281,4,1356,1290
1718,3,3.0.12,0,524,1,16,12,28,0,12,28,66,0,0,45,1,2,135,269,135,281,4,1356,1290
1718,3,4.0.12,0,516,0,76,12,88,0,12,88,88,0,0,45,1,2,299,269,299,281,4,1356,1290
1718,3,5.3.66,1,516,0,43,66,109,66,0,109,109,-66,66,111,4,1,92,243,158,243,4,1356,1290
1718,4,0.0.12,0,533,3,81,12,93,0,12,93,109,0,0,111,1,2,241,269,241,281,5,1356,1247
1718,4,1.0.12,0,516,0,26,12,38,0,12,38,109,0,0,111,1,2,199,269,199,281,5,1356,1247
1718,4,2.0.12,0,530,2,70,12,82,0,12,82,109,0,0,111,1,2,324,269,324,281,5,1356,1247
1718,4,3.0.12,0,524,1,16,12,28,0,12,28,109,0,0,111,1,2,135,269,135,281,5,1356,1247
1718,4,4.0.12,0,516,0,76,12,88,0,12,88,109,0,0,111,1,2,299,269,299,281,5,1356,1247
1718,4,5.4.109,1,516,0,49,109,158,109,0,158,158,-109,109,220,5,1,49,303,158,303,5,1356,1247
1718,5,0.0.12,0,533,3,81,12,93,0,12,93,158,0,0,220,1,2,241,269,241,281,6,1356,1198
1718,5,1.0.12,0,516,0,26,12,38,0,12,38,158,0,0,220,1,2,199,269,199,281,6,1356,1198
1718,5,2.0.12,1,530,2,70,12,82,0,12,82,158,0,0,220,1,2,324,269,324,281,6,1356,1198
1718,5,3.0.12,0,524,1,16,12,28,0,12,28,158,0,0,220,1,2,135,269,135,281,6,1356,1198
1718,5,4.0.12,0,516,0,76,12,88,0,12,88,158,0,0,220,1,2,299,269,299,281,6,1356,1198
1718,6,0.0.82,0,543,3,81,82,163,0,82,163,163,0,0,220,1,3,241,199,241,281,7,1356,1128
1718,6,1.0.82,0,530,0,26,82,108,0,82,108,158,0,0,220,1,3,199,199,199,281,7,1356,1128
1718,6,2.1.82,1,543,3,83,82,165,82,0,165,165,-49,61,269,2,2,254,156,324,177,7,1356,1128
1718,6,3.0.82,0,538,1,16,82,98,0,82,98,158,0,0,220,1,3,135,199,135,281,7,1356,1128
1718,6,4.0.82,0,541,2,76,82,158,0,82,158,158,0,0,220,1,3,299,199,299,281,7,1356,1128
1718,7,0.0.82,0,543,0,81,82,163,0,82,163,165,0,0,269,1,3,241,199,241,281,8,1356,1045
1718,7,1.0.82,1,543,0,26,82,108,0,82,108,165,0,0,269,1,3,199,199,199,281,8,1356,1045
1718,7,2.2.165,0,543,0,85,165,250,165,0,250,250,-99,132,368,3,2,171,319,324,352,8,1356,1045
1718,7,3.0.82,0,543,0,16,82,98,0,82,98,165,0,0,269,1,3,135,199,135,281,8,1356,1045
1718,7,4.0.82,0,548,1,76,82,158,0,82,158,165,0,0,269,1,3,299,199,299,281,8,1356,1045
1718,8,0.0.108,0,543,0,81,108,189,0,108,189,189,0,0,269,1,4,241,173,241,281,9,1356,1019
1718,8,1.1.165,1,543,0,7,165,172,108,57,172,172,0,61,269,2,3,173,73,199,177,9,1356,1019
1718,8,2.2.165,0,543,0,85,165,250,165,0,250,250,-99,132,368,3,2,171,319,324,352,9,1356,1019
1718,8,3.0.108,0,546,1,16,108,124,0,108,124,165,0,0,269,1,4,135,173,135,281,9,1356,1019
1718,8,4.0.108,0,567,2,76,108,184,0,108,184,184,0,0,269,1,4,299,173,299,281,9,1356,1019
1718,9,0.0.108,0,543,0,81,108,189,0,108,189,189,0,0,269,1,4,241,173,241,281,10,1356,1012
1718,9,1.2.172,0,546,1,81,172,253,172,0,253,253,-106,139,375,3,2,166,319,199,352,10,1356,1012
1718,9,2.2.165,0,543,0,85,165,250,165,0,250,250,-99,132,368,3,2,171,319,324,352,10,1356,1012
1718,9,3.0.108,0,546,1,16,108,124,0,108,124,172,0,0,269,1,4,135,173,135,281,10,1356,1012
1718,9,4.0.108,1,567,2,76,108,184,0,108,184,184,0,0,269,1,4,299,173,299,281,10,1356,1012
1718,10,0.0.184,0,567,0,81,184,265,0,184,265,265,0,0,269,1,5,241,97,241,281,11,1356,936
1718,10,1.2.172,0,580,2,81,172,253,172,0,253,253,-106,139,375,3,2,166,319,199,352,11,1356,936
1718,10,2.2.165,0,578,1,85,165,250,165,0,250,250,-99,132,368,3,2,171,319,324,352,11,1356,936
1718,10,3.0.184,0,567,0,16,184,200,0,184,200,200,0,0,269,1,5,135,97,135,281,11,1356,936
1718,10,4.1.184,1,567,0,8,184,192,184,0,192,192,-12,73,281,2,4,223,66,299,177,11,1356,936
1718,11,0.0.184,0,567,0,81,184,265,0,184,265,265,0,0,281,1,5,241,97,241,281,12,1356,928
1718,11,1.2.172,0,580,2,81,172,253,172,0,253,253,-106,139,387,3,2,166,319,199,352,12,1356,928
1718,11,2.2.165,0,578,1,85,165,250,165,0,250,250,-99,132,380,3,2,171,319,324,352,12,1356,928
1718,11,3.0.184,1,567,0,16,184,200,0,184,200,200,0,0,281,1,5,135,97,135,281,12,1356,928
1718,11,4.2.192,0,567,0,69,192,261,192,0,261,261,-126,159,407,3,2,215,319,299,352,12,1356,928
1718,12,0.0.200,0,567,0,81,200,281,0,200,281,281,0,0,281,1,6,241,81,241,281,13,1356,912
1718,12,1.2.172,0,580,2,81,172,253,172,0,253,253,-106,139,387,3,2,166,319,199,352,13,1356,912
1718,12,2.2.165,0,578,1,85,165,250,165,0,250,250,-99,132,380,3,2,171,319,324,352,13,1356,912
1718,12,3.1.200,1,567,0,20,200,220,200,0,220,220,-8,81,289,2,5,119,58,135,177,13,1356,912
1718,12,4.2.192,0,567,0,69,192,261,192,0,261,261,-126,159,407,3,2,215,319,299,352,13,1356,912
1718,13,0.0.200,1,567,0,81,200,281,0,200,281,281,0,0,289,1,6,241,81,241,281,14,1356,892
1718,13,1.2.172,0,580,2,81,172,253,172,0,253,253,-106,139,395,3,2,166,319,199,352,14,1356,892
1718,13,2.2.165,0,578,1,85,165,250,165,0,250,250,-99,132,388,3,2,171,319,324,352,14,1356,892
1718,13,3.2.220,0,625,3,51,220,271,220,0,271,271,-154,187,443,3,2,99,319,135,352,14,1356,892
1718,13,4.2.192,0,567,0,69,192,261,192,0,261,261,-126,159,415,3,2,215,319,299,352,14,1356,892
1718,14,0.1.281,1,567,0,38,281,319,281,0,319,319,-61,142,350,2,6,160,38,241,177,15,1356,811
1718,14,1.2.172,0,580,2,81,172,253,172,0,253,281,-106,139,395,3,2,166,319,199,352,15,1356,811
1718,14,2.2.165,0,578,1,85,165,250,165,0,250,281,-99,132,388,3,2,171,319,324,352,15,1356,811
1718,14,3.2.220,0,625,3,51,220,271,220,0,271,281,-154,187,443,3,2,99,319,135,352,15,1356,811
1718,14,4.2.192,0,567,0,69,192,261,192,0,261,281,-126,159,415,3,2,215,319,299,352,15,1356,811
1718,15,0.2.319,0,578,1,33,319,352,319,0,352,352,-253,286,603,3,2,122,319,241,352,16,1356,773
1718,15,1.2.172,0,580,2,81,172,253,172,0,253,319,-106,139,456,3,2,166,319,199,352,16,1356,773
1718,15,2.2.165,1,578,1,85,165,250,165,0,250,319,-99,132,449,3,2,171,319,324,352,16,1356,773
1718,15,3.2.220,0,625,3,51,220,271,220,0,271,319,-154,187,504,3,2,99,319,135,352,16,1356,773
1718,15,4.2.192,0,567,0,69,192,261,192,0,261,319,-126,159,476,3,2,215,319,299,352,16,1356,773
1718,16,0.2.319,0,578,0,33,319,352,319,0,352,352,-69,201,518,3,3,122,234,241,352,17,1356,688
1718,16,1.2.250,0,590,1,81,250,331,172,78,331,331,0,132,449,3,3,166,234,199,352,17,1356,688
1718,16,2.3.250,1,578,0,52,250,302,250,0,302,319,-141,207,590,4,2,86,200,324,243,17,1356,688
1718,16,3.2.250,0,602,2,51,250,301,220,30,301,319,0,132,449,3,3,99,234,135,352,17,1356,688
1718,16,4.2.250,0,578,0,69,250,319,192,58,319,319,0,132,449,3,3,215,234,299,352,17,1356,688
1718,17,0.2.319,0,578,0,33,319,352,319,0,352,352,-69,201,659,3,3,122,234,241,352,18,1356,636
1718,17,1.2.250,0,590,1,81,250,331,172,78,331,331,0,132,590,3,3,166,234,199,352,18,1356,636
1718,17,2.4.302,1,578,0,34,302,336,302,0,336,336,-144,253,734,5,2,34,254,324,303,18,1356,636
1718,17,3.2.250,0,602,2,51,250,301,220,30,301,319,0,132,590,3,3,99,234,135,352,18,1356,636
1718,17,4.2.250,0,578,0,69,250,319,192,58,319,319,0,132,590,3,3,215,234,299,352,18,1356,636
1718,18,0.2.319,0,578,0,33,319,352,319,0,352,352,-69,201,803,3,3,122,234,241,352,19,1356,602
1718,18,1.2.250,0,590,1,81,250,331,172,78,331,336,0,132,734,3,3,166,234,199,352,19,1356,602
1718,18,3.2.250,0,602,2,51,250,301,220,30,301,336,0,132,734,3,3,99,234,135,352,19,1356,602
1718,18,4.2.250,1,578,0,69,250,319,192,58,319,336,0,132,734,3,3,215,234,299,352,19,1356,602
1718,19,0.2.319,0,578,0,33,319,352,319,0,352,352,0,132,734,3,4,122,165,241,352,20,1356,533
1718,19,1.2.319,0,591,1,81,319,400,172,147,400,400,0,132,734,3,4,166,165,199,352,20,1356,533
1718,19,3.2.319,0,591,1,51,319,370,220,99,370,370,0,132,734,3,4,99,165,135,352,20,1356,533
1718,19,4.3.319,1,591,1,52,319,371,319,0,371,371,-17,224,751,4,3,146,148,299,243,20,1356,533
1718,20,0.2.319,0,591,0,33,319,352,319,0,352,371,0,132,751,3,4,122,165,241,352,21,1356,481
1718,20,1.2.319,1,591,0,81,319,400,172,147,400,400,0,132,751,3,4,166,165,199,352,21,1356,481
1718,20,3.2.319,0,591,0,51,319,370,220,99,370,371,0,132,751,3,4,99,165,135,352,21,1356,481
1718,20,4.4.371,0,591,0,94,371,465,371,0,465,465,-35,288,786,5,3,94,220,299,303,21,1356,481
1718,21,0.2.400,1,591,0,33,400,433,319,81,433,433,0,132,751,3,5,122,84,241,352,22,1356,400
1718,21,1.3.400,0,591,0,50,400,450,400,0,450,450,-29,253,780,4,4,85,96,199,243,22,1356,400
1718,21,3.2.400,0,591,0,51,400,451,220,180,451,451,0,132,751,3,5,99,84,135,352,22,1356,400
1718,21,4.4.371,0,591,0,94,371,465,371,0,465,465,-35,288,786,5,3,94,220,299,303,22,1356,400
1718,22,0.3.433,1,591,0,6,433,439,433,0,439,439,-62,286,813,4,4,89,96,241,243,23,1356,367
1718,22,1.3.400,0,591,0,50,400,450,400,0,450,450,-29,253,780,4,4,85,96,199,243,23,1356,367
1718,22,3.2.433,0,591,0,51,433,484,220,213,484,484,0,132,751,3,6,99,51,135,352,23,1356,367
1718,22,4.4.371,0,591,0,94,371,465,371,0,465,465,-35,288,786,5,3,94,220,299,303,23,1356,367
1718,23,0.4.439,0,659,1,83,439,522,439,0,522,522,-103,356,916,5,3,83,220,241,303,24,1356,361
1718,23,1.3.439,0,591,0,50,439,489,400,39,489,489,0,286,813,4,5,85,90,199,243,24,1356,361
1718,23,3.2.433,1,591,0,51,433,484,220,213,484,484,0,132,813,3,6,99,51,135,352,24,1356,361
1718,23,4.4.371,0,591,0,94,371,465,371,0,465,465,-35,288,848,5,3,94,220,299,303,24,1356,361
1718,24,0.4.439,0,659,2,83,439,522,439,0,522,522,-103,356,916,5,3,83,220,241,303,25,1356,310
1718,24,1.3.439,1,591,0,50,439,489,400,39,489,489,0,286,813,4,5,85,90,199,243,25,1356,310
1718,24,3.3.484,0,609,1,40,484,524,484,0,524,524,-45,331,858,4,5,48,90,135,243,25,1356,310
1718,24,4.4.371,0,591,0,94,371,465,371,0,465,484,-35,288,848,5,3,94,220,299,303,25,1356,310
1718,25,0.4.439,0,659,2,83,439,522,439,0,522,522,-103,356,916,5,3,83,220,241,303,26,1356,260
1718,25,1.4.489,0,615,1,35,489,524,489,0,524,524,-153,406,966,5,3,35,220,199,303,26,1356,260
1718,25,3.3.489,1,591,0,40,489,529,484,5,529,529,0,286,813,4,6,48,40,135,243,26,1356,260
1718,25,4.4.371,0,591,0,94,371,465,371,0,465,489,-35,288,848,5,3,94,220,299,303,26,1356,260
1718,26,0.4.439,0,659,3,83,439,522,439,0,522,529,-103,356,916,5,3,83,220,241,303,27,1356,220
1718,26,1.4.489,0,615,1,35,489,524,489,0,524,529,-153,406,966,5,3,35,220,199,303,27,1356,220
1718,26,3.4.529,0,620,2,8,529,537,529,0,537,537,-193,446,1006,5,3,8,220,135,303,27,1356,220
1718,26,4.4.371,1,591,0,94,371,465,371,0,465,529,-35,288,848,5,3,94,220,299,303,27,1356,220
1718,27,0.4.465,0,591,0,83,465,548,439,26,548,548,0,288,848,5,4,83,126,241,303,28,1356,126
1718,27,1.4.489,1,615,1,35,489,524,489,0,524,529,-24,312,872,5,4,35,126,199,303,28,1356,126
1718,27,3.4.529,0,620,2,8,529,537,529,0,537,537,-64,352,912,5,4,8,126,135,303,28,1356,126
1718,28,0.4.524,0,615,0,83,524,607,439,85,607,607,0,312,872,5,5,83,91,241,303,29,1356,91
1718,28,3.4.529,1,620,1,8,529,537,529,0,537,537,-5,317,877,5,5,8,91,135,303,29,1356,91
1718,29,0.4.537,1,620,0,83,537,620,439,98,620,620,0,317,877,5,6,83,83,241,303,30,1356,83
1719,0,0.0.0,0,620,5,94,0,94,0,0,94,94,0,0,0,1,1,186,294,186,294,1,1525,1525
1719,0,1.0.0,1,542,1,2,0,2,0,0,2,2,0,0,0,1,1,300,294,300,294,1,1525,1525
1719,0,2.0.0,0,556,2,16,0,16,0,0,16,16,0,0,0,1,1,252,294,252,294,1,1525,1525
1719,0,3.0.0,0,580,3,69,0,69,0,0,69,69,0,0,0,1,1,293,294,293,294,1,1525,1525
1719,0,4.0.0,0,615,4,97,0,97,0,0,97,97,0,0,0,1,1,336,294,336,294,1,1525,1525
1719,0,5.0.0,0,540,0,16,0,16,0,0,16,16,0,0,0,1,1,158,294,158,294,1,1525,1525
1719,1,0.0.2,0,574,2,94,2,96,0,2,96,96,0,0,0,1,2,186,292,186,294,2,1525,1523
1719,1,1.1.2,1,556,1,75,2,77,2,0,77,77,-2,2,2,2,1,298,280,300,280,2,1525,1523
1719,1,2.0.2,0,556,1,16,2,18,0,2,18,18,0,0,0,1,2,252,292,252,294,2,1525,1523
1719,1,3.0.2,0,556,1,69,2,71,0,2,71,71,0,0,0,1,2,293,292,293,294,2,1525,1523
1719,1,4.0.2,0,584,3,97,2,99,0,2,99,99,0,0,0,1,2,336,292,336,294,2,1525,1523
1719,1,5.0.2,0,542,0,16,2,18,0,2,18,18,0,0,0,1,2,158,292,158,294,2,1525,1523
1719,2,0.0.2,0,574,1,94,2,96,0,2,96,96,0,0,2,1,2,186,292,186,294,3,1525,1448
1719,2,1.2.77,0,556,0,87,77,164,77,0,164,164,-77,77,79,3,1,223,322,300,322,3,1525,1448
1719,2,2.0.2,1,556,0,16,2,18,0,2,18,77,0,0,2,1,2,252,292,252,294,3,1525,1448
1719,2,3.0.2,0,556,0,69,2,71,0,2,71,77,0,0,2,1,2,293,292,293,294,3,1525,1448
1719,2,4.0.2,0,584,2,97,2,99,0,2,99,99,0,0,2,1,2,336,292,336,294,3,1525,1448
1719,2,5.0.2,0,556,0,16,2,18,0,2,18,77,0,0,2,1,2,158,292,158,294,3,1525,1448
1719,3,0.0.18,0,561,1,94,18,112,0,18,112,112,0,0,2,1,3,186,276,186,294,4,1525,1432
1719,3,1.2.77,0,556,0,87,77,164,77,0,164,164,-77,77,79,3,1,223,322,300,322,4,1525,1432
1719,3,2.1.77,1,556,0,77,77,154,18,59,154,154,0,2,2,2,2,236,205,252,280,4,1525,1432
1719,3,3.0.18,0,556,0,69,18,87,0,18,87,87,0,0,2,1,3,293,276,293,294,4,1525,1432
1719,3,4.0.18,0,556,0,97,18,115,0,18,115,115,0,0,2,1,3,336,276,336,294,4,1525,1432
1719,3,5.0.18,0,556,0,16,18,34,0,18,34,77,0,0,2,1,3,158,276,158,294,4,1525,1432
1719,4,0.0.18,0,561,1,94,18,112,0,18,112,154,0,0,2,1,3,186,276,186,294,5,1525,1355
1719,4,1.2.77,1,556,0,87,77,164,77,0,164,164,-77,77,79,3,1,223,322,300,322,5,1525,1355
1719,4,2.2.154,0,595,2,39,154,193,154,0,193,193,-154,154,156,3,1,159,322,252,322,5,1525,1355
1719,4,3.0.18,0,556,0,69,18,87,0,18,87,154,0,0,2,1,3,293,276,293,294,5,1525,1355
1719,4,4.0.18,0,556,0,97,18,115,0,18,115,154,0,0,2,1,3,336,276,336,294,5,1525,1355
1719,4,5.0.18,0,556,0,16,18,34,0,18,34,154,0,0,2,1,3,158,276,158,294,5,1525,1355
1719,5,0.0.18,0,561,1,94,18,112,0,18,112,164,0,0,79,1,3,186,276,186,294,6,1525,1268
1719,5,1.3.164,0,588,2,92,164,256,164,0,256,256,-164,164,243,4,1,136,297,300,297,6,1525,1268
1719,5,2.2.164,1,556,0,39,164,203,154,10,203,203,0,77,79,3,2,159,235,252,322,6,1525,1268
1719,5,3.0.18,0,556,0,69,18,87,0,18,87,164,0,0,79,1,3,293,276,293,294,6,1525,1268
1719,5,4.0.18,0,556,0,97,18,115,0,18,115,164,0,0,79,1,3,336,276,336,294,6,1525,1268
1719,5,5.0.18,0,556,0,16,18,34,0,18,34,164,0,0,79,1,3,158,276,158,294,6,1525,1268
1719,6,0.0.18,0,561,1,94,18,112,0,18,112,203,0,0,79,1,3,186,276,186,294,7,1525,1229
1719,6,1.3.164,0,588,2,92,164,256,164,0,256,256,-164,164,243,4,1,136,297,300,297,7,1525,1229
1719,6,2.3.203,1,556,0,21,203,224,203,0,224,224,-203,203,282,4,1,120,297,252,297,7,1525,1229
1719,6,3.0.18,0,556,0,69,18,87,0,18,87,203,0,0,79,1,3,293,276,293,294,7,1525,1229
1719,6,4.0.18,0,556,0,97,18,115,0,18,115,203,0,0,79,1,3,336,276,336,294,7,1525,1229
1719,6,5.0.18,0,556,0,16,18,34,0,18,34,203,0,0,79,1,3,158,276,158,294,7,1525,1229
1719,7,0.0.18,0,561,1,94,18,112,0,18,112,224,0,0,282,1,3,186,276,186,294,8,1525,1208
1719,7,1.3.224,0,556,0,92,224,316,164,60,316,316,0,203,282,4,2,136,276,300,297,8,1525,1208
1719,7,2.4.224,1,556,0,99,224,323,224,0,323,323,-224,224,506,5,1,99,332,252,332,8,1525,1208
1719,7,3.0.18,0,556,0,69,18,87,0,18,87,224,0,0,282,1,3,293,276,293,294,8,1525,1208
1719,7,4.0.18,0,556,0,97,18,115,0,18,115,224,0,0,282,1,3,336,276,336,294,8,1525,1208
1719,7,5.0.18,0,556,0,16,18,34,0,18,34,224,0,0,282,1,3,158,276,158,294,8,1525,1208
1719,8,0.0.18,0,561,1,94,18,112,0,18,112,323,0,0,506,1,3,186,276,186,294,9,1525,1109
1719,8,1.3.224,1,556,0,92,224,316,164,60,316,323,0,203,506,4,2,136,276,300,297,9,1525,1109
1719,8,3.0.18,0,556,0,69,18,87,0,18,87,323,0,0,506,1,3,293,276,293,294,9,1525,1109
1719,8,4.0.18,0,556,0,97,18,115,0,18,115,323,0,0,506,1,3,336,276,336,294,9,1525,1109
1719,8,5.0.18,0,556,0,16,18,34,0,18,34,323,0,0,506,1,3,158,276,158,294,9,1525,1109
1719,9,0.0.18,0,561,1,94,18,112,0,18,112,323,0,0,506,1,3,186,276,186,294,10,1525,1017
1719,9,1.4.323,1,556,0,44,323,367,316,7,367,367,0,224,506,5,2,44,233,300,332,10,1525,1017
1719,9,3.0.18,0,556,0,69,18,87,0,18,87,323,0,0,506,1,3,293,276,293,294,10,1525,1017
1719,9,4.0.18,0,556,0,97,18,115,0,18,115,323,0,0,506,1,3,336,276,336,294,10,1525,1017
1719,9,5.0.18,0,556,0,16,18,34,0,18,34,323,0,0,506,1,3,158,276,158,294,10,1525,1017
1719,10,0.0.18,0,561,1,94,18,112,0,18,112,367,0,0,506,1,3,186,276,186,294,11,1525,973
1719,10,3.0.18,1,556,0,69,18,87,0,18,87,367,0,0,506,1,3,293,276,293,294,11,1525,973
1719,10,4.0.18,0,556,0,97,18,115,0,18,115,367,0,0,506,1,3,336,276,336,294,11,1525,973
1719,10,5.0.18,0,556,0,16,18,34,0,18,34,367,0,0,506,1,3,158,276,158,294,11,1525,973
1719,11,0.0.87,0,568,2,94,87,181,0,87,181,367,0,0,506,1,4,186,207,186,294,12,1525,904
1719,11,3.1.154,1,563,1,58,154,212,87,67,212,367,0,2,506,2,3,224,128,293,280,12,1525,904
1719,11,4.0.87,0,556,0,97,87,184,0,87,184,367,0,0,506,1,4,336,207,336,294,12,1525,904
1719,11,5.0.87,0,556,0,16,87,103,0,87,103,367,0,0,506,1,4,158,207,158,294,12,1525,904
1719,12,0.0.87,0,568,1,94,87,181,0,87,181,367,0,0,506,1,4,186,207,186,294,13,1525,846
1719,12,3.2.212,1,568,1,18,212,230,212,0,230,367,-9,86,515,3,3,166,196,293,322,13,1525,846
1719,12,4.0.87,0,563,0,97,87,184,0,87,184,367,0,0,506,1,4,336,207,336,294,13,1525,846
1719,12,5.0.87,0,563,0,16,87,103,0,87,103,367,0,0,506,1,4,158,207,158,294,13,1525,846
1719,13,0.0.87,0,568,0,94,87,181,0,87,181,367,0,0,515,1,4,186,207,186,294,14,1525,828
1719,13,3.3.316,1,604,1,99,316,415,230,86,415,415,0,203,515,4,3,148,184,293,297,14,1525,828
1719,13,4.0.87,0,568,0,97,87,184,0,87,184,367,0,0,515,1,4,336,207,336,294,14,1525,828
1719,13,5.0.87,0,568,0,16,87,103,0,87,103,367,0,0,515,1,4,158,207,158,294,14,1525,828
1719,14,0.0.87,0,604,0,94,87,181,0,87,181,415,0,0,515,1,4,186,207,186,294,15,1525,729
1719,14,3.4.415,1,604,0,49,415,464,415,0,464,464,-48,272,563,5,3,49,189,293,332,15,1525,729
1719,14,4.0.87,0,604,0,97,87,184,0,87,184,415,0,0,515,1,4,336,207,336,294,15,1525,729
1719,14,5.0.87,0,604,0,16,87,103,0,87,103,415,0,0,515,1,4,158,207,158,294,15,1525,729
1719,15,0.0.87,0,604,0,94,87,181,0,87,181,464,0,0,563,1,4,186,207,186,294,16,1525,680
1719,15,4.0.87,0,604,0,97,87,184,0,87,184,464,0,0,563,1,4,336,207,336,294,16,1525,680
1719,15,5.0.87,1,604,0,16,87,103,0,87,103,464,0,0,563,1,4,158,207,158,294,16,1525,680
1719,16,0.0.103,0,604,0,94,103,197,0,103,197,464,0,0,563,1,5,186,191,186,294,17,1525,664
1719,16,4.0.103,0,604,0,97,103,200,0,103,200,464,0,0,563,1,5,336,191,336,294,17,1525,664
1719,16,5.1.212,1,604,0,4,212,216,103,109,216,464,0,2,563,2,4,142,70,158,280,17,1525,664
1719,17,0.0.103,0,604,0,94,103,197,0,103,197,464,0,0,563,1,5,186,191,186,294,18,1525,660
1719,17,4.0.103,1,604,0,97,103,200,0,103,200,464,0,0,563,1,5,336,191,336,294,18,1525,660
1719,17,5.2.230,0,604,0,71,230,301,216,14,301,464,0,86,563,3,4,138,178,158,322,18,1525,660
1719,18,0.0.200,0,604,0,94,200,294,0,200,294,464,0,0,563,1,6,186,94,186,294,19,1525,563
1719,18,4.1.216,1,604,0,60,216,276,200,16,276,464,0,2,563,2,5,239,66,336,280,19,1525,563
1719,18,5.2.230,0,604,0,71,230,301,216,14,301,464,0,86,563,3,4,138,178,158,322,19,1525,563
1719,19,0.0.200,1,604,0,94,200,294,0,200,294,464,0,0,563,1,6,186,94,186,294,20,1525,503
1719,19,4.2.276,0,604,0,70,276,346,276,0,346,464,-46,132,609,3,4,179,178,336,322,20,1525,503
1719,19,5.2.230,0,604,0,71,230,301,216,14,301,464,0,86,563,3,4,138,178,158,322,20,1525,503
1719,20,0.1.294,1,604,0,6,294,300,294,0,300,464,-18,20,581,2,6,92,6,186,280,21,1525,409
1719,20,4.2.276,0,604,0,70,276,346,276,0,346,464,-46,132,609,3,4,179,178,336,322,21,1525,409
1719,20,5.2.230,0,604,0,71,230,301,216,14,301,464,0,86,563,3,4,138,178,158,322,21,1525,409
1719,21,0.2.300,0,604,0,37,300,337,300,0,337,464,-70,156,651,3,4,86,178,186,322,22,1525,403
1719,21,4.2.276,1,604,0,70,276,346,276,0,346,464,-46,132,627,3,4,179,178,336,322,22,1525,403
1719,21,5.2.230,0,604,0,71,230,301,216,14,301,464,0,86,581,3,4,138,178,158,322,22,1525,403
1719,22,0.2.346,0,604,0,37,346,383,300,46,383,464,0,132,627,3,5,86,108,186,322,23,1525,333
1719,22,4.3.415,1,604,0,45,415,460,346,69,460,464,0,203,627,4,4,109,85,336,297,23,1525,333
1719,22,5.2.346,0,604,0,71,346,417,216,130,417,464,0,132,627,3,5,138,108,158,322,23,1525,333
1719,23,0.2.346,0,604,0,37,346,383,300,46,383,464,0,132,627,3,5,86,108,186,322,24,1525,288
1719,23,4.4.464,1,604,0,64,464,528,460,4,528,528,0,272,627,5,4,64,140,336,332,24,1525,288
1719,23,5.2.346,0,604,0,71,346,417,216,130,417,464,0,132,627,3,5,138,108,158,322,24,1525,288
1719,24,0.2.346,0,604,0,37,346,383,300,46,383,528,0,132,627,3,5,86,108,186,322,25,1525,224
1719,24,5.2.346,1,604,0,71,346,417,216,130,417,528,0,132,627,3,5,138,108,158,322,25,1525,224
1719,25,0.2.417,1,604,0,37,417,454,300,117,454,528,0,132,627,3,6,86,37,186,322,26,1525,153
1719,25,5.3.460,0,604,0,27,460,487,417,43,487,528,0,203,627,4,5,67,40,158,297,26,1525,153
1719,26,0.3.460,1,604,0,13,460,473,454,6,473,528,0,203,627,4,5,49,40,186,297,27,1525,116
1719,26,5.3.460,0,604,0,27,460,487,417,43,487,528,0,203,627,4,5,67,40,158,297,27,1525,116
1719,27,0.4.528,0,604,0,36,528,564,473,55,564,564,0,272,627,5,5,36,76,186,332,28,1525,103
1719,27,5.3.473,1,604,0,27,473,500,417,56,500,528,0,203,627,4,6,67,27,158,297,28,1525,103
1719,28,0.4.528,1,604,0,36,528,564,473,55,564,564,0,272,627,5,5,36,76,186,332,29,1525,76
1719,28,5.4.528,0,604,0,40,528,568,500,28,568,568,0,272,627,5,5,40,76,158,332,29,1525,76
1719,29,5.4.564,1,604,0,40,564,604,500,64,604,604,0,272,627,5,6,40,40,158,332,30,1525,40
1720,0,0.0.0,0,597,1,8,0,8,0,0,8,8,0,0,0,1,1,228,211,228,211,1,1595,1595
1720,0,1.0.0,0,666,5,77,0,77,0,0,77,77,0,0,0,1,1,299,211,299,211,1,1595,1595
1720,0,2.0.0,0,645,4,62,0,62,0,0,62,62,0,0,0,1,1,377,211,377,211,1,1595,1595
1720,0,3.0.0,1,619,3,23,0,23,0,0,23,23,0,0,0,1,1,353,211,353,211,1,1595,1595
1720,0,4.0.0,0,596,0,20,0,20,0,0,20,20,0,0,0,1,1,176,211,176,211,1,1595,1595
1720,0,5.0.0,0,617,2,21,0,21,0,0,21,21,0,0,0,1,1,162,211,162,211,1,1595,1595
1720,1,0.0.23,1,620,1,8,23,31,0,23,31,31,0,0,0,1,2,228,188,228,211,2,1595,1572
1720,1,1.0.23,0,626,2,77,23,100,0,23,100,100,0,0,0,1,2,299,188,299,211,2,1595,1572
1720,1,2.0.23,0,626,2,62,23,85,0,23,85,85,0,0,0,1,2,377,188,377,211,2,1595,1572
1720,1,3.1.23,0,626,2,96,23,119,23,0,119,119,-23,23,23,2,1,330,381,353,381,2,1595,1572
1720,1,4.0.23,0,619,0,20,23,43,0,23,43,43,0,0,0,1,2,176,188,176,211,2,1595,1572
1720,1,5.0.23,0,626,2,21,23,44,0,23,44,44,0,0,0,1,2,162,188,162,211,2,1595,1572
1720,2,0.1.31,0,620,0,73,31,104,31,0,104,104,-31,31,31,2,1,220,381,228,381,3,1595,1564
1720,2,1.0.31,0,626,1,77,31,108,0,31,108,108,0,0,0,1,3,299,180,299,211,3,1595,1564
1720,2,2.0.31,1,626,1,62,31,93,0,31,93,93,0,0,0,1,3,377,180,377,211,3,1595,1564
1720,2,3.1.23,0,626,1,96,23,119,23,0,119,119,-23,23,23,2,1,330,381,353,381,3,1595,1564
1720,2,4.0.31,0,620,0,20,31,51,0,31,51,51,0,0,0,1,3,176,180,176,211,3,1595,1564
1720,2,5.0.31,0,620,0,21,31,52,0,31,52,52,0,0,0,1,3,162,180,162,211,3,1595,1564
1720,3,0.1.31,0,626,0,73,31,104,31,0,104,104,-31,31,31,2,1,220,381,228,381,4,1595,1502
1720,3,1.0.93,0,626,0,77,93,170,0,93,170,170,0,0,0,1,4,299,118,299,211,4,1595,1502
1720,3,2.1.93,0,678,1,70,93,163,93,0,163,163,-93,93,93,2,1,315,381,377,381,4,1595,1502
1720,3,3.1.23,0,626,0,96,23,119,23,0,119,119,-23,23,23,2,1,330,381,353,381,4,1595,1502
1720,3,4.0.93,1,626,0,20,93,113,0,93,113,113,0,0,0,1,4,176,118,176,211,4,1595,1502
1720,3,5.0.93,0,626,0,21,93,114,0,93,114,114,0,0,0,1,4,162,118,162,211,4,1595,1502
1720,4,0.1.31,0,626,0,73,31,104,31,0,104,113,-31,31,31,2,1,220,381,228,381,5,1595,1482
1720,4,1.0.113,0,626,0,77,113,190,0,113,190,190,0,0,0,1,5,299,98,299,211,5,1595,1482
1720,4,2.1.93,0,678,1,70,93,163,93,0,163,163,-93,93,93,2,1,315,381,377,381,5,1595,1482
1720,4,3.1.23,0,626,0,96,23,119,23,0,119,119,-23,23,23,2,1,330,381,353,381,5,1595,1482
1720,4,4.1.113,0,626,0,12,113,125,113,0,125,125,-113,113,113,2,1,156,381,176,381,5,1595,1482
1720,4,5.0.113,1,626,0,21,113,134,0,113,134,134,0,0,0,1,5,162,98,162,211,5,1595,1482
1720,5,0.1.31,0,626,0,73,31,104,31,0,104,134,-31,31,31,2,1,220,381,228,381,6,1595,1461
1720,5,1.0.134,1,626,0,77,134,211,0,134,211,211,0,0,0,1,6,299,77,299,211,6,1595,1461
1720,5,2.1.93,0,678,2,70,93,163,93,0,163,163,-93,93,93,2,1,315,381,377,381,6,1595,1461
1720,5,3.1.23,0,626,0,96,23,119,23,0,119,134,-23,23,23,2,1,330,381,353,381,6,1595,1461
1720,5,4.1.113,0,626,0,12,113,125,113,0,125,134,-113,113,113,2,1,156,381,176,381,6,1595,1461
1720,5,5.1.134,0,648,1,87,134,221,134,0,221,221,-134,134,134,2,1,141,381,162,381,6,1595,1461
1720,6,0.1.31,0,626,0,73,31,104,31,0,104,211,-31,31,31,2,1,220,381,228,381,7,1595,1384
1720,6,1.1.211,0,644,1,43,211,254,211,0,254,254,-211,211,211,2,1,222,381,299,381,7,1595,1384
1720,6,2.1.93,0,678,3,70,93,163,93,0,163,211,-93,93,93,2,1,315,381,377,381,7,1595,1384
1720,6,3.1.23,1,626,0,96,23,119,23,0,119,211,-23,23,23,2,1,330,381,353,381,7,1595,1384
1720,6,4.1.113,0,626,0,12,113,125,113,0,125,211,-113,113,113,2,1,156,381,176,381,7,1595,1384
1720,6,5.1.134,0,648,2,87,134,221,134,0,221,221,-134,134,134,2,1,141,381,162,381,7,1595,1384
1720,7,0.1.119,0,626,0,73,119,192,31,88,192,211,0,23,23,2,2,220,285,228,381,8,1595,1288
1720,7,1.1.211,0,644,2,43,211,254,211,0,254,254,-92,115,115,2,2,222,285,299,381,8,1595,1288
1720,7,2.1.119,1,627,1,70,119,189,93,26,189,211,0,23,23,2,2,315,285,377,381,8,1595,1288
1720,7,3.2.119,0,626,0,85,119,204,119,0,204,211,-119,119,142,3,1,234,389,353,389,8,1595,1288
1720,7,4.1.119,0,627,1,12,119,131,113,6,131,211,0,23,23,2,2,156,285,176,381,8,1595,1288
1720,7,5.1.134,0,648,3,87,134,221,134,0,221,221,-15,38,38,2,2,141,285,162,381,8,1595,1288
1720,8,0.1.189,0,627,0,73,189,262,31,158,262,262,0,23,23,2,3,220,215,228,381,9,1595,1218
1720,8,1.1.211,0,657,2,43,211,254,211,0,254,254,-22,45,45,2,3,222,215,299,381,9,1595,1218
1720,8,2.2.189,0,704,3,91,189,280,189,0,280,280,-189,189,212,3,1,245,389,377,389,9,1595,1218
1720,8,3.2.119,0,627,0,85,119,204,119,0,204,211,-119,119,142,3,1,234,389,353,389,9,1595,1218
1720,8,4.1.189,1,627,0,12,189,201,113,76,201,211,0,23,23,2,3,156,215,176,381,9,1595,1218
1720,8,5.1.189,0,647,1,87,189,276,134,55,276,276,0,23,23,2,3,141,215,162,381,9,1595,1218
1720,9,0.1.201,1,627,0,73,201,274,31,170,274,274,0,23,23,2,4,220,203,228,381,10,1595,1206
1720,9,1.1.211,0,657,2,43,211,254,211,0,254,254,-10,33,33,2,4,222,203,299,381,10,1595,1206
1720,9,2.2.189,0,704,3,91,189,280,189,0,280,280,-189,189,212,3,1,245,389,377,389,10,1595,1206
1720,9,3.2.119,0,627,0,85,119,204,119,0,204,211,-119,119,142,3,1,234,389,353,389,10,1595,1206
1720,9,4.2.201,0,707,4,71,201,272,201,0,272,272,-201,201,224,3,1,144,389,176,389,10,1595,1206
1720,9,5.1.201,0,642,1,87,201,288,134,67,288,288,0,23,23,2,4,141,203,162,381,10,1595,1206
1720,10,0.2.274,0,669,2,40,274,314,274,0,314,314,-274,274,297,3,1,147,389,228,389,11,1595,1133
1720,10,1.1.274,1,628,1,43,274,317,211,63,317,317,0,23,23,2,5,222,130,299,381,11,1595,1133
1720,10,2.2.189,0,704,3,91,189,280,189,0,280,280,-189,189,212,3,1,245,389,377,389,11,1595,1133
1720,10,3.2.119,0,627,0,85,119,204,119,0,204,274,-119,119,142,3,1,234,389,353,389,11,1595,1133
1720,10,4.2.201,0,707,4,71,201,272,201,0,272,274,-201,201,224,3,1,144,389,176,389,11,1595,1133
1720,10,5.1.274,0,627,0,87,274,361,134,140,361,361,0,23,23,2,5,141,130,162,381,11,1595,1133
1720,11,0.2.274,0,669,2,40,274,314,274,0,314,317,-274,274,297,3,1,147,389,228,389,12,1595,1090
1720,11,1.2.317,0,657,1,92,317,409,317,0,409,409,-317,317,340,3,1,179,389,299,389,12,1595,1090
1720,11,2.2.189,0,704,3,91,189,280,189,0,280,317,-189,189,212,3,1,245,389,377,389,12,1595,1090
1720,11,3.2.119,0,628,0,85,119,204,119,0,204,317,-119,119,142,3,1,234,389,353,389,12,1595,1090
1720,11,4.2.201,0,712,4,71,201,272,201,0,272,317,-201,201,224,3,1,144,389,176,389,12,1595,1090
1720,11,5.1.317,1,628,0,87,317,404,134,183,404,404,0,23,23,2,6,141,87,162,381,12,1595,1090
1720,12,0.2.274,0,669,3,40,274,314,274,0,314,404,-274,274,297,3,1,147,389,228,389,13,1595,1003
1720,12,1.2.317,0,657,2,92,317,409,317,0,409,409,-317,317,340,3,1,179,389,299,389,13,1595,1003
1720,12,2.2.189,0,704,4,91,189,280,189,0,280,404,-189,189,212,3,1,245,389,377,389,13,1595,1003
1720,12,3.2.119,1,628,0,85,119,204,119,0,204,404,-119,119,142,3,1,234,389,353,389,13,1595,1003
1720,12,4.2.201,0,712,5,71,201,272,201,0,272,404,-201,201,224,3,1,144,389,176,389,13,1595,1003
1720,12,5.2.404,0,650,1,10,404,414,404,0,414,414,-404,404,427,3,1,54,389,162,389,13,1595,1003
1720,13,0.2.274,0,669,4,40,274,314,274,0,314,404,-70,189,212,3,2,147,304,228,389,14,1595,918
1720,13,1.2.317,0,657,3,92,317,409,317,0,409,409,-113,232,255,3,2,179,304,299,389,14,1595,918
1720,13,2.2.204,0,628,0,91,204,295,189,15,295,404,0,119,142,3,2,245,304,377,389,14,1595,918
1720,13,3.3.204,1,628,0,58,204,262,204,0,262,404,-204,204,346,4,1,149,250,353,250,14,1595,918
1720,13,4.2.204,0,635,1,71,204,275,201,3,275,404,0,119,142,3,2,144,304,176,389,14,1595,918
1720,13,5.2.404,0,650,2,10,404,414,404,0,414,414,-200,319,342,3,2,54,304,162,389,14,1595,918
1720,14,0.2.274,0,669,4,40,274,314,274,0,314,404,-70,189,416,3,2,147,304,228,389,15,1595,860
1720,14,1.2.317,0,657,3,92,317,409,317,0,409,409,-113,232,459,3,2,179,304,299,389,15,1595,860
1720,14,2.2.204,0,628,0,91,204,295,189,15,295,404,0,119,346,3,2,245,304,377,389,15,1595,860
1720,14,3.4.262,1,628,0,91,262,353,262,0,353,404,-262,262,608,5,1,91,364,353,364,15,1595,860
1720,14,4.2.204,0,635,1,71,204,275,201,3,275,404,0,119,346,3,2,144,304,176,389,15,1595,860
1720,14,5.2.404,0,650,2,10,404,414,404,0,414,414,-200,319,546,3,2,54,304,162,389,15,1595,860
1720,15,0.2.274,0,669,4,40,274,314,274,0,314,404,-70,189,678,3,2,147,304,228,389,16,1595,769
1720,15,1.2.317,0,657,3,92,317,409,317,0,409,409,-113,232,721,3,2,179,304,299,389,16,1595,769
1720,15,2.2.204,1,628,0,91,204,295,189,15,295,404,0,119,608,3,2,245,304,377,389,16,1595,769
1720,15,4.2.204,0,635,1,71,204,275,201,3,275,404,0,119,608,3,2,144,304,176,389,16,1595,769
1720,15,5.2.404,0,650,2,10,404,414,404,0,414,414,-200,319,808,3,2,54,304,162,389,16,1595,769
1720,16,0.2.295,0,628,0,40,295,335,274,21,335,404,0,119,608,3,3,147,213,228,389,17,1595,678
1720,16,1.2.317,0,657,2,92,317,409,317,0,409,409,-22,141,630,3,3,179,213,299,389,17,1595,678
1720,16,2.3.295,1,657,2,89,295,384,295,0,384,404,-33,237,641,4,2,154,192,377,250,17,1595,678
1720,16,4.2.295,0,657,2,71,295,366,201,94,366,404,0,119,608,3,3,144,213,176,389,17,1595,678
1720,16,5.2.404,0,650,1,10,404,414,404,0,414,414,-109,228,717,3,3,54,213,162,389,17,1595,678
1720,17,0.2.295,0,657,0,40,295,335,274,21,335,404,0,119,641,3,3,147,213,228,389,18,1595,589
1720,17,1.2.317,0,657,0,92,317,409,317,0,409,409,-22,141,663,3,3,179,213,299,389,18,1595,589
1720,17,2.4.384,1,657,0,65,384,449,384,0,449,449,-31,293,672,5,2,65,273,377,364,18,1595,589
1720,17,4.2.295,0,657,0,71,295,366,201,94,366,404,0,119,641,3,3,144,213,176,389,18,1595,589
1720,17,5.2.404,0,657,0,10,404,414,404,0,414,414,-109,228,750,3,3,54,213,162,389,18,1595,589
1720,18,0.2.295,1,657,0,40,295,335,274,21,335,449,0,119,672,3,3,147,213,228,389,19,1595,524
1720,18,1.2.317,0,657,0,92,317,409,317,0,409,449,-22,141,694,3,3,179,213,299,389,19,1595,524
1720,18,4.2.295,0,657,0,71,295,366,201,94,366,449,0,119,672,3,3,144,213,176,389,19,1595,524
1720,18,5.2.404,0,657,0,10,404,414,404,0,414,449,-109,228,781,3,3,54,213,162,389,19,1595,524
1720,19,0.3.384,1,657,0,19,384,403,335,49,403,449,0,237,672,4,3,107,103,228,250,20,1595,484
1720,19,1.2.335,0,657,0,92,335,427,317,18,427,449,0,119,672,3,4,179,173,299,389,20,1595,484
1720,19,4.2.335,0,657,0,71,335,406,201,134,406,449,0,119,672,3,4,144,173,176,389,20,1595,484
1720,19,5.2.404,0,657,0,10,404,414,404,0,414,449,-69,188,741,3,4,54,173,162,389,20,1595,484
1720,20,0.4.449,0,657,0,88,449,537,403,46,537,537,0,293,672,5,3,88,208,228,364,21,1595,465
1720,20,1.2.335,0,657,0,92,335,427,317,18,427,449,0,119,672,3,4,179,173,299,389,21,1595,465
1720,20,4.2.335,1,657,0,71,335,406,201,134,406,449,0,119,672,3,4,144,173,176,389,21,1595,465
1720,20,5.2.404,0,657,0,10,404,414,404,0,414,449,-69,188,741,3,4,54,173,162,389,21,1595,465
1720,21,0.4.449,0,657,0,88,449,537,403,46,537,537,0,293,672,5,3,88,208,228,364,22,1595,394
1720,21,1.2.406,0,657,0,92,406,498,317,89,498,498,0,119,672,3,5,179,102,299,389,22,1595,394
1720,21,4.3.406,1,657,0,38,406,444,406,0,444,449,-3,240,675,4,4,73,84,176,250,22,1595,394
1720,21,5.2.406,0,657,0,10,406,416,404,2,416,449,0,119,672,3,5,54,102,162,389,22,1595,394
1720,22,0.4.449,0,657,0,88,449,537,403,46,537,537,0,293,675,5,3,88,208,228,364,23,1595,356
1720,22,1.2.406,1,657,0,92,406,498,317,89,498,498,0,119,675,3,5,179,102,299,389,23,1595,356
1720,22,4.4.449,0,657,0,35,449,484,444,5,484,484,0,293,675,5,3,35,208,176,364,23,1595,356
1720,22,5.2.406,0,657,0,10,406,416,404,2,416,449,0,119,675,3,5,54,102,162,389,23,1595,356
1720,23,0.4.449,0,657,0,88,449,537,403,46,537,537,0,293,675,5,3,88,208,228,364,24,1595,264
1720,23,1.3.498,1,657,0,34,498,532,498,0,532,532,-54,294,729,4,5,87,46,299,250,24,1595,264
1720,23,4.4.449,0,657,0,35,449,484,444,5,484,498,0,293,675,5,3,35,208,176,364,24,1595,264
1720,23,5.2.498,0,657,0,10,498,508,404,94,508,508,0,119,675,3,6,54,10,162,389,24,1595,264
1720,24,0.4.449,0,657,0,88,449,537,403,46,537,537,0,293,729,5,3,88,208,228,364,25,1595,230
1720,24,1.4.532,0,705,1,53,532,585,532,0,585,585,-83,376,812,5,3,53,208,299,364,25,1595,230
1720,24,4.4.449,0,657,0,35,449,484,444,5,484,532,0,293,729,5,3,35,208,176,364,25,1595,230
1720,24,5.2.498,1,657,0,10,498,508,404,94,508,532,0,119,729,3,6,54,10,162,389,25,1595,230
1720,25,0.4.449,0,657,0,88,449,537,403,46,537,537,0,293,729,5,3,88,208,228,364,26,1595,220
1720,25,1.4.532,0,705,1,53,532,585,532,0,585,585,-83,376,812,5,3,53,208,299,364,26,1595,220
1720,25,4.4.449,0,657,0,35,449,484,444,5,484,532,0,293,729,5,3,35,208,176,364,26,1595,220
1720,25,5.3.532,1,657,0,12,532,544,508,24,544,544,0,294,729,4,6,44,12,162,250,26,1595,220
1720,26,0.4.449,0,657,0,88,449,537,403,46,537,544,0,293,729,5,3,88,208,228,364,27,1595,208
1720,26,1.4.532,0,705,2,53,532,585,532,0,585,585,-83,376,812,5,3,53,208,299,364,27,1595,208
1720,26,4.4.449,1,657,0,35,449,484,444,5,484,544,0,293,729,5,3,35,208,176,364,27,1595,208
1720,26,5.4.544,0,664,1,32,544,576,544,0,576,576,-95,388,824,5,3,32,208,162,364,27,1595,208
1720,27,0.4.484,1,657,0,88,484,572,403,81,572,572,0,293,729,5,4,88,173,228,364,28,1595,173
1720,27,1.4.532,0,705,1,53,532,585,532,0,585,585,-48,341,777,5,4,53,173,299,364,28,1595,173
1720,27,5.4.544,0,717,2,32,544,576,544,0,576,576,-60,353,789,5,4,32,173,162,364,28,1595,173
1720,28,1.4.572,1,657,0,53,572,625,532,40,625,625,0,293,729,5,5,53,85,299,364,29,1595,85
1720,28,5.4.572,0,657,0,32,572,604,544,28,604,604,0,293,729,5,5,32,85,162,364,29,1595,85
1720,29,5.4.625,1,657,0,32,625,657,544,81,657,657,0,293,729,5,6,32,32,162,364,30,1595,32
1721,0,0.0.0,0,482,2,21,0,21,0,0,21,21,0,0,0,1,1,172,225,172,225,1,1364,1364
1721,0,1.0.0,0,469,0,53,0,53,0,0,53,53,0,0,0,1,1,298,225,298,225,1,1364,1364
1721,0,2.0.0,0,472,1,8,0,8,0,0,8,8,0,0,0,1,1,205,225,205,225,1,1364,1364
1721,0,3.0.0,0,538,5,75,0,75,0,0,75,75,0,0,0,1,1,212,225,212,225,1,1364,1364
1721,0,4.0.0,0,511,4,42,0,42,0,0,42,42,0,0,0,1,1,214,225,214,225,1,1364,1364
1721,0,5.0.0,1,489,3,26,0,26,0,0,26,26,0,0,0,1,1,263,225,263,225,1,1364,1364
1721,1,0.0.26,0,489,0,21,26,47,0,26,47,47,0,0,0,1,2,172,199,172,225,2,1364,1338
1721,1,1.0.26,0,489,0,53,26,79,0,26,79,79,0,0,0,1,2,298,199,298,225,2,1364,1338
1721,1,2.0.26,1,489,0,8,26,34,0,26,34,34,0,0,0,1,2,205,199,205,225,2,1364,1338
1721,1,3.0.26,0,506,1,75,26,101,0,26,101,101,0,0,0,1,2,212,199,212,225,2,1364,1338
1721,1,4.0.26,0,489,0,42,26,68,0,26,68,68,0,0,0,1,2,214,199,214,225,2,1364,1338
1721,1,5.1.26,0,489,0,70,26,96,26,0,96,96,-26,26,26,2,1,237,285,263,285,2,1364,1338
1721,2,0.0.34,0,489,0,21,34,55,0,34,55,55,0,0,0,1,3,172,191,172,225,3,1364,1330
1721,2,1.0.34,1,489,0,53,34,87,0,34,87,87,0,0,0,1,3,298,191,298,225,3,1364,1330
1721,2,2.1.34,0,498,1,64,34,98,34,0,98,98,-34,34,34,2,1,197,285,205,285,3,1364,1330
1721,2,3.0.34,0,506,2,75,34,109,0,34,109,109,0,0,0,1,3,212,191,212,225,3,1364,1330
1721,2,4.0.34,0,489,0,42,34,76,0,34,76,76,0,0,0,1,3,214,191,214,225,3,1364,1330
1721,2,5.1.26,0,489,0,70,26,96,26,0,96,96,-26,26,26,2,1,237,285,263,285,3,1364,1330
1721,3,0.0.87,1,489,0,21,87,108,0,87,108,108,0,0,0,1,4,172,138,172,225,4,1364,1277
1721,3,1.1.87,0,503,2,11,87,98,87,0,98,98,-87,87,87,2,1,245,285,298,285,4,1364,1277
1721,3,2.1.34,0,498,1,64,34,98,34,0,98,98,-34,34,34,2,1,197,285,205,285,4,1364,1277
1721,3,3.0.87,0,489,0,75,87,162,0,87,162,162,0,0,0,1,4,212,138,212,225,4,1364,1277
1721,3,4.0.87,0,489,0,42,87,129,0,87,129,129,0,0,0,1,4,214,138,214,225,4,1364,1277
1721,3,5.1.26,0,489,0,70,26,96,26,0,96,96,-26,26,26,2,1,237,285,263,285,4,1364,1277
1721,4,0.1.108,0,489,0,41,108,149,108,0,149,149,-108,108,108,2,1,151,285,172,285,5,1364,1256
1721,4,1.1.87,0,503,2,11,87,98,87,0,98,108,-87,87,87,2,1,245,285,298,285,5,1364,1256
1721,4,2.1.34,0,498,1,64,34,98,34,0,98,108,-34,34,34,2,1,197,285,205,285,5,1364,1256
1721,4,3.0.108,0,489,0,75,108,183,0,108,183,183,0,0,0,1,5,212,117,212,225,5,1364,1256
1721,4,4.0.108,1,489,0,42,108,150,0,108,150,150,0,0,0,1,5,214,117,214,225,5,1364,1256
1721,4,5.1.26,0,489,0,70,26,96,26,0,96,108,-26,26,26,2,1,237,285,263,285,5,1364,1256
1721,5,0.1.108,0,489,0,41,108,149,108,0,149,150,-108,108,108,2,1,151,285,172,285,6,1364,1214
1721,5,1.1.87,0,503,2,11,87,98,87,0,98,150,-87,87,87,2,1,245,285,298,285,6,1364,1214
1721,5,2.1.34,0,498,1,64,34,98,34,0,98,150,-34,34,34,2,1,197,285,205,285,6,1364,1214
1721,5,3.0.150,1,489,0,75,150,225,0,150,225,225,0,0,0,1,6,212,75,212,225,6,1364,1214
1721,5,4.1.150,0,489,0,64,150,214,150,0,214,214,-150,150,150,2,1,172,285,214,285,6,1364,1214
1721,5,5.1.26,0,489,0,70,26,96,26,0,96,150,-26,26,26,2,1,237,285,263,285,6,1364,1214
1721,6,0.1.108,0,489,0,41,108,149,108,0,149,225,-108,108,108,2,1,151,285,172,285,7,1364,1139
1721,6,1.1.87,1,503,2,11,87,98,87,0,98,225,-87,87,87,2,1,245,285,298,285,7,1364,1139
1721,6,2.1.34,0,498,1,64,34,98,34,0,98,225,-34,34,34,2,1,197,285,205,285,7,1364,1139
1721,6,3.1.225,0,489,0,35,225,260,225,0,260,260,-225,225,225,2,1,137,285,212,285,7,1364,1139
1721,6,4.1.150,0,489,0,64,150,214,150,0,214,225,-150,150,150,2,1,172,285,214,285,7,1364,1139
1721,6,5.1.26,0,489,0,70,26,96,26,0,96,225,-26,26,26,2,1,237,285,263,285,7,1364,1139
1721,7,0.1.108,0,503,0,41,108,149,108,0,149,225,-10,97,97,2,2,151,274,172,285,8,1364,1128
1721,7,1.2.98,0,503,0,97,98,195,98,0,195,225,-98,98,185,3,1,234,357,298,357,8,1364,1128
1721,7,2.1.98,0,511,1,64,98,162,34,64,162,225,0,87,87,2,2,197,274,205,285,8,1364,1128
1721,7,3.1.225,0,503,0,35,225,260,225,0,260,260,-127,214,214,2,2,137,274,212,285,8,1364,1128
1721,7,4.1.150,0,539,2,64,150,214,150,0,214,225,-52,139,139,2,2,172,274,214,285,8,1364,1128
1721,7,5.1.98,1,503,0,70,98,168,26,72,168,225,0,87,87,2,2,237,274,263,285,8,1364,1128
1721,8,0.1.168,0,503,0,41,168,209,108,60,209,225,0,87,87,2,3,151,204,172,285,9,1364,1058
1721,8,1.2.98,0,503,0,97,98,195,98,0,195,225,-98,98,185,3,1,234,357,298,357,9,1364,1058
1721,8,2.1.168,1,503,0,64,168,232,34,134,232,232,0,87,87,2,3,197,204,205,285,9,1364,1058
1721,8,3.1.225,0,503,0,35,225,260,225,0,260,260,-57,144,144,2,3,137,204,212,285,9,1364,1058
1721,8,4.1.168,0,525,1,64,168,232,150,18,232,232,0,87,87,2,3,172,204,214,285,9,1364,1058
1721,8,5.2.168,0,561,2,48,168,216,168,0,216,225,-168,168,255,3,1,167,357,263,357,9,1364,1058
1721,9,0.1.232,1,503,0,41,232,273,108,124,273,273,0,87,87,2,4,151,140,172,285,10,1364,994
1721,9,1.2.98,0,503,0,97,98,195,98,0,195,232,-98,98,185,3,1,234,357,298,357,10,1364,994
1721,9,2.2.232,0,528,1,45,232,277,232,0,277,277,-232,232,319,3,1,133,357,205,357,10,1364,994
1721,9,3.1.232,0,503,0,35,232,267,225,7,267,267,0,87,87,2,4,137,140,212,285,10,1364,994
1721,9,4.1.232,0,533,2,64,232,296,150,82,296,296,0,87,87,2,4,172,140,214,285,10,1364,994
1721,9,5.2.168,0,561,3,48,168,216,168,0,216,232,-168,168,255,3,1,167,357,263,357,10,1364,994
1721,10,0.2.273,0,521,2,43,273,316,273,0,316,316,-273,273,360,3,1,110,357,172,357,11,1364,953
1721,10,1.2.98,0,503,0,97,98,195,98,0,195,273,-98,98,185,3,1,234,357,298,357,11,1364,953
1721,10,2.2.232,0,528,3,45,232,277,232,0,277,277,-232,232,319,3,1,133,357,205,357,11,1364,953
1721,10,3.1.273,0,503,0,35,273,308,225,48,308,308,0,87,87,2,5,137,99,212,285,11,1364,953
1721,10,4.1.273,1,518,1,64,273,337,150,123,337,337,0,87,87,2,5,172,99,214,285,11,1364,953
1721,10,5.2.168,0,561,4,48,168,216,168,0,216,273,-168,168,255,3,1,167,357,263,357,11,1364,953
1721,11,0.2.273,0,532,1,43,273,316,273,0,316,337,-273,273,360,3,1,110,357,172,357,12,1364,889
1721,11,1.2.98,0,518,0,97,98,195,98,0,195,337,-98,98,185,3,1,234,357,298,357,12,1364,889
1721,11,2.2.232,0,532,1,45,232,277,232,0,277,337,-232,232,319,3,1,133,357,205,357,12,1364,889
1721,11,3.1.337,1,518,0,35,337,372,225,112,372,372,0,87,87,2,6,137,35,212,285,12,1364,889
1721,11,4.2.337,0,518,0,72,337,409,337,0,409,409,-337,337,424,3,1,108,357,214,357,12,1364,889
1721,11,5.2.168,0,561,2,48,168,216,168,0,216,337,-168,168,255,3,1,167,357,263,357,12,1364,889
1721,12,0.2.273,0,532,1,43,273,316,273,0,316,372,-273,273,360,3,1,110,357,172,357,13,1364,854
1721,12,1.2.98,1,518,0,97,98,195,98,0,195,372,-98,98,185,3,1,234,357,298,357,13,1364,854
1721,12,2.2.232,0,532,1,45,232,277,232,0,277,372,-232,232,319,3,1,133,357,205,357,13,1364,854
1721,12,3.2.372,0,532,1,52,372,424,372,0,424,424,-372,372,459,3,1,102,357,212,357,13,1364,854
1721,12,4.2.337,0,518,0,72,337,409,337,0,409,409,-337,337,424,3,1,108,357,214,357,13,1364,854
1721,12,5.2.168,0,561,2,48,168,216,168,0,216,372,-168,168,255,3,1,167,357,263,357,13,1364,854
1721,13,0.2.273,0,532,1,43,273,316,273,0,316,372,-78,176,263,3,2,110,260,172,357,14,1364,757
1721,13,1.3.195,1,518,0,75,195,270,195,0,270,372,-195,195,380,4,1,137,303,298,303,14,1364,757
1721,13,2.2.232,0,532,1,45,232,277,232,0,277,372,-37,135,222,3,2,133,260,205,357,14,1364,757
1721,13,3.2.372,0,532,1,52,372,424,372,0,424,424,-177,275,362,3,2,102,260,212,357,14,1364,757
1721,13,4.2.337,0,518,0,72,337,409,337,0,409,409,-142,240,327,3,2,108,260,214,357,14,1364,757
1721,13,5.2.195,0,518,0,48,195,243,168,27,243,372,0,98,185,3,2,167,260,263,357,14,1364,757
1721,14,0.2.273,0,532,1,43,273,316,273,0,316,372,-78,176,458,3,2,110,260,172,357,15,1364,682
1721,14,1.4.270,1,518,0,62,270,332,270,0,332,372,-270,270,650,5,1,62,194,298,194,15,1364,682
1721,14,2.2.232,0,532,1,45,232,277,232,0,277,372,-37,135,417,3,2,133,260,205,357,15,1364,682
1721,14,3.2.372,0,532,1,52,372,424,372,0,424,424,-177,275,557,3,2,102,260,212,357,15,1364,682
1721,14,4.2.337,0,518,0,72,337,409,337,0,409,409,-142,240,522,3,2,108,260,214,357,15,1364,682
1721,14,5.2.195,0,518,0,48,195,243,168,27,243,372,0,98,380,3,2,167,260,263,357,15,1364,682
1721,15,0.2.273,0,532,1,43,273,316,273,0,316,372,-78,176,728,3,2,110,260,172,357,16,1364,620
1721,15,2.2.232,0,532,1,45,232,277,232,0,277,372,-37,135,687,3,2,133,260,205,357,16,1364,620
1721,15,3.2.372,0,532,1,52,372,424,372,0,424,424,-177,275,827,3,2,102,260,212,357,16,1364,620
1721,15,4.2.337,0,518,0,72,337,409,337,0,409,409,-142,240,792,3,2,108,260,214,357,16,1364,620
1721,15,5.2.195,1,518,0,48,195,243,168,27,243,372,0,98,650,3,2,167,260,263,357,16,1364,620
1721,16,0.2.273,0,532,1,43,273,316,273,0,316,372,-30,128,680,3,3,110,212,172,357,17,1364,572
1721,16,2.2.243,0,518,0,45,243,288,232,11,288,372,0,98,650,3,3,133,212,205,357,17,1364,572
1721,16,3.2.372,0,532,1,52,372,424,372,0,424,424,-129,227,779,3,3,102,212,212,357,17,1364,572
1721,16,4.2.337,0,518,0,72,337,409,337,0,409,409,-94,192,744,3,3,108,212,214,357,17,1364,572
1721,16,5.3.270,1,518,0,96,270,366,243,27,366,372,0,195,650,4,2,119,228,263,303,17,1364,572
1721,17,0.2.273,0,532,1,43,273,316,273,0,316,372,-30,128,680,3,3,110,212,172,357,18,1364,476
1721,17,2.2.243,0,518,0,45,243,288,232,11,288,372,0,98,650,3,3,133,212,205,357,18,1364,476
1721,17,3.2.372,0,532,1,52,372,424,372,0,424,424,-129,227,779,3,3,102,212,212,357,18,1364,476
1721,17,4.2.337,0,518,0,72,337,409,337,0,409,409,-94,192,744,3,3,108,212,214,357,18,1364,476
1721,17,5.4.366,1,518,0,23,366,389,366,0,389,389,-34,304,684,5,2,23,132,263,194,18,1364,476
1721,18,0.2.273,0,532,1,43,273,316,273,0,316,389,-30,128,714,3,3,110,212,172,357,19,1364,453
1721,18,2.2.243,1,518,0,45,243,288,232,11,288,389,0,98,684,3,3,133,212,205,357,19,1364,453
1721,18,3.2.372,0,532,1,52,372,424,372,0,424,424,-129,227,813,3,3,102,212,212,357,19,1364,453
1721,18,4.2.337,0,518,0,72,337,409,337,0,409,409,-94,192,778,3,3,108,212,214,357,19,1364,453
1721,19,0.2.288,0,518,0,43,288,331,273,15,331,389,0,98,684,3,4,110,167,172,357,20,1364,408
1721,19,2.3.366,1,533,2,58,366,424,288,78,424,424,0,195,684,4,3,88,132,205,303,20,1364,408
1721,19,3.2.372,0,532,1,52,372,424,372,0,424,424,-84,182,768,3,4,102,167,212,357,20,1364,408
1721,19,4.2.337,0,518,0,72,337,409,337,0,409,409,-49,147,733,3,4,108,167,214,357,20,1364,408
1721,20,0.2.288,0,533,0,43,288,331,273,15,331,424,0,98,684,3,4,110,167,172,357,21,1364,350
1721,20,2.4.424,1,533,0,30,424,454,424,0,454,454,-35,339,719,5,3,30,109,205,194,21,1364,350
1721,20,3.2.372,0,533,0,52,372,424,372,0,424,424,-84,182,768,3,4,102,167,212,357,21,1364,350
1721,20,4.2.337,0,533,0,72,337,409,337,0,409,424,-49,147,733,3,4,108,167,214,357,21,1364,350
1721,21,0.2.288,1,533,0,43,288,331,273,15,331,454,0,98,719,3,4,110,167,172,357,22,1364,320
1721,21,3.2.372,0,533,0,52,372,424,372,0,424,454,-84,182,803,3,4,102,167,212,357,22,1364,320
1721,21,4.2.337,0,533,0,72,337,409,337,0,409,454,-49,147,768,3,4,108,167,214,357,22,1364,320
1721,22,0.3.424,1,533,0,26,424,450,331,93,450,454,0,195,719,4,4,67,74,172,303,23,1364,277
1721,22,3.2.372,0,533,0,52,372,424,372,0,424,454,-41,139,760,3,5,102,124,212,357,23,1364,277
1721,22,4.2.337,0,533,0,72,337,409,337,0,409,454,-6,104,725,3,5,108,124,214,357,23,1364,277
1721,23,0.4.454,1,533,0,41,454,495,450,4,495,495,0,339,719,5,4,41,79,172,194,24,1364,251
1721,23,3.2.372,0,533,0,52,372,424,372,0,424,454,-41,139,760,3,5,102,124,212,357,24,1364,251
1721,23,4.2.337,0,533,0,72,337,409,337,0,409,454,-6,104,725,3,5,108,124,214,357,24,1364,251
1721,24,3.2.372,0,533,0,52,372,424,372,0,424,495,-41,139,760,3,5,102,124,212,357,25,1364,210
1721,24,4.2.337,1,533,0,72,337,409,337,0,409,495,-6,104,725,3,5,108,124,214,357,25,1364,210
1721,25,3.2.409,0,533,0,52,409,461,372,37,461,495,0,104,725,3,6,102,52,212,357,26,1364,138
1721,25,4.3.450,1,533,0,31,450,481,409,41,481,495,0,195,725,4,5,36,48,214,303,26,1364,138
1721,26,3.2.409,0,533,0,52,409,461,372,37,461,495,0,104,725,3,6,102,52,212,357,27,1364,107
1721,26,4.4.495,1,533,0,5,495,500,481,14,500,500,0,339,725,5,5,5,38,214,194,27,1364,107
1721,27,3.2.409,1,533,0,52,409,461,372,37,461,500,0,104,725,3,6,102,52,212,357,28,1364,102
1721,28,3.3.481,1,533,0,17,481,498,461,20,498,500,0,195,725,4,6,50,17,212,303,29,1364,50
1721,29,3.4.500,1,533,0,33,500,533,498,2,533,533,0,339,725,5,6,33,33,212,194,30,1364,33
1722,0,0.0.0,0,543,0,34,0,34,0,0,34,34,0,0,0,1,1,215,237,215,237,1,1530,1530
1722,0,1.0.0,0,549,1,28,0,28,0,0,28,28,0,0,0,1,1,199,237,199,237,1,1530,1530
1722,0,2.0.0,0,596,4,53,0,53,0,0,53,53,0,0,0,1,1,330,237,330,237,1,1530,1530
1722,0,3.0.0,1,572,2,29,0,29,0,0,29,29,0,0,0,1,1,272,237,272,237,1,1530,1530
1722,0,4.0.0,0,597,5,63,0,63,0,0,63,63,0,0,0,1,1,250,237,250,237,1,1530,1530
1722,0,5.0.0,0,573,3,30,0,30,0,0,30,30,0,0,0,1,1,264,237,264,237,1,1530,1530
1722,1,0.0.29,0,572,0,34,29,63,0,29,63,63,0,0,0,1,2,215,208,215,237,2,1530,1501
1722,1,1.0.29,0,578,1,28,29,57,0,29,57,57,0,0,0,1,2,199,208,199,237,2,1530,1501
1722,1,2.0.29,0,619,4,53,29,82,0,29,82,82,0,0,0,1,2,330,208,330,237,2,1530,1501
1722,1,3.1.29,0,611,3,73,29,102,29,0,102,102,-29,29,29,2,1,243,287,272,287,2,1530,1501
1722,1,4.0.29,0,619,4,63,29,92,0,29,92,92,0,0,0,1,2,250,208,250,237,2,1530,1501
1722,1,5.0.29,1,602,2,30,29,59,0,29,59,59,0,0,0,1,2,264,208,264,237,2,1530,1501
1722,2,0.0.59,0,602,0,34,59,93,0,59,93,93,0,0,0,1,3,215,178,215,237,3,1530,1471
1722,2,1.0.59,0,608,1,28,59,87,0,59,87,87,0,0,0,1,3,199,178,199,237,3,1530,1471
1722,2,2.0.59,1,619,3,53,59,112,0,59,112,112,0,0,0,1,3,330,178,330,237,3,1530,1471
1722,2,3.1.29,0,611,2,73,29,102,29,0,102,102,-29,29,29,2,1,243,287,272,287,3,1530,1471
1722,2,4.0.59,0,619,3,63,59,122,0,59,122,122,0,0,0,1,3,250,178,250,237,3,1530,1471
1722,2,5.1.59,0,621,4,53,59,112,59,0,112,112,-59,59,59,2,1,234,287,264,287,3,1530,1471
1722,3,0.0.112,0,619,0,34,112,146,0,112,146,146,0,0,0,1,4,215,125,215,237,4,1530,1418
1722,3,1.0.112,1,619,0,28,112,140,0,112,140,140,0,0,0,1,4,199,125,199,237,4,1530,1418
1722,3,2.1.112,0,619,0,58,112,170,112,0,170,170,-112,112,112,2,1,277,287,330,287,4,1530,1418
1722,3,3.1.29,0,619,0,73,29,102,29,0,102,112,-29,29,29,2,1,243,287,272,287,4,1530,1418
1722,3,4.0.112,0,635,1,63,112,175,0,112,175,175,0,0,0,1,4,250,125,250,237,4,1530,1418
1722,3,5.1.59,0,655,2,53,59,112,59,0,112,112,-59,59,59,2,1,234,287,264,287,4,1530,1418
1722,4,0.0.140,1,619,0,34,140,174,0,140,174,174,0,0,0,1,5,215,97,215,237,5,1530,1390
1722,4,1.1.140,0,624,1,78,140,218,140,0,218,218,-140,140,140,2,1,171,287,199,287,5,1530,1390
1722,4,2.1.112,0,619,0,58,112,170,112,0,170,170,-112,112,112,2,1,277,287,330,287,5,1530,1390
1722,4,3.1.29,0,619,0,73,29,102,29,0,102,140,-29,29,29,2,1,243,287,272,287,5,1530,1390
1722,4,4.0.140,0,619,0,63,140,203,0,140,203,203,0,0,0,1,5,250,97,250,237,5,1530,1390
1722,4,5.1.59,0,661,2,53,59,112,59,0,112,140,-59,59,59,2,1,234,287,264,287,5,1530,1390
1722,5,0.1.174,0,619,0,9,174,183,174,0,183,183,-174,174,174,2,1,181,287,215,287,6,1530,1356
1722,5,1.1.140,0,624,1,78,140,218,140,0,218,218,-140,140,140,2,1,171,287,199,287,6,1530,1356
1722,5,2.1.112,0,619,0,58,112,170,112,0,170,174,-112,112,112,2,1,277,287,330,287,6,1530,1356
1722,5,3.1.29,0,619,0,73,29,102,29,0,102,174,-29,29,29,2,1,243,287,272,287,6,1530,1356
1722,5,4.0.174,1,619,0,63,174,237,0,174,237,237,0,0,0,1,6,250,63,250,237,6,1530,1356
1722,5,5.1.59,0,661,2,53,59,112,59,0,112,174,-59,59,59,2,1,234,287,264,287,6,1530,1356
1722,6,0.1.174,0,619,0,9,174,183,174,0,183,237,-174,174,174,2,1,181,287,215,287,7,1530,1293
1722,6,1.1.140,0,624,1,78,140,218,140,0,218,237,-140,140,140,2,1,171,287,199,287,7,1530,1293
1722,6,2.1.112,0,619,0,58,112,170,112,0,170,237,-112,112,112,2,1,277,287,330,287,7,1530,1293
1722,6,3.1.29,1,619,0,73,29,102,29,0,102,237,-29,29,29,2,1,243,287,272,287,7,1530,1293
1722,6,4.1.237,0,619,0,16,237,253,237,0,253,253,-237,237,237,2,1,187,287,250,287,7,1530,1293
1722,6,5.1.59,0,661,2,53,59,112,59,0,112,237,-59,59,59,2,1,234,287,264,287,7,1530,1293
1722,7,0.1.174,0,619,0,9,174,183,174,0,183,237,-72,101,101,2,2,181,214,215,287,8,1530,1220
1722,7,1.1.140,0,624,1,78,140,218,140,0,218,237,-38,67,67,2,2,171,214,199,287,8,1530,1220
1722,7,2.1.112,0,619,0,58,112,170,112,0,170,237,-10,39,39,2,2,277,214,330,287,8,1530,1220
1722,7,3.2.102,0,619,0,20,102,122,102,0,122,237,-102,102,131,3,1,170,326,272,326,8,1530,1220
1722,7,4.1.237,0,619,0,16,237,253,237,0,253,253,-135,164,164,2,2,187,214,250,287,8,1530,1220
1722,7,5.1.102,1,619,0,53,102,155,59,43,155,237,0,29,29,2,2,234,214,264,287,8,1530,1220
1722,8,0.1.174,0,619,0,9,174,183,174,0,183,237,-19,48,48,2,3,181,161,215,287,9,1530,1167
1722,8,1.1.155,0,619,0,78,155,233,140,15,233,237,0,29,29,2,3,171,161,199,287,9,1530,1167
1722,8,2.1.155,1,648,1,58,155,213,112,43,213,237,0,29,29,2,3,277,161,330,287,9,1530,1167
1722,8,3.2.102,0,619,0,20,102,122,102,0,122,237,-102,102,131,3,1,170,326,272,326,9,1530,1167
1722,8,4.1.237,0,619,0,16,237,253,237,0,253,253,-82,111,111,2,3,187,161,250,287,9,1530,1167
1722,8,5.2.155,0,619,0,86,155,241,155,0,241,241,-155,155,184,3,1,181,326,264,326,9,1530,1167
1722,9,0.1.213,1,648,0,9,213,222,174,39,222,237,0,29,29,2,4,181,103,215,287,10,1530,1109
1722,9,1.1.213,0,660,1,78,213,291,140,73,291,291,0,29,29,2,4,171,103,199,287,10,1530,1109
1722,9,2.2.213,0,679,2,97,213,310,213,0,310,310,-213,213,242,3,1,219,326,330,326,10,1530,1109
1722,9,3.2.102,0,648,0,20,102,122,102,0,122,237,-102,102,131,3,1,170,326,272,326,10,1530,1109
1722,9,4.1.237,0,648,0,16,237,253,237,0,253,253,-24,53,53,2,4,187,103,250,287,10,1530,1109
1722,9,5.2.155,0,660,1,86,155,241,155,0,241,241,-155,155,184,3,1,181,326,264,326,10,1530,1109
1722,10,0.2.222,0,648,0,47,222,269,222,0,269,269,-222,222,251,3,1,172,326,215,326,11,1530,1100
1722,10,1.1.222,0,648,0,78,222,300,140,82,300,300,0,29,29,2,5,171,94,199,287,11,1530,1100
1722,10,2.2.213,0,679,2,97,213,310,213,0,310,310,-213,213,242,3,1,219,326,330,326,11,1530,1100
1722,10,3.2.102,0,648,0,20,102,122,102,0,122,237,-102,102,131,3,1,170,326,272,326,11,1530,1100
1722,10,4.1.237,1,648,0,16,237,253,237,0,253,253,-15,44,44,2,5,187,94,250,287,11,1530,1100
1722,10,5.2.155,0,667,1,86,155,241,155,0,241,241,-155,155,184,3,1,181,326,264,326,11,1530,1100
1722,11,0.2.222,0,648,0,47,222,269,222,0,269,269,-222,222,266,3,1,172,326,215,326,12,1530,1084
1722,11,1.1.253,1,648,0,78,253,331,140,113,331,331,0,44,44,2,6,171,78,199,287,12,1530,1084
1722,11,2.2.213,0,684,3,97,213,310,213,0,310,310,-213,213,257,3,1,219,326,330,326,12,1530,1084
1722,11,3.2.102,0,648,0,20,102,122,102,0,122,253,-102,102,146,3,1,170,326,272,326,12,1530,1084
1722,11,4.2.253,0,683,2,72,253,325,253,0,325,325,-253,253,297,3,1,171,326,250,326,12,1530,1084
1722,11,5.2.155,0,667,1,86,155,241,155,0,241,253,-155,155,199,3,1,181,326,264,326,12,1530,1084
1722,12,0.2.222,0,648,0,47,222,269,222,0,269,331,-222,222,266,3,1,172,326,215,326,13,1530,1006
1722,12,1.2.331,0,667,1,4,331,335,331,0,335,335,-331,331,375,3,1,93,326,199,326,13,1530,1006
1722,12,2.2.213,0,684,3,97,213,310,213,0,310,331,-213,213,257,3,1,219,326,330,326,13,1530,1006
1722,12,3.2.102,1,648,0,20,102,122,102,0,122,331,-102,102,146,3,1,170,326,272,326,13,1530,1006
1722,12,4.2.253,0,683,2,72,253,325,253,0,325,331,-253,253,297,3,1,171,326,250,326,13,1530,1006
1722,12,5.2.155,0,667,1,86,155,241,155,0,241,331,-155,155,199,3,1,181,326,264,326,13,1530,1006
1722,13,0.2.222,0,648,0,47,222,269,222,0,269,331,-100,202,246,3,2,172,306,215,326,14,1530,986
1722,13,1.2.331,0,667,1,4,331,335,331,0,335,335,-209,311,355,3,2,93,306,199,326,14,1530,986
1722,13,2.2.213,0,684,3,97,213,310,213,0,310,331,-91,193,237,3,2,219,306,330,326,14,1530,986
1722,13,3.3.122,1,648,0,76,122,198,122,0,198,331,-122,122,268,4,1,150,259,272,259,14,1530,986
1722,13,4.2.253,0,683,2,72,253,325,253,0,325,331,-131,233,277,3,2,171,306,250,326,14,1530,986
1722,13,5.2.155,0,667,1,86,155,241,155,0,241,331,-33,135,179,3,2,181,306,264,326,14,1530,986
1722,14,0.2.222,0,648,0,47,222,269,222,0,269,331,-100,202,368,3,2,172,306,215,326,15,1530,910
1722,14,1.2.331,0,667,1,4,331,335,331,0,335,335,-209,311,477,3,2,93,306,199,326,15,1530,910
1722,14,2.2.213,0,684,3,97,213,310,213,0,310,331,-91,193,359,3,2,219,306,330,326,15,1530,910
1722,14,3.4.198,1,648,0,74,198,272,198,0,272,331,-198,198,466,5,1,74,421,272,421,15,1530,910
1722,14,4.2.253,0,683,2,72,253,325,253,0,325,331,-131,233,399,3,2,171,306,250,326,15,1530,910
1722,14,5.2.155,0,667,1,86,155,241,155,0,241,331,-33,135,301,3,2,181,306,264,326,15,1530,910
1722,15,0.2.222,0,648,0,47,222,269,222,0,269,331,-100,202,566,3,2,172,306,215,326,16,1530,836
1722,15,1.2.331,0,667,1,4,331,335,331,0,335,335,-209,311,675,3,2,93,306,199,326,16,1530,836
1722,15,2.2.213,0,684,3,97,213,310,213,0,310,331,-91,193,557,3,2,219,306,330,326,16,1530,836
1722,15,4.2.253,0,683,2,72,253,325,253,0,325,331,-131,233,597,3,2,171,306,250,326,16,1530,836
1722,15,5.2.155,1,667,1,86,155,241,155,0,241,331,-33,135,499,3,2,181,306,264,326,16,1530,836
1722,16,0.2.241,0,667,0,47,241,288,222,19,288,331,0,135,499,3,3,172,220,215,326,17,1530,750
1722,16,1.2.331,0,667,0,4,331,335,331,0,335,335,-90,225,589,3,3,93,220,199,326,17,1530,750
1722,16,2.2.241,0,693,2,97,241,338,213,28,338,338,0,135,499,3,3,219,220,330,326,17,1530,750
1722,16,4.2.253,0,683,1,72,253,325,253,0,325,331,-12,147,511,3,3,171,220,250,326,17,1530,750
1722,16,5.3.241,1,683,1,81,241,322,241,0,322,331,-43,165,542,4,2,95,183,264,259,17,1530,750
1722,17,0.2.241,1,686,1,47,241,288,222,19,288,331,0,135,542,3,3,172,220,215,326,18,1530,669
1722,17,1.2.331,0,683,0,4,331,335,331,0,335,335,-90,225,632,3,3,93,220,199,326,18,1530,669
1722,17,2.2.241,0,693,2,97,241,338,213,28,338,338,0,135,542,3,3,219,220,330,326,18,1530,669
1722,17,4.2.253,0,683,0,72,253,325,253,0,325,331,-12,147,554,3,3,171,220,250,326,18,1530,669
1722,17,5.4.322,0,683,0,14,322,336,322,0,336,336,-50,248,592,5,2,14,347,264,421,18,1530,669
1722,18,0.3.322,1,687,1,32,322,354,288,34,354,354,0,165,542,4,3,125,102,215,259,19,1530,622
1722,18,1.2.331,0,686,0,4,331,335,331,0,335,335,-43,178,585,3,4,93,173,199,326,19,1530,622
1722,18,2.2.288,0,687,1,97,288,385,213,75,385,385,0,135,542,3,4,219,173,330,326,19,1530,622
1722,18,4.2.288,0,687,1,72,288,360,253,35,360,360,0,135,542,3,4,171,173,250,326,19,1530,622
1722,18,5.4.322,0,686,0,14,322,336,322,0,336,336,-50,248,592,5,2,14,347,264,421,19,1530,622
1722,19,0.4.354,0,687,0,93,354,447,354,0,447,447,-82,280,624,5,2,93,347,215,421,20,1530,590
1722,19,1.2.331,0,687,0,4,331,335,331,0,335,354,-43,178,585,3,4,93,173,199,326,20,1530,590
1722,19,2.2.288,1,687,0,97,288,385,213,75,385,385,0,135,542,3,4,219,173,330,326,20,1530,590
1722,19,4.2.288,0,687,0,72,288,360,253,35,360,360,0,135,542,3,4,171,173,250,326,20,1530,590
1722,19,5.4.322,0,687,0,14,322,336,322,0,336,354,-50,248,592,5,2,14,347,264,421,20,1530,590
1722,20,0.4.354,0,687,0,93,354,447,354,0,447,447,-82,280,624,5,2,93,347,215,421,21,1530,493
1722,20,1.2.385,0,687,0,4,385,389,331,54,389,389,0,135,542,3,5,93,76,199,326,21,1530,493
1722,20,2.3.385,1,687,0,27,385,412,385,0,412,412,-31,196,573,4,4,122,70,330,259,21,1530,493
1722,20,4.2.385,0,687,0,72,385,457,253,132,457,457,0,135,542,3,5,171,76,250,326,21,1530,493
1722,20,5.4.322,0,687,0,14,322,336,322,0,336,385,-50,248,592,5,2,14,347,264,421,21,1530,493
1722,21,0.4.354,0,687,0,93,354,447,354,0,447,447,-82,280,655,5,2,93,347,215,421,22,1530,466
1722,21,1.2.385,1,687,0,4,385,389,331,54,389,412,0,135,573,3,5,93,76,199,326,22,1530,466
1722,21,2.4.412,0,745,1,95,412,507,412,0,507,507,-140,338,713,5,2,95,347,330,421,22,1530,466
1722,21,4.2.385,0,687,0,72,385,457,253,132,457,457,0,135,573,3,5,171,76,250,326,22,1530,466
1722,21,5.4.322,0,687,0,14,322,336,322,0,336,412,-50,248,623,5,2,14,347,264,421,22,1530,466
1722,22,0.4.354,0,687,0,93,354,447,354,0,447,447,-82,280,655,5,2,93,347,215,421,23,1530,462
1722,22,1.3.412,1,687,0,18,412,430,389,23,430,430,0,196,573,4,5,89,43,199,259,23,1530,462
1722,22,2.4.412,0,745,1,95,412,507,412,0,507,507,-140,338,713,5,2,95,347,330,421,23,1530,462
1722,22,4.2.389,0,687,0,72,389,461,253,136,461,461,0,135,573,3,6,171,72,250,326,23,1530,462
1722,22,5.4.322,0,687,0,14,322,336,322,0,336,412,-50,248,623,5,2,14,347,264,421,23,1530,462
1722,23,0.4.354,0,687,0,93,354,447,354,0,447,447,-82,280,655,5,2,93,347,215,421,24,1530,444
1722,23,1.4.430,0,763,2,71,430,501,430,0,501,501,-158,356,731,5,2,71,347,199,421,24,1530,444
1722,23,2.4.412,0,745,1,95,412,507,412,0,507,507,-140,338,713,5,2,95,347,330,421,24,1530,444
1722,23,4.2.389,1,687,0,72,389,461,253,136,461,461,0,135,573,3,6,171,72,250,326,24,1530,444
1722,23,5.4.322,0,687,0,14,322,336,322,0,336,430,-50,248,623,5,2,14,347,264,421,24,1530,444
1722,24,0.4.354,0,687,0,93,354,447,354,0,447,461,-82,280,655,5,2,93,347,215,421,25,1530,372
1722,24,1.4.430,0,763,2,71,430,501,430,0,501,501,-158,356,731,5,2,71,347,199,421,25,1530,372
1722,24,2.4.412,0,745,1,95,412,507,412,0,507,507,-140,338,713,5,2,95,347,330,421,25,1530,372
1722,24,4.3.461,1,687,0,25,461,486,461,0,486,486,-31,227,604,4,6,99,25,250,259,25,1530,372
1722,24,5.4.322,0,687,0,14,322,336,322,0,336,461,-50,248,623,5,2,14,347,264,421,25,1530,372
1722,25,0.4.354,0,687,0,93,354,447,354,0,447,486,-82,280,686,5,2,93,347,215,421,26,1530,347
1722,25,1.4.430,0,763,3,71,430,501,430,0,501,501,-158,356,762,5,2,71,347,199,421,26,1530,347
1722,25,2.4.412,0,745,2,95,412,507,412,0,507,507,-140,338,744,5,2,95,347,330,421,26,1530,347
1722,25,4.4.486,0,726,1,74,486,560,486,0,560,560,-214,412,818,5,2,74,347,250,421,26,1530,347
1722,25,5.4.322,1,687,0,14,322,336,322,0,336,486,-50,248,654,5,2,14,347,264,421,26,1530,347
1722,26,0.4.354,1,687,0,93,354,447,354,0,447,486,-18,266,672,5,3,93,333,215,421,27,1530,333
1722,26,1.4.430,0,763,3,71,430,501,430,0,501,501,-94,342,748,5,3,71,333,199,421,27,1530,333
1722,26,2.4.412,0,745,2,95,412,507,412,0,507,507,-76,324,730,5,3,95,333,330,421,27,1530,333
1722,26,4.4.486,0,726,1,74,486,560,486,0,560,560,-150,398,804,5,3,74,333,250,421,27,1530,333
1722,27,1.4.447,0,687,0,71,447,518,430,17,518,518,0,266,672,5,4,71,240,199,421,28,1530,240
1722,27,2.4.447,1,687,0,95,447,542,412,35,542,542,0,266,672,5,4,95,240,330,421,28,1530,240
1722,27,4.4.486,0,726,1,74,486,560,486,0,560,560,-39,305,711,5,4,74,240,250,421,28,1530,240
1722,28,1.4.542,1,687,0,71,542,613,430,112,613,613,0,266,672,5,5,71,145,199,421,29,1530,145
1722,28,4.4.542,0,687,0,74,542,616,486,56,616,616,0,266,672,5,5,74,145,250,421,29,1530,145
1722,29,4.4.613,1,687,0,74,613,687,486,127,687,687,0,266,672,5,6,74,74,250,421,30,1530,74
1723,0,0.0.0,0,537,0,47,0,47,0,0,47,47,0,0,0,1,1,259,352,259,352,1,1502,1502
1723,0,1.0.0,1,537,0,4,0,4,0,0,4,4,0,0,0,1,1,199,352,199,352,1,1502,1502
1723,0,2.0.0,0,553,2,99,0,99,0,0,99,99,0,0,0,1,1,357,352,357,352,1,1502,1502
1723,0,3.0.0,0,553,2,82,0,82,0,0,82,82,0,0,0,1,1,231,352,231,352,1,1502,1502
1723,0,4.0.0,0,553,2,85,0,85,0,0,85,85,0,0,0,1,1,288,352,288,352,1,1502,1502
1723,0,5.0.0,0,543,1,35,0,35,0,0,35,35,0,0,0,1,1,168,352,168,352,1,1502,1502
1723,1,0.0.4,0,537,0,47,4,51,0,4,51,51,0,0,0,1,2,259,348,259,352,2,1502,1498
1723,1,1.1.4,1,537,0,47,4,51,4,0,51,51,-4,4,4,2,1,195,291,199,291,2,1502,1498
1723,1,2.0.4,0,537,0,99,4,103,0,4,103,103,0,0,0,1,2,357,348,357,352,2,1502,1498
1723,1,3.0.4,0,553,3,82,4,86,0,4,86,86,0,0,0,1,2,231,348,231,352,2,1502,1498
1723,1,4.0.4,0,538,1,85,4,89,0,4,89,89,0,0,0,1,2,288,348,288,352,2,1502,1498
1723,1,5.0.4,0,543,2,35,4,39,0,4,39,39,0,0,0,1,2,168,348,168,352,2,1502,1498
1723,2,0.0.4,0,537,0,47,4,51,0,4,51,51,0,0,4,1,2,259,348,259,352,3,1502,1451
1723,2,1.2.51,1,537,0,9,51,60,51,0,60,60,-51,51,55,3,1,148,294,199,294,3,1502,1451
1723,2,2.0.4,0,537,0,99,4,103,0,4,103,103,0,0,4,1,2,357,348,357,352,3,1502,1451
1723,2,3.0.4,0,553,3,82,4,86,0,4,86,86,0,0,4,1,2,231,348,231,352,3,1502,1451
1723,2,4.0.4,0,538,1,85,4,89,0,4,89,89,0,0,4,1,2,288,348,288,352,3,1502,1451
1723,2,5.0.4,0,543,2,35,4,39,0,4,39,51,0,0,4,1,2,168,348,168,352,3,1502,1451
1723,3,0.0.4,0,537,0,47,4,51,0,4,51,60,0,0,55,1,2,259,348,259,352,4,1502,1442
1723,3,1.3.60,1,537,0,59,60,119,60,0,119,119,-60,60,115,4,1,139,312,199,312,4,1502,1442
1723,3,2.0.4,0,537,0,99,4,103,0,4,103,103,0,0,55,1,2,357,348,357,352,4,1502,1442
1723,3,3.0.4,0,553,3,82,4,86,0,4,86,86,0,0,55,1,2,231,348,231,352,4,1502,1442
1723,3,4.0.4,0,538,1,85,4,89,0,4,89,89,0,0,55,1,2,288,348,288,352,4,1502,1442
1723,3,5.0.4,0,543,2,35,4,39,0,4,39,60,0,0,55,1,2,168,348,168,352,4,1502,1442
1723,4,0.0.4,0,537,0,47,4,51,0,4,51,119,0,0,115,1,2,259,348,259,352,5,1502,1383
1723,4,1.4.119,1,537,0,80,119,199,119,0,199,199,-119,119,234,5,1,80,253,199,253,5,1502,1383
1723,4,2.0.4,0,537,0,99,4,103,0,4,103,119,0,0,115,1,2,357,348,357,352,5,1502,1383
1723,4,3.0.4,0,553,3,82,4,86,0,4,86,119,0,0,115,1,2,231,348,231,352,5,1502,1383
1723,4,4.0.4,0,538,1,85,4,89,0,4,89,119,0,0,115,1,2,288,348,288,352,5,1502,1383
1723,4,5.0.4,0,543,2,35,4,39,0,4,39,119,0,0,115,1,2,168,348,168,352,5,1502,1383
1723,5,0.0.4,1,537,0,47,4,51,0,4,51,199,0,0,234,1,2,259,348,259,352,6,1502,1303
1723,5,2.0.4,0,537,0,99,4,103,0,4,103,199,0,0,234,1,2,357,348,357,352,6,1502,1303
1723,5,3.0.4,0,553,3,82,4,86,0,4,86,199,0,0,234,1,2,231,348,231,352,6,1502,1303
1723,5,4.0.4,0,538,1,85,4,89,0,4,89,199,0,0,234,1,2,288,348,288,352,6,1502,1303
1723,5,5.0.4,0,543,2,35,4,39,0,4,39,199,0,0,234,1,2,168,348,168,352,6,1502,1303
1723,6,0.1.51,1,537,0,77,51,128,51,0,128,199,0,4,234,2,2,212,244,259,291,7,1502,1256
1723,6,2.0.51,0,537,0,99,51,150,0,51,150,199,0,0,234,1,3,357,301,357,352,7,1502,1256
1723,6,3.0.51,0,553,3,82,51,133,0,51,133,199,0,0,234,1,3,231,301,231,352,7,1502,1256
1723,6,4.0.51,0,538,1,85,51,136,0,51,136,199,0,0,234,1,3,288,301,288,352,7,1502,1256
1723,6,5.0.51,0,544,2,35,51,86,0,51,86,199,0,0,234,1,3,168,301,168,352,7,1502,1256
1723,7,0.2.128,1,537,0,50,128,178,128,0,178,199,-68,119,302,3,2,135,285,259,294,8,1502,1179
1723,7,2.0.51,0,537,0,99,51,150,0,51,150,199,0,0,234,1,3,357,301,357,352,8,1502,1179
1723,7,3.0.51,0,553,3,82,51,133,0,51,133,199,0,0,234,1,3,231,301,231,352,8,1502,1179
1723,7,4.0.51,0,538,1,85,51,136,0,51,136,199,0,0,234,1,3,288,301,288,352,8,1502,1179
1723,7,5.0.51,0,544,2,35,51,86,0,51,86,199,0,0,234,1,3,168,301,168,352,8,1502,1179
1723,8,0.3.178,1,537,0,39,178,217,178,0,217,217,-59,119,361,4,2,85,253,259,312,9,1502,1129
1723,8,2.0.51,0,537,0,99,51,150,0,51,150,199,0,0,302,1,3,357,301,357,352,9,1502,1129
1723,8,3.0.51,0,553,3,82,51,133,0,51,133,199,0,0,302,1,3,231,301,231,352,9,1502,1129
1723,8,4.0.51,0,538,1,85,51,136,0,51,136,199,0,0,302,1,3,288,301,288,352,9,1502,1129
1723,8,5.0.51,0,544,2,35,51,86,0,51,86,199,0,0,302,1,3,168,301,168,352,9,1502,1129
1723,9,0.4.217,1,537,0,46,217,263,217,0,263,263,-18,137,379,5,2,46,173,259,253,10,1502,1090
1723,9,2.0.51,0,537,0,99,51,150,0,51,150,217,0,0,361,1,3,357,301,357,352,10,1502,1090
1723,9,3.0.51,0,553,3,82,51,133,0,51,133,217,0,0,361,1,3,231,301,231,352,10,1502,1090
1723,9,4.0.51,0,538,1,85,51,136,0,51,136,217,0,0,361,1,3,288,301,288,352,10,1502,1090
1723,9,5.0.51,0,544,2,35,51,86,0,51,86,217,0,0,361,1,3,168,301,168,352,10,1502,1090
1723,10,2.0.51,1,537,0,99,51,150,0,51,150,263,0,0,379,1,3,357,301,357,352,11,1502,1044
1723,10,3.0.51,0,553,3,82,51,133,0,51,133,263,0,0,379,1,3,231,301,231,352,11,1502,1044
1723,10,4.0.51,0,538,1,85,51,136,0,51,136,263,0,0,379,1,3,288,301,288,352,11,1502,1044
1723,10,5.0.51,0,544,2,35,51,86,0,51,86,263,0,0,379,1,3,168,301,168,352,11,1502,1044
1723,11,2.1.150,1,537,0,51,150,201,150,0,201,263,-22,26,401,2,3,258,167,357,291,12,1502,945
1723,11,3.0.150,0,553,2,82,150,232,0,150,232,263,0,0,379,1,4,231,202,231,352,12,1502,945
1723,11,4.0.150,0,537,0,85,150,235,0,150,235,263,0,0,379,1,4,288,202,288,352,12,1502,945
1723,11,5.0.150,0,547,1,35,150,185,0,150,185,263,0,0,379,1,4,168,202,168,352,12,1502,945
1723,12,2.2.201,1,537,0,51,201,252,201,0,252,263,-23,142,424,3,3,207,235,357,294,13,1502,894
1723,12,3.0.150,0,553,2,82,150,232,0,150,232,263,0,0,401,1,4,231,202,231,352,13,1502,894
1723,12,4.0.150,0,537,0,85,150,235,0,150,235,263,0,0,401,1,4,288,202,288,352,13,1502,894
1723,12,5.0.150,0,547,1,35,150,185,0,150,185,263,0,0,401,1,4,168,202,168,352,13,1502,894
1723,13,2.3.252,1,537,0,95,252,347,252,0,347,347,-35,154,459,4,3,156,214,357,312,14,1502,843
1723,13,3.0.150,0,553,2,82,150,232,0,150,232,263,0,0,424,1,4,231,202,231,352,14,1502,843
1723,13,4.0.150,0,537,0,85,150,235,0,150,235,263,0,0,424,1,4,288,202,288,352,14,1502,843
1723,13,5.0.150,0,547,1,35,150,185,0,150,185,263,0,0,424,1,4,168,202,168,352,14,1502,843
1723,14,2.4.347,1,537,0,61,347,408,347,0,408,408,-84,221,543,5,3,61,127,357,253,15,1502,748
1723,14,3.0.150,0,553,2,82,150,232,0,150,232,347,0,0,459,1,4,231,202,231,352,15,1502,748
1723,14,4.0.150,0,537,0,85,150,235,0,150,235,347,0,0,459,1,4,288,202,288,352,15,1502,748
1723,14,5.0.150,0,547,1,35,150,185,0,150,185,347,0,0,459,1,4,168,202,168,352,15,1502,748
1723,15,3.0.150,0,553,2,82,150,232,0,150,232,408,0,0,543,1,4,231,202,231,352,16,1502,687
1723,15,4.0.150,0,537,0,85,150,235,0,150,235,408,0,0,543,1,4,288,202,288,352,16,1502,687
1723,15,5.0.150,1,547,1,35,150,185,0,150,185,408,0,0,543,1,4,168,202,168,352,16,1502,687
1723,16,3.0.185,0,555,1,82,185,267,0,185,267,408,0,0,543,1,5,231,167,231,352,17,1502,652
1723,16,4.0.185,0,547,0,85,185,270,0,185,270,408,0,0,543,1,5,288,167,288,352,17,1502,652
1723,16,5.1.201,1,547,0,37,201,238,185,16,238,408,0,26,543,2,4,133,116,168,291,17,1502,652
1723,17,3.0.185,0,555,1,82,185,267,0,185,267,408,0,0,543,1,5,231,167,231,352,18,1502,615
1723,17,4.0.185,0,547,0,85,185,270,0,185,270,408,0,0,543,1,5,288,167,288,352,18,1502,615
1723,17,5.2.252,1,547,0,25,252,277,238,14,277,408,0,142,543,3,4,96,184,168,294,18,1502,615
1723,18,3.0.185,0,555,1,82,185,267,0,185,267,408,0,0,543,1,5,231,167,231,352,19,1502,590
1723,18,4.0.185,0,547,0,85,185,270,0,185,270,408,0,0,543,1,5,288,167,288,352,19,1502,590
1723,18,5.3.347,1,547,0,66,347,413,277,70,413,413,0,154,543,4,4,71,119,168,312,19,1502,590
1723,19,3.0.185,0,555,1,82,185,267,0,185,267,413,0,0,543,1,5,231,167,231,352,20,1502,524
1723,19,4.0.185,0,547,0,85,185,270,0,185,270,413,0,0,543,1,5,288,167,288,352,20,1502,524
1723,19,5.4.413,1,547,0,5,413,418,413,0,418,418,-5,226,548,5,4,5,66,168,253,20,1502,524
1723,20,3.0.185,0,555,1,82,185,267,0,185,267,418,0,0,548,1,5,231,167,231,352,21,1502,519
1723,20,4.0.185,1,547,0,85,185,270,0,185,270,418,0,0,548,1,5,288,167,288,352,21,1502,519
1723,21,3.0.270,1,547,0,82,270,352,0,270,352,418,0,0,548,1,6,231,82,231,352,22,1502,434
1723,21,4.1.270,0,547,0,67,270,337,270,0,337,418,-32,58,580,2,5,203,79,288,291,22,1502,434
1723,22,3.1.352,0,547,0,12,352,364,352,0,364,418,-114,140,662,2,5,149,79,231,291,23,1502,352
1723,22,4.1.270,1,547,0,67,270,337,270,0,337,418,-32,58,580,2,5,203,79,288,291,23,1502,352
1723,23,3.1.352,1,547,0,12,352,364,352,0,364,418,-15,73,595,2,6,149,12,231,291,24,1502,285
1723,23,4.2.337,0,547,0,73,337,410,337,0,410,418,-60,202,640,3,5,136,159,288,294,24,1502,285
1723,24,3.2.364,0,586,1,86,364,450,364,0,450,450,-87,229,682,3,5,137,159,231,294,25,1502,273
1723,24,4.2.337,1,547,0,73,337,410,337,0,410,418,-60,202,655,3,5,136,159,288,294,25,1502,273
1723,25,3.2.410,0,547,0,86,410,496,364,46,496,496,0,202,655,3,6,137,86,231,294,26,1502,200
1723,25,4.3.413,1,547,0,18,413,431,410,3,431,431,0,154,655,4,5,63,53,288,312,26,1502,200
1723,26,3.2.410,0,547,0,86,410,496,364,46,496,496,0,202,655,3,6,137,86,231,294,27,1502,182
1723,26,4.4.431,1,547,0,45,431,476,431,0,476,476,-13,239,668,5,5,45,61,288,253,27,1502,182
1723,27,3.2.410,1,547,0,86,410,496,364,46,496,496,0,202,668,3,6,137,86,231,294,28,1502,137
1723,28,3.3.496,1,547,0,35,496,531,496,0,531,531,-65,219,733,4,6,51,35,231,312,29,1502,51
1723,29,3.4.531,1,547,0,16,531,547,531,0,547,547,-55,294,788,5,6,16,16,231,253,30,1502,16
1724,0,0.0.0,0,555,5,60,0,60,0,0,60,60,0,0,0,1,1,304,268,304,268,1,1373,1373
1724,0,1.0.0,0,545,3,79,0,79,0,0,79,79,0,0,0,1,1,198,268,198,268,1,1373,1373
1724,0,2.0.0,0,549,4,45,0,45,0,0,45,45,0,0,0,1,1,185,268,185,268,1,1373,1373
1724,0,3.0.0,1,541,2,36,0,36,0,0,36,36,0,0,0,1,1,290,268,290,268,1,1373,1373
1724,0,4.0.0,0,538,1,8,0,8,0,0,8,8,0,0,0,1,1,128,268,128,268,1,1373,1373
1724,0,5.0.0,0,531,0,40,0,40,0,0,40,40,0,0,0,1,1,268,268,268,268,1,1373,1373
1724,1,0.0.36,0,591,3,60,36,96,0,36,96,96,0,0,0,1,2,304,232,304,268,2,1373,1337
1724,1,1.0.36,0,541,0,79,36,115,0,36,115,115,0,0,0,1,2,198,232,198,268,2,1373,1337
1724,1,2.0.36,0,576,2,45,36,81,0,36,81,81,0,0,0,1,2,185,232,185,268,2,1373,1337
1724,1,3.1.36,1,541,0,50,36,86,36,0,86,86,-36,36,36,2,1,254,195,290,195,2,1373,1337
1724,1,4.0.36,0,541,0,8,36,44,0,36,44,44,0,0,0,1,2,128,232,128,268,2,1373,1337
1724,1,5.0.36,0,567,1,40,36,76,0,36,76,76,0,0,0,1,2,268,232,268,268,2,1373,1337
1724,2,0.0.36,0,591,3,60,36,96,0,36,96,96,0,0,36,1,2,304,232,304,268,3,1373,1287
1724,2,1.0.36,0,541,0,79,36,115,0,36,115,115,0,0,36,1,2,198,232,198,268,3,1373,1287
1724,2,2.0.36,0,576,2,45,36,81,0,36,81,86,0,0,36,1,2,185,232,185,268,3,1373,1287
1724,2,3.2.86,1,541,0,54,86,140,86,0,140,140,-86,86,122,3,1,204,263,290,263,3,1373,1287
1724,2,4.0.36,0,541,0,8,36,44,0,36,44,86,0,0,36,1,2,128,232,128,268,3,1373,1287
1724,2,5.0.36,0,567,1,40,36,76,0,36,76,86,0,0,36,1,2,268,232,268,268,3,1373,1287
1724,3,0.0.36,0,591,3,60,36,96,0,36,96,140,0,0,122,1,2,304,232,304,268,4,1373,1233
1724,3,1.0.36,0,541,0,79,36,115,0,36,115,140,0,0,122,1,2,198,232,198,268,4,1373,1233
1724,3,2.0.36,0,576,2,45,36,81,0,36,81,140,0,0,122,1,2,185,232,185,268,4,1373,1233
1724,3,3.3.140,1,615,4,93,140,233,140,0,233,233,-140,140,262,4,1,150,265,290,265,4,1373,1233
1724,3,4.0.36,0,541,0,8,36,44,0,36,44,140,0,0,122,1,2,128,232,128,268,4,1373,1233
1724,3,5.0.36,0,571,1,40,36,76,0,36,76,140,0,0,122,1,2,268,232,268,268,4,1373,1233
1724,4,0.0.36,0,615,0,60,36,96,0,36,96,233,0,0,262,1,2,304,232,304,268,5,1373,1140
1724,4,1.0.36,0,615,0,79,36,115,0,36,115,233,0,0,262,1,2,198,232,198,268,5,1373,1140
1724,4,2.0.36,0,615,0,45,36,81,0,36,81,233,0,0,262,1,2,185,232,185,268,5,1373,1140
1724,4,3.4.233,1,615,0,57,233,290,233,0,290,290,-233,233,495,5,1,57,382,290,382,5,1373,1140
1724,4,4.0.36,0,615,0,8,36,44,0,36,44,233,0,0,262,1,2,128,232,128,268,5,1373,1140
1724,4,5.0.36,0,615,0,40,36,76,0,36,76,233,0,0,262,1,2,268,232,268,268,5,1373,1140
1724,5,0.0.36,0,615,0,60,36,96,0,36,96,290,0,0,495,1,2,304,232,304,268,6,1373,1083
1724,5,1.0.36,0,615,0,79,36,115,0,36,115,290,0,0,495,1,2,198,232,198,268,6,1373,1083
1724,5,2.0.36,0,615,0,45,36,81,0,36,81,290,0,0,495,1,2,185,232,185,268,6,1373,1083
1724,5,4.0.36,0,615,0,8,36,44,0,36,44,290,0,0,495,1,2,128,232,128,268,6,1373,1083
1724,5,5.0.36,1,615,0,40,36,76,0,36,76,290,0,0,495,1,2,268,232,268,268,6,1373,1083
1724,6,0.0.76,0,615,0,60,76,136,0,76,136,290,0,0,495,1,3,304,192,304,268,7,1373,1043
1724,6,1.0.76,0,615,0,79,76,155,0,76,155,290,0,0,495,1,3,198,192,198,268,7,1373,1043
1724,6,2.0.76,0,615,0,45,76,121,0,76,121,290,0,0,495,1,3,185,192,185,268,7,1373,1043
1724,6,4.0.76,0,615,0,8,76,84,0,76,84,290,0,0,495,1,3,128,192,128,268,7,1373,1043
1724,6,5.1.86,1,615,0,20,86,106,76,10,106,290,0,36,495,2,2,228,145,268,195,7,1373,1043
1724,7,0.0.76,0,615,0,60,76,136,0,76,136,290,0,0,495,1,3,304,192,304,268,8,1373,1023
1724,7,1.0.76,0,615,0,79,76,155,0,76,155,290,0,0,495,1,3,198,192,198,268,8,1373,1023
1724,7,2.0.76,0,615,0,45,76,121,0,76,121,290,0,0,495,1,3,185,192,185,268,8,1373,1023
1724,7,4.0.76,0,615,0,8,76,84,0,76,84,290,0,0,495,1,3,128,192,128,268,8,1373,1023
1724,7,5.2.140,1,615,0,63,140,203,106,34,203,290,0,86,495,3,2,208,209,268,263,8,1373,1023
1724,8,0.0.76,0,615,0,60,76,136,0,76,136,290,0,0,495,1,3,304,192,304,268,9,1373,960
1724,8,1.0.76,0,615,0,79,76,155,0,76,155,290,0,0,495,1,3,198,192,198,268,9,1373,960
1724,8,2.0.76,0,615,0,45,76,121,0,76,121,290,0,0,495,1,3,185,192,185,268,9,1373,960
1724,8,4.0.76,0,615,0,8,76,84,0,76,84,290,0,0,495,1,3,128,192,128,268,9,1373,960
1724,8,5.3.233,1,615,0,50,233,283,203,30,283,290,0,140,495,4,2,145,172,268,265,9,1373,960
1724,9,0.0.76,1,615,0,60,76,136,0,76,136,290,0,0,495,1,3,304,192,304,268,10,1373,910
1724,9,1.0.76,0,615,0,79,76,155,0,76,155,290,0,0,495,1,3,198,192,198,268,10,1373,910
1724,9,2.0.76,0,615,0,45,76,121,0,76,121,290,0,0,495,1,3,185,192,185,268,10,1373,910
1724,9,4.0.76,0,615,0,8,76,84,0,76,84,290,0,0,495,1,3,128,192,128,268,10,1373,910
1724,9,5.4.290,0,615,0,95,290,385,283,7,385,385,0,233,495,5,2,95,325,268,382,10,1373,910
1724,10,0.1.136,1,615,0,45,136,181,136,0,181,290,-30,66,525,2,3,244,125,304,195,11,1373,850
1724,10,1.0.136,0,615,0,79,136,215,0,136,215,290,0,0,495,1,4,198,132,198,268,11,1373,850
1724,10,2.0.136,0,615,0,45,136,181,0,136,181,290,0,0,495,1,4,185,132,185,268,11,1373,850
1724,10,4.0.136,0,615,0,8,136,144,0,136,144,290,0,0,495,1,4,128,132,128,268,11,1373,850
1724,10,5.4.290,0,615,0,95,290,385,283,7,385,385,0,233,495,5,2,95,325,268,382,11,1373,850
1724,11,0.2.203,1,615,0,54,203,257,181,22,257,290,0,86,525,3,3,199,146,304,263,12,1373,805
1724,11,1.0.136,0,615,0,79,136,215,0,136,215,290,0,0,525,1,4,198,132,198,268,12,1373,805
1724,11,2.0.136,0,615,0,45,136,181,0,136,181,290,0,0,525,1,4,185,132,185,268,12,1373,805
1724,11,4.0.136,0,615,0,8,136,144,0,136,144,290,0,0,525,1,4,128,132,128,268,12,1373,805
1724,11,5.4.290,0,615,0,95,290,385,283,7,385,385,0,233,525,5,2,95,325,268,382,12,1373,805
1724,12,0.3.283,1,615,0,46,283,329,257,26,329,329,0,140,525,4,3,145,122,304,265,13,1373,751
1724,12,1.0.136,0,615,0,79,136,215,0,136,215,290,0,0,525,1,4,198,132,198,268,13,1373,751
1724,12,2.0.136,0,615,0,45,136,181,0,136,181,290,0,0,525,1,4,185,132,185,268,13,1373,751
1724,12,4.0.136,0,615,0,8,136,144,0,136,144,290,0,0,525,1,4,128,132,128,268,13,1373,751
1724,12,5.4.290,0,615,0,95,290,385,283,7,385,385,0,233,525,5,2,95,325,268,382,13,1373,751
1724,13,0.4.329,0,654,1,99,329,428,329,0,428,428,-39,272,564,5,2,99,325,304,382,14,1373,705
1724,13,1.0.136,0,615,0,79,136,215,0,136,215,329,0,0,525,1,4,198,132,198,268,14,1373,705
1724,13,2.0.136,0,615,0,45,136,181,0,136,181,329,0,0,525,1,4,185,132,185,268,14,1373,705
1724,13,4.0.136,1,615,0,8,136,144,0,136,144,329,0,0,525,1,4,128,132,128,268,14,1373,705
1724,13,5.4.290,0,615,0,95,290,385,283,7,385,385,0,233,525,5,2,95,325,268,382,14,1373,705
1724,14,0.4.329,0,654,1,99,329,428,329,0,428,428,-39,272,564,5,2,99,325,304,382,15,1373,697
1724,14,1.0.144,0,615,0,79,144,223,0,144,223,329,0,0,525,1,5,198,124,198,268,15,1373,697
1724,14,2.0.144,0,615,0,45,144,189,0,144,189,329,0,0,525,1,5,185,124,185,268,15,1373,697
1724,14,4.1.181,1,615,0,20,181,201,144,37,201,329,0,66,525,2,4,120,80,128,195,15,1373,697
1724,14,5.4.290,0,615,0,95,290,385,283,7,385,385,0,233,525,5,2,95,325,268,382,15,1373,697
1724,15,0.4.329,0,654,1,99,329,428,329,0,428,428,-39,272,564,5,2,99,325,304,382,16,1373,677
1724,15,1.0.144,0,615,0,79,144,223,0,144,223,329,0,0,525,1,5,198,124,198,268,16,1373,677
1724,15,2.0.144,1,615,0,45,144,189,0,144,189,329,0,0,525,1,5,185,124,185,268,16,1373,677
1724,15,4.2.257,0,615,0,74,257,331,201,56,331,331,0,86,525,3,4,100,92,128,263,16,1373,677
1724,15,5.4.290,0,615,0,95,290,385,283,7,385,385,0,233,525,5,2,95,325,268,382,16,1373,677
1724,16,0.4.329,0,654,1,99,329,428,329,0,428,428,-39,272,564,5,2,99,325,304,382,17,1373,632
1724,16,1.0.189,0,615,0,79,189,268,0,189,268,329,0,0,525,1,6,198,79,198,268,17,1373,632
1724,16,2.1.201,1,615,0,45,201,246,189,12,246,329,0,66,525,2,5,140,60,185,195,17,1373,632
1724,16,4.2.257,0,615,0,74,257,331,201,56,331,331,0,86,525,3,4,100,92,128,263,17,1373,632
1724,16,5.4.290,0,615,0,95,290,385,283,7,385,385,0,233,525,5,2,95,325,268,382,17,1373,632
1724,17,0.4.329,0,654,1,99,329,428,329,0,428,428,-39,272,564,5,2,99,325,304,382,18,1373,587
1724,17,1.0.189,0,615,0,79,189,268,0,189,268,329,0,0,525,1,6,198,79,198,268,18,1373,587
1724,17,2.2.257,1,615,0,4,257,261,246,11,261,329,0,86,525,3,4,95,92,185,263,18,1373,587
1724,17,4.2.257,0,615,0,74,257,331,201,56,331,331,0,86,525,3,4,100,92,128,263,18,1373,587
1724,17,5.4.290,0,615,0,95,290,385,283,7,385,385,0,233,525,5,2,95,325,268,382,18,1373,587
1724,18,0.4.329,0,654,1,99,329,428,329,0,428,428,-39,272,564,5,2,99,325,304,382,19,1373,583
1724,18,1.0.189,0,615,0,79,189,268,0,189,268,329,0,0,525,1,6,198,79,198,268,19,1373,583
1724,18,2.3.329,1,615,0,64,329,393,261,68,393,393,0,140,525,4,4,91,76,185,265,19,1373,583
1724,18,4.2.261,0,615,0,74,261,335,201,60,335,335,0,86,525,3,5,100,88,128,263,19,1373,583
1724,18,5.4.290,0,615,0,95,290,385,283,7,385,385,0,233,525,5,2,95,325,268,382,19,1373,583
1724,19,0.4.329,0,654,2,99,329,428,329,0,428,428,-39,272,564,5,2,99,325,304,382,20,1373,519
1724,19,1.0.189,0,615,0,79,189,268,0,189,268,393,0,0,525,1,6,198,79,198,268,20,1373,519
1724,19,2.4.393,0,623,1,27,393,420,393,0,420,420,-103,336,628,5,2,27,325,185,382,20,1373,519
1724,19,4.2.261,1,615,0,74,261,335,201,60,335,393,0,86,525,3,5,100,88,128,263,20,1373,519
1724,19,5.4.290,0,615,0,95,290,385,283,7,385,393,0,233,525,5,2,95,325,268,382,20,1373,519
1724,20,0.4.329,0,654,2,99,329,428,329,0,428,428,-39,272,564,5,2,99,325,304,382,21,1373,445
1724,20,1.0.189,0,615,0,79,189,268,0,189,268,393,0,0,525,1,6,198,79,198,268,21,1373,445
1724,20,2.4.393,0,623,1,27,393,420,393,0,420,420,-103,336,628,5,2,27,325,185,382,21,1373,445
1724,20,4.3.393,1,615,0,11,393,404,335,58,404,404,0,140,525,4,5,26,12,128,265,21,1373,445
1724,20,5.4.290,0,615,0,95,290,385,283,7,385,393,0,233,525,5,2,95,325,268,382,21,1373,445
1724,21,0.4.329,0,654,3,99,329,428,329,0,428,428,-39,272,564,5,2,99,325,304,382,22,1373,434
1724,21,1.0.189,1,615,0,79,189,268,0,189,268,404,0,0,525,1,6,198,79,198,268,22,1373,434
1724,21,2.4.393,0,623,1,27,393,420,393,0,420,420,-103,336,628,5,2,27,325,185,382,22,1373,434
1724,21,4.4.404,0,634,2,15,404,419,404,0,419,419,-114,347,639,5,2,15,325,128,382,22,1373,434
1724,21,5.4.290,0,615,0,95,290,385,283,7,385,404,0,233,525,5,2,95,325,268,382,22,1373,434
1724,22,0.4.329,0,654,3,99,329,428,329,0,428,428,-39,272,564,5,2,99,325,304,382,23,1373,355
1724,22,1.1.268,1,615,0,15,268,283,268,0,283,404,-22,88,547,2,6,119,15,198,195,23,1373,355
1724,22,2.4.393,0,623,1,27,393,420,393,0,420,420,-103,336,628,5,2,27,325,185,382,23,1373,355
1724,22,4.4.404,0,634,2,15,404,419,404,0,419,419,-114,347,639,5,2,15,325,128,382,23,1373,355
1724,22,5.4.290,0,615,0,95,290,385,283,7,385,404,0,233,525,5,2,95,325,268,382,23,1373,355
1724,23,0.4.329,0,654,3,99,329,428,329,0,428,428,-39,272,586,5,2,99,325,304,382,24,1373,340
1724,23,1.2.335,1,615,0,14,335,349,283,52,349,404,0,86,547,3,6,104,14,198,263,24,1373,340
1724,23,2.4.393,0,623,1,27,393,420,393,0,420,420,-103,336,650,5,2,27,325,185,382,24,1373,340
1724,23,4.4.404,0,634,2,15,404,419,404,0,419,419,-114,347,661,5,2,15,325,128,382,24,1373,340
1724,23,5.4.290,0,615,0,95,290,385,283,7,385,404,0,233,547,5,2,95,325,268,382,24,1373,340
1724,24,0.4.329,0,654,3,99,329,428,329,0,428,428,-39,272,586,5,2,99,325,304,382,25,1373,326
1724,24,1.3.404,1,615,0,1,404,405,349,55,405,405,0,140,547,4,6,90,1,198,265,25,1373,326
1724,24,2.4.393,0,623,1,27,393,420,393,0,420,420,-103,336,650,5,2,27,325,185,382,25,1373,326
1724,24,4.4.404,0,634,2,15,404,419,404,0,419,419,-114,347,661,5,2,15,325,128,382,25,1373,326
1724,24,5.4.290,0,615,0,95,290,385,283,7,385,404,0,233,547,5,2,95,325,268,382,25,1373,326
1724,25,0.4.329,0,654,4,99,329,428,329,0,428,428,-39,272,586,5,2,99,325,304,382,26,1373,325
1724,25,1.4.405,0,635,3,89,405,494,405,0,494,494,-115,348,662,5,2,89,325,198,382,26,1373,325
1724,25,2.4.393,0,623,1,27,393,420,393,0,420,420,-103,336,650,5,2,27,325,185,382,26,1373,325
1724,25,4.4.404,0,634,2,15,404,419,404,0,419,419,-114,347,661,5,2,15,325,128,382,26,1373,325
1724,25,5.4.290,1,615,0,95,290,385,283,7,385,405,0,233,547,5,2,95,325,268,382,26,1373,325
1724,26,0.4.385,0,615,0,99,385,484,329,56,484,484,0,233,547,5,3,99,230,304,382,27,1373,230
1724,26,1.4.405,0,635,3,89,405,494,405,0,494,494,-20,253,567,5,3,89,230,198,382,27,1373,230
1724,26,2.4.393,1,623,1,27,393,420,393,0,420,420,-8,241,555,5,3,27,230,185,382,27,1373,230
1724,26,4.4.404,0,634,2,15,404,419,404,0,419,419,-19,252,566,5,3,15,230,128,382,27,1373,230
1724,27,0.4.420,0,623,0,99,420,519,329,91,519,519,0,241,555,5,4,99,203,304,382,28,1373,203
1724,27,1.4.420,0,623,0,89,420,509,405,15,509,509,0,241,555,5,4,89,203,198,382,28,1373,203
1724,27,4.4.420,1,623,0,15,420,435,404,16,435,435,0,241,555,5,4,15,203,128,382,28,1373,203
1724,28,0.4.435,1,623,0,99,435,534,329,106,534,534,0,241,555,5,5,99,188,304,382,29,1373,188
1724,28,1.4.435,0,623,0,89,435,524,405,30,524,524,0,241,555,5,5,89,188,198,382,29,1373,188
1724,29,1.4.534,1,623,0,89,534,623,405,129,623,623,0,241,555,5,6,89,89,198,382,30,1373,89
1725,0,0.0.0,0,668,2,73,0,73,0,0,73,73,0,0,0,1,1,247,380,247,380,1,1635,1635
1725,0,1.0.0,0,670,3,55,0,55,0,0,55,55,0,0,0,1,1,297,380,297,380,1,1635,1635
1725,0,2.0.0,0,685,4,91,0,91,0,0,91,91,0,0,0,1,1,310,380,310,380,1,1635,1635
1725,0,3.0.0,0,720,5,88,0,88,0,0,88,88,0,0,0,1,1,347,380,347,380,1,1635,1635
1725,0,4.0.0,1,650,1,29,0,29,0,0,29,29,0,0,0,1,1,264,380,264,380,1,1635,1635
1725,0,5.0.0,0,647,0,44,0,44,0,0,44,44,0,0,0,1,1,170,380,170,380,1,1635,1635
1725,1,0.0.29,0,689,2,73,29,102,0,29,102,102,0,0,0,1,2,247,351,247,380,2,1635,1606
1725,1,1.0.29,0,678,1,55,29,84,0,29,84,84,0,0,0,1,2,297,351,297,380,2,1635,1606
1725,1,2.0.29,0,689,2,91,29,120,0,29,120,120,0,0,0,1,2,310,351,310,380,2,1635,1606
1725,1,3.0.29,0,689,2,88,29,117,0,29,117,117,0,0,0,1,2,347,351,347,380,2,1635,1606
1725,1,4.1.29,1,650,0,71,29,100,29,0,100,100,-29,29,29,2,1,235,295,264,295,2,1635,1606
1725,1,5.0.29,0,650,0,44,29,73,0,29,73,73,0,0,0,1,2,170,351,170,380,2,1635,1606
1725,2,0.0.29,0,689,2,73,29,102,0,29,102,102,0,0,29,1,2,247,351,247,380,3,1635,1535
1725,2,1.0.29,0,678,1,55,29,84,0,29,84,100,0,0,29,1,2,297,351,297,380,3,1635,1535
1725,2,2.0.29,0,689,2,91,29,120,0,29,120,120,0,0,29,1,2,310,351,310,380,3,1635,1535
1725,2,3.0.29,0,689,2,88,29,117,0,29,117,117,0,0,29,1,2,347,351,347,380,3,1635,1535
1725,2,4.2.100,1,689,2,75,100,175,100,0,175,175,-100,100,129,3,1,164,231,264,231,3,1635,1535
1725,2,5.0.29,0,650,0,44,29,73,0,29,73,100,0,0,29,1,2,170,351,170,380,3,1635,1535
1725,3,0.0.29,0,689,0,73,29,102,0,29,102,175,0,0,129,1,2,247,351,247,380,4,1635,1460
1725,3,1.0.29,0,689,0,55,29,84,0,29,84,175,0,0,129,1,2,297,351,297,380,4,1635,1460
1725,3,2.0.29,0,689,0,91,29,120,0,29,120,175,0,0,129,1,2,310,351,310,380,4,1635,1460
1725,3,3.0.29,0,689,0,88,29,117,0,29,117,175,0,0,129,1,2,347,351,347,380,4,1635,1460
1725,3,4.3.175,1,689,0,4,175,179,175,0,179,179,-175,175,304,4,1,89,219,264,219,4,1635,1460
1725,3,5.0.29,0,689,0,44,29,73,0,29,73,175,0,0,129,1,2,170,351,170,380,4,1635,1460
1725,4,0.0.29,0,689,0,73,29,102,0,29,102,179,0,0,304,1,2,247,351,247,380,5,1635,1456
1725,4,1.0.29,1,689,0,55,29,84,0,29,84,179,0,0,304,1,2,297,351,297,380,5,1635,1456
1725,4,2.0.29,0,689,0,91,29,120,0,29,120,179,0,0,304,1,2,310,351,310,380,5,1635,1456
1725,4,3.0.29,0,689,0,88,29,117,0,29,117,179,0,0,304,1,2,347,351,347,380,5,1635,1456
1725,4,4.4.179,0,689,0,85,179,264,179,0,264,264,-179,179,483,5,1,85,510,264,510,5,1635,1456
1725,4,5.0.29,0,689,0,44,29,73,0,29,73,179,0,0,304,1,2,170,351,170,380,5,1635,1456
1725,5,0.0.84,0,689,0,73,84,157,0,84,157,179,0,0,304,1,3,247,296,247,380,6,1635,1401
1725,5,1.1.100,1,689,0,82,100,182,84,16,182,182,0,29,304,2,2,242,224,297,295,6,1635,1401
1725,5,2.0.84,0,689,0,91,84,175,0,84,175,179,0,0,304,1,3,310,296,310,380,6,1635,1401
1725,5,3.0.84,0,689,0,88,84,172,0,84,172,179,0,0,304,1,3,347,296,347,380,6,1635,1401
1725,5,4.4.179,0,689,0,85,179,264,179,0,264,264,-179,179,483,5,1,85,510,264,510,6,1635,1401
1725,5,5.0.84,0,689,0,44,84,128,0,84,128,179,0,0,304,1,3,170,296,170,380,6,1635,1401
1725,6,0.0.84,0,689,0,73,84,157,0,84,157,182,0,0,304,1,3,247,296,247,380,7,1635,1319
1725,6,1.2.182,1,689,0,19,182,201,182,0,201,201,-7,107,311,3,2,160,156,297,231,7,1635,1319
1725,6,2.0.84,0,689,0,91,84,175,0,84,175,182,0,0,304,1,3,310,296,310,380,7,1635,1319
1725,6,3.0.84,0,689,0,88,84,172,0,84,172,182,0,0,304,1,3,347,296,347,380,7,1635,1319
1725,6,4.4.179,0,689,0,85,179,264,179,0,264,264,-179,179,483,5,1,85,510,264,510,7,1635,1319
1725,6,5.0.84,0,689,0,44,84,128,0,84,128,182,0,0,304,1,3,170,296,170,380,7,1635,1319
1725,7,0.0.84,0,689,0,73,84,157,0,84,157,201,0,0,311,1,3,247,296,247,380,8,1635,1300
1725,7,1.3.201,1,689,0,43,201,244,201,0,244,244,-22,197,333,4,2,141,215,297,219,8,1635,1300
1725,7,2.0.84,0,689,0,91,84,175,0,84,175,201,0,0,311,1,3,310,296,310,380,8,1635,1300
1725,7,3.0.84,0,689,0,88,84,172,0,84,172,201,0,0,311,1,3,347,296,347,380,8,1635,1300
1725,7,4.4.179,0,689,0,85,179,264,179,0,264,264,-179,179,490,5,1,85,510,264,510,8,1635,1300
1725,7,5.0.84,0,689,0,44,84,128,0,84,128,201,0,0,311,1,3,170,296,170,380,8,1635,1300
1725,8,0.0.84,0,689,0,73,84,157,0,84,157,244,0,0,333,1,3,247,296,247,380,9,1635,1257
1725,8,1.4.244,0,754,1,98,244,342,244,0,342,342,-244,244,577,5,1,98,510,297,510,9,1635,1257
1725,8,2.0.84,0,689,0,91,84,175,0,84,175,244,0,0,333,1,3,310,296,310,380,9,1635,1257
1725,8,3.0.84,1,689,0,88,84,172,0,84,172,244,0,0,333,1,3,347,296,347,380,9,1635,1257
1725,8,4.4.179,0,689,0,85,179,264,179,0,264,264,-179,179,512,5,1,85,510,264,510,9,1635,1257
1725,8,5.0.84,0,689,0,44,84,128,0,84,128,244,0,0,333,1,3,170,296,170,380,9,1635,1257
1725,9,0.0.172,0,689,0,73,172,245,0,172,245,245,0,0,333,1,4,247,208,247,380,10,1635,1169
1725,9,1.4.244,0,754,1,98,244,342,244,0,342,342,-244,244,577,5,1,98,510,297,510,10,1635,1169
1725,9,2.0.172,0,689,0,91,172,263,0,172,263,263,0,0,333,1,4,310,208,310,380,10,1635,1169
1725,9,3.1.182,1,689,0,88,182,270,172,10,270,270,0,29,333,2,3,259,142,347,295,10,1635,1169
1725,9,4.4.179,0,689,0,85,179,264,179,0,264,264,-179,179,512,5,1,85,510,264,510,10,1635,1169
1725,9,5.0.172,0,689,0,44,172,216,0,172,216,244,0,0,333,1,4,170,208,170,380,10,1635,1169
1725,10,0.0.172,0,689,0,73,172,245,0,172,245,270,0,0,333,1,4,247,208,247,380,11,1635,1081
1725,10,1.4.244,0,754,1,98,244,342,244,0,342,342,-244,244,577,5,1,98,510,297,510,11,1635,1081
1725,10,2.0.172,0,689,0,91,172,263,0,172,263,270,0,0,333,1,4,310,208,310,380,11,1635,1081
1725,10,3.2.270,1,689,0,21,270,291,270,0,291,291,-69,176,402,3,3,171,137,347,231,11,1635,1081
1725,10,4.4.179,0,689,0,85,179,264,179,0,264,270,-179,179,512,5,1,85,510,264,510,11,1635,1081
1725,10,5.0.172,0,689,0,44,172,216,0,172,216,270,0,0,333,1,4,170,208,170,380,11,1635,1081
1725,11,0.0.172,0,689,0,73,172,245,0,172,245,291,0,0,402,1,4,247,208,247,380,12,1635,1060
1725,11,1.4.244,0,754,1,98,244,342,244,0,342,342,-244,244,646,5,1,98,510,297,510,12,1635,1060
1725,11,2.0.172,0,689,0,91,172,263,0,172,263,291,0,0,402,1,4,310,208,310,380,12,1635,1060
1725,11,3.3.291,1,689,0,52,291,343,291,0,343,343,-47,244,449,4,3,150,172,347,219,12,1635,1060
1725,11,4.4.179,0,689,0,85,179,264,179,0,264,291,-179,179,581,5,1,85,510,264,510,12,1635,1060
1725,11,5.0.172,0,689,0,44,172,216,0,172,216,291,0,0,402,1,4,170,208,170,380,12,1635,1060
1725,12,0.0.172,0,689,0,73,172,245,0,172,245,343,0,0,449,1,4,247,208,247,380,13,1635,1008
1725,12,1.4.244,0,754,1,98,244,342,244,0,342,343,-244,244,693,5,1,98,510,297,510,13,1635,1008
1725,12,2.0.172,1,689,0,91,172,263,0,172,263,343,0,0,449,1,4,310,208,310,380,13,1635,1008
1725,12,3.4.343,0,755,2,98,343,441,343,0,441,441,-343,343,792,5,1,98,510,347,510,13,1635,1008
1725,12,4.4.179,0,689,0,85,179,264,179,0,264,343,-179,179,628,5,1,85,510,264,510,13,1635,1008
1725,12,5.0.172,0,689,0,44,172,216,0,172,216,343,0,0,449,1,4,170,208,170,380,13,1635,1008
1725,13,0.0.263,0,689,0,73,263,336,0,263,336,343,0,0,449,1,5,247,117,247,380,14,1635,917
1725,13,1.4.244,0,754,1,98,244,342,244,0,342,343,-244,244,693,5,1,98,510,297,510,14,1635,917
1725,13,2.1.270,1,689,0,38,270,308,263,7,308,343,0,29,449,2,4,219,54,310,295,14,1635,917
1725,13,3.4.343,0,755,2,98,343,441,343,0,441,441,-343,343,792,5,1,98,510,347,510,14,1635,917
1725,13,4.4.179,0,689,0,85,179,264,179,0,264,343,-179,179,628,5,1,85,510,264,510,14,1635,917
1725,13,5.0.263,0,689,0,44,263,307,0,263,307,343,0,0,449,1,5,170,117,170,380,14,1635,917
1725,14,0.0.263,0,689,0,73,263,336,0,263,336,343,0,0,449,1,5,247,117,247,380,15,1635,879
1725,14,1.4.244,0,754,1,98,244,342,244,0,342,343,-244,244,693,5,1,98,510,297,510,15,1635,879
1725,14,2.2.308,1,689,0,57,308,365,308,0,365,365,-17,193,466,3,4,181,116,310,231,15,1635,879
1725,14,3.4.343,0,755,2,98,343,441,343,0,441,441,-343,343,792,5,1,98,510,347,510,15,1635,879
1725,14,4.4.179,0,689,0,85,179,264,179,0,264,343,-179,179,628,5,1,85,510,264,510,15,1635,879
1725,14,5.0.263,0,689,0,44,263,307,0,263,307,343,0,0,449,1,5,170,117,170,380,15,1635,879
1725,15,0.0.263,0,689,0,73,263,336,0,263,336,365,0,0,466,1,5,247,117,247,380,16,1635,822
1725,15,1.4.244,0,754,1,98,244,342,244,0,342,365,-244,244,710,5,1,98,510,297,510,16,1635,822
1725,15,2.3.365,1,689,0,33,365,398,365,0,398,398,-22,266,488,4,4,124,120,310,219,16,1635,822
1725,15,3.4.343,0,755,2,98,343,441,343,0,441,441,-343,343,809,5,1,98,510,347,510,16,1635,822
1725,15,4.4.179,0,689,0,85,179,264,179,0,264,365,-179,179,645,5,1,85,510,264,510,16,1635,822
1725,15,5.0.263,0,689,0,44,263,307,0,263,307,365,0,0,466,1,5,170,117,170,380,16,1635,822
1725,16,0.0.263,1,689,0,73,263,336,0,263,336,398,0,0,488,1,5,247,117,247,380,17,1635,789
1725,16,1.4.244,0,754,2,98,244,342,244,0,342,398,-244,244,732,5,1,98,510,297,510,17,1635,789
1725,16,2.4.398,0,725,1,91,398,489,398,0,489,489,-398,398,886,5,1,91,510,310,510,17,1635,789
1725,16,3.4.343,0,755,3,98,343,441,343,0,441,441,-343,343,831,5,1,98,510,347,510,17,1635,789
1725,16,4.4.179,0,689,0,85,179,264,179,0,264,398,-179,179,667,5,1,85,510,264,510,17,1635,789
1725,16,5.0.263,0,689,0,44,263,307,0,263,307,398,0,0,488,1,5,170,117,170,380,17,1635,789
1725,17,0.1.336,0,689,0,13,336,349,336,0,349,398,-28,57,516,2,5,174,16,247,295,18,1635,716
1725,17,1.4.244,0,754,2,98,244,342,244,0,342,398,-244,244,732,5,1,98,510,297,510,18,1635,716
1725,17,2.4.398,0,725,1,91,398,489,398,0,489,489,-398,398,886,5,1,91,510,310,510,18,1635,716
1725,17,3.4.343,0,755,3,98,343,441,343,0,441,441,-343,343,831,5,1,98,510,347,510,18,1635,716
1725,17,4.4.179,0,689,0,85,179,264,179,0,264,398,-179,179,667,5,1,85,510,264,510,18,1635,716
1725,17,5.0.336,1,689,0,44,336,380,0,336,380,398,0,0,488,1,6,170,44,170,380,18,1635,716
1725,18,0.1.336,1,689,0,13,336,349,336,0,349,398,-28,57,516,2,5,174,16,247,295,19,1635,672
1725,18,1.4.244,0,754,2,98,244,342,244,0,342,398,-244,244,732,5,1,98,510,297,510,19,1635,672
1725,18,2.4.398,0,725,1,91,398,489,398,0,489,489,-398,398,886,5,1,91,510,310,510,19,1635,672
1725,18,3.4.343,0,755,3,98,343,441,343,0,441,441,-343,343,831,5,1,98,510,347,510,19,1635,672
1725,18,4.4.179,0,689,0,85,179,264,179,0,264,398,-179,179,667,5,1,85,510,264,510,19,1635,672
1725,18,5.1.380,0,689,0,3,380,383,380,0,383,398,-72,101,560,2,5,126,16,170,295,19,1635,672
1725,19,0.2.365,1,689,0,57,365,422,349,16,422,422,0,193,516,3,5,161,59,247,231,20,1635,659
1725,19,1.4.244,0,754,2,98,244,342,244,0,342,398,-244,244,760,5,1,98,510,297,510,20,1635,659
1725,19,2.4.398,0,725,1,91,398,489,398,0,489,489,-398,398,914,5,1,91,510,310,510,20,1635,659
1725,19,3.4.343,0,755,3,98,343,441,343,0,441,441,-343,343,859,5,1,98,510,347,510,20,1635,659
1725,19,4.4.179,0,689,0,85,179,264,179,0,264,398,-179,179,695,5,1,85,510,264,510,20,1635,659
1725,19,5.1.380,0,689,0,3,380,383,380,0,383,398,-31,88,547,2,6,126,3,170,295,20,1635,659
1725,20,0.3.422,1,689,0,52,422,474,422,0,474,474,-24,290,540,4,5,104,87,247,219,21,1635,602
1725,20,1.4.244,0,754,2,98,244,342,244,0,342,422,-244,244,760,5,1,98,510,297,510,21,1635,602
1725,20,2.4.398,0,725,1,91,398,489,398,0,489,489,-398,398,914,5,1,91,510,310,510,21,1635,602
1725,20,3.4.343,0,755,3,98,343,441,343,0,441,441,-343,343,859,5,1,98,510,347,510,21,1635,602
1725,20,4.4.179,0,689,0,85,179,264,179,0,264,422,-179,179,695,5,1,85,510,264,510,21,1635,602
1725,20,5.1.380,0,689,0,3,380,383,380,0,383,422,-31,88,547,2,6,126,3,170,295,21,1635,602
1725,21,0.4.474,0,703,1,52,474,526,474,0,526,526,-474,474,1014,5,1,52,510,247,510,22,1635,550
1725,21,1.4.244,0,754,3,98,244,342,244,0,342,474,-244,244,784,5,1,98,510,297,510,22,1635,550
1725,21,2.4.398,0,725,2,91,398,489,398,0,489,489,-398,398,938,5,1,91,510,310,510,22,1635,550
1725,21,3.4.343,0,755,4,98,343,441,343,0,441,474,-343,343,883,5,1,98,510,347,510,22,1635,550
1725,21,4.4.179,0,689,0,85,179,264,179,0,264,474,-179,179,719,5,1,85,510,264,510,22,1635,550
1725,21,5.1.380,1,689,0,3,380,383,380,0,383,474,-31,88,571,2,6,126,3,170,295,22,1635,550
1725,22,0.4.474,0,703,1,52,474,526,474,0,526,526,-474,474,1045,5,1,52,510,247,510,23,1635,547
1725,22,1.4.244,0,754,3,98,244,342,244,0,342,474,-244,244,815,5,1,98,510,297,510,23,1635,547
1725,22,2.4.398,0,725,2,91,398,489,398,0,489,489,-398,398,969,5,1,91,510,310,510,23,1635,547
1725,22,3.4.343,0,755,4,98,343,441,343,0,441,474,-343,343,914,5,1,98,510,347,510,23,1635,547
1725,22,4.4.179,0,689,0,85,179,264,179,0,264,474,-179,179,750,5,1,85,510,264,510,23,1635,547
1725,22,5.2.422,1,689,0,2,422,424,383,39,424,474,0,193,571,3,6,123,2,170,231,23,1635,547
1725,23,0.4.474,0,703,1,52,474,526,474,0,526,526,-474,474,1045,5,1,52,510,247,510,24,1635,545
1725,23,1.4.244,0,754,3,98,244,342,244,0,342,474,-244,244,815,5,1,98,510,297,510,24,1635,545
1725,23,2.4.398,0,725,2,91,398,489,398,0,489,489,-398,398,969,5,1,91,510,310,510,24,1635,545
1725,23,3.4.343,0,755,4,98,343,441,343,0,441,474,-343,343,914,5,1,98,510,347,510,24,1635,545
1725,23,4.4.179,0,689,0,85,179,264,179,0,264,474,-179,179,750,5,1,85,510,264,510,24,1635,545
1725,23,5.3.474,1,689,0,35,474,509,424,50,509,509,0,290,571,4,6,121,35,170,219,24,1635,545
1725,24,0.4.474,0,703,1,52,474,526,474,0,526,526,-474,474,1045,5,1,52,510,247,510,25,1635,510
1725,24,1.4.244,0,754,4,98,244,342,244,0,342,509,-244,244,815,5,1,98,510,297,510,25,1635,510
1725,24,2.4.398,0,725,2,91,398,489,398,0,489,509,-398,398,969,5,1,91,510,310,510,25,1635,510
1725,24,3.4.343,0,755,5,98,343,441,343,0,441,509,-343,343,914,5,1,98,510,347,510,25,1635,510
1725,24,4.4.179,1,689,0,85,179,264,179,0,264,509,-179,179,750,5,1,85,510,264,510,25,1635,510
1725,24,5.4.509,0,738,3,86,509,595,509,0,595,595,-509,509,1080,5,1,86,510,170,510,25,1635,510
1725,25,0.4.474,0,703,1,52,474,526,474,0,526,526,-210,389,960,5,2,52,425,247,510,26,1635,425
1725,25,1.4.264,1,689,0,98,264,362,244,20,362,509,0,179,750,5,2,98,425,297,510,26,1635,425
1725,25,2.4.398,0,725,2,91,398,489,398,0,489,509,-134,313,884,5,2,91,425,310,510,26,1635,425
1725,25,3.4.343,0,768,4,98,343,441,343,0,441,509,-79,258,829,5,2,98,425,347,510,26,1635,425
1725,25,5.4.509,0,738,3,86,509,595,509,0,595,595,-245,424,995,5,2,86,425,170,510,26,1635,425
1725,26,0.4.474,0,703,1,52,474,526,474,0,526,526,-112,291,862,5,3,52,327,247,510,27,1635,327
1725,26,2.4.398,0,725,2,91,398,489,398,0,489,509,-36,215,786,5,3,91,327,310,510,27,1635,327
1725,26,3.4.362,1,689,0,98,362,460,343,19,460,509,0,179,750,5,3,98,327,347,510,27,1635,327
1725,26,5.4.509,0,738,3,86,509,595,509,0,595,595,-147,326,897,5,3,86,327,170,510,27,1635,327
1725,27,0.4.474,0,703,1,52,474,526,474,0,526,526,-14,193,764,5,4,52,229,247,510,28,1635,229
1725,27,2.4.460,1,689,0,91,460,551,398,62,551,551,0,179,750,5,4,91,229,310,510,28,1635,229
1725,27,5.4.509,0,738,2,86,509,595,509,0,595,595,-49,228,799,5,4,86,229,170,510,28,1635,229
1725,28,0.4.551,1,689,0,52,551,603,474,77,603,603,0,179,750,5,5,52,138,247,510,29,1635,138
1725,28,5.4.551,0,689,0,86,551,637,509,42,637,637,0,179,750,5,5,86,138,170,510,29,1635,138
1725,29,5.4.603,1,689,0,86,603,689,509,94,689,689,0,179,750,5,6,86,86,170,510,30,1635,86
1726,0,0.0.0,0,565,3,86,0,86,0,0,86,86,0,0,0,1,1,291,296,291,296,1,1409,1409
1726,0,1.0.0,0,501,1,31,0,31,0,0,31,31,0,0,0,1,1,198,296,198,296,1,1409,1409
1726,0,2.0.0,0,501,1,37,0,37,0,0,37,37,0,0,0,1,1,138,296,138,296,1,1409,1409
1726,0,3.0.0,0,501,1,42,0,42,0,0,42,42,0,0,0,1,1,210,296,210,296,1,1409,1409
1726,0,4.0.0,1,489,0,51,0,51,0,0,51,51,0,0,0,1,1,301,296,301,296,1,1409,1409
1726,0,5.0.0,0,507,2,49,0,49,0,0,49,49,0,0,0,1,1,271,296,271,296,1,1409,1409
1726,1,0.0.51,0,533,2,86,51,137,0,51,137,137,0,0,0,1,2,291,245,291,296,2,1409,1358
1726,1,1.0.51,0,489,0,31,51,82,0,51,82,82,0,0,0,1,2,198,245,198,296,2,1409,1358
1726,1,2.0.51,0,501,1,37,51,88,0,51,88,88,0,0,0,1,2,138,245,138,296,2,1409,1358
1726,1,3.0.51,0,489,0,42,51,93,0,51,93,93,0,0,0,1,2,210,245,210,296,2,1409,1358
1726,1,4.1.51,1,489,0,24,51,75,51,0,75,75,-51,51,51,2,1,250,298,301,298,2,1409,1358
1726,1,5.0.51,0,489,0,49,51,100,0,51,100,100,0,0,0,1,2,271,245,271,296,2,1409,1358
1726,2,0.0.51,0,533,2,86,51,137,0,51,137,137,0,0,51,1,2,291,245,291,296,3,1409,1334
1726,2,1.0.51,0,489,0,31,51,82,0,51,82,82,0,0,51,1,2,198,245,198,296,3,1409,1334
1726,2,2.0.51,0,501,1,37,51,88,0,51,88,88,0,0,51,1,2,138,245,138,296,3,1409,1334
1726,2,3.0.51,0,489,0,42,51,93,0,51,93,93,0,0,51,1,2,210,245,210,296,3,1409,1334
1726,2,4.2.75,1,489,0,75,75,150,75,0,150,150,-75,75,126,3,1,226,299,301,299,3,1409,1334
1726,2,5.0.51,0,489,0,49,51,100,0,51,100,100,0,0,51,1,2,271,245,271,296,3,1409,1334
1726,3,0.0.51,0,533,2,86,51,137,0,51,137,150,0,0,126,1,2,291,245,291,296,4,1409,1259
1726,3,1.0.51,0,489,0,31,51,82,0,51,82,150,0,0,126,1,2,198,245,198,296,4,1409,1259
1726,3,2.0.51,0,501,1,37,51,88,0,51,88,150,0,0,126,1,2,138,245,138,296,4,1409,1259
1726,3,3.0.51,0,489,0,42,51,93,0,51,93,150,0,0,126,1,2,210,245,210,296,4,1409,1259
1726,3,4.3.150,1,489,0,96,150,246,150,0,246,246,-150,150,276,4,1,151,273,301,273,4,1409,1259
1726,3,5.0.51,0,489,0,49,51,100,0,51,100,150,0,0,126,1,2,271,245,271,296,4,1409,1259
1726,4,0.0.51,0,533,2,86,51,137,0,51,137,246,0,0,276,1,2,291,245,291,296,5,1409,1163
1726,4,1.0.51,0,489,0,31,51,82,0,51,82,246,0,0,276,1,2,198,245,198,296,5,1409,1163
1726,4,2.0.51,0,501,1,37,51,88,0,51,88,246,0,0,276,1,2,138,245,138,296,5,1409,1163
1726,4,3.0.51,0,489,0,42,51,93,0,51,93,246,0,0,276,1,2,210,245,210,296,5,1409,1163
1726,4,4.4.246,1,489,0,55,246,301,246,0,301,301,-246,246,522,5,1,55,243,301,243,5,1409,1163
1726,4,5.0.51,0,489,0,49,51,100,0,51,100,246,0,0,276,1,2,271,245,271,296,5,1409,1163
1726,5,0.0.51,0,533,2,86,51,137,0,51,137,301,0,0,522,1,2,291,245,291,296,6,1409,1108
1726,5,1.0.51,0,489,0,31,51,82,0,51,82,301,0,0,522,1,2,198,245,198,296,6,1409,1108
1726,5,2.0.51,0,501,1,37,51,88,0,51,88,301,0,0,522,1,2,138,245,138,296,6,1409,1108
1726,5,3.0.51,0,489,0,42,51,93,0,51,93,301,0,0,522,1,2,210,245,210,296,6,1409,1108
1726,5,5.0.51,1,489,0,49,51,100,0,51,100,301,0,0,522,1,2,271,245,271,296,6,1409,1108
1726,6,0.0.100,0,519,2,86,100,186,0,100,186,301,0,0,522,1,3,291,196,291,296,7,1409,1059
1726,6,1.0.100,1,489,0,31,100,131,0,100,131,301,0,0,522,1,3,198,196,198,296,7,1409,1059
1726,6,2.0.100,0,501,1,37,100,137,0,100,137,301,0,0,522,1,3,138,196,138,296,7,1409,1059
1726,6,3.0.100,0,489,0,42,100,142,0,100,142,301,0,0,522,1,3,210,196,210,296,7,1409,1059
1726,6,5.1.100,0,489,0,85,100,185,100,0,185,301,-25,76,547,2,2,222,274,271,298,7,1409,1059
1726,7,0.0.131,0,511,3,86,131,217,0,131,217,301,0,0,522,1,4,291,165,291,296,8,1409,1028
1726,7,1.1.131,0,510,2,50,131,181,131,0,181,301,-56,107,578,2,2,167,274,198,298,8,1409,1028
1726,7,2.0.131,0,501,1,37,131,168,0,131,168,301,0,0,522,1,4,138,165,138,296,8,1409,1028
1726,7,3.0.131,1,489,0,42,131,173,0,131,173,301,0,0,522,1,4,210,165,210,296,8,1409,1028
1726,7,5.1.100,0,489,0,85,100,185,100,0,185,301,-25,76,547,2,2,222,274,271,298,8,1409,1028
1726,8,0.0.173,1,489,0,86,173,259,0,173,259,301,0,0,522,1,5,291,123,291,296,9,1409,986
1726,8,1.1.131,0,510,2,50,131,181,131,0,181,301,-56,107,578,2,2,167,274,198,298,9,1409,986
1726,8,2.0.173,0,501,1,37,173,210,0,173,210,301,0,0,522,1,5,138,123,138,296,9,1409,986
1726,8,3.1.173,0,552,3,27,173,200,173,0,200,301,-98,149,620,2,2,168,274,210,298,9,1409,986
1726,8,5.1.100,0,489,0,85,100,185,100,0,185,301,-25,76,547,2,2,222,274,271,298,9,1409,986
1726,9,0.1.259,0,551,2,80,259,339,259,0,339,339,-184,235,706,2,2,205,274,291,298,10,1409,900
1726,9,1.1.131,0,510,1,50,131,181,131,0,181,301,-56,107,578,2,2,167,274,198,298,10,1409,900
1726,9,2.0.259,1,489,0,37,259,296,0,259,296,301,0,0,522,1,6,138,37,138,296,10,1409,900
1726,9,3.1.173,0,552,3,27,173,200,173,0,200,301,-98,149,620,2,2,168,274,210,298,10,1409,900
1726,9,5.1.100,0,489,0,85,100,185,100,0,185,301,-25,76,547,2,2,222,274,271,298,10,1409,900
1726,10,0.1.259,0,551,3,80,259,339,259,0,339,339,-184,235,706,2,2,205,274,291,298,11,1409,863
1726,10,1.1.131,0,510,1,50,131,181,131,0,181,301,-56,107,578,2,2,167,274,198,298,11,1409,863
1726,10,2.1.296,0,533,2,32,296,328,296,0,328,328,-221,272,743,2,2,101,274,138,298,11,1409,863
1726,10,3.1.173,0,552,4,27,173,200,173,0,200,301,-98,149,620,2,2,168,274,210,298,11,1409,863
1726,10,5.1.100,1,489,0,85,100,185,100,0,185,301,-25,76,547,2,2,222,274,271,298,11,1409,863
1726,11,0.1.259,0,551,3,80,259,339,259,0,339,339,-74,150,621,2,3,205,189,291,298,12,1409,778
1726,11,1.1.185,0,489,0,50,185,235,131,54,235,301,0,76,547,2,3,167,189,198,298,12,1409,778
1726,11,2.1.296,0,533,2,32,296,328,296,0,328,328,-111,187,658,2,3,101,189,138,298,12,1409,778
1726,11,3.1.185,0,492,1,27,185,212,173,12,212,301,0,76,547,2,3,168,189,210,298,12,1409,778
1726,11,5.2.185,1,489,0,40,185,225,185,0,225,301,-35,110,582,3,2,137,224,271,299,12,1409,778
1726,12,0.1.259,0,551,3,80,259,339,259,0,339,339,-74,150,656,2,3,205,189,291,298,13,1409,738
1726,12,1.1.185,0,489,0,50,185,235,131,54,235,301,0,76,582,2,3,167,189,198,298,13,1409,738
1726,12,2.1.296,0,533,2,32,296,328,296,0,328,328,-111,187,693,2,3,101,189,138,298,13,1409,738
1726,12,3.1.185,0,492,1,27,185,212,173,12,212,301,0,76,582,2,3,168,189,210,298,13,1409,738
1726,12,5.3.246,1,489,0,20,246,266,225,21,266,301,0,150,582,4,2,97,177,271,273,13,1409,738
1726,13,0.1.259,0,551,3,80,259,339,259,0,339,339,-74,150,656,2,3,205,189,291,298,14,1409,718
1726,13,1.1.185,0,489,0,50,185,235,131,54,235,301,0,76,582,2,3,167,189,198,298,14,1409,718
1726,13,2.1.296,0,533,2,32,296,328,296,0,328,328,-111,187,693,2,3,101,189,138,298,14,1409,718
1726,13,3.1.185,0,492,1,27,185,212,173,12,212,301,0,76,582,2,3,168,189,210,298,14,1409,718
1726,13,5.4.301,1,489,0,77,301,378,266,35,378,378,0,246,582,5,2,77,188,271,243,14,1409,718
1726,14,0.1.259,0,551,3,80,259,339,259,0,339,378,-74,150,656,2,3,205,189,291,298,15,1409,641
1726,14,1.1.185,0,489,0,50,185,235,131,54,235,378,0,76,582,2,3,167,189,198,298,15,1409,641
1726,14,2.1.296,0,533,2,32,296,328,296,0,328,378,-111,187,693,2,3,101,189,138,298,15,1409,641
1726,14,3.1.185,1,492,1,27,185,212,173,12,212,378,0,76,582,2,3,168,189,210,298,15,1409,641
1726,15,0.1.259,0,553,2,80,259,339,259,0,339,378,-47,123,629,2,4,205,162,291,298,16,1409,614
1726,15,1.1.212,1,492,0,50,212,262,131,81,262,378,0,76,582,2,4,167,162,198,298,16,1409,614
1726,15,2.1.296,0,533,1,32,296,328,296,0,328,378,-84,160,666,2,4,101,162,138,298,16,1409,614
1726,15,3.2.225,0,492,0,88,225,313,212,13,313,378,0,110,582,3,3,141,184,210,299,16,1409,614
1726,16,0.1.262,0,492,0,80,262,342,259,3,342,378,0,76,582,2,5,205,112,291,298,17,1409,564
1726,16,1.2.262,1,510,1,25,262,287,262,0,287,378,-37,147,619,3,3,117,184,198,299,17,1409,564
1726,16,2.1.296,0,533,2,32,296,328,296,0,328,378,-34,110,616,2,5,101,112,138,298,17,1409,564
1726,16,3.2.225,0,492,0,88,225,313,212,13,313,378,0,110,582,3,3,141,184,210,299,17,1409,564
1726,17,0.1.262,0,510,0,80,262,342,259,3,342,378,0,76,619,2,5,205,112,291,298,18,1409,539
1726,17,1.3.287,1,510,0,84,287,371,287,0,371,378,-21,171,640,4,3,92,157,198,273,18,1409,539
1726,17,2.1.296,0,533,1,32,296,328,296,0,328,378,-34,110,653,2,5,101,112,138,298,18,1409,539
1726,17,3.2.287,0,510,0,88,287,375,212,75,375,378,0,147,619,3,4,141,159,210,299,18,1409,539
1726,18,0.1.262,0,510,0,80,262,342,259,3,342,378,0,76,640,2,5,205,112,291,298,19,1409,455
1726,18,1.4.378,1,510,0,8,378,386,371,7,386,386,0,246,640,5,3,8,111,198,243,19,1409,455
1726,18,2.1.296,0,533,1,32,296,328,296,0,328,378,-34,110,674,2,5,101,112,138,298,19,1409,455
1726,18,3.2.287,0,510,0,88,287,375,212,75,375,378,0,147,640,3,4,141,159,210,299,19,1409,455
1726,19,0.1.262,0,510,0,80,262,342,259,3,342,386,0,76,640,2,5,205,112,291,298,20,1409,447
1726,19,2.1.296,0,533,1,32,296,328,296,0,328,386,-34,110,674,2,5,101,112,138,298,20,1409,447
1726,19,3.2.287,1,510,0,88,287,375,212,75,375,386,0,147,640,3,4,141,159,210,299,20,1409,447
1726,20,0.1.262,0,510,0,80,262,342,259,3,342,386,0,76,640,2,5,205,112,291,298,21,1409,359
1726,20,2.1.296,0,533,1,32,296,328,296,0,328,386,-34,110,674,2,5,101,112,138,298,21,1409,359
1726,20,3.3.375,1,510,0,12,375,387,375,0,387,387,-4,175,644,4,4,53,73,210,273,21,1409,359
1726,21,0.1.262,0,510,0,80,262,342,259,3,342,387,0,76,644,2,5,205,112,291,298,22,1409,347
1726,21,2.1.296,0,533,1,32,296,328,296,0,328,387,-34,110,678,2,5,101,112,138,298,22,1409,347
1726,21,3.4.387,1,510,0,41,387,428,387,0,428,428,-1,247,645,5,4,41,103,210,243,22,1409,347
1726,22,0.1.262,1,510,0,80,262,342,259,3,342,428,0,76,645,2,5,205,112,291,298,23,1409,306
1726,22,2.1.296,0,533,1,32,296,328,296,0,328,428,-34,110,679,2,5,101,112,138,298,23,1409,306
1726,23,0.2.375,1,512,1,61,375,436,342,33,436,436,0,147,645,3,5,125,71,291,299,24,1409,226
1726,23,2.1.342,0,510,0,32,342,374,296,46,374,428,0,76,645,2,6,101,32,138,298,24,1409,226
1726,24,0.3.436,1,557,1,59,436,495,436,0,495,495,-49,224,694,4,5,64,61,291,273,25,1409,165
1726,24,2.1.342,0,512,0,32,342,374,296,46,374,436,0,76,645,2,6,101,32,138,298,25,1409,165
1726,25,0.4.495,1,557,0,5,495,500,495,0,500,500,-67,314,761,5,5,5,62,291,243,26,1409,106
1726,25,2.1.342,0,557,0,32,342,374,296,46,374,495,0,76,694,2,6,101,32,138,298,26,1409,106
1726,26,2.1.342,1,557,0,32,342,374,296,46,374,500,0,76,761,2,6,101,32,138,298,27,1409,101
1726,27,2.2.436,1,557,0,10,436,446,374,62,446,500,0,147,761,3,6,69,10,138,299,28,1409,69
1726,28,2.3.495,1,557,0,2,495,497,446,49,497,500,0,224,761,4,6,59,2,138,273,29,1409,59
1726,29,2.4.500,1,557,0,57,500,557,497,3,557,557,0,314,761,5,6,57,57,138,243,30,1409,57
1727,0,0.0.0,0,637,4,99,0,99,0,0,99,99,0,0,0,1,1,335,409,335,409,1,1675,1675
1727,0,1.0.0,0,599,0,6,0,6,0,0,6,6,0,0,0,1,1,99,409,99,409,1,1675,1675
1727,0,2.0.0,0,654,5,82,0,82,0,0,82,82,0,0,0,1,1,262,409,262,409,1,1675,1675
1727,0,3.0.0,0,631,3,95,0,95,0,0,95,95,0,0,0,1,1,367,409,367,409,1,1675,1675
1727,0,4.0.0,1,612,1,73,0,73,0,0,73,73,0,0,0,1,1,338,409,338,409,1,1675,1675
1727,0,5.0.0,0,617,2,54,0,54,0,0,54,54,0,0,0,1,1,274,409,274,409,1,1675,1675
1727,1,0.0.73,0,627,1,99,73,172,0,73,172,172,0,0,0,1,2,335,336,335,409,2,1675,1602
1727,1,1.0.73,0,612,0,6,73,79,0,73,79,79,0,0,0,1,2,99,336,99,409,2,1675,1602
1727,1,2.0.73,0,651,3,82,73,155,0,73,155,155,0,0,0,1,2,262,336,262,409,2,1675,1602
1727,1,3.0.73,0,631,2,95,73,168,0,73,168,168,0,0,0,1,2,367,336,367,409,2,1675,1602
1727,1,4.1.73,1,612,0,75,73,148,73,0,148,148,-73,73,73,2,1,265,302,338,302,2,1675,1602
1727,1,5.0.73,0,612,0,54,73,127,0,73,127,127,0,0,0,1,2,274,336,274,409,2,1675,1602
1727,2,0.0.73,0,627,1,99,73,172,0,73,172,172,0,0,73,1,2,335,336,335,409,3,1675,1527
1727,2,1.0.73,0,612,0,6,73,79,0,73,79,148,0,0,73,1,2,99,336,99,409,3,1675,1527
1727,2,2.0.73,0,651,3,82,73,155,0,73,155,155,0,0,73,1,2,262,336,262,409,3,1675,1527
1727,2,3.0.73,0,631,2,95,73,168,0,73,168,168,0,0,73,1,2,367,336,367,409,3,1675,1527
1727,2,4.2.148,1,612,0,76,148,224,148,0,224,224,-148,148,221,3,1,190,365,338,365,3,1675,1527
1727,2,5.0.73,0,612,0,54,73,127,0,73,127,148,0,0,73,1,2,274,336,274,409,3,1675,1527
1727,3,0.0.73,0,627,1,99,73,172,0,73,172,224,0,0,221,1,2,335,336,335,409,4,1675,1451
1727,3,1.0.73,0,612,0,6,73,79,0,73,79,224,0,0,221,1,2,99,336,99,409,4,1675,1451
1727,3,2.0.73,0,651,3,82,73,155,0,73,155,224,0,0,221,1,2,262,336,262,409,4,1675,1451
1727,3,3.0.73,0,631,2,95,73,168,0,73,168,224,0,0,221,1,2,367,336,367,409,4,1675,1451
1727,3,4.3.224,1,612,0,89,224,313,224,0,313,313,-224,224,445,4,1,114,326,338,326,4,1675,1451
1727,3,5.0.73,0,612,0,54,73,127,0,73,127,224,0,0,221,1,2,274,336,274,409,4,1675,1451
1727,4,0.0.73,0,627,1,99,73,172,0,73,172,313,0,0,445,1,2,335,336,335,409,5,1675,1362
1727,4,1.0.73,0,612,0,6,73,79,0,73,79,313,0,0,445,1,2,99,336,99,409,5,1675,1362
1727,4,2.0.73,0,651,3,82,73,155,0,73,155,313,0,0,445,1,2,262,336,262,409,5,1675,1362
1727,4,3.0.73,0,631,2,95,73,168,0,73,168,313,0,0,445,1,2,367,336,367,409,5,1675,1362
1727,4,4.4.313,1,612,0,25,313,338,313,0,338,338,-313,313,758,5,1,25,273,338,273,5,1675,1362
1727,4,5.0.73,0,612,0,54,73,127,0,73,127,313,0,0,445,1,2,274,336,274,409,5,1675,1362
1727,5,0.0.73,0,627,1,99,73,172,0,73,172,338,0,0,758,1,2,335,336,335,409,6,1675,1337
1727,5,1.0.73,0,612,0,6,73,79,0,73,79,338,0,0,758,1,2,99,336,99,409,6,1675,1337
1727,5,2.0.73,0,651,3,82,73,155,0,73,155,338,0,0,758,1,2,262,336,262,409,6,1675,1337
1727,5,3.0.73,0,631,2,95,73,168,0,73,168,338,0,0,758,1,2,367,336,367,409,6,1675,1337
1727,5,5.0.73,1,612,0,54,73,127,0,73,127,338,0,0,758,1,2,274,336,274,409,6,1675,1337
1727,6,0.0.127,0,633,1,99,127,226,0,127,226,338,0,0,758,1,3,335,282,335,409,7,1675,1283
1727,6,1.0.127,0,612,0,6,127,133,0,127,133,338,0,0,758,1,3,99,282,99,409,7,1675,1283
1727,6,2.0.127,0,661,2,82,127,209,0,127,209,338,0,0,758,1,3,262,282,262,409,7,1675,1283
1727,6,3.0.127,0,612,0,95,127,222,0,127,222,338,0,0,758,1,3,367,282,367,409,7,1675,1283
1727,6,5.1.148,1,612,0,69,148,217,127,21,217,338,0,73,758,2,2,220,227,274,302,7,1675,1283
1727,7,0.0.127,0,633,1,99,127,226,0,127,226,338,0,0,758,1,3,335,282,335,409,8,1675,1214
1727,7,1.0.127,0,612,0,6,127,133,0,127,133,338,0,0,758,1,3,99,282,99,409,8,1675,1214
1727,7,2.0.127,0,661,2,82,127,209,0,127,209,338,0,0,758,1,3,262,282,262,409,8,1675,1214
1727,7,3.0.127,1,612,0,95,127,222,0,127,222,338,0,0,758,1,3,367,282,367,409,8,1675,1214
1727,7,5.2.224,0,612,0,78,224,302,217,7,302,338,0,148,758,3,2,151,289,274,365,8,1675,1214
1727,8,0.0.222,0,614,1,99,222,321,0,222,321,338,0,0,758,1,4,335,187,335,409,9,1675,1119
1727,8,1.0.222,0,612,0,6,222,228,0,222,228,338,0,0,758,1,4,99,187,99,409,9,1675,1119
1727,8,2.0.222,0,646,2,82,222,304,0,222,304,338,0,0,758,1,4,262,187,262,409,9,1675,1119
1727,8,3.1.222,1,612,0,65,222,287,222,0,287,338,-5,78,763,2,3,272,158,367,302,9,1675,1119
1727,8,5.2.224,0,612,0,78,224,302,217,7,302,338,0,148,758,3,2,151,289,274,365,9,1675,1119
1727,9,0.0.222,1,614,1,99,222,321,0,222,321,338,0,0,763,1,4,335,187,335,409,10,1675,1054
1727,9,1.0.222,0,612,0,6,222,228,0,222,228,338,0,0,763,1,4,99,187,99,409,10,1675,1054
1727,9,2.0.222,0,646,2,82,222,304,0,222,304,338,0,0,763,1,4,262,187,262,409,10,1675,1054
1727,9,3.2.287,0,664,3,55,287,342,287,0,342,342,-63,211,826,3,2,207,289,367,365,10,1675,1054
1727,9,5.2.224,0,612,0,78,224,302,217,7,302,338,0,148,763,3,2,151,289,274,365,10,1675,1054
1727,10,0.1.321,0,614,0,49,321,370,321,0,370,370,-34,112,797,2,4,236,93,335,302,11,1675,955
1727,10,1.0.321,1,614,0,6,321,327,0,321,327,338,0,0,763,1,5,99,88,99,409,11,1675,955
1727,10,2.0.321,0,614,0,82,321,403,0,321,403,403,0,0,763,1,5,262,88,262,409,11,1675,955
1727,10,3.2.287,0,664,1,55,287,342,287,0,342,342,-63,211,826,3,2,207,289,367,365,11,1675,955
1727,10,5.2.224,0,614,0,78,224,302,217,7,302,338,0,148,763,3,2,151,289,274,365,11,1675,955
1727,11,0.1.321,0,614,0,49,321,370,321,0,370,370,-34,112,797,2,4,236,93,335,302,12,1675,949
1727,11,1.1.327,0,618,1,19,327,346,327,0,346,346,-40,118,803,2,4,93,93,99,302,12,1675,949
1727,11,2.0.327,1,614,0,82,327,409,0,327,409,409,0,0,763,1,6,262,82,262,409,12,1675,949
1727,11,3.2.287,0,664,2,55,287,342,287,0,342,342,-63,211,826,3,2,207,289,367,365,12,1675,949
1727,11,5.2.224,0,614,0,78,224,302,217,7,302,338,0,148,763,3,2,151,289,274,365,12,1675,949
1727,12,0.1.321,1,614,0,49,321,370,321,0,370,409,-34,112,797,2,4,236,93,335,302,13,1675,867
1727,12,1.1.327,0,618,1,19,327,346,327,0,346,409,-40,118,803,2,4,93,93,99,302,13,1675,867
1727,12,2.1.409,0,614,0,25,409,434,409,0,434,434,-122,200,885,2,4,180,93,262,302,13,1675,867
1727,12,3.2.287,0,664,2,55,287,342,287,0,342,409,-63,211,826,3,2,207,289,367,365,13,1675,867
1727,12,5.2.224,0,614,0,78,224,302,217,7,302,409,0,148,763,3,2,151,289,274,365,13,1675,867
1727,13,0.2.370,0,614,0,64,370,434,370,0,434,434,-146,294,943,3,2,187,289,335,365,14,1675,818
1727,13,1.1.370,1,614,0,19,370,389,327,43,389,409,0,112,797,2,5,93,44,99,302,14,1675,818
1727,13,2.1.409,0,614,0,25,409,434,409,0,434,434,-39,151,836,2,5,180,44,262,302,14,1675,818
1727,13,3.2.287,0,664,1,55,287,342,287,0,342,409,-63,211,860,3,2,207,289,367,365,14,1675,818
1727,13,5.2.224,0,614,0,78,224,302,217,7,302,409,0,148,797,3,2,151,289,274,365,14,1675,818
1727,14,0.2.370,0,614,0,64,370,434,370,0,434,434,-146,294,943,3,2,187,289,335,365,15,1675,799
1727,14,1.2.389,0,642,1,30,389,419,389,0,419,419,-165,313,962,3,2,74,289,99,365,15,1675,799
1727,14,2.1.409,1,614,0,25,409,434,409,0,434,434,-20,132,817,2,6,180,25,262,302,15,1675,799
1727,14,3.2.287,0,664,2,55,287,342,287,0,342,409,-63,211,860,3,2,207,289,367,365,15,1675,799
1727,14,5.2.224,0,614,0,78,224,302,217,7,302,409,0,148,797,3,2,151,289,274,365,15,1675,799
1727,15,0.2.370,0,614,0,64,370,434,370,0,434,434,-146,294,963,3,2,187,289,335,365,16,1675,774
1727,15,1.2.389,0,642,1,30,389,419,389,0,419,434,-165,313,982,3,2,74,289,99,365,16,1675,774
1727,15,2.2.434,0,614,0,62,434,496,434,0,496,496,-210,358,1027,3,2,155,289,262,365,16,1675,774
1727,15,3.2.287,1,664,2,55,287,342,287,0,342,434,-63,211,880,3,2,207,289,367,365,16,1675,774
1727,15,5.2.224,0,614,0,78,224,302,217,7,302,434,0,148,817,3,2,151,289,274,365,16,1675,774
1727,16,0.2.370,0,679,1,64,370,434,370,0,434,434,-28,239,908,3,3,187,234,335,365,17,1675,719
1727,16,1.2.389,0,710,2,30,389,419,389,0,419,434,-47,258,927,3,3,74,234,99,365,17,1675,719
1727,16,2.2.434,0,679,1,62,434,496,434,0,496,496,-92,303,972,3,3,155,234,262,365,17,1675,719
1727,16,3.3.342,1,664,0,70,342,412,342,0,412,434,-29,253,909,4,2,152,237,367,326,17,1675,719
1727,16,5.2.342,0,664,0,78,342,420,217,125,420,434,0,211,880,3,3,151,234,274,365,17,1675,719
1727,17,0.2.370,0,679,1,64,370,434,370,0,434,434,-28,239,937,3,3,187,234,335,365,18,1675,649
1727,17,1.2.389,0,710,2,30,389,419,389,0,419,434,-47,258,956,3,3,74,234,99,365,18,1675,649
1727,17,2.2.434,0,679,1,62,434,496,434,0,496,496,-92,303,1001,3,3,155,234,262,365,18,1675,649
1727,17,3.4.412,1,664,0,82,412,494,412,0,494,494,-74,387,983,5,2,82,248,367,273,18,1675,649
1727,17,5.2.342,0,664,0,78,342,420,217,125,420,434,0,211,909,3,3,151,234,274,365,18,1675,649
1727,18,0.2.370,0,679,1,64,370,434,370,0,434,494,-28,239,1011,3,3,187,234,335,365,19,1675,567
1727,18,1.2.389,0,710,2,30,389,419,389,0,419,494,-47,258,1030,3,3,74,234,99,365,19,1675,567
1727,18,2.2.434,0,679,1,62,434,496,434,0,496,496,-92,303,1075,3,3,155,234,262,365,19,1675,567
1727,18,5.2.342,1,664,0,78,342,420,217,125,420,494,0,211,983,3,3,151,234,274,365,19,1675,567
1727,19,0.2.420,0,664,0,64,420,484,370,50,484,494,0,211,983,3,4,187,156,335,365,20,1675,489
1727,19,1.2.420,0,673,1,30,420,450,389,31,450,494,0,211,983,3,4,74,156,99,365,20,1675,489
1727,19,2.2.434,0,707,2,62,434,496,434,0,496,496,-14,225,997,3,4,155,156,262,365,20,1675,489
1727,19,5.3.420,1,664,0,5,420,425,420,0,425,494,-8,261,991,4,3,73,167,274,326,20,1675,489
1727,20,0.2.420,0,664,0,64,420,484,370,50,484,494,0,211,991,3,4,187,156,335,365,21,1675,484
1727,20,1.2.420,0,673,1,30,420,450,389,31,450,494,0,211,991,3,4,74,156,99,365,21,1675,484
1727,20,2.2.434,0,707,2,62,434,496,434,0,496,496,-14,225,1005,3,4,155,156,262,365,21,1675,484
1727,20,5.4.494,1,664,0,68,494,562,425,69,562,562,0,387,991,5,3,68,166,274,273,21,1675,484
1727,21,0.2.420,1,664,0,64,420,484,370,50,484,562,0,211,991,3,4,187,156,335,365,22,1675,416
1727,21,1.2.420,0,673,1,30,420,450,389,31,450,562,0,211,991,3,4,74,156,99,365,22,1675,416
1727,21,2.2.434,0,707,2,62,434,496,434,0,496,562,-14,225,1005,3,4,155,156,262,365,22,1675,416
1727,22,0.3.484,1,664,0,66,484,550,484,0,550,562,-59,320,1050,4,4,123,162,335,326,23,1675,352
1727,22,1.2.484,0,669,1,30,484,514,389,95,514,562,0,211,991,3,5,74,92,99,365,23,1675,352
1727,22,2.2.484,0,664,0,62,484,546,434,50,546,562,0,211,991,3,5,155,92,262,365,23,1675,352
1727,23,0.4.562,1,664,0,57,562,619,550,12,619,619,0,387,1050,5,4,57,98,335,273,24,1675,286
1727,23,1.2.484,0,669,1,30,484,514,389,95,514,562,0,211,1050,3,5,74,92,99,365,24,1675,286
1727,23,2.2.484,0,664,0,62,484,546,434,50,546,562,0,211,1050,3,5,155,92,262,365,24,1675,286
1727,24,1.2.484,0,669,1,30,484,514,389,95,514,619,0,211,1050,3,5,74,92,99,365,25,1675,229
1727,24,2.2.484,1,664,0,62,484,546,434,50,546,619,0,211,1050,3,5,155,92,262,365,25,1675,229
1727,25,1.2.546,1,664,0,30,546,576,389,157,576,619,0,211,1050,3,6,74,30,99,365,26,1675,167
1727,25,2.3.550,0,664,0,70,550,620,546,4,620,620,0,320,1050,4,5,93,96,262,326,26,1675,167
1727,26,1.3.576,0,695,1,26,576,602,576,0,602,619,-26,346,1076,4,5,44,96,99,326,27,1675,137
1727,26,2.3.550,1,664,0,70,550,620,546,4,620,620,0,320,1050,4,5,93,96,262,326,27,1675,137
1727,27,1.3.620,0,664,0,26,620,646,576,44,646,646,0,320,1050,4,6,44,26,99,326,28,1675,67
1727,27,2.4.620,1,664,0,23,620,643,620,0,643,643,-1,388,1051,5,5,23,41,262,273,28,1675,67
1727,28,1.3.620,1,664,0,26,620,646,576,44,646,646,0,320,1051,4,6,44,26,99,326,29,1675,44
1727,29,1.4.646,1,664,0,18,646,664,646,0,664,664,-3,391,1054,5,6,18,18,99,273,30,1675,18
1728,0,0.0.0,1,527,0,13,0,13,0,0,13,13,0,0,0,1,1,179,324,179,324,1,1445,1445
1728,0,1.0.0,0,590,4,81,0,81,0,0,81,81,0,0,0,1,1,297,324,297,324,1,1445,1445
1728,0,2.0.0,0,527,0,29,0,29,0,0,29,29,0,0,0,1,1,191,324,191,324,1,1445,1445
1728,0,3.0.0,0,552,1,49,0,49,0,0,49,49,0,0,0,1,1,128,324,128,324,1,1445,1445
1728,0,4.0.0,0,584,3,94,0,94,0,0,94,94,0,0,0,1,1,376,324,376,324,1,1445,1445
1728,0,5.0.0,0,553,2,58,0,58,0,0,58,58,0,0,0,1,1,274,324,274,324,1,1445,1445
1728,1,0.1.13,1,527,0,17,13,30,13,0,30,30,-13,13,13,2,1,166,206,179,206,2,1445,1432
1728,1,1.0.13,0,588,3,81,13,94,0,13,94,94,0,0,0,1,2,297,311,297,324,2,1445,1432
1728,1,2.0.13,0,527,0,29,13,42,0,13,42,42,0,0,0,1,2,191,311,191,324,2,1445,1432
1728,1,3.0.13,0,552,2,49,13,62,0,13,62,62,0,0,0,1,2,128,311,128,324,2,1445,1432
1728,1,4.0.13,0,539,1,94,13,107,0,13,107,107,0,0,0,1,2,376,311,376,324,2,1445,1432
1728,1,5.0.13,0,527,0,58,13,71,0,13,71,71,0,0,0,1,2,274,311,274,324,2,1445,1432
1728,2,0.2.30,1,527,0,67,30,97,30,0,97,97,-30,30,43,3,1,149,233,179,233,3,1445,1415
1728,2,1.0.13,0,588,3,81,13,94,0,13,94,94,0,0,13,1,2,297,311,297,324,3,1445,1415
1728,2,2.0.13,0,527,0,29,13,42,0,13,42,42,0,0,13,1,2,191,311,191,324,3,1445,1415
1728,2,3.0.13,0,552,2,49,13,62,0,13,62,62,0,0,13,1,2,128,311,128,324,3,1445,1415
1728,2,4.0.13,0,539,1,94,13,107,0,13,107,107,0,0,13,1,2,376,311,376,324,3,1445,1415
1728,2,5.0.13,0,527,0,58,13,71,0,13,71,71,0,0,13,1,2,274,311,274,324,3,1445,1415
1728,3,0.3.97,1,527,0,72,97,169,97,0,169,169,-97,97,140,4,1,82,378,179,378,4,1445,1348
1728,3,1.0.13,0,588,3,81,13,94,0,13,94,97,0,0,43,1,2,297,311,297,324,4,1445,1348
1728,3,2.0.13,0,527,0,29,13,42,0,13,42,97,0,0,43,1,2,191,311,191,324,4,1445,1348
1728,3,3.0.13,0,552,2,49,13,62,0,13,62,97,0,0,43,1,2,128,311,128,324,4,1445,1348
1728,3,4.0.13,0,539,1,94,13,107,0,13,107,107,0,0,43,1,2,376,311,376,324,4,1445,1348
1728,3,5.0.13,0,527,0,58,13,71,0,13,71,97,0,0,43,1,2,274,311,274,324,4,1445,1348
1728,4,0.4.169,1,527,0,10,169,179,169,0,179,179,-169,169,309,5,1,10,304,179,304,5,1445,1276
1728,4,1.0.13,0,588,3,81,13,94,0,13,94,169,0,0,140,1,2,297,311,297,324,5,1445,1276
1728,4,2.0.13,0,527,0,29,13,42,0,13,42,169,0,0,140,1,2,191,311,191,324,5,1445,1276
1728,4,3.0.13,0,552,2,49,13,62,0,13,62,169,0,0,140,1,2,128,311,128,324,5,1445,1276
1728,4,4.0.13,0,539,1,94,13,107,0,13,107,169,0,0,140,1,2,376,311,376,324,5,1445,1276
1728,4,5.0.13,0,527,0,58,13,71,0,13,71,169,0,0,140,1,2,274,311,274,324,5,1445,1276
1728,5,1.0.13,0,588,3,81,13,94,0,13,94,179,0,0,309,1,2,297,311,297,324,6,1445,1266
1728,5,2.0.13,0,527,0,29,13,42,0,13,42,179,0,0,309,1,2,191,311,191,324,6,1445,1266
1728,5,3.0.13,0,552,2,49,13,62,0,13,62,179,0,0,309,1,2,128,311,128,324,6,1445,1266
1728,5,4.0.13,1,539,1,94,13,107,0,13,107,179,0,0,309,1,2,376,311,376,324,6,1445,1266
1728,5,5.0.13,0,527,0,58,13,71,0,13,71,179,0,0,309,1,2,274,311,274,324,6,1445,1266
1728,6,1.0.107,0,585,3,81,107,188,0,107,188,188,0,0,309,1,3,297,217,297,324,7,1445,1172
1728,6,2.0.107,0,539,0,29,107,136,0,107,136,179,0,0,309,1,3,191,217,191,324,7,1445,1172
1728,6,3.0.107,0,561,1,49,107,156,0,107,156,179,0,0,309,1,3,128,217,128,324,7,1445,1172
1728,6,4.1.107,1,539,0,28,107,135,107,0,135,179,-77,90,386,2,2,282,189,376,206,7,1445,1172
1728,6,5.0.107,0,562,2,58,107,165,0,107,165,179,0,0,309,1,3,274,217,274,324,7,1445,1172
1728,7,1.0.107,0,585,3,81,107,188,0,107,188,188,0,0,386,1,3,297,217,297,324,8,1445,1144
1728,7,2.0.107,0,539,0,29,107,136,0,107,136,179,0,0,386,1,3,191,217,191,324,8,1445,1144
1728,7,3.0.107,0,561,1,49,107,156,0,107,156,179,0,0,386,1,3,128,217,128,324,8,1445,1144
1728,7,4.2.135,1,561,1,77,135,212,135,0,212,212,-38,68,424,3,2,254,166,376,233,8,1445,1144
1728,7,5.0.107,0,562,2,58,107,165,0,107,165,179,0,0,386,1,3,274,217,274,324,8,1445,1144
1728,8,1.0.107,0,585,2,81,107,188,0,107,188,212,0,0,424,1,3,297,217,297,324,9,1445,1067
1728,8,2.0.107,0,561,0,29,107,136,0,107,136,212,0,0,424,1,3,191,217,191,324,9,1445,1067
1728,8,3.0.107,0,561,0,49,107,156,0,107,156,212,0,0,424,1,3,128,217,128,324,9,1445,1067
1728,8,4.3.212,1,588,3,82,212,294,212,0,294,294,-43,140,467,4,2,177,306,376,378,9,1445,1067
1728,8,5.0.107,0,562,1,58,107,165,0,107,165,212,0,0,424,1,3,274,217,274,324,9,1445,1067
1728,9,1.0.107,0,588,0,81,107,188,0,107,188,294,0,0,467,1,3,297,217,297,324,10,1445,985
1728,9,2.0.107,0,588,0,29,107,136,0,107,136,294,0,0,467,1,3,191,217,191,324,10,1445,985
1728,9,3.0.107,0,588,0,49,107,156,0,107,156,294,0,0,467,1,3,128,217,128,324,10,1445,985
1728,9,4.4.294,1,588,0,95,294,389,294,0,389,389,-115,284,582,5,2,95,294,376,304,10,1445,985
1728,9,5.0.107,0,588,0,58,107,165,0,107,165,294,0,0,467,1,3,274,217,274,324,10,1445,985
1728,10,1.0.107,0,588,0,81,107,188,0,107,188,389,0,0,582,1,3,297,217,297,324,11,1445,890
1728,10,2.0.107,0,588,0,29,107,136,0,107,136,389,0,0,582,1,3,191,217,191,324,11,1445,890
1728,10,3.0.107,0,588,0,49,107,156,0,107,156,389,0,0,582,1,3,128,217,128,324,11,1445,890
1728,10,5.0.107,1,588,0,58,107,165,0,107,165,389,0,0,582,1,3,274,217,274,324,11,1445,890
1728,11,1.0.165,0,588,0,81,165,246,0,165,246,389,0,0,582,1,4,297,159,297,324,12,1445,832
1728,11,2.0.165,0,588,0,29,165,194,0,165,194,389,0,0,582,1,4,191,159,191,324,12,1445,832
1728,11,3.0.165,0,588,0,49,165,214,0,165,214,389,0,0,582,1,4,128,159,128,324,12,1445,832
1728,11,5.1.165,1,588,0,52,165,217,165,0,217,389,-30,120,612,2,3,216,161,274,206,12,1445,832
1728,12,1.0.165,0,588,0,81,165,246,0,165,246,389,0,0,612,1,4,297,159,297,324,13,1445,780
1728,12,2.0.165,0,588,0,29,165,194,0,165,194,389,0,0,612,1,4,191,159,191,324,13,1445,780
1728,12,3.0.165,0,588,0,49,165,214,0,165,214,389,0,0,612,1,4,128,159,128,324,13,1445,780
1728,12,5.2.217,1,588,0,16,217,233,217,0,233,389,-5,73,617,3,3,164,89,274,233,13,1445,780
1728,13,1.0.165,0,588,0,81,165,246,0,165,246,389,0,0,617,1,4,297,159,297,324,14,1445,764
1728,13,2.0.165,1,588,0,29,165,194,0,165,194,389,0,0,617,1,4,191,159,191,324,14,1445,764
1728,13,3.0.165,0,588,0,49,165,214,0,165,214,389,0,0,617,1,4,128,159,128,324,14,1445,764
1728,13,5.3.294,0,588,0,88,294,382,233,61,382,389,0,140,617,4,3,148,224,274,378,14,1445,764
1728,14,1.0.194,0,588,0,81,194,275,0,194,275,389,0,0,617,1,5,297,130,297,324,15,1445,735
1728,14,2.1.217,1,588,0,19,217,236,194,23,236,389,0,120,617,2,4,162,109,191,206,15,1445,735
1728,14,3.0.194,0,588,0,49,194,243,0,194,243,389,0,0,617,1,5,128,130,128,324,15,1445,735
1728,14,5.3.294,0,588,0,88,294,382,233,61,382,389,0,140,617,4,3,148,224,274,378,15,1445,735
1728,15,1.0.194,0,588,0,81,194,275,0,194,275,389,0,0,617,1,5,297,130,297,324,16,1445,716
1728,15,2.2.236,1,588,0,16,236,252,236,0,252,389,-3,76,620,3,4,143,73,191,233,16,1445,716
1728,15,3.0.194,0,588,0,49,194,243,0,194,243,389,0,0,617,1,5,128,130,128,324,16,1445,716
1728,15,5.3.294,0,588,0,88,294,382,233,61,382,389,0,140,617,4,3,148,224,274,378,16,1445,716
1728,16,1.0.194,1,588,0,81,194,275,0,194,275,389,0,0,620,1,5,297,130,297,324,17,1445,700
1728,16,2.3.294,0,588,0,39,294,333,252,42,333,389,0,140,620,4,3,127,224,191,378,17,1445,700
1728,16,3.0.194,0,588,0,49,194,243,0,194,243,389,0,0,620,1,5,128,130,128,324,17,1445,700
1728,16,5.3.294,0,588,0,88,294,382,233,61,382,389,0,140,620,4,3,148,224,274,378,17,1445,700
1728,17,1.1.275,0,588,0,86,275,361,275,0,361,389,-39,159,659,2,5,216,90,297,206,18,1445,619
1728,17,2.3.294,0,588,0,39,294,333,252,42,333,389,0,140,620,4,3,127,224,191,378,18,1445,619
1728,17,3.0.275,1,588,0,49,275,324,0,275,324,389,0,0,620,1,6,128,49,128,324,18,1445,619
1728,17,5.3.294,0,588,0,88,294,382,233,61,382,389,0,140,620,4,3,148,224,274,378,18,1445,619
1728,18,1.1.275,0,588,0,86,275,361,275,0,361,389,-39,159,659,2,5,216,90,297,206,19,1445,570
1728,18,2.3.294,1,588,0,39,294,333,252,42,333,389,0,140,620,4,3,127,224,191,378,19,1445,570
1728,18,3.1.324,0,588,0,4,324,328,324,0,328,389,-88,208,708,2,5,79,90,128,206,19,1445,570
1728,18,5.3.294,0,588,0,88,294,382,233,61,382,389,0,140,620,4,3,148,224,274,378,19,1445,570
1728,19,1.1.275,0,588,0,86,275,361,275,0,361,389,-39,159,659,2,5,216,90,297,206,20,1445,531
1728,19,2.4.389,0,588,0,88,389,477,333,56,477,477,0,284,620,5,3,88,199,191,304,20,1445,531
1728,19,3.1.324,0,588,0,4,324,328,324,0,328,389,-88,208,708,2,5,79,90,128,206,20,1445,531
1728,19,5.3.333,1,588,0,88,333,421,233,100,421,421,0,140,620,4,4,148,185,274,378,20,1445,531
1728,20,1.1.275,1,588,0,86,275,361,275,0,361,421,-39,159,659,2,5,216,90,297,206,21,1445,443
1728,20,2.4.389,0,588,0,88,389,477,333,56,477,477,0,284,620,5,3,88,199,191,304,21,1445,443
1728,20,3.1.324,0,588,0,4,324,328,324,0,328,421,-88,208,708,2,5,79,90,128,206,21,1445,443
1728,20,5.4.421,0,620,1,60,421,481,421,0,481,481,-32,316,652,5,3,60,199,274,304,21,1445,443
1728,21,1.2.361,1,588,0,35,361,396,361,0,396,421,-109,185,768,3,5,130,57,297,233,22,1445,357
1728,21,2.4.389,0,588,0,88,389,477,333,56,477,477,0,284,659,5,3,88,199,191,304,22,1445,357
1728,21,3.1.361,0,588,0,4,361,365,324,37,365,421,0,159,659,2,6,79,4,128,206,22,1445,357
1728,21,5.4.421,0,620,1,60,421,481,421,0,481,481,-32,316,691,5,3,60,199,274,304,22,1445,357
1728,22,1.3.421,0,588,0,68,421,489,396,25,489,489,0,140,768,4,5,95,97,297,378,23,1445,322
1728,22,2.4.389,0,588,0,88,389,477,333,56,477,477,0,284,768,5,3,88,199,191,304,23,1445,322
1728,22,3.1.361,1,588,0,4,361,365,324,37,365,421,0,159,768,2,6,79,4,128,206,23,1445,322
1728,22,5.4.421,0,620,1,60,421,481,421,0,481,481,-32,316,800,5,3,60,199,274,304,23,1445,322
1728,23,1.3.421,0,588,0,68,421,489,396,25,489,489,0,140,768,4,5,95,97,297,378,24,1445,318
1728,23,2.4.389,0,588,0,88,389,477,333,56,477,477,0,284,768,5,3,88,199,191,304,24,1445,318
1728,23,3.2.396,1,588,0,22,396,418,365,31,418,421,0,185,768,3,6,75,22,128,233,24,1445,318
1728,23,5.4.421,0,620,1,60,421,481,421,0,481,481,-32,316,800,5,3,60,199,274,304,24,1445,318
1728,24,1.3.421,1,588,0,68,421,489,396,25,489,489,0,140,768,4,5,95,97,297,378,25,1445,296
1728,24,2.4.389,0,588,0,88,389,477,333,56,477,477,0,284,768,5,3,88,199,191,304,25,1445,296
1728,24,3.3.421,0,588,0,29,421,450,418,3,450,450,0,140,768,4,5,53,97,128,378,25,1445,296
1728,24,5.4.421,0,620,1,60,421,481,421,0,481,481,-32,316,800,5,3,60,199,274,304,25,1445,296
1728,25,1.4.489,0,600,1,27,489,516,489,0,516,516,-100,384,868,5,3,27,199,297,304,26,1445,228
1728,25,2.4.389,0,588,0,88,389,477,333,56,477,489,0,284,768,5,3,88,199,191,304,26,1445,228
1728,25,3.3.489,1,588,0,29,489,518,418,71,518,518,0,140,768,4,6,53,29,128,378,26,1445,228
1728,25,5.4.421,0,620,2,60,421,481,421,0,481,489,-32,316,800,5,3,60,199,274,304,26,1445,228
1728,26,1.4.489,0,600,1,27,489,516,489,0,516,518,-100,384,868,5,3,27,199,297,304,27,1445,199
1728,26,2.4.389,1,588,0,88,389,477,333,56,477,518,0,284,768,5,3,88,199,191,304,27,1445,199
1728,26,3.4.518,0,602,2,24,518,542,518,0,542,542,-129,413,897,5,3,24,199,128,304,27,1445,199
1728,26,5.4.421,0,620,3,60,421,481,421,0,481,518,-32,316,800,5,3,60,199,274,304,27,1445,199
1728,27,1.4.489,1,600,1,27,489,516,489,0,516,518,-12,296,780,5,4,27,111,297,304,28,1445,111
1728,27,3.4.518,0,602,2,24,518,542,518,0,542,542,-41,325,809,5,4,24,111,128,304,28,1445,111
1728,27,5.4.477,0,588,0,60,477,537,421,56,537,537,0,284,768,5,4,60,111,274,304,28,1445,111
1728,28,3.4.518,0,602,1,24,518,542,518,0,542,542,-2,298,782,5,5,24,84,128,304,29,1445,84
1728,28,5.4.516,1,600,0,60,516,576,421,95,576,576,0,296,780,5,5,60,84,274,304,29,1445,84
1728,29,3.4.576,1,600,0,24,576,600,518,58,600,600,0,296,780,5,6,24,24,128,304,30,1445,24
1729,0,0.0.0,0,599,2,26,0,26,0,0,26,26,0,0,0,1,1,322,239,322,239,1,1611,1611
1729,0,1.0.0,0,630,4,57,0,57,0,0,57,57,0,0,0,1,1,198,239,198,239,1,1611,1611
1729,0,2.0.0,0,630,4,74,0,74,0,0,74,74,0,0,0,1,1,215,239,215,239,1,1611,1611
1729,0,3.0.0,1,573,0,2,0,2,0,0,2,2,0,0,0,1,1,286,239,286,239,1,1611,1611
1729,0,4.0.0,0,590,1,17,0,17,0,0,17,17,0,0,0,1,1,314,239,314,239,1,1611,1611
1729,0,5.0.0,0,625,3,63,0,63,0,0,63,63,0,0,0,1,1,276,239,276,239,1,1611,1611
1729,1,0.0.2,0,573,0,26,2,28,0,2,28,28,0,0,0,1,2,322,237,322,239,2,1611,1609
1729,1,1.0.2,0,585,3,57,2,59,0,2,59,59,0,0,0,1,2,198,237,198,239,2,1611,1609
1729,1,2.0.2,0,578,1,74,2,76,0,2,76,76,0,0,0,1,2,215,237,215,239,2,1611,1609
1729,1,3.1.2,0,573,0,42,2,44,2,0,44,44,-2,2,2,2,1,284,306,286,306,2,1611,1609
1729,1,4.0.2,1,573,0,17,2,19,0,2,19,19,0,0,0,1,2,314,237,314,239,2,1611,1609
1729,1,5.0.2,0,582,2,63,2,65,0,2,65,65,0,0,0,1,2,276,237,276,239,2,1611,1609
1729,2,0.0.19,1,573,0,26,19,45,0,19,45,45,0,0,0,1,3,322,220,322,239,3,1611,1592
1729,2,1.0.19,0,573,0,57,19,76,0,19,76,76,0,0,0,1,3,198,220,198,239,3,1611,1592
1729,2,2.0.19,0,577,1,74,19,93,0,19,93,93,0,0,0,1,3,215,220,215,239,3,1611,1592
1729,2,3.1.2,0,573,0,42,2,44,2,0,44,44,-2,2,2,2,1,284,306,286,306,3,1611,1592
1729,2,4.1.19,0,623,2,79,19,98,19,0,98,98,-19,19,19,2,1,297,306,314,306,3,1611,1592
1729,2,5.0.19,0,573,0,63,19,82,0,19,82,82,0,0,0,1,3,276,220,276,239,3,1611,1592
1729,3,0.1.45,0,576,1,84,45,129,45,0,129,129,-45,45,45,2,1,296,306,322,306,4,1611,1566
1729,3,1.0.45,0,573,0,57,45,102,0,45,102,102,0,0,0,1,4,198,194,198,239,4,1611,1566
1729,3,2.0.45,0,577,2,74,45,119,0,45,119,119,0,0,0,1,4,215,194,215,239,4,1611,1566
1729,3,3.1.2,0,573,0,42,2,44,2,0,44,45,-2,2,2,2,1,284,306,286,306,4,1611,1566
1729,3,4.1.19,0,623,3,79,19,98,19,0,98,98,-19,19,19,2,1,297,306,314,306,4,1611,1566
1729,3,5.0.45,1,573,0,63,45,108,0,45,108,108,0,0,0,1,4,276,194,276,239,4,1611,1566
1729,4,0.1.45,0,576,1,84,45,129,45,0,129,129,-45,45,45,2,1,296,306,322,306,5,1611,1503
1729,4,1.0.108,1,573,0,57,108,165,0,108,165,165,0,0,0,1,5,198,131,198,239,5,1611,1503
1729,4,2.0.108,0,577,2,74,108,182,0,108,182,182,0,0,0,1,5,215,131,215,239,5,1611,1503
1729,4,3.1.2,0,573,0,42,2,44,2,0,44,108,-2,2,2,2,1,284,306,286,306,5,1611,1503
1729,4,4.1.19,0,623,4,79,19,98,19,0,98,108,-19,19,19,2,1,297,306,314,306,5,1611,1503
1729,4,5.1.108,0,605,3,35,108,143,108,0,143,143,-108,108,108,2,1,213,306,276,306,5,1611,1503
1729,5,0.1.45,0,576,1,84,45,129,45,0,129,165,-45,45,45,2,1,296,306,322,306,6,1611,1446
1729,5,1.1.165,0,573,0,54,165,219,165,0,219,219,-165,165,165,2,1,141,306,198,306,6,1611,1446
1729,5,2.0.165,1,573,0,74,165,239,0,165,239,239,0,0,0,1,6,215,74,215,239,6,1611,1446
1729,5,3.1.2,0,573,0,42,2,44,2,0,44,165,-2,2,2,2,1,284,306,286,306,6,1611,1446
1729,5,4.1.19,0,623,3,79,19,98,19,0,98,165,-19,19,19,2,1,297,306,314,306,6,1611,1446
1729,5,5.1.108,0,607,2,35,108,143,108,0,143,165,-108,108,108,2,1,213,306,276,306,6,1611,1446
1729,6,0.1.45,0,576,1,84,45,129,45,0,129,239,-45,45,45,2,1,296,306,322,306,7,1611,1372
1729,6,1.1.165,0,573,0,54,165,219,165,0,219,239,-165,165,165,2,1,141,306,198,306,7,1611,1372
1729,6,2.1.239,0,577,2,12,239,251,239,0,251,251,-239,239,239,2,1,141,306,215,306,7,1611,1372
1729,6,3.1.2,1,573,0,42,2,44,2,0,44,239,-2,2,2,2,1,284,306,286,306,7,1611,1372
1729,6,4.1.19,0,623,4,79,19,98,19,0,98,239,-19,19,19,2,1,297,306,314,306,7,1611,1372
1729,6,5.1.108,0,607,3,35,108,143,108,0,143,239,-108,108,108,2,1,213,306,276,306,7,1611,1372
1729,7,0.1.45,0,576,1,84,45,129,45,0,129,239,-1,3,3,2,2,296,264,322,306,8,1611,1330
1729,7,1.1.165,0,573,0,54,165,219,165,0,219,239,-121,123,123,2,2,141,264,198,306,8,1611,1330
1729,7,2.1.239,0,577,2,12,239,251,239,0,251,251,-195,197,197,2,2,141,264,215,306,8,1611,1330
1729,7,3.2.44,0,573,0,89,44,133,44,0,133,239,-44,44,46,3,1,242,401,286,401,8,1611,1330
1729,7,4.1.44,1,573,0,79,44,123,19,25,123,239,0,2,2,2,2,297,264,314,306,8,1611,1330
1729,7,5.1.108,0,607,3,35,108,143,108,0,143,239,-64,66,66,2,2,213,264,276,306,8,1611,1330
1729,8,0.1.123,1,577,1,84,123,207,45,78,207,239,0,2,2,2,3,296,185,322,306,9,1611,1251
1729,8,1.1.165,0,573,0,54,165,219,165,0,219,239,-42,44,44,2,3,141,185,198,306,9,1611,1251
1729,8,2.1.239,0,577,1,12,239,251,239,0,251,251,-116,118,118,2,3,141,185,215,306,9,1611,1251
1729,8,3.2.44,0,573,0,89,44,133,44,0,133,239,-44,44,46,3,1,242,401,286,401,9,1611,1251
1729,8,4.2.123,0,648,2,78,123,201,123,0,201,239,-123,123,125,3,1,218,401,314,401,9,1611,1251
1729,8,5.1.123,0,573,0,35,123,158,108,15,158,239,0,2,2,2,3,213,185,276,306,9,1611,1251
1729,9,0.2.207,0,637,1,71,207,278,207,0,278,278,-207,207,209,3,1,212,401,322,401,10,1611,1167
1729,9,1.1.207,0,577,0,54,207,261,165,42,261,261,0,2,2,2,4,141,101,198,306,10,1611,1167
1729,9,2.1.239,0,577,0,12,239,251,239,0,251,251,-32,34,34,2,4,141,101,215,306,10,1611,1167
1729,9,3.2.44,0,577,0,89,44,133,44,0,133,239,-44,44,46,3,1,242,401,286,401,10,1611,1167
1729,9,4.2.123,0,648,2,78,123,201,123,0,201,239,-123,123,125,3,1,218,401,314,401,10,1611,1167
1729,9,5.1.207,1,577,0,35,207,242,108,99,242,242,0,2,2,2,4,213,101,276,306,10,1611,1167
1729,10,0.2.207,0,637,2,71,207,278,207,0,278,278,-207,207,209,3,1,212,401,322,401,11,1611,1132
1729,10,1.1.242,0,577,0,54,242,296,165,77,296,296,0,2,2,2,5,141,66,198,306,11,1611,1132
1729,10,2.1.242,1,577,0,12,242,254,239,3,254,254,0,2,2,2,5,141,66,215,306,11,1611,1132
1729,10,3.2.44,0,577,0,89,44,133,44,0,133,242,-44,44,46,3,1,242,401,286,401,11,1611,1132
1729,10,4.2.123,0,654,3,78,123,201,123,0,201,242,-123,123,125,3,1,218,401,314,401,11,1611,1132
1729,10,5.2.242,0,599,1,54,242,296,242,0,296,296,-242,242,244,3,1,178,401,276,401,11,1611,1132
1729,11,0.2.207,0,637,3,71,207,278,207,0,278,278,-207,207,209,3,1,212,401,322,401,12,1611,1120
1729,11,1.1.254,1,577,0,54,254,308,165,89,308,308,0,2,2,2,6,141,54,198,306,12,1611,1120
1729,11,2.2.254,0,621,2,68,254,322,254,0,322,322,-254,254,256,3,1,129,401,215,401,12,1611,1120
1729,11,3.2.44,0,577,0,89,44,133,44,0,133,254,-44,44,46,3,1,242,401,286,401,12,1611,1120
1729,11,4.2.123,0,655,4,78,123,201,123,0,201,254,-123,123,125,3,1,218,401,314,401,12,1611,1120
1729,11,5.2.242,0,599,1,54,242,296,242,0,296,296,-242,242,244,3,1,178,401,276,401,12,1611,1120
1729,12,0.2.207,0,637,4,71,207,278,207,0,278,308,-207,207,209,3,1,212,401,322,401,13,1611,1066
1729,12,1.2.308,0,580,1,41,308,349,308,0,349,349,-308,308,310,3,1,87,401,198,401,13,1611,1066
1729,12,2.2.254,0,621,3,68,254,322,254,0,322,322,-254,254,256,3,1,129,401,215,401,13,1611,1066
1729,12,3.2.44,1,577,0,89,44,133,44,0,133,308,-44,44,46,3,1,242,401,286,401,13,1611,1066
1729,12,4.2.123,0,655,5,78,123,201,123,0,201,308,-123,123,125,3,1,218,401,314,401,13,1611,1066
1729,12,5.2.242,0,599,2,54,242,296,242,0,296,308,-242,242,244,3,1,178,401,276,401,13,1611,1066
1729,13,0.2.207,0,637,4,71,207,278,207,0,278,308,-74,118,120,3,2,212,312,322,401,14,1611,977
1729,13,1.2.308,0,580,1,41,308,349,308,0,349,349,-175,219,221,3,2,87,312,198,401,14,1611,977
1729,13,2.2.254,0,621,3,68,254,322,254,0,322,322,-121,165,167,3,2,129,312,215,401,14,1611,977
1729,13,3.3.133,1,577,0,88,133,221,133,0,221,308,-133,133,179,4,1,153,333,286,333,14,1611,977
1729,13,4.2.133,0,577,0,78,133,211,123,10,211,308,0,44,46,3,2,218,312,314,401,14,1611,977
1729,13,5.2.242,0,599,2,54,242,296,242,0,296,308,-109,153,155,3,2,178,312,276,401,14,1611,977
1729,14,0.2.207,0,637,4,71,207,278,207,0,278,308,-74,118,253,3,2,212,312,322,401,15,1611,889
1729,14,1.2.308,0,580,1,41,308,349,308,0,349,349,-175,219,354,3,2,87,312,198,401,15,1611,889
1729,14,2.2.254,0,621,3,68,254,322,254,0,322,322,-121,165,300,3,2,129,312,215,401,15,1611,889
1729,14,3.4.221,1,577,0,65,221,286,221,0,286,308,-221,221,400,5,1,65,332,286,332,15,1611,889
1729,14,4.2.133,0,577,0,78,133,211,123,10,211,308,0,44,179,3,2,218,312,314,401,15,1611,889
1729,14,5.2.242,0,599,2,54,242,296,242,0,296,308,-109,153,288,3,2,178,312,276,401,15,1611,889
1729,15,0.2.207,0,637,4,71,207,278,207,0,278,308,-74,118,474,3,2,212,312,322,401,16,1611,824
1729,15,1.2.308,0,580,1,41,308,349,308,0,349,349,-175,219,575,3,2,87,312,198,401,16,1611,824
1729,15,2.2.254,0,621,3,68,254,322,254,0,322,322,-121,165,521,3,2,129,312,215,401,16,1611,824
1729,15,4.2.133,1,577,0,78,133,211,123,10,211,308,0,44,400,3,2,218,312,314,401,16,1611,824
1729,15,5.2.242,0,599,2,54,242,296,242,0,296,308,-109,153,509,3,2,178,312,276,401,16,1611,824
1729,16,0.2.211,0,577,0,71,211,282,207,4,282,308,0,44,400,3,3,212,234,322,401,17,1611,746
1729,16,1.2.308,0,580,1,41,308,349,308,0,349,349,-97,141,497,3,3,87,234,198,401,17,1611,746
1729,16,2.2.254,0,621,3,68,254,322,254,0,322,322,-43,87,443,3,3,129,234,215,401,17,1611,746
1729,16,4.3.221,1,577,0,75,221,296,211,10,296,308,0,133,400,4,2,140,245,314,333,17,1611,746
1729,16,5.2.242,0,599,2,54,242,296,242,0,296,308,-31,75,431,3,3,178,234,276,401,17,1611,746
1729,17,0.2.211,0,577,0,71,211,282,207,4,282,308,0,44,400,3,3,212,234,322,401,18,1611,671
1729,17,1.2.308,0,580,1,41,308,349,308,0,349,349,-97,141,497,3,3,87,234,198,401,18,1611,671
1729,17,2.2.254,0,621,3,68,254,322,254,0,322,322,-43,87,443,3,3,129,234,215,401,18,1611,671
1729,17,4.4.296,1,577,0,65,296,361,296,0,361,361,-10,231,410,5,2,65,267,314,332,18,1611,671
1729,17,5.2.242,0,599,2,54,242,296,242,0,296,308,-31,75,431,3,3,178,234,276,401,18,1611,671
1729,18,0.2.211,1,577,0,71,211,282,207,4,282,361,0,44,410,3,3,212,234,322,401,19,1611,606
1729,18,1.2.308,0,580,1,41,308,349,308,0,349,361,-97,141,507,3,3,87,234,198,401,19,1611,606
1729,18,2.2.254,0,621,3,68,254,322,254,0,322,361,-43,87,453,3,3,129,234,215,401,19,1611,606
1729,18,5.2.242,0,599,2,54,242,296,242,0,296,361,-31,75,441,3,3,178,234,276,401,19,1611,606
1729,19,0.3.296,1,577,0,79,296,375,282,14,375,375,0,133,410,4,3,141,170,322,333,20,1611,535
1729,19,1.2.308,0,580,1,41,308,349,308,0,349,361,-26,70,436,3,4,87,163,198,401,20,1611,535
1729,19,2.2.282,0,577,0,68,282,350,254,28,350,361,0,44,410,3,4,129,163,215,401,20,1611,535
1729,19,5.2.282,0,577,0,54,282,336,242,40,336,361,0,44,410,3,4,178,163,276,401,20,1611,535
1729,20,0.4.375,1,577,0,62,375,437,375,0,437,437,-14,245,424,5,3,62,202,322,332,21,1611,456
1729,20,1.2.308,0,580,1,41,308,349,308,0,349,375,-26,70,436,3,4,87,163,198,401,21,1611,456
1729,20,2.2.282,0,577,0,68,282,350,254,28,350,375,0,44,410,3,4,129,163,215,401,21,1611,456
1729,20,5.2.282,0,577,0,54,282,336,242,40,336,375,0,44,410,3,4,178,163,276,401,21,1611,456
1729,21,1.2.308,0,580,1,41,308,349,308,0,349,437,-26,70,450,3,4,87,163,198,401,22,1611,394
1729,21,2.2.282,0,577,0,68,282,350,254,28,350,437,0,44,424,3,4,129,163,215,401,22,1611,394
1729,21,5.2.282,1,577,0,54,282,336,242,40,336,437,0,44,424,3,4,178,163,276,401,22,1611,394
1729,22,1.2.336,0,577,0,41,336,377,308,28,377,437,0,44,424,3,5,87,109,198,401,23,1611,340
1729,22,2.2.336,0,577,0,68,336,404,254,82,404,437,0,44,424,3,5,129,109,215,401,23,1611,340
1729,22,5.3.375,1,588,1,73,375,448,336,39,448,448,0,133,424,4,4,124,91,276,333,23,1611,340
1729,23,1.2.336,0,588,0,41,336,377,308,28,377,448,0,44,424,3,5,87,109,198,401,24,1611,267
1729,23,2.2.336,0,588,0,68,336,404,254,82,404,448,0,44,424,3,5,129,109,215,401,24,1611,267
1729,23,5.4.448,1,588,0,51,448,499,448,0,499,499,-11,256,435,5,4,51,140,276,332,24,1611,267
1729,24,1.2.336,0,588,0,41,336,377,308,28,377,499,0,44,435,3,5,87,109,198,401,25,1611,216
1729,24,2.2.336,1,588,0,68,336,404,254,82,404,499,0,44,435,3,5,129,109,215,401,25,1611,216
1729,25,1.2.404,0,588,0,41,404,445,308,96,445,499,0,44,435,3,6,87,41,198,401,26,1611,148
1729,25,2.3.448,1,588,0,8,448,456,404,44,456,499,0,133,435,4,5,61,18,215,333,26,1611,148
1729,26,1.2.404,1,588,0,41,404,445,308,96,445,499,0,44,435,3,6,87,41,198,401,27,1611,140
1729,26,2.4.499,0,588,0,53,499,552,456,43,552,552,0,256,435,5,5,53,89,215,332,27,1611,140
1729,27,1.3.456,1,588,0,10,456,466,445,11,466,499,0,133,435,4,6,46,10,198,333,28,1611,99
1729,27,2.4.499,0,588,0,53,499,552,456,43,552,552,0,256,435,5,5,53,89,215,332,28,1611,99
1729,28,1.4.499,1,588,0,36,499,535,466,33,535,535,0,256,435,5,5,36,89,198,332,29,1611,89
1729,28,2.4.499,0,588,0,53,499,552,456,43,552,552,0,256,435,5,5,53,89,215,332,29,1611,89
1729,29,2.4.535,1,588,0,53,535,588,456,79,588,588,0,256,435,5,6,53,53,215,332,30,1611,53
1730,0,0.0.0,1,519,3,39,0,39,0,0,39,39,0,0,0,1,1,266,255,266,255,1,1382,1382
1730,0,1.0.0,0,484,1,33,0,33,0,0,33,33,0,0,0,1,1,197,255,197,255,1,1382,1382
1730,0,2.0.0,0,480,0,21,0,21,0,0,21,21,0,0,0,1,1,144,255,144,255,1,1382,1382
1730,0,3.0.0,0,535,4,55,0,55,0,0,55,55,0,0,0,1,1,245,255,245,255,1,1382,1382
1730,0,4.0.0,0,499,2,39,0,39,0,0,39,39,0,0,0,1,1,252,255,252,255,1,1382,1382
1730,0,5.0.0,0,536,5,68,0,68,0,0,68,68,0,0,0,1,1,278,255,278,255,1,1382,1382
1730,1,0.1.39,1,521,1,52,39,91,39,0,91,91,-39,39,39,2,1,227,209,266,209,2,1382,1343
1730,1,1.0.39,0,523,2,33,39,72,0,39,72,72,0,0,0,1,2,197,216,197,255,2,1382,1343
1730,1,2.0.39,0,519,0,21,39,60,0,39,60,60,0,0,0,1,2,144,216,144,255,2,1382,1343
1730,1,3.0.39,0,545,4,55,39,94,0,39,94,94,0,0,0,1,2,245,216,245,255,2,1382,1343
1730,1,4.0.39,0,529,3,39,39,78,0,39,78,78,0,0,0,1,2,252,216,252,255,2,1382,1343
1730,1,5.0.39,0,557,5,68,39,107,0,39,107,107,0,0,0,1,2,278,216,278,255,2,1382,1343
1730,2,0.2.91,0,557,4,74,91,165,91,0,165,165,-91,91,130,3,1,175,368,266,368,3,1382,1291
1730,2,1.0.39,0,523,1,33,39,72,0,39,72,91,0,0,39,1,2,197,216,197,255,3,1382,1291
1730,2,2.0.39,0,521,0,21,39,60,0,39,60,91,0,0,39,1,2,144,216,144,255,3,1382,1291
1730,2,3.0.39,0,545,3,55,39,94,0,39,94,94,0,0,39,1,2,245,216,245,255,3,1382,1291
1730,2,4.0.39,1,529,2,39,39,78,0,39,78,91,0,0,39,1,2,252,216,252,255,3,1382,1291
1730,2,5.0.39,0,557,4,68,39,107,0,39,107,107,0,0,39,1,2,278,216,278,255,3,1382,1291
1730,3,0.2.91,0,557,2,74,91,165,91,0,165,165,-91,91,130,3,1,175,368,266,368,4,1382,1252
1730,3,1.0.78,0,557,2,33,78,111,0,78,111,111,0,0,39,1,3,197,177,197,255,4,1382,1252
1730,3,2.0.78,0,529,0,21,78,99,0,78,99,99,0,0,39,1,3,144,177,144,255,4,1382,1252
1730,3,3.0.78,0,557,2,55,78,133,0,78,133,133,0,0,39,1,3,245,177,245,255,4,1382,1252
1730,3,4.1.91,1,552,1,31,91,122,78,13,122,122,0,39,39,2,2,213,157,252,209,4,1382,1252
1730,3,5.0.78,0,557,2,68,78,146,0,78,146,146,0,0,39,1,3,278,177,278,255,4,1382,1252
1730,4,0.2.91,0,557,1,74,91,165,91,0,165,165,-91,91,130,3,1,175,368,266,368,5,1382,1221
1730,4,1.0.78,1,557,1,33,78,111,0,78,111,122,0,0,39,1,3,197,177,197,255,5,1382,1221
1730,4,2.0.78,0,552,0,21,78,99,0,78,99,122,0,0,39,1,3,144,177,144,255,5,1382,1221
1730,4,3.0.78,0,557,1,55,78,133,0,78,133,133,0,0,39,1,3,245,177,245,255,5,1382,1221
1730,4,4.2.122,0,592,2,78,122,200,122,0,200,200,-122,122,161,3,1,182,368,252,368,5,1382,1221
1730,4,5.0.78,0,557,1,68,78,146,0,78,146,146,0,0,39,1,3,278,177,278,255,5,1382,1221
1730,5,0.2.91,0,557,0,74,91,165,91,0,165,165,-91,91,130,3,1,175,368,266,368,6,1382,1188
1730,5,1.1.122,1,557,0,22,122,144,111,11,144,144,0,39,39,2,3,164,126,197,209,6,1382,1188
1730,5,2.0.111,0,557,0,21,111,132,0,111,132,132,0,0,39,1,4,144,144,144,255,6,1382,1188
1730,5,3.0.111,0,557,0,55,111,166,0,111,166,166,0,0,39,1,4,245,144,245,255,6,1382,1188
1730,5,4.2.122,0,592,1,78,122,200,122,0,200,200,-122,122,161,3,1,182,368,252,368,6,1382,1188
1730,5,5.0.111,0,557,0,68,111,179,0,111,179,179,0,0,39,1,4,278,144,278,255,6,1382,1188
1730,6,0.2.91,0,557,0,74,91,165,91,0,165,165,-91,91,130,3,1,175,368,266,368,7,1382,1166
1730,6,1.2.144,0,582,1,46,144,190,144,0,190,190,-144,144,183,3,1,142,368,197,368,7,1382,1166
1730,6,2.0.111,0,557,0,21,111,132,0,111,132,144,0,0,39,1,4,144,144,144,255,7,1382,1166
1730,6,3.0.111,1,557,0,55,111,166,0,111,166,166,0,0,39,1,4,245,144,245,255,7,1382,1166
1730,6,4.2.122,0,592,2,78,122,200,122,0,200,200,-122,122,161,3,1,182,368,252,368,7,1382,1166
1730,6,5.0.111,0,557,0,68,111,179,0,111,179,179,0,0,39,1,4,278,144,278,255,7,1382,1166
1730,7,0.2.91,0,557,0,74,91,165,91,0,165,166,-91,91,130,3,1,175,368,266,368,8,1382,1111
1730,7,1.2.144,0,582,1,46,144,190,144,0,190,190,-144,144,183,3,1,142,368,197,368,8,1382,1111
1730,7,2.0.166,1,557,0,21,166,187,0,166,187,187,0,0,39,1,5,144,89,144,255,8,1382,1111
1730,7,3.1.166,0,557,0,80,166,246,166,0,246,246,-22,61,61,2,4,190,104,245,209,8,1382,1111
1730,7,4.2.122,0,592,2,78,122,200,122,0,200,200,-122,122,161,3,1,182,368,252,368,8,1382,1111
1730,7,5.0.166,0,557,0,68,166,234,0,166,234,234,0,0,39,1,5,278,89,278,255,8,1382,1111
1730,8,0.2.91,0,557,0,74,91,165,91,0,165,187,-91,91,130,3,1,175,368,266,368,9,1382,1090
1730,8,1.2.144,0,582,1,46,144,190,144,0,190,190,-144,144,183,3,1,142,368,197,368,9,1382,1090
1730,8,2.1.187,0,557,0,6,187,193,187,0,193,193,-43,82,82,2,4,123,104,144,209,9,1382,1090
1730,8,3.1.166,0,557,0,80,166,246,166,0,246,246,-22,61,61,2,4,190,104,245,209,9,1382,1090
1730,8,4.2.122,0,592,2,78,122,200,122,0,200,200,-122,122,161,3,1,182,368,252,368,9,1382,1090
1730,8,5.0.187,1,557,0,68,187,255,0,187,255,255,0,0,39,1,6,278,68,278,255,9,1382,1090
1730,9,0.2.91,0,557,0,74,91,165,91,0,165,255,-91,91,130,3,1,175,368,266,368,10,1382,1022
1730,9,1.2.144,0,582,1,46,144,190,144,0,190,255,-144,144,183,3,1,142,368,197,368,10,1382,1022
1730,9,2.1.187,1,557,0,6,187,193,187,0,193,255,-43,82,82,2,4,123,104,144,209,10,1382,1022
1730,9,3.1.166,0,557,0,80,166,246,166,0,246,255,-22,61,61,2,4,190,104,245,209,10,1382,1022
1730,9,4.2.122,0,592,2,78,122,200,122,0,200,255,-122,122,161,3,1,182,368,252,368,10,1382,1022
1730,9,5.1.255,0,557,0,18,255,273,255,0,273,273,-111,150,150,2,4,210,104,278,209,10,1382,1022
1730,10,0.2.91,0,557,0,74,91,165,91,0,165,255,-91,91,173,3,1,175,368,266,368,11,1382,1016
1730,10,1.2.144,0,582,1,46,144,190,144,0,190,255,-144,144,226,3,1,142,368,197,368,11,1382,1016
1730,10,2.2.193,0,557,0,22,193,215,193,0,215,255,-193,193,275,3,1,117,368,144,368,11,1382,1016
1730,10,3.1.193,0,557,0,80,193,273,166,27,273,273,0,82,82,2,5,190,98,245,209,11,1382,1016
1730,10,4.2.122,0,592,2,78,122,200,122,0,200,255,-122,122,204,3,1,182,368,252,368,11,1382,1016
1730,10,5.1.255,1,557,0,18,255,273,255,0,273,273,-62,144,144,2,5,210,98,278,209,11,1382,1016
1730,11,0.2.91,0,557,0,74,91,165,91,0,165,273,-91,91,235,3,1,175,368,266,368,12,1382,998
1730,11,1.2.144,0,582,1,46,144,190,144,0,190,273,-144,144,288,3,1,142,368,197,368,12,1382,998
1730,11,2.2.193,0,557,0,22,193,215,193,0,215,273,-193,193,337,3,1,117,368,144,368,12,1382,998
1730,11,3.1.273,1,557,0,80,273,353,166,107,353,353,0,144,144,2,6,190,80,245,209,12,1382,998
1730,11,4.2.122,0,592,2,78,122,200,122,0,200,273,-122,122,266,3,1,182,368,252,368,12,1382,998
1730,11,5.2.273,0,557,0,92,273,365,273,0,365,365,-273,273,417,3,1,192,368,278,368,12,1382,998
1730,12,0.2.91,1,557,0,74,91,165,91,0,165,353,-91,91,235,3,1,175,368,266,368,13,1382,918
1730,12,1.2.144,0,582,1,46,144,190,144,0,190,353,-144,144,288,3,1,142,368,197,368,13,1382,918
1730,12,2.2.193,0,557,0,22,193,215,193,0,215,353,-193,193,337,3,1,117,368,144,368,13,1382,918
1730,12,3.2.353,0,601,3,56,353,409,353,0,409,409,-353,353,497,3,1,110,368,245,368,13,1382,918
1730,12,4.2.122,0,592,2,78,122,200,122,0,200,353,-122,122,266,3,1,182,368,252,368,13,1382,918
1730,12,5.2.273,0,557,0,92,273,365,273,0,365,365,-273,273,417,3,1,192,368,278,368,13,1382,918
1730,13,0.3.165,0,557,0,85,165,250,165,0,250,353,-165,165,400,4,1,101,385,266,385,14,1382,844
1730,13,1.2.165,1,557,0,46,165,211,144,21,211,353,0,91,235,3,2,142,294,197,368,14,1382,844
1730,13,2.2.193,0,557,0,22,193,215,193,0,215,353,-28,119,263,3,2,117,294,144,368,14,1382,844
1730,13,3.2.353,0,601,1,56,353,409,353,0,409,409,-188,279,423,3,2,110,294,245,368,14,1382,844
1730,13,4.2.165,0,557,0,78,165,243,122,43,243,353,0,91,235,3,2,182,294,252,368,14,1382,844
1730,13,5.2.273,0,557,0,92,273,365,273,0,365,365,-108,199,343,3,2,192,294,278,368,14,1382,844
1730,14,0.3.165,0,557,0,85,165,250,165,0,250,353,-165,165,400,4,1,101,385,266,385,15,1382,798
1730,14,1.3.211,0,603,3,51,211,262,211,0,262,353,-211,211,446,4,1,96,385,197,385,15,1382,798
1730,14,2.2.211,0,557,0,22,211,233,193,18,233,353,0,91,235,3,3,117,248,144,368,15,1382,798
1730,14,3.2.353,0,601,2,56,353,409,353,0,409,409,-142,233,377,3,3,110,248,245,368,15,1382,798
1730,14,4.2.211,1,557,0,78,211,289,122,89,289,353,0,91,235,3,3,182,248,252,368,15,1382,798
1730,14,5.2.273,0,565,1,92,273,365,273,0,365,365,-62,153,297,3,3,192,248,278,368,15,1382,798
1730,15,0.3.165,0,557,0,85,165,250,165,0,250,353,-165,165,400,4,1,101,385,266,385,16,1382,720
1730,15,1.3.211,0,603,4,51,211,262,211,0,262,353,-211,211,446,4,1,96,385,197,385,16,1382,720
1730,15,2.2.289,1,557,0,22,289,311,193,96,311,353,0,91,235,3,4,117,170,144,368,16,1382,720
1730,15,3.2.353,0,601,3,56,353,409,353,0,409,409,-64,155,299,3,4,110,170,245,368,16,1382,720
1730,15,4.3.289,0,596,2,68,289,357,289,0,357,357,-289,289,524,4,1,104,385,252,385,16,1382,720
1730,15,5.2.289,0,569,1,92,289,381,273,16,381,381,0,91,235,3,4,192,170,278,368,16,1382,720
1730,16,0.3.165,0,557,0,85,165,250,165,0,250,353,-165,165,400,4,1,101,385,266,385,17,1382,698
1730,16,1.3.211,0,603,4,51,211,262,211,0,262,353,-211,211,446,4,1,96,385,197,385,17,1382,698
1730,16,2.3.311,0,567,1,76,311,387,311,0,387,387,-311,311,546,4,1,95,385,144,385,17,1382,698
1730,16,3.2.353,0,601,3,56,353,409,353,0,409,409,-42,133,277,3,5,110,148,245,368,17,1382,698
1730,16,4.3.289,0,596,2,68,289,357,289,0,357,357,-289,289,524,4,1,104,385,252,385,17,1382,698
1730,16,5.2.311,1,557,0,92,311,403,273,38,403,403,0,91,235,3,5,192,148,278,368,17,1382,698
1730,17,0.3.165,0,557,0,85,165,250,165,0,250,403,-165,165,400,4,1,101,385,266,385,18,1382,606
1730,17,1.3.211,0,603,4,51,211,262,211,0,262,403,-211,211,446,4,1,96,385,197,385,18,1382,606
1730,17,2.3.311,0,567,1,76,311,387,311,0,387,403,-311,311,546,4,1,95,385,144,385,18,1382,606
1730,17,3.2.403,1,557,0,56,403,459,353,50,459,459,0,91,235,3,6,110,56,245,368,18,1382,606
1730,17,4.3.289,0,596,3,68,289,357,289,0,357,403,-289,289,524,4,1,104,385,252,385,18,1382,606
1730,17,5.3.403,0,583,2,58,403,461,403,0,461,461,-403,403,638,4,1,100,385,278,385,18,1382,606
1730,18,0.3.165,1,557,0,85,165,250,165,0,250,459,-165,165,400,4,1,101,385,266,385,19,1382,550
1730,18,1.3.211,0,603,4,51,211,262,211,0,262,459,-211,211,446,4,1,96,385,197,385,19,1382,550
1730,18,2.3.311,0,567,1,76,311,387,311,0,387,459,-311,311,546,4,1,95,385,144,385,19,1382,550
1730,18,3.3.459,0,606,5,47,459,506,459,0,506,506,-459,459,694,4,1,54,385,245,385,19,1382,550
1730,18,4.3.289,0,596,3,68,289,357,289,0,357,459,-289,289,524,4,1,104,385,252,385,19,1382,550
1730,18,5.3.403,0,583,2,58,403,461,403,0,461,461,-403,403,638,4,1,100,385,278,385,19,1382,550
1730,19,0.4.250,1,557,0,16,250,266,250,0,266,459,-250,250,650,5,1,16,165,266,165,20,1382,465
1730,19,1.3.250,0,557,0,51,250,301,211,39,301,459,0,165,400,4,2,96,300,197,385,20,1382,465
1730,19,2.3.311,0,567,1,76,311,387,311,0,387,459,-61,226,461,4,2,95,300,144,385,20,1382,465
1730,19,3.3.459,0,606,4,47,459,506,459,0,506,506,-209,374,609,4,2,54,300,245,385,20,1382,465
1730,19,4.3.289,0,596,3,68,289,357,289,0,357,459,-39,204,439,4,2,104,300,252,385,20,1382,465
1730,19,5.3.403,0,583,2,58,403,461,403,0,461,461,-153,318,553,4,2,100,300,278,385,20,1382,465
1730,20,1.3.250,1,557,0,51,250,301,211,39,301,459,0,165,650,4,2,96,300,197,385,21,1382,449
1730,20,2.3.311,0,567,1,76,311,387,311,0,387,459,-61,226,711,4,2,95,300,144,385,21,1382,449
1730,20,3.3.459,0,606,4,47,459,506,459,0,506,506,-209,374,859,4,2,54,300,245,385,21,1382,449
1730,20,4.3.289,0,596,3,68,289,357,289,0,357,459,-39,204,689,4,2,104,300,252,385,21,1382,449
1730,20,5.3.403,0,583,2,58,403,461,403,0,461,461,-153,318,803,4,2,100,300,278,385,21,1382,449
1730,21,1.4.301,1,557,0,45,301,346,301,0,346,459,-35,285,685,5,2,45,149,197,165,22,1382,398
1730,21,2.3.311,0,567,1,76,311,387,311,0,387,459,-10,175,660,4,3,95,249,144,385,22,1382,398
1730,21,3.3.459,0,606,3,47,459,506,459,0,506,506,-158,323,808,4,3,54,249,245,385,22,1382,398
1730,21,4.3.301,0,557,0,68,301,369,289,12,369,459,0,165,650,4,3,104,249,252,385,22,1382,398
1730,21,5.3.403,0,583,2,58,403,461,403,0,461,461,-102,267,752,4,3,100,249,278,385,22,1382,398
1730,22,2.3.311,0,567,1,76,311,387,311,0,387,459,-10,175,695,4,3,95,249,144,385,23,1382,353
1730,22,3.3.459,0,606,3,47,459,506,459,0,506,506,-158,323,843,4,3,54,249,245,385,23,1382,353
1730,22,4.3.301,1,557,0,68,301,369,289,12,369,459,0,165,685,4,3,104,249,252,385,23,1382,353
1730,22,5.3.403,0,583,2,58,403,461,403,0,461,461,-102,267,787,4,3,100,249,278,385,23,1382,353
1730,23,2.3.369,0,557,0,76,369,445,311,58,445,459,0,165,685,4,4,95,181,144,385,24,1382,285
1730,23,3.3.459,0,606,2,47,459,506,459,0,506,506,-90,255,775,4,4,54,181,245,385,24,1382,285
1730,23,4.4.369,1,557,0,36,369,405,369,0,405,459,-23,308,708,5,3,36,104,252,165,24,1382,285
1730,23,5.3.403,0,591,1,58,403,461,403,0,461,461,-34,199,719,4,4,100,181,278,385,24,1382,285
1730,24,2.3.369,0,557,0,76,369,445,311,58,445,459,0,165,708,4,4,95,181,144,385,25,1382,249
1730,24,3.3.459,0,606,2,47,459,506,459,0,506,506,-90,255,798,4,4,54,181,245,385,25,1382,249
1730,24,5.3.403,1,591,1,58,403,461,403,0,461,461,-34,199,742,4,4,100,181,278,385,25,1382,249
1730,25,2.3.461,0,591,0,76,461,537,311,150,537,537,0,199,742,4,5,95,123,144,385,26,1382,191
1730,25,3.3.461,0,603,1,47,461,508,459,2,508,508,0,199,742,4,5,54,123,245,385,26,1382,191
1730,25,5.4.461,1,591,0,42,461,503,461,0,503,503,-56,364,798,5,4,42,68,278,165,26,1382,191
1730,26,2.3.461,1,591,0,76,461,537,311,150,537,537,0,199,798,4,5,95,123,144,385,27,1382,149
1730,26,3.3.461,0,603,1,47,461,508,459,2,508,508,0,199,798,4,5,54,123,245,385,27,1382,149
1730,27,2.4.537,1,591,0,19,537,556,537,0,556,556,-34,398,832,5,5,19,26,144,165,28,1382,73
1730,27,3.3.537,0,591,0,47,537,584,459,78,584,584,0,199,798,4,6,54,47,245,385,28,1382,73
1730,28,3.3.537,1,591,0,47,537,584,459,78,584,584,0,199,832,4,6,54,47,245,385,29,1382,54
1730,29,3.4.584,1,591,0,7,584,591,584,0,591,591,-28,426,860,5,6,7,7,245,165,30,1382,7
